Chr	Start	End	Mutation	Size	Middle	Start_C	End_C	Mutations_C
chr1	248344775	248352775	248349077	8000	248348775	-4000	4000	302
chr1	143901977	143909977	143904312	8000	143905977	-4000	4000	-1665
chr1	152155228	152163228	152155595	8000	152159228	-4000	4000	-3633
chr1	149809693	149817693	149812291	8000	149813693	-4000	4000	-1402
chr1	152755561	152763561	152760603	8000	152759561	-4000	4000	1042
chr1	237886922	237894922	237890148	8000	237890922	-4000	4000	-774
chr1	46664855	46672855	46665282	8000	46668855	-4000	4000	-3573
chr1	247601586	247609586	247606502	8000	247605586	-4000	4000	916
chr1	42149410	42157410	42153516	8000	42153410	-4000	4000	106
chr1	149809693	149817693	149813390	8000	149813693	-4000	4000	-303
chr1	152111444	152119444	152111858	8000	152115444	-4000	4000	-3586
chr1	152715522	152723522	152719689	8000	152719522	-4000	4000	167
chr1	159950237	159958237	159951799	8000	159954237	-4000	4000	-2438
chr1	152410263	152418263	152410366	8000	152414263	-4000	4000	-3897
chr1	159710589	159718589	159714052	8000	159714589	-4000	4000	-537
chr1	165352715	165360715	165355718	8000	165356715	-4000	4000	-997
chr1	152755561	152763561	152760854	8000	152759561	-4000	4000	1293
chr1	204192491	204200491	204192813	8000	204196491	-4000	4000	-3678
chr1	156575723	156583723	156582289	8000	156579723	-4000	4000	2566
chr1	143901977	143909977	143904370	8000	143905977	-4000	4000	-1607
chr1	149883965	149891965	149886521	8000	149887965	-4000	4000	-1444
chr1	13052575	13060575	13053557	8000	13056575	-4000	4000	-3018
chr1	152802651	152810651	152805425	8000	152806651	-4000	4000	-1226
chr1	152802651	152810651	152805427	8000	152806651	-4000	4000	-1224
chr1	12787397	12795397	12793374	8000	12791397	-4000	4000	1977
chr1	248320568	248328568	248323712	8000	248324568	-4000	4000	-856
chr1	158750720	158758720	158754847	8000	158754720	-4000	4000	127
chr1	248469351	248477351	248473878	8000	248473351	-4000	4000	527
chr1	12912610	12920610	12920255	8000	12916610	-4000	4000	3645
chr1	155297438	155305438	155300985	8000	155301438	-4000	4000	-453
chr1	152562780	152570780	152566134	8000	152566780	-4000	4000	-646
chr1	173913327	173921327	173917228	8000	173917327	-4000	4000	-99
chr1	152755561	152763561	152760708	8000	152759561	-4000	4000	1147
chr1	173913327	173921327	173914814	8000	173917327	-4000	4000	-2513
chr1	241995098	242003098	241998820	8000	241999098	-4000	4000	-278
chr1	160077538	160085538	160084429	8000	160081538	-4000	4000	2891
chr1	1169880	1177880	1175652	8000	1173880	-4000	4000	1772
chr1	162372854	162380854	162373910	8000	162376854	-4000	4000	-2944
chr1	47133435	47141435	47137451	8000	47137435	-4000	4000	16
chr1	34755740	34763740	34762130	8000	34759740	-4000	4000	2390
chr1	248570757	248578757	248574629	8000	248574757	-4000	4000	-128
chr1	90713302	90721302	90714549	8000	90717302	-4000	4000	-2753
chr1	13367900	13375900	13370662	8000	13371900	-4000	4000	-1238
chr1	152356006	152364006	152357158	8000	152360006	-4000	4000	-2848
chr1	248141148	248149148	248145832	8000	248145148	-4000	4000	684
chr1	158682715	158690715	158683496	8000	158686715	-4000	4000	-3219
chr1	247734615	247742615	247738656	8000	247738615	-4000	4000	41
chr1	247961233	247969233	247965464	8000	247965233	-4000	4000	231
chr1	248320568	248328568	248324373	8000	248324568	-4000	4000	-195
chr1	12827410	12835410	12828773	8000	12831410	-4000	4000	-2637
chr1	63318567	63326567	63323864	8000	63322567	-4000	4000	1297
chr1	109615929	109623929	109620076	8000	109619929	-4000	4000	147
chr1	152755561	152763561	152760387	8000	152759561	-4000	4000	826
chr1	159433845	159441845	159440152	8000	159437845	-4000	4000	2307
chr1	114850863	114858863	114857232	8000	114854863	-4000	4000	2369
chr1	154317090	154325090	154321160	8000	154321090	-4000	4000	70
chr1	153067611	153075611	153070589	8000	153071611	-4000	4000	-1022
chr1	153067611	153075611	153070590	8000	153071611	-4000	4000	-1021
chr1	54014186	54022186	54014241	8000	54018186	-4000	4000	-3945
chr1	212620474	212628474	212624988	8000	212624474	-4000	4000	514
chr1	152085064	152093064	152085532	8000	152089064	-4000	4000	-3532
chr1	13343134	13351134	13344486	8000	13347134	-4000	4000	-2648
chr1	160858887	160866887	160862648	8000	160862887	-4000	4000	-239
chr1	152085064	152093064	152087375	8000	152089064	-4000	4000	-1689
chr1	152981231	152989231	152985248	8000	152985231	-4000	4000	17
chr1	248320568	248328568	248324409	8000	248324568	-4000	4000	-159
chr1	158682715	158690715	158685194	8000	158686715	-4000	4000	-1521
chr1	247601586	247609586	247606019	8000	247605586	-4000	4000	433
chr1	212620474	212628474	212625525	8000	212624474	-4000	4000	1051
chr1	248469351	248477351	248473842	8000	248473351	-4000	4000	491
chr1	248570757	248578757	248574266	8000	248574757	-4000	4000	-491
chr1	6551307	6559307	6555500	8000	6555307	-4000	4000	193
chr1	12894270	12902270	12894844	8000	12898270	-4000	4000	-3426
chr1	15461909	15469909	15462851	8000	15465909	-4000	4000	-3058
chr1	154151116	154159116	154152851	8000	154155116	-4000	4000	-2265
chr1	158575899	158583899	158579068	8000	158579899	-4000	4000	-831
chr1	206113699	206121699	206116273	8000	206117699	-4000	4000	-1426
chr1	159433845	159441845	159439989	8000	159437845	-4000	4000	2144
chr1	13281174	13289174	13283994	8000	13285174	-4000	4000	-1180
chr1	156333314	156341314	156335839	8000	156337314	-4000	4000	-1475
chr1	153037931	153045931	153040045	8000	153041931	-4000	4000	-1886
chr1	247837896	247845896	247841030	8000	247841896	-4000	4000	-866
chr1	247837896	247845896	247841354	8000	247841896	-4000	4000	-542
chr1	247837896	247845896	247841527	8000	247841896	-4000	4000	-369
chr1	16014875	16022875	16022691	8000	16018875	-4000	4000	3816
chr1	21973022	21981022	21977058	8000	21977022	-4000	4000	36
chr1	46937484	46945484	46941269	8000	46941484	-4000	4000	-215
chr1	53138638	53146638	53142439	8000	53142638	-4000	4000	-199
chr1	54994933	55002933	54999252	8000	54998933	-4000	4000	319
chr1	143901977	143909977	143904286	8000	143905977	-4000	4000	-1691
chr1	149809693	149817693	149813683	8000	149813693	-4000	4000	-10
chr1	152823473	152831473	152827647	8000	152827473	-4000	4000	174
chr1	152981231	152989231	152985239	8000	152985231	-4000	4000	8
chr1	154202333	154210333	154205607	8000	154206333	-4000	4000	-726
chr1	156811640	156819640	156816747	8000	156815640	-4000	4000	1107
chr1	158575899	158583899	158579172	8000	158579899	-4000	4000	-727
chr1	158696652	158704652	158700212	8000	158700652	-4000	4000	-440
chr1	158716720	158724720	158717691	8000	158720720	-4000	4000	-3029
chr1	160950809	160958809	160951179	8000	160954809	-4000	4000	-3630
chr1	206019909	206027909	206023783	8000	206023909	-4000	4000	-126
chr1	248399048	248407048	248406130	8000	248403048	-4000	4000	3082
chr1	149883965	149891965	149886301	8000	149887965	-4000	4000	-1664
chr1	152576516	152584516	152579700	8000	152580516	-4000	4000	-816
chr1	15434442	15442442	15440549	8000	15438442	-4000	4000	2107
chr1	248141148	248149148	248146012	8000	248145148	-4000	4000	864
chr1	152694345	152702345	152699106	8000	152698345	-4000	4000	761
chr1	248357665	248365665	248361800	8000	248361665	-4000	4000	135
chr1	223389415	223397415	223395420	8000	223393415	-4000	4000	2005
chr1	152659380	152667380	152664639	8000	152663380	-4000	4000	1259
chr1	152220193	152228193	152220443	8000	152224193	-4000	4000	-3750
chr1	152682123	152690123	152686948	8000	152686123	-4000	4000	825
chr1	12912610	12920610	12919908	8000	12916610	-4000	4000	3298
chr1	13222106	13230106	13225258	8000	13226106	-4000	4000	-848
chr1	149809693	149817693	149813650	8000	149813693	-4000	4000	-43
chr1	159433845	159441845	159439980	8000	159437845	-4000	4000	2135
chr1	247601586	247609586	247606140	8000	247605586	-4000	4000	554
chr1	54014186	54022186	54014243	8000	54018186	-4000	4000	-3943
chr1	48218685	48226685	48222895	8000	48222685	-4000	4000	210
chr1	227811693	227819693	227817411	8000	227815693	-4000	4000	1718
chr1	227811693	227819693	227817412	8000	227815693	-4000	4000	1719
chr1	26186561	26194561	26188249	8000	26190561	-4000	4000	-2312
chr1	26186561	26194561	26191385	8000	26190561	-4000	4000	824
chr1	158682715	158690715	158685147	8000	158686715	-4000	4000	-1568
chr1	12894270	12902270	12894849	8000	12898270	-4000	4000	-3421
chr1	15738499	15746499	15738725	8000	15742499	-4000	4000	-3774
chr1	33856475	33864475	33864426	8000	33860475	-4000	4000	3951
chr1	158327531	158335531	158329857	8000	158331531	-4000	4000	-1674
chr1	17368196	17376196	17375491	8000	17372196	-4000	4000	3295
chr1	63318567	63326567	63323738	8000	63322567	-4000	4000	1171
chr1	237000441	237008441	237004351	8000	237004441	-4000	4000	-90
chr1	66797276	66805276	66801146	8000	66801276	-4000	4000	-130
chr1	158395466	158403466	158398919	8000	158399466	-4000	4000	-547
chr1	248570757	248578757	248574673	8000	248574757	-4000	4000	-84
chr1	212620474	212628474	212626288	8000	212624474	-4000	4000	1814
chr1	119892515	119900515	119895973	8000	119896515	-4000	4000	-542
chr1	13343134	13351134	13344568	8000	13347134	-4000	4000	-2566
chr1	160363071	160371071	160370945	8000	160367071	-4000	4000	3874
chr1	63318567	63326567	63323535	8000	63322567	-4000	4000	968
chr1	152755561	152763561	152760163	8000	152759561	-4000	4000	602
chr1	158696652	158704652	158699703	8000	158700652	-4000	4000	-949
chr1	237000441	237008441	237004406	8000	237004441	-4000	4000	-35
chr1	152704160	152712160	152709178	8000	152708160	-4000	4000	1018
chr1	149809693	149817693	149812264	8000	149813693	-4000	4000	-1429
chr1	3017467	3025467	3022597	8000	3021467	-4000	4000	1130
chr1	158682715	158690715	158685193	8000	158686715	-4000	4000	-1522
chr1	247920889	247928889	247921061	8000	247924889	-4000	4000	-3828
chr1	17368196	17376196	17373080	8000	17372196	-4000	4000	884
chr1	152356006	152364006	152356896	8000	152360006	-4000	4000	-3110
chr1	159710589	159718589	159714065	8000	159714589	-4000	4000	-524
chr1	13367900	13375900	13369361	8000	13371900	-4000	4000	-2539
chr1	248469351	248477351	248474279	8000	248473351	-4000	4000	928
chr1	103613427	103621427	103618070	8000	103617427	-4000	4000	643
chr1	13281174	13289174	13281830	8000	13285174	-4000	4000	-3344
chr1	158777204	158785204	158777254	8000	158781204	-4000	4000	-3950
chr1	17304195	17312195	17308202	8000	17308195	-4000	4000	7
chr1	165540000	165548000	165544244	8000	165544000	-4000	4000	244
chr1	156855117	156863117	156858719	8000	156859117	-4000	4000	-398
chr1	75124434	75132434	75130504	8000	75128434	-4000	4000	2070
chr1	157773132	157781132	157777077	8000	157777132	-4000	4000	-55
chr1	158682715	158690715	158683381	8000	158686715	-4000	4000	-3334
chr1	159710589	159718589	159713428	8000	159714589	-4000	4000	-1161
chr1	159950237	159958237	159953619	8000	159954237	-4000	4000	-618
chr1	158327531	158335531	158330843	8000	158331531	-4000	4000	-688
chr1	248344775	248352775	248349667	8000	248348775	-4000	4000	892
chr1	241995098	242003098	241996309	8000	241999098	-4000	4000	-2789
chr1	158327531	158335531	158328255	8000	158331531	-4000	4000	-3276
chr1	32205089	32213089	32207922	8000	32209089	-4000	4000	-1167
chr1	247944858	247952858	247949648	8000	247948858	-4000	4000	790
chr1	159532007	159540007	159535654	8000	159536007	-4000	4000	-353
chr1	152755561	152763561	152760599	8000	152759561	-4000	4000	1038
chr1	153199430	153207430	153204755	8000	153203430	-4000	4000	1325
chr1	156575723	156583723	156582283	8000	156579723	-4000	4000	2560
chr1	248320568	248328568	248323865	8000	248324568	-4000	4000	-703
chr1	152838856	152846856	152843592	8000	152842856	-4000	4000	736
chr1	12787397	12795397	12793336	8000	12791397	-4000	4000	1939
chr1	54994933	55002933	54999271	8000	54998933	-4000	4000	338
chr1	152510482	152518482	152515995	8000	152514482	-4000	4000	1513
chr1	158682715	158690715	158683486	8000	158686715	-4000	4000	-3229
chr1	247944858	247952858	247949366	8000	247948858	-4000	4000	508
chr1	248320568	248328568	248324545	8000	248324568	-4000	4000	-23
chr1	247961233	247969233	247966248	8000	247965233	-4000	4000	1015
chr1	114850863	114858863	114857454	8000	114854863	-4000	4000	2591
chr1	12882201	12890201	12883123	8000	12886201	-4000	4000	-3078
chr1	158716720	158724720	158717999	8000	158720720	-4000	4000	-2721
chr1	109535872	109543872	109543791	8000	109539872	-4000	4000	3919
chr1	170141959	170149959	170146145	8000	170145959	-4000	4000	186
chr1	62593520	62601520	62601137	8000	62597520	-4000	4000	3617
chr1	247584360	247592360	247589082	8000	247588360	-4000	4000	722
chr1	152802651	152810651	152805437	8000	152806651	-4000	4000	-1214
chr1	18855682	18863682	18859626	8000	18859682	-4000	4000	-56
chr1	152576516	152584516	152579947	8000	152580516	-4000	4000	-569
chr1	248141148	248149148	248145448	8000	248145148	-4000	4000	300
chr1	248469351	248477351	248473712	8000	248473351	-4000	4000	361
chr1	149809693	149817693	149812029	8000	149813693	-4000	4000	-1664
chr1	149809693	149817693	149812186	8000	149813693	-4000	4000	-1507
chr1	149809693	149817693	149812364	8000	149813693	-4000	4000	-1329
chr1	158327531	158335531	158330016	8000	158331531	-4000	4000	-1515
chr1	168539997	168547997	168543955	8000	168543997	-4000	4000	-42
chr1	46937484	46945484	46941380	8000	46941484	-4000	4000	-104
chr1	207084860	207092860	207089567	8000	207088860	-4000	4000	707
chr1	247920889	247928889	247921336	8000	247924889	-4000	4000	-3553
chr1	248570757	248578757	248574378	8000	248574757	-4000	4000	-379
chr1	152596234	152604234	152600671	8000	152600234	-4000	4000	437
chr1	63318567	63326567	63323146	8000	63322567	-4000	4000	579
chr1	152807971	152815971	152812928	8000	152811971	-4000	4000	957
chr1	160950809	160958809	160951046	8000	160954809	-4000	4000	-3763
chr1	103613427	103621427	103619018	8000	103617427	-4000	4000	1591
chr1	158575899	158583899	158579093	8000	158579899	-4000	4000	-806
chr1	159532007	159540007	159535348	8000	159536007	-4000	4000	-659
chr1	247601586	247609586	247606087	8000	247605586	-4000	4000	501
chr1	27388622	27396622	27394609	8000	27392622	-4000	4000	1987
chr1	158601268	158609268	158606553	8000	158605268	-4000	4000	1285
chr1	228421360	228429360	228424867	8000	228425360	-4000	4000	-493
chr1	207084860	207092860	207089549	8000	207088860	-4000	4000	689
chr1	158327531	158335531	158329622	8000	158331531	-4000	4000	-1909
chr1	167090075	167098075	167094855	8000	167094075	-4000	4000	780
chr1	153199430	153207430	153204712	8000	153203430	-4000	4000	1282
chr1	15732258	15740258	15736717	8000	15736258	-4000	4000	459
chr1	46664855	46672855	46665372	8000	46668855	-4000	4000	-3483
chr1	56850797	56858797	56854869	8000	56854797	-4000	4000	72
chr1	149883965	149891965	149886455	8000	149887965	-4000	4000	-1510
chr1	154498219	154506219	154499236	8000	154502219	-4000	4000	-2983
chr1	223389415	223397415	223394880	8000	223393415	-4000	4000	1465
chr1	47412285	47420285	47416684	8000	47416285	-4000	4000	399
chr1	158750720	158758720	158755204	8000	158754720	-4000	4000	484
chr1	247944858	247952858	247949043	8000	247948858	-4000	4000	185
chr1	159710589	159718589	159713937	8000	159714589	-4000	4000	-652
chr1	206113699	206121699	206116505	8000	206117699	-4000	4000	-1194
chr1	200868981	200876981	200873987	8000	200872981	-4000	4000	1006
chr1	42149410	42157410	42155548	8000	42153410	-4000	4000	2138
chr1	12882201	12890201	12883340	8000	12886201	-4000	4000	-2861
chr1	16014875	16022875	16015581	8000	16018875	-4000	4000	-3294
chr1	38042793	38050793	38045687	8000	38046793	-4000	4000	-1106
chr1	152155228	152163228	152156543	8000	152159228	-4000	4000	-2685
chr1	207084860	207092860	207089443	8000	207088860	-4000	4000	583
chr1	158327531	158335531	158328045	8000	158331531	-4000	4000	-3486
chr1	158601268	158609268	158607189	8000	158605268	-4000	4000	1921
chr1	152111444	152119444	152112664	8000	152115444	-4000	4000	-2780
chr1	44803351	44811351	44810262	8000	44807351	-4000	4000	2911
chr1	158682715	158690715	158683374	8000	158686715	-4000	4000	-3341
chr1	248469351	248477351	248474151	8000	248473351	-4000	4000	800
chr1	248631091	248639091	248638511	8000	248635091	-4000	4000	3420
chr1	12853086	12861086	12860210	8000	12857086	-4000	4000	3124
chr1	152755561	152763561	152760619	8000	152759561	-4000	4000	1058
chr1	44803351	44811351	44810302	8000	44807351	-4000	4000	2951
chr1	197264204	197272204	197268401	8000	197268204	-4000	4000	197
chr1	15461909	15469909	15467496	8000	15465909	-4000	4000	1587
chr1	152755561	152763561	152761309	8000	152759561	-4000	4000	1748
chr1	152356006	152364006	152356023	8000	152360006	-4000	4000	-3983
chr1	149883965	149891965	149886630	8000	149887965	-4000	4000	-1335
chr1	152715522	152723522	152719800	8000	152719522	-4000	4000	278
chr1	153109516	153117516	153112592	8000	153113516	-4000	4000	-924
chr1	248570757	248578757	248574114	8000	248574757	-4000	4000	-643
chr1	228421360	228429360	228424886	8000	228425360	-4000	4000	-474
chr1	247734615	247742615	247739555	8000	247738615	-4000	4000	940
chr1	248344775	248352775	248349485	8000	248348775	-4000	4000	710
chr1	54994933	55002933	54999223	8000	54998933	-4000	4000	290
chr1	158716720	158724720	158717701	8000	158720720	-4000	4000	-3019
chr1	158696652	158704652	158700037	8000	158700652	-4000	4000	-615
chr1	247584360	247592360	247588797	8000	247588360	-4000	4000	437
chr1	153435949	153443949	153438312	8000	153439949	-4000	4000	-1637
chr1	12827410	12835410	12827599	8000	12831410	-4000	4000	-3811
chr1	152111444	152119444	152112738	8000	152115444	-4000	4000	-2706
chr1	152111444	152119444	152111445	8000	152115444	-4000	4000	-3999
chr1	223389415	223397415	223394597	8000	223393415	-4000	4000	1182
chr1	247601586	247609586	247605662	8000	247605586	-4000	4000	76
chr1	248570757	248578757	248574470	8000	248574757	-4000	4000	-287
chr1	153371621	153379621	153373793	8000	153375621	-4000	4000	-1828
chr1	159433845	159441845	159440469	8000	159437845	-4000	4000	2624
chr1	237886922	237894922	237888466	8000	237890922	-4000	4000	-2456
chr1	159710589	159718589	159713744	8000	159714589	-4000	4000	-845
chr1	237886922	237894922	237889932	8000	237890922	-4000	4000	-990
chr1	152802651	152810651	152805443	8000	152806651	-4000	4000	-1208
chr1	158750720	158758720	158755244	8000	158754720	-4000	4000	524
chr1	90713302	90721302	90716977	8000	90717302	-4000	4000	-325
chr1	159433845	159441845	159440213	8000	159437845	-4000	4000	2368
chr1	13385632	13393632	13389926	8000	13389632	-4000	4000	294
chr1	206766764	206774764	206768660	8000	206770764	-4000	4000	-2104
chr1	75928404	75936404	75932102	8000	75932404	-4000	4000	-302
chr1	158327531	158335531	158329585	8000	158331531	-4000	4000	-1946
chr1	248570757	248578757	248574714	8000	248574757	-4000	4000	-43
chr1	12827410	12835410	12827750	8000	12831410	-4000	4000	-3660
chr1	149883965	149891965	149886215	8000	149887965	-4000	4000	-1750
chr1	237886922	237894922	237888391	8000	237890922	-4000	4000	-2531
chr1	24139140	24147140	24143118	8000	24143140	-4000	4000	-22
chr1	153308952	153316952	153310621	8000	153312952	-4000	4000	-2331
chr1	173913327	173921327	173914882	8000	173917327	-4000	4000	-2445
chr1	158696652	158704652	158700193	8000	158700652	-4000	4000	-459
chr1	149883965	149891965	149886087	8000	149887965	-4000	4000	-1878
chr1	154202333	154210333	154207625	8000	154206333	-4000	4000	1292
chr1	21973022	21981022	21978410	8000	21977022	-4000	4000	1388
chr1	114691618	114699618	114693449	8000	114695618	-4000	4000	-2169
chr1	119807580	119815580	119808844	8000	119811580	-4000	4000	-2736
chr1	33856475	33864475	33864457	8000	33860475	-4000	4000	3982
chr1	244450377	244458377	244451797	8000	244454377	-4000	4000	-2580
chr1	16014875	16022875	16015435	8000	16018875	-4000	4000	-3440
chr1	237886922	237894922	237888472	8000	237890922	-4000	4000	-2450
chr1	21973022	21981022	21978429	8000	21977022	-4000	4000	1407
chr1	247920889	247928889	247921268	8000	247924889	-4000	4000	-3621
chr1	34755740	34763740	34762613	8000	34759740	-4000	4000	2873
chr1	109535872	109543872	109543751	8000	109539872	-4000	4000	3879
chr1	158327531	158335531	158328131	8000	158331531	-4000	4000	-3400
chr1	12912610	12920610	12917884	8000	12916610	-4000	4000	1274
chr1	248344775	248352775	248349323	8000	248348775	-4000	4000	548
chr1	158750720	158758720	158755706	8000	158754720	-4000	4000	986
chr1	167090075	167098075	167094941	8000	167094075	-4000	4000	866
chr1	247734615	247742615	247738656	8000	247738615	-4000	4000	41
chr1	12882201	12890201	12882424	8000	12886201	-4000	4000	-3777
chr1	108708908	108716908	108713516	8000	108712908	-4000	4000	608
chr1	248399048	248407048	248406748	8000	248403048	-4000	4000	3700
chr1	152155228	152163228	152156838	8000	152159228	-4000	4000	-2390
chr1	149809693	149817693	149813574	8000	149813693	-4000	4000	-119
chr1	149883965	149891965	149886428	8000	149887965	-4000	4000	-1537
chr1	3017467	3025467	3022696	8000	3021467	-4000	4000	1229
chr1	115839917	115847917	115840238	8000	115843917	-4000	4000	-3679
chr1	149883965	149891965	149886569	8000	149887965	-4000	4000	-1396
chr1	152619103	152627103	152623023	8000	152623103	-4000	4000	-80
chr1	247837896	247845896	247841124	8000	247841896	-4000	4000	-772
chr1	33856475	33864475	33864329	8000	33860475	-4000	4000	3854
chr1	149883965	149891965	149886378	8000	149887965	-4000	4000	-1587
chr1	158327531	158335531	158331369	8000	158331531	-4000	4000	-162
chr1	158716720	158724720	158717630	8000	158720720	-4000	4000	-3090
chr1	247944858	247952858	247949380	8000	247948858	-4000	4000	522
chr1	152356006	152364006	152356868	8000	152360006	-4000	4000	-3138
chr1	247584360	247592360	247588944	8000	247588360	-4000	4000	584
chr1	152356006	152364006	152356338	8000	152360006	-4000	4000	-3668
chr1	170141959	170149959	170146117	8000	170145959	-4000	4000	158
chr1	13343134	13351134	13344592	8000	13347134	-4000	4000	-2542
chr1	90713302	90721302	90714663	8000	90717302	-4000	4000	-2639
chr1	109535872	109543872	109543727	8000	109539872	-4000	4000	3855
chr1	12769738	12777738	12775671	8000	12773738	-4000	4000	1933
chr1	152085064	152093064	152085302	8000	152089064	-4000	4000	-3762
chr1	237886922	237894922	237888427	8000	237890922	-4000	4000	-2495
chr1	33856475	33864475	33864453	8000	33860475	-4000	4000	3978
chr1	152659380	152667380	152664564	8000	152663380	-4000	4000	1184
chr1	173046941	173054941	173050784	8000	173050941	-4000	4000	-157
chr1	75792882	75800882	75797098	8000	75796882	-4000	4000	216
chr1	114850863	114858863	114855474	8000	114854863	-4000	4000	611
chr1	162372854	162380854	162376700	8000	162376854	-4000	4000	-154
chr1	212620474	212628474	212625940	8000	212624474	-4000	4000	1466
chr1	212620474	212628474	212626351	8000	212624474	-4000	4000	1877
chr1	223389415	223397415	223395470	8000	223393415	-4000	4000	2055
chr1	227811693	227819693	227816099	8000	227815693	-4000	4000	406
chr1	248357665	248365665	248362579	8000	248361665	-4000	4000	914
chr1	12787397	12795397	12794014	8000	12791397	-4000	4000	2617
chr1	34755740	34763740	34761897	8000	34759740	-4000	4000	2157
chr1	153067611	153075611	153070538	8000	153071611	-4000	4000	-1073
chr1	159532007	159540007	159535322	8000	159536007	-4000	4000	-685
chr1	42736254	42744254	42738237	8000	42740254	-4000	4000	-2017
chr1	152410263	152418263	152410681	8000	152414263	-4000	4000	-3582
chr1	247961233	247969233	247965505	8000	247965233	-4000	4000	272
chr1	153067611	153075611	153070576	8000	153071611	-4000	4000	-1035
chr1	152356006	152364006	152357216	8000	152360006	-4000	4000	-2790
chr1	152755561	152763561	152760400	8000	152759561	-4000	4000	839
chr1	152807971	152815971	152813070	8000	152811971	-4000	4000	1099
chr1	153067611	153075611	153070595	8000	153071611	-4000	4000	-1016
chr1	223389415	223397415	223395126	8000	223393415	-4000	4000	1711
chr1	109535872	109543872	109543774	8000	109539872	-4000	4000	3902
chr1	110515175	110523175	110518687	8000	110519175	-4000	4000	-488
chr1	247944858	247952858	247949110	8000	247948858	-4000	4000	252
chr1	13299539	13307539	13305985	8000	13303539	-4000	4000	2446
chr1	32205089	32213089	32207899	8000	32209089	-4000	4000	-1190
chr1	34755740	34763740	34761905	8000	34759740	-4000	4000	2165
chr1	152085064	152093064	152088045	8000	152089064	-4000	4000	-1019
chr1	153435949	153443949	153438198	8000	153439949	-4000	4000	-1751
chr1	216419448	216427448	216422285	8000	216423448	-4000	4000	-1163
chr1	152755561	152763561	152760711	8000	152759561	-4000	4000	1150
chr1	156333314	156341314	156333640	8000	156337314	-4000	4000	-3674
chr1	160950809	160958809	160954762	8000	160954809	-4000	4000	-47
chr1	228421360	228429360	228425148	8000	228425360	-4000	4000	-212
chr1	237886922	237894922	237889939	8000	237890922	-4000	4000	-983
chr1	247944858	247952858	247949709	8000	247948858	-4000	4000	851
chr1	247961233	247969233	247966137	8000	247965233	-4000	4000	904
chr1	248631091	248639091	248638737	8000	248635091	-4000	4000	3646
chr1	2526263	2534263	2526579	8000	2530263	-4000	4000	-3684
chr1	50419443	50427443	50419567	8000	50423443	-4000	4000	-3876
chr1	110515175	110523175	110518220	8000	110519175	-4000	4000	-955
chr1	149809693	149817693	149813390	8000	149813693	-4000	4000	-303
chr1	158716720	158724720	158717625	8000	158720720	-4000	4000	-3095
chr1	167910215	167918215	167918197	8000	167914215	-4000	4000	3982
chr1	242520697	242528697	242524220	8000	242524697	-4000	4000	-477
chr1	247584360	247592360	247589196	8000	247588360	-4000	4000	836
chr1	248399048	248407048	248406062	8000	248403048	-4000	4000	3014
chr1	110515175	110523175	110517770	8000	110519175	-4000	4000	-1405
chr1	152576516	152584516	152579744	8000	152580516	-4000	4000	-772
chr1	182949525	182957525	182951339	8000	182953525	-4000	4000	-2186
chr1	206113699	206121699	206116683	8000	206117699	-4000	4000	-1016
chr1	247891587	247899587	247896103	8000	247895587	-4000	4000	516
chr1	247920889	247928889	247921650	8000	247924889	-4000	4000	-3239
chr1	156333314	156341314	156338309	8000	156337314	-4000	4000	995
chr1	152704160	152712160	152709062	8000	152708160	-4000	4000	902
chr1	152782214	152790214	152787347	8000	152786214	-4000	4000	1133
chr1	165441355	165449355	165445036	8000	165445355	-4000	4000	-319
chr1	38042793	38050793	38044515	8000	38046793	-4000	4000	-2278
chr1	13222106	13230106	13224962	8000	13226106	-4000	4000	-1144
chr1	12769738	12777738	12775078	8000	12773738	-4000	4000	1340
chr1	152576516	152584516	152579752	8000	152580516	-4000	4000	-764
chr1	152085064	152093064	152086181	8000	152089064	-4000	4000	-2883
chr1	247837896	247845896	247841830	8000	247841896	-4000	4000	-66
chr1	13412351	13420351	13418663	8000	13416351	-4000	4000	2312
chr1	205846132	205854132	205850083	8000	205850132	-4000	4000	-49
chr1	26909975	26917975	26913784	8000	26913975	-4000	4000	-191
chr1	247584360	247592360	247588899	8000	247588360	-4000	4000	539
chr1	158696652	158704652	158700567	8000	158700652	-4000	4000	-85
chr1	248344775	248352775	248349146	8000	248348775	-4000	4000	371
chr1	158601268	158609268	158607344	8000	158605268	-4000	4000	2076
chr1	13412351	13420351	13418138	8000	13416351	-4000	4000	1787
chr1	159532007	159540007	159535643	8000	159536007	-4000	4000	-364
chr1	223389415	223397415	223394180	8000	223393415	-4000	4000	765
chr1	248484589	248492589	248488670	8000	248488589	-4000	4000	81
chr1	206113699	206121699	206116373	8000	206117699	-4000	4000	-1326
chr1	223389415	223397415	223394199	8000	223393415	-4000	4000	784
chr1	24139140	24147140	24143066	8000	24143140	-4000	4000	-74
chr1	19660875	19668875	19666068	8000	19664875	-4000	4000	1193
chr1	179361720	179369720	179366539	8000	179365720	-4000	4000	819
chr1	152755561	152763561	152759824	8000	152759561	-4000	4000	263
chr1	159950237	159958237	159953546	8000	159954237	-4000	4000	-691
chr1	13299539	13307539	13306874	8000	13303539	-4000	4000	3335
chr1	152155228	152163228	152156637	8000	152159228	-4000	4000	-2591
chr1	12827410	12835410	12827630	8000	12831410	-4000	4000	-3780
chr1	247601586	247609586	247605741	8000	247605586	-4000	4000	155
chr1	152755561	152763561	152761163	8000	152759561	-4000	4000	1602
chr1	119892515	119900515	119895998	8000	119896515	-4000	4000	-517
chr1	152823473	152831473	152827544	8000	152827473	-4000	4000	71
chr1	53138638	53146638	53142365	8000	53142638	-4000	4000	-273
chr1	223389415	223397415	223394655	8000	223393415	-4000	4000	1240
chr1	158750720	158758720	158755304	8000	158754720	-4000	4000	584
chr1	160950809	160958809	160951247	8000	160954809	-4000	4000	-3562
chr1	228421360	228429360	228425051	8000	228425360	-4000	4000	-309
chr1	152356006	152364006	152357485	8000	152360006	-4000	4000	-2521
chr1	152220193	152228193	152223197	8000	152224193	-4000	4000	-996
chr1	154498219	154506219	154501541	8000	154502219	-4000	4000	-678
chr1	207084860	207092860	207090457	8000	207088860	-4000	4000	1597
chr1	248320568	248328568	248324222	8000	248324568	-4000	4000	-346
chr1	244450377	244458377	244451866	8000	244454377	-4000	4000	-2511
chr1	160950809	160958809	160952663	8000	160954809	-4000	4000	-2146
chr1	168539997	168547997	168540895	8000	168543997	-4000	4000	-3102
chr1	247944858	247952858	247949714	8000	247948858	-4000	4000	856
chr1	153146890	153154890	153150063	8000	153150890	-4000	4000	-827
chr1	152596234	152604234	152600928	8000	152600234	-4000	4000	694
chr1	247961233	247969233	247965541	8000	247965233	-4000	4000	308
chr1	248399048	248407048	248406492	8000	248403048	-4000	4000	3444
chr1	34755740	34763740	34758020	8000	34759740	-4000	4000	-1720
chr1	158601268	158609268	158606955	8000	158605268	-4000	4000	1687
chr1	152111444	152119444	152113015	8000	152115444	-4000	4000	-2429
chr1	248344775	248352775	248349046	8000	248348775	-4000	4000	271
chr1	40241947	40249947	40248138	8000	40245947	-4000	4000	2191
chr1	13222106	13230106	13226029	8000	13226106	-4000	4000	-77
chr1	12640085	12648085	12644556	8000	12644085	-4000	4000	471
chr1	152155228	152163228	152155566	8000	152159228	-4000	4000	-3662
chr1	152802651	152810651	152805125	8000	152806651	-4000	4000	-1526
chr1	247734615	247742615	247739449	8000	247738615	-4000	4000	834
chr1	152220193	152228193	152220286	8000	152224193	-4000	4000	-3907
chr1	152220193	152228193	152221289	8000	152224193	-4000	4000	-2904
chr1	109109857	109117857	109114315	8000	109113857	-4000	4000	458
chr1	248570757	248578757	248574033	8000	248574757	-4000	4000	-724
chr1	153067611	153075611	153070744	8000	153071611	-4000	4000	-867
chr1	162372854	162380854	162374105	8000	162376854	-4000	4000	-2749
chr1	159869053	159877053	159876701	8000	159873053	-4000	4000	3648
chr1	248469351	248477351	248473958	8000	248473351	-4000	4000	607
chr1	248469351	248477351	248473959	8000	248473351	-4000	4000	608
chr1	44803351	44811351	44810265	8000	44807351	-4000	4000	2914
chr1	13343134	13351134	13345264	8000	13347134	-4000	4000	-1870
chr1	13367900	13375900	13369456	8000	13371900	-4000	4000	-2444
chr1	13385632	13393632	13389819	8000	13389632	-4000	4000	187
chr1	16014875	16022875	16022644	8000	16018875	-4000	4000	3769
chr1	34755740	34763740	34761653	8000	34759740	-4000	4000	1913
chr1	34755740	34763740	34761936	8000	34759740	-4000	4000	2196
chr1	62593520	62601520	62598792	8000	62597520	-4000	4000	1272
chr1	103613427	103621427	103620614	8000	103617427	-4000	4000	3187
chr1	109303011	109311011	109306916	8000	109307011	-4000	4000	-95
chr1	149809693	149817693	149811694	8000	149813693	-4000	4000	-1999
chr1	149809693	149817693	149812114	8000	149813693	-4000	4000	-1579
chr1	149883965	149891965	149886228	8000	149887965	-4000	4000	-1737
chr1	149883965	149891965	149886593	8000	149887965	-4000	4000	-1372
chr1	152085064	152093064	152086304	8000	152089064	-4000	4000	-2760
chr1	152111444	152119444	152112871	8000	152115444	-4000	4000	-2573
chr1	152111444	152119444	152112925	8000	152115444	-4000	4000	-2519
chr1	152155228	152163228	152156543	8000	152159228	-4000	4000	-2685
chr1	152609811	152617811	152613992	8000	152613811	-4000	4000	181
chr1	152671279	152679279	152676159	8000	152675279	-4000	4000	880
chr1	152807971	152815971	152812518	8000	152811971	-4000	4000	547
chr1	153067611	153075611	153070538	8000	153071611	-4000	4000	-1073
chr1	153344841	153352841	153346182	8000	153348841	-4000	4000	-2659
chr1	154317090	154325090	154323264	8000	154321090	-4000	4000	2174
chr1	156811640	156819640	156814236	8000	156815640	-4000	4000	-1404
chr1	159532007	159540007	159535448	8000	159536007	-4000	4000	-559
chr1	159710589	159718589	159714015	8000	159714589	-4000	4000	-574
chr1	165352715	165360715	165355501	8000	165356715	-4000	4000	-1214
chr1	182949525	182957525	182951353	8000	182953525	-4000	4000	-2172
chr1	237886922	237894922	237890479	8000	237890922	-4000	4000	-443
chr1	247601586	247609586	247605649	8000	247605586	-4000	4000	63
chr1	247837896	247845896	247841237	8000	247841896	-4000	4000	-659
chr1	248141148	248149148	248145822	8000	248145148	-4000	4000	674
chr1	248344775	248352775	248349323	8000	248348775	-4000	4000	548
chr1	248593700	248601700	248593715	8000	248597700	-4000	4000	-3985
chr1	154317090	154325090	154323318	8000	154321090	-4000	4000	2228
chr1	237000441	237008441	237004280	8000	237004441	-4000	4000	-161
chr1	153199430	153207430	153204988	8000	153203430	-4000	4000	1558
chr1	18855682	18863682	18859519	8000	18859682	-4000	4000	-163
chr1	152356006	152364006	152358891	8000	152360006	-4000	4000	-1115
chr1	152155228	152163228	152157875	8000	152159228	-4000	4000	-1353
chr1	247944858	247952858	247948890	8000	247948858	-4000	4000	32
chr1	149883965	149891965	149886419	8000	149887965	-4000	4000	-1546
chr1	158716720	158724720	158717352	8000	158720720	-4000	4000	-3368
chr1	149809693	149817693	149813418	8000	149813693	-4000	4000	-275
chr1	152802651	152810651	152805411	8000	152806651	-4000	4000	-1240
chr1	158395466	158403466	158399137	8000	158399466	-4000	4000	-329
chr1	158716720	158724720	158717370	8000	158720720	-4000	4000	-3350
chr1	212620474	212628474	212625708	8000	212624474	-4000	4000	1234
chr1	153067611	153075611	153070698	8000	153071611	-4000	4000	-913
chr1	31613686	31621686	31619674	8000	31617686	-4000	4000	1988
chr1	47412285	47420285	47416702	8000	47416285	-4000	4000	417
chr1	62593520	62601520	62597819	8000	62597520	-4000	4000	299
chr1	75124434	75132434	75130625	8000	75128434	-4000	4000	2191
chr1	110515175	110523175	110517341	8000	110519175	-4000	4000	-1834
chr1	110515175	110523175	110517983	8000	110519175	-4000	4000	-1192
chr1	113883581	113891581	113887470	8000	113887581	-4000	4000	-111
chr1	149809693	149817693	149813294	8000	149813693	-4000	4000	-399
chr1	152155228	152163228	152155725	8000	152159228	-4000	4000	-3503
chr1	152155228	152163228	152156919	8000	152159228	-4000	4000	-2309
chr1	152220193	152228193	152220454	8000	152224193	-4000	4000	-3739
chr1	152410263	152418263	152412198	8000	152414263	-4000	4000	-2065
chr1	153067611	153075611	153070740	8000	153071611	-4000	4000	-871
chr1	153537765	153545765	153541625	8000	153541765	-4000	4000	-140
chr1	159433845	159441845	159440023	8000	159437845	-4000	4000	2178
chr1	159433845	159441845	159440552	8000	159437845	-4000	4000	2707
chr1	159532007	159540007	159535225	8000	159536007	-4000	4000	-782
chr1	205846132	205854132	205849960	8000	205850132	-4000	4000	-172
chr1	247837896	247845896	247841035	8000	247841896	-4000	4000	-861
chr1	152085064	152093064	152088045	8000	152089064	-4000	4000	-1019
chr1	152111444	152119444	152112073	8000	152115444	-4000	4000	-3371
chr1	152111444	152119444	152112510	8000	152115444	-4000	4000	-2934
chr1	159950237	159958237	159951829	8000	159954237	-4000	4000	-2408
chr1	212620474	212628474	212625765	8000	212624474	-4000	4000	1291
chr1	247891587	247899587	247895637	8000	247895587	-4000	4000	50
chr1	168572605	168580605	168580076	8000	168576605	-4000	4000	3471
chr1	207641113	207649113	207645167	8000	207645113	-4000	4000	54
chr1	26064436	26072436	26067467	8000	26068436	-4000	4000	-969
chr1	247601586	247609586	247605882	8000	247605586	-4000	4000	296
chr1	158696652	158704652	158699918	8000	158700652	-4000	4000	-734
chr1	247837896	247845896	247841770	8000	247841896	-4000	4000	-126
chr1	205846132	205854132	205849951	8000	205850132	-4000	4000	-181
chr1	152576516	152584516	152579508	8000	152580516	-4000	4000	-1008
chr1	212620474	212628474	212625427	8000	212624474	-4000	4000	953
chr1	143901977	143909977	143904387	8000	143905977	-4000	4000	-1590
chr1	143901977	143909977	143904388	8000	143905977	-4000	4000	-1589
chr1	152085064	152093064	152086979	8000	152089064	-4000	4000	-2085
chr1	3017467	3025467	3022445	8000	3021467	-4000	4000	978
chr1	248399048	248407048	248406515	8000	248403048	-4000	4000	3467
chr1	157816120	157824120	157820089	8000	157820120	-4000	4000	-31
chr1	241995098	242003098	241996060	8000	241999098	-4000	4000	-3038
chr1	12769738	12777738	12777340	8000	12773738	-4000	4000	3602
chr1	156855117	156863117	156858793	8000	156859117	-4000	4000	-324
chr1	13385632	13393632	13390462	8000	13389632	-4000	4000	830
chr1	13343134	13351134	13344599	8000	13347134	-4000	4000	-2535
chr1	103613427	103621427	103620557	8000	103617427	-4000	4000	3130
chr1	158682715	158690715	158683496	8000	158686715	-4000	4000	-3219
chr1	247961233	247969233	247965464	8000	247965233	-4000	4000	231
chr1	159583826	159591826	159587959	8000	159587826	-4000	4000	133
chr1	75928404	75936404	75932206	8000	75932404	-4000	4000	-198
chr1	158395466	158403466	158398573	8000	158399466	-4000	4000	-893
chr1	247601586	247609586	247605650	8000	247605586	-4000	4000	64
chr1	9022423	9030423	9022926	8000	9026423	-4000	4000	-3497
chr1	27388622	27396622	27394765	8000	27392622	-4000	4000	2143
chr1	110515175	110523175	110517225	8000	110519175	-4000	4000	-1950
chr1	149883965	149891965	149886247	8000	149887965	-4000	4000	-1718
chr1	151706433	151714433	151709072	8000	151710433	-4000	4000	-1361
chr1	152671279	152679279	152676008	8000	152675279	-4000	4000	729
chr1	179361720	179369720	179366466	8000	179365720	-4000	4000	746
chr1	205846132	205854132	205849912	8000	205850132	-4000	4000	-220
chr1	247601586	247609586	247606356	8000	247605586	-4000	4000	770
chr1	248344775	248352775	248349630	8000	248348775	-4000	4000	855
chr1	160881180	160889180	160881301	8000	160885180	-4000	4000	-3879
chr1	12853086	12861086	12859773	8000	12857086	-4000	4000	2687
chr1	13281174	13289174	13281662	8000	13285174	-4000	4000	-3512
chr1	152782214	152790214	152787421	8000	152786214	-4000	4000	1207
chr1	12912610	12920610	12917834	8000	12916610	-4000	4000	1224
chr1	158601268	158609268	158606564	8000	158605268	-4000	4000	1296
chr1	3742460	3750460	3746096	8000	3746460	-4000	4000	-364
chr1	248484589	248492589	248488850	8000	248488589	-4000	4000	261
chr1	162372854	162380854	162373751	8000	162376854	-4000	4000	-3103
chr1	19811283	19819283	19814795	8000	19815283	-4000	4000	-488
chr1	247584360	247592360	247588902	8000	247588360	-4000	4000	542
chr1	228002998	228010998	228007081	8000	228006998	-4000	4000	83
chr1	158750720	158758720	158754818	8000	158754720	-4000	4000	98
chr1	152682123	152690123	152686892	8000	152686123	-4000	4000	769
chr1	206113699	206121699	206116811	8000	206117699	-4000	4000	-888
chr1	247920889	247928889	247921113	8000	247924889	-4000	4000	-3776
chr1	3017467	3025467	3021531	8000	3021467	-4000	4000	64
chr1	158682715	158690715	158685330	8000	158686715	-4000	4000	-1385
chr1	152220193	152228193	152221035	8000	152224193	-4000	4000	-3158
chr1	159433845	159441845	159440039	8000	159437845	-4000	4000	2194
chr1	12853086	12861086	12860056	8000	12857086	-4000	4000	2970
chr1	247891587	247899587	247895688	8000	247895587	-4000	4000	101
chr1	34755740	34763740	34758049	8000	34759740	-4000	4000	-1691
chr1	62593520	62601520	62598700	8000	62597520	-4000	4000	1180
chr1	66797276	66805276	66798108	8000	66801276	-4000	4000	-3168
chr1	160881180	160889180	160883507	8000	160885180	-4000	4000	-1673
chr1	248357665	248365665	248362046	8000	248361665	-4000	4000	381
chr1	119892515	119900515	119895991	8000	119896515	-4000	4000	-524
chr1	152659380	152667380	152664341	8000	152663380	-4000	4000	961
chr1	20548573	20556573	20553094	8000	20552573	-4000	4000	521
chr1	152155228	152163228	152156527	8000	152159228	-4000	4000	-2701
chr1	158395466	158403466	158399319	8000	158399466	-4000	4000	-147
chr1	152155228	152163228	152156123	8000	152159228	-4000	4000	-3105
chr1	159583826	159591826	159588521	8000	159587826	-4000	4000	695
chr1	160077538	160085538	160084708	8000	160081538	-4000	4000	3170
chr1	158601268	158609268	158607000	8000	158605268	-4000	4000	1732
chr1	165540000	165548000	165544528	8000	165544000	-4000	4000	528
chr1	223389415	223397415	223395119	8000	223393415	-4000	4000	1704
chr1	248570757	248578757	248574683	8000	248574757	-4000	4000	-74
chr1	15738499	15746499	15743152	8000	15742499	-4000	4000	653
chr1	84394484	84402484	84398614	8000	84398484	-4000	4000	130
chr1	90713302	90721302	90717024	8000	90717302	-4000	4000	-278
chr1	158682715	158690715	158686535	8000	158686715	-4000	4000	-180
chr1	197264204	197272204	197268359	8000	197268204	-4000	4000	155
chr1	149809693	149817693	149813312	8000	149813693	-4000	4000	-381
chr1	149809693	149817693	149813313	8000	149813693	-4000	4000	-380
chr1	152111444	152119444	152112361	8000	152115444	-4000	4000	-3083
chr1	19919617	19927617	19923541	8000	19923617	-4000	4000	-76
chr1	153037931	153045931	153040321	8000	153041931	-4000	4000	-1610
chr1	248399048	248407048	248406139	8000	248403048	-4000	4000	3091
chr1	152155228	152163228	152156764	8000	152159228	-4000	4000	-2464
chr1	152576516	152584516	152579622	8000	152580516	-4000	4000	-894
chr1	241648278	241656278	241652359	8000	241652278	-4000	4000	81
chr1	158395466	158403466	158399046	8000	158399466	-4000	4000	-420
chr1	237886922	237894922	237889921	8000	237890922	-4000	4000	-1001
chr1	13299539	13307539	13306873	8000	13303539	-4000	4000	3334
chr1	159869053	159877053	159876692	8000	159873053	-4000	4000	3639
chr1	160950809	160958809	160954795	8000	160954809	-4000	4000	-14
chr1	248469351	248477351	248473564	8000	248473351	-4000	4000	213
chr1	53455399	53463399	53461552	8000	53459399	-4000	4000	2153
chr1	152671279	152679279	152676052	8000	152675279	-4000	4000	773
chr1	152155228	152163228	152155632	8000	152159228	-4000	4000	-3596
chr1	152085064	152093064	152086088	8000	152089064	-4000	4000	-2976
chr1	159433845	159441845	159440709	8000	159437845	-4000	4000	2864
chr1	160950809	160958809	160954433	8000	160954809	-4000	4000	-376
chr1	173599072	173607072	173601844	8000	173603072	-4000	4000	-1228
chr1	212620474	212628474	212625412	8000	212624474	-4000	4000	938
chr1	75124434	75132434	75130823	8000	75128434	-4000	4000	2389
chr1	12853086	12861086	12859132	8000	12857086	-4000	4000	2046
chr1	12882201	12890201	12883201	8000	12886201	-4000	4000	-3000
chr1	13222106	13230106	13225901	8000	13226106	-4000	4000	-205
chr1	63318567	63326567	63323502	8000	63322567	-4000	4000	935
chr1	75928404	75936404	75932100	8000	75932404	-4000	4000	-304
chr1	162372854	162380854	162374496	8000	162376854	-4000	4000	-2358
chr1	227811693	227819693	227816131	8000	227815693	-4000	4000	438
chr1	173913327	173921327	173914785	8000	173917327	-4000	4000	-2542
chr1	12827410	12835410	12828707	8000	12831410	-4000	4000	-2703
chr1	86543078	86551078	86547135	8000	86547078	-4000	4000	57
chr1	149883965	149891965	149886147	8000	149887965	-4000	4000	-1818
chr1	149809693	149817693	149812366	8000	149813693	-4000	4000	-1327
chr1	152682123	152690123	152687193	8000	152686123	-4000	4000	1070
chr1	154498219	154506219	154501474	8000	154502219	-4000	4000	-745
chr1	159532007	159540007	159535906	8000	159536007	-4000	4000	-101
chr1	12853086	12861086	12859706	8000	12857086	-4000	4000	2620
chr1	152755561	152763561	152760698	8000	152759561	-4000	4000	1137
chr1	160950809	160958809	160954388	8000	160954809	-4000	4000	-421
chr2	218828086	218836086	218830030	8000	218832086	-4000	4000	-2056
chr2	80300752	80308752	80303649	8000	80304752	-4000	4000	-1103
chr2	232374724	232382724	232378676	8000	232378724	-4000	4000	-48
chr2	85664741	85672741	85667801	8000	85668741	-4000	4000	-940
chr2	31576938	31584938	31580649	8000	31580938	-4000	4000	-289
chr2	206638487	206646487	206644254	8000	206642487	-4000	4000	1767
chr2	96112571	96120571	96113902	8000	96116571	-4000	4000	-2669
chr2	104849287	104857287	104856879	8000	104853287	-4000	4000	3592
chr2	80300752	80308752	80303514	8000	80304752	-4000	4000	-1238
chr2	79084019	79092019	79085140	8000	79088019	-4000	4000	-2879
chr2	135833184	135841184	135836899	8000	135837184	-4000	4000	-285
chr2	27492839	27500839	27493936	8000	27496839	-4000	4000	-2903
chr2	29070523	29078523	29072837	8000	29074523	-4000	4000	-1686
chr2	176079962	176087962	176083597	8000	176083962	-4000	4000	-365
chr2	240026429	240034429	240029284	8000	240030429	-4000	4000	-1145
chr2	218955666	218963666	218961963	8000	218959666	-4000	4000	2297
chr2	240864824	240872824	240868896	8000	240868824	-4000	4000	72
chr2	190058729	190066729	190060196	8000	190062729	-4000	4000	-2533
chr2	79116362	79124362	79121942	8000	79120362	-4000	4000	1580
chr2	233771679	233779679	233772349	8000	233775679	-4000	4000	-3330
chr2	24171053	24179053	24175464	8000	24175053	-4000	4000	411
chr2	43834865	43842865	43838557	8000	43838865	-4000	4000	-308
chr2	70816599	70824599	70820505	8000	70820599	-4000	4000	-94
chr2	127641864	127649864	127642929	8000	127645864	-4000	4000	-2935
chr2	201615178	201623178	201618982	8000	201619178	-4000	4000	-196
chr2	208120524	208128524	208121743	8000	208124524	-4000	4000	-2781
chr2	43834865	43842865	43838423	8000	43838865	-4000	4000	-442
chr2	79116362	79124362	79123356	8000	79120362	-4000	4000	2994
chr2	216368483	216376483	216370111	8000	216372483	-4000	4000	-2372
chr2	206717570	206725570	206718333	8000	206721570	-4000	4000	-3237
chr2	218162962	218170962	218164894	8000	218166962	-4000	4000	-2068
chr2	240864824	240872824	240871396	8000	240868824	-4000	4000	2572
chr2	3699575	3707575	3701595	8000	3703575	-4000	4000	-1980
chr2	113054638	113062638	113062150	8000	113058638	-4000	4000	3512
chr2	79155753	79163753	79157280	8000	79159753	-4000	4000	-2473
chr2	79084019	79092019	79086470	8000	79088019	-4000	4000	-1549
chr2	96112571	96120571	96115101	8000	96116571	-4000	4000	-1470
chr2	85664741	85672741	85666661	8000	85668741	-4000	4000	-2080
chr2	238134668	238142668	238140973	8000	238138668	-4000	4000	2305
chr2	54252229	54260229	54256011	8000	54256229	-4000	4000	-218
chr2	42489982	42497982	42493247	8000	42493982	-4000	4000	-735
chr2	135833184	135841184	135836654	8000	135837184	-4000	4000	-530
chr2	241865600	241873600	241869828	8000	241869600	-4000	4000	228
chr2	214407054	214415054	214410319	8000	214411054	-4000	4000	-735
chr2	233028672	233036672	233034587	8000	233032672	-4000	4000	1915
chr2	231526445	231534445	231528466	8000	231530445	-4000	4000	-1979
chr2	234046679	234054679	234050991	8000	234050679	-4000	4000	312
chr2	79116362	79124362	79122912	8000	79120362	-4000	4000	2550
chr2	240687866	240695866	240692263	8000	240691866	-4000	4000	397
chr2	80300752	80308752	80302540	8000	80304752	-4000	4000	-2212
chr2	17514440	17522440	17518235	8000	17518440	-4000	4000	-205
chr2	208159589	208167589	208160905	8000	208163589	-4000	4000	-2684
chr2	79021686	79029686	79027903	8000	79025686	-4000	4000	2217
chr2	29070523	29078523	29071748	8000	29074523	-4000	4000	-2775
chr2	208159589	208167589	208161045	8000	208163589	-4000	4000	-2544
chr2	219510170	219518170	219514946	8000	219514170	-4000	4000	776
chr2	135833184	135841184	135836824	8000	135837184	-4000	4000	-360
chr2	208125828	208133828	208129641	8000	208129828	-4000	4000	-187
chr2	105237743	105245743	105242918	8000	105241743	-4000	4000	1175
chr2	206717570	206725570	206718394	8000	206721570	-4000	4000	-3176
chr2	80300752	80308752	80302730	8000	80304752	-4000	4000	-2022
chr2	201615178	201623178	201619083	8000	201619178	-4000	4000	-95
chr2	219056921	219064921	219057605	8000	219060921	-4000	4000	-3316
chr2	70786643	70794643	70787662	8000	70790643	-4000	4000	-2981
chr2	127641864	127649864	127642166	8000	127645864	-4000	4000	-3698
chr2	17514440	17522440	17518057	8000	17518440	-4000	4000	-383
chr2	27492839	27500839	27497273	8000	27496839	-4000	4000	434
chr2	216368483	216376483	216370040	8000	216372483	-4000	4000	-2443
chr2	240043027	240051027	240045802	8000	240047027	-4000	4000	-1225
chr2	219249243	219257243	219251682	8000	219253243	-4000	4000	-1561
chr2	80300752	80308752	80303332	8000	80304752	-4000	4000	-1420
chr2	27135410	27143410	27137950	8000	27139410	-4000	4000	-1460
chr2	168897291	168905291	168904540	8000	168901291	-4000	4000	3249
chr2	208120524	208128524	208124118	8000	208124524	-4000	4000	-406
chr2	162834767	162842767	162838476	8000	162838767	-4000	4000	-291
chr2	240687866	240695866	240692025	8000	240691866	-4000	4000	159
chr2	216368483	216376483	216369849	8000	216372483	-4000	4000	-2634
chr2	218162962	218170962	218164376	8000	218166962	-4000	4000	-2586
chr2	29070523	29078523	29073830	8000	29074523	-4000	4000	-693
chr2	88124062	88132062	88126189	8000	88128062	-4000	4000	-1873
chr2	88520649	88528649	88526488	8000	88524649	-4000	4000	1839
chr2	219329177	219337177	219332547	8000	219333177	-4000	4000	-630
chr2	232452125	232460125	232458288	8000	232456125	-4000	4000	2163
chr2	74509463	74517463	74515659	8000	74513463	-4000	4000	2196
chr2	26554756	26562756	26558495	8000	26558756	-4000	4000	-261
chr2	107982523	107990523	107988179	8000	107986523	-4000	4000	1656
chr2	100466482	100474482	100470549	8000	100470482	-4000	4000	67
chr2	127414427	127422427	127421294	8000	127418427	-4000	4000	2867
chr2	27304445	27312445	27309974	8000	27308445	-4000	4000	1529
chr2	218162962	218170962	218164447	8000	218166962	-4000	4000	-2515
chr2	218162962	218170962	218164448	8000	218166962	-4000	4000	-2514
chr2	29070523	29078523	29071854	8000	29074523	-4000	4000	-2669
chr2	96112571	96120571	96115763	8000	96116571	-4000	4000	-808
chr2	153474762	153482762	153478163	8000	153478762	-4000	4000	-599
chr2	29070523	29078523	29073518	8000	29074523	-4000	4000	-1005
chr2	218981184	218989184	218985031	8000	218985184	-4000	4000	-153
chr2	219056921	219064921	219060405	8000	219060921	-4000	4000	-516
chr2	79084019	79092019	79086734	8000	79088019	-4000	4000	-1285
chr2	168897291	168905291	168901415	8000	168901291	-4000	4000	124
chr2	208125828	208133828	208128283	8000	208129828	-4000	4000	-1545
chr2	79116362	79124362	79121649	8000	79120362	-4000	4000	1287
chr2	232374724	232382724	232380275	8000	232378724	-4000	4000	1551
chr2	232402844	232410844	232408356	8000	232406844	-4000	4000	1512
chr2	236164386	236172386	236166385	8000	236168386	-4000	4000	-2001
chr2	29070523	29078523	29072859	8000	29074523	-4000	4000	-1664
chr2	218162962	218170962	218164214	8000	218166962	-4000	4000	-2748
chr2	240026429	240034429	240029992	8000	240030429	-4000	4000	-437
chr2	231526445	231534445	231528200	8000	231530445	-4000	4000	-2245
chr2	29070523	29078523	29073543	8000	29074523	-4000	4000	-980
chr2	176088721	176096721	176095519	8000	176092721	-4000	4000	2798
chr2	216856064	216864064	216859517	8000	216860064	-4000	4000	-547
chr2	232374724	232382724	232379891	8000	232378724	-4000	4000	1167
chr2	241865600	241873600	241872918	8000	241869600	-4000	4000	3318
chr2	29070523	29078523	29073884	8000	29074523	-4000	4000	-639
chr2	29917586	29925586	29920022	8000	29921586	-4000	4000	-1564
chr2	29917586	29925586	29920167	8000	29921586	-4000	4000	-1419
chr2	88124062	88132062	88127984	8000	88128062	-4000	4000	-78
chr2	168897291	168905291	168901276	8000	168901291	-4000	4000	-15
chr2	206638487	206646487	206644419	8000	206642487	-4000	4000	1932
chr2	234046679	234054679	234050871	8000	234050679	-4000	4000	192
chr2	236260409	236268409	236264254	8000	236264409	-4000	4000	-155
chr2	73198574	73206574	73202879	8000	73202574	-4000	4000	305
chr2	101471112	101479112	101474648	8000	101475112	-4000	4000	-464
chr2	206638487	206646487	206644387	8000	206642487	-4000	4000	1900
chr2	80300752	80308752	80302168	8000	80304752	-4000	4000	-2584
chr2	208120524	208128524	208121701	8000	208124524	-4000	4000	-2823
chr2	26342817	26350817	26346224	8000	26346817	-4000	4000	-593
chr2	79084019	79092019	79087589	8000	79088019	-4000	4000	-430
chr2	208120524	208128524	208121735	8000	208124524	-4000	4000	-2789
chr2	219249243	219257243	219251226	8000	219253243	-4000	4000	-2017
chr2	27145004	27153004	27149153	8000	27149004	-4000	4000	149
chr2	68970573	68978573	68977690	8000	68974573	-4000	4000	3117
chr2	104849287	104857287	104856663	8000	104853287	-4000	4000	3376
chr2	124021287	124029287	124025658	8000	124025287	-4000	4000	371
chr2	130725070	130733070	130729217	8000	130729070	-4000	4000	147
chr2	79116362	79124362	79120860	8000	79120362	-4000	4000	498
chr2	80300752	80308752	80303284	8000	80304752	-4000	4000	-1468
chr2	162834767	162842767	162836645	8000	162838767	-4000	4000	-2122
chr2	79084019	79092019	79085798	8000	79088019	-4000	4000	-2221
chr2	208125828	208133828	208129613	8000	208129828	-4000	4000	-215
chr2	218162962	218170962	218164885	8000	218166962	-4000	4000	-2077
chr2	240043027	240051027	240045443	8000	240047027	-4000	4000	-1584
chr2	96112571	96120571	96115607	8000	96116571	-4000	4000	-964
chr2	240687866	240695866	240692226	8000	240691866	-4000	4000	360
chr2	17514440	17522440	17515523	8000	17518440	-4000	4000	-2917
chr2	127414427	127422427	127421330	8000	127418427	-4000	4000	2903
chr2	218162962	218170962	218164124	8000	218166962	-4000	4000	-2838
chr2	29070523	29078523	29071126	8000	29074523	-4000	4000	-3397
chr2	79084019	79092019	79087596	8000	79088019	-4000	4000	-423
chr2	17514440	17522440	17516610	8000	17518440	-4000	4000	-1830
chr2	95588001	95596001	95594067	8000	95592001	-4000	4000	2066
chr2	227867054	227875054	227871642	8000	227871054	-4000	4000	588
chr2	80300752	80308752	80303484	8000	80304752	-4000	4000	-1268
chr2	79116362	79124362	79123158	8000	79120362	-4000	4000	2796
chr2	29070523	29078523	29071133	8000	29074523	-4000	4000	-3390
chr2	104849287	104857287	104856966	8000	104853287	-4000	4000	3679
chr2	206638487	206646487	206644473	8000	206642487	-4000	4000	1986
chr2	214407054	214415054	214414266	8000	214411054	-4000	4000	3212
chr2	218955666	218963666	218961804	8000	218959666	-4000	4000	2138
chr2	73638422	73646422	73641547	8000	73642422	-4000	4000	-875
chr2	27135410	27143410	27137088	8000	27139410	-4000	4000	-2322
chr2	232402844	232410844	232409936	8000	232406844	-4000	4000	3092
chr2	234046679	234054679	234051038	8000	234050679	-4000	4000	359
chr2	236164386	236172386	236166192	8000	236168386	-4000	4000	-2194
chr2	79116362	79124362	79122124	8000	79120362	-4000	4000	1762
chr2	27271817	27279817	27277997	8000	27275817	-4000	4000	2180
chr2	27304445	27312445	27309931	8000	27308445	-4000	4000	1486
chr2	29070523	29078523	29073865	8000	29074523	-4000	4000	-658
chr2	43672429	43680429	43675693	8000	43676429	-4000	4000	-736
chr2	74509463	74517463	74515651	8000	74513463	-4000	4000	2188
chr2	79084019	79092019	79085734	8000	79088019	-4000	4000	-2285
chr2	80300752	80308752	80302635	8000	80304752	-4000	4000	-2117
chr2	85664741	85672741	85665319	8000	85668741	-4000	4000	-3422
chr2	88063825	88071825	88067960	8000	88067825	-4000	4000	135
chr2	94867430	94875430	94873517	8000	94871430	-4000	4000	2087
chr2	95588001	95596001	95594281	8000	95592001	-4000	4000	2280
chr2	113054638	113062638	113059447	8000	113058638	-4000	4000	809
chr2	153474762	153482762	153478328	8000	153478762	-4000	4000	-434
chr2	168897291	168905291	168901429	8000	168901291	-4000	4000	138
chr2	190058729	190066729	190062445	8000	190062729	-4000	4000	-284
chr2	208142158	208150158	208145974	8000	208146158	-4000	4000	-184
chr2	214407054	214415054	214414193	8000	214411054	-4000	4000	3139
chr2	218981184	218989184	218982164	8000	218985184	-4000	4000	-3020
chr2	219056921	219064921	219057465	8000	219060921	-4000	4000	-3456
chr2	231526445	231534445	231528721	8000	231530445	-4000	4000	-1724
chr2	231526445	231534445	231528995	8000	231530445	-4000	4000	-1450
chr2	43672429	43680429	43675589	8000	43676429	-4000	4000	-840
chr2	107982523	107990523	107988187	8000	107986523	-4000	4000	1664
chr2	29070523	29078523	29071501	8000	29074523	-4000	4000	-3022
chr2	79084019	79092019	79085562	8000	79088019	-4000	4000	-2457
chr2	80300752	80308752	80302881	8000	80304752	-4000	4000	-1871
chr2	79155753	79163753	79157257	8000	79159753	-4000	4000	-2496
chr2	240687866	240695866	240692122	8000	240691866	-4000	4000	256
chr2	29070523	29078523	29072822	8000	29074523	-4000	4000	-1701
chr2	17514440	17522440	17515409	8000	17518440	-4000	4000	-3031
chr2	17514440	17522440	17516303	8000	17518440	-4000	4000	-2137
chr2	27145004	27153004	27152701	8000	27149004	-4000	4000	3697
chr2	29070523	29078523	29070738	8000	29074523	-4000	4000	-3785
chr2	29070523	29078523	29071911	8000	29074523	-4000	4000	-2612
chr2	31229858	31237858	31234699	8000	31233858	-4000	4000	841
chr2	73638422	73646422	73641045	8000	73642422	-4000	4000	-1377
chr2	162834767	162842767	162836700	8000	162838767	-4000	4000	-2067
chr2	214407054	214415054	214414392	8000	214411054	-4000	4000	3338
chr2	216856064	216864064	216860030	8000	216860064	-4000	4000	-34
chr2	219037527	219045527	219038970	8000	219041527	-4000	4000	-2557
chr2	227377995	227385995	227379122	8000	227381995	-4000	4000	-2873
chr2	233771679	233779679	233772637	8000	233775679	-4000	4000	-3042
chr2	95588001	95596001	95594192	8000	95592001	-4000	4000	2191
chr2	228177687	228185687	228181626	8000	228181687	-4000	4000	-61
chr2	208125828	208133828	208129787	8000	208129828	-4000	4000	-41
chr2	29070523	29078523	29070917	8000	29074523	-4000	4000	-3606
chr2	234046679	234054679	234050852	8000	234050679	-4000	4000	173
chr2	176088721	176096721	176093603	8000	176092721	-4000	4000	882
chr2	85664741	85672741	85665627	8000	85668741	-4000	4000	-3114
chr2	208125828	208133828	208128271	8000	208129828	-4000	4000	-1557
chr2	29070523	29078523	29071374	8000	29074523	-4000	4000	-3149
chr2	232452125	232460125	232458953	8000	232456125	-4000	4000	2828
chr2	17514440	17522440	17516279	8000	17518440	-4000	4000	-2161
chr2	79116362	79124362	79120817	8000	79120362	-4000	4000	455
chr2	233028672	233036672	233034940	8000	233032672	-4000	4000	2268
chr2	79084019	79092019	79085649	8000	79088019	-4000	4000	-2370
chr2	17514440	17522440	17516541	8000	17518440	-4000	4000	-1899
chr2	29070523	29078523	29072957	8000	29074523	-4000	4000	-1566
chr2	79155753	79163753	79157626	8000	79159753	-4000	4000	-2127
chr2	54252229	54260229	54255796	8000	54256229	-4000	4000	-433
chr2	80300752	80308752	80302231	8000	80304752	-4000	4000	-2521
chr2	80300752	80308752	80302417	8000	80304752	-4000	4000	-2335
chr2	233028672	233036672	233034571	8000	233032672	-4000	4000	1899
chr2	233771679	233779679	233772421	8000	233775679	-4000	4000	-3258
chr2	240043027	240051027	240045564	8000	240047027	-4000	4000	-1463
chr2	232402844	232410844	232407136	8000	232406844	-4000	4000	292
chr2	233771679	233779679	233772280	8000	233775679	-4000	4000	-3399
chr2	176079962	176087962	176083834	8000	176083962	-4000	4000	-128
chr2	227867054	227875054	227871670	8000	227871054	-4000	4000	616
chr2	231588864	231596864	231593042	8000	231592864	-4000	4000	178
chr2	79021686	79029686	79026747	8000	79025686	-4000	4000	1061
chr2	29070523	29078523	29070781	8000	29074523	-4000	4000	-3742
chr2	135833184	135841184	135840836	8000	135837184	-4000	4000	3652
chr2	73198574	73206574	73202686	8000	73202574	-4000	4000	112
chr2	218352857	218360857	218357177	8000	218356857	-4000	4000	320
chr2	233771679	233779679	233772400	8000	233775679	-4000	4000	-3279
chr2	232452125	232460125	232456394	8000	232456125	-4000	4000	269
chr2	190058729	190066729	190060153	8000	190062729	-4000	4000	-2576
chr2	29070523	29078523	29074024	8000	29074523	-4000	4000	-499
chr2	49150527	49158527	49154416	8000	49154527	-4000	4000	-111
chr2	240026429	240034429	240030159	8000	240030429	-4000	4000	-270
chr2	218162962	218170962	218164301	8000	218166962	-4000	4000	-2661
chr2	29070523	29078523	29073880	8000	29074523	-4000	4000	-643
chr2	68970573	68978573	68974611	8000	68974573	-4000	4000	38
chr2	233771679	233779679	233772633	8000	233775679	-4000	4000	-3046
chr2	79021686	79029686	79026771	8000	79025686	-4000	4000	1085
chr2	79021686	79029686	79026772	8000	79025686	-4000	4000	1086
chr2	29070523	29078523	29072134	8000	29074523	-4000	4000	-2389
chr2	17514440	17522440	17516776	8000	17518440	-4000	4000	-1664
chr2	113001459	113009459	113005992	8000	113005459	-4000	4000	533
chr2	124021287	124029287	124025626	8000	124025287	-4000	4000	339
chr2	222294998	222302998	222295537	8000	222298998	-4000	4000	-3461
chr2	176184668	176192668	176190684	8000	176188668	-4000	4000	2016
chr2	284851	292851	286186	8000	288851	-4000	4000	-2665
chr2	240026429	240034429	240029875	8000	240030429	-4000	4000	-554
chr3	187698557	187706557	187702401	8000	187702557	-4000	4000	-156
chr3	49795873	49803873	49796985	8000	49799873	-4000	4000	-2888
chr3	108949879	108957879	108953648	8000	108953879	-4000	4000	-231
chr3	52773595	52781595	52780358	8000	52777595	-4000	4000	2763
chr3	98386666	98394666	98391062	8000	98390666	-4000	4000	396
chr3	98527978	98535978	98532977	8000	98531978	-4000	4000	999
chr3	68000247	68008247	68006416	8000	68004247	-4000	4000	2169
chr3	9549822	9557822	9552445	8000	9553822	-4000	4000	-1377
chr3	138128390	138136390	138131108	8000	138132390	-4000	4000	-1282
chr3	187287980	187295980	187291815	8000	187291980	-4000	4000	-165
chr3	13876071	13884071	13879829	8000	13880071	-4000	4000	-242
chr3	44237886	44245886	44241998	8000	44241886	-4000	4000	112
chr3	154426190	154434190	154428762	8000	154430190	-4000	4000	-1428
chr3	98278505	98286505	98283434	8000	98282505	-4000	4000	929
chr3	187666394	187674394	187669060	8000	187670394	-4000	4000	-1334
chr3	98278505	98286505	98283171	8000	98282505	-4000	4000	666
chr3	98126721	98134721	98133006	8000	98130721	-4000	4000	2285
chr3	187666394	187674394	187669243	8000	187670394	-4000	4000	-1151
chr3	98278505	98286505	98283352	8000	98282505	-4000	4000	847
chr3	73057659	73065659	73065426	8000	73061659	-4000	4000	3767
chr3	119143375	119151375	119146403	8000	119147375	-4000	4000	-972
chr3	133396056	133404056	133400362	8000	133400056	-4000	4000	306
chr3	42681537	42689537	42685599	8000	42685537	-4000	4000	62
chr3	184049047	184057047	184056278	8000	184053047	-4000	4000	3231
chr3	51951381	51959381	51958937	8000	51955381	-4000	4000	3556
chr3	62370324	62378324	62371314	8000	62374324	-4000	4000	-3010
chr3	187193486	187201486	187199618	8000	187197486	-4000	4000	2132
chr3	138943137	138951137	138946516	8000	138947137	-4000	4000	-621
chr3	154426190	154434190	154429543	8000	154430190	-4000	4000	-647
chr3	44237886	44245886	44242225	8000	44241886	-4000	4000	339
chr3	134647636	134655636	134651030	8000	134651636	-4000	4000	-606
chr3	98126721	98134721	98132981	8000	98130721	-4000	4000	2260
chr3	51951381	51959381	51955721	8000	51955381	-4000	4000	340
chr3	98259252	98267252	98265029	8000	98263252	-4000	4000	1777
chr3	190318541	190326541	190322110	8000	190322541	-4000	4000	-431
chr3	98031304	98039304	98034936	8000	98035304	-4000	4000	-368
chr3	42262185	42270185	42263399	8000	42266185	-4000	4000	-2786
chr3	107373439	107381439	107377665	8000	107377439	-4000	4000	226
chr3	119143375	119151375	119151242	8000	119147375	-4000	4000	3867
chr3	119143375	119151375	119146955	8000	119147375	-4000	4000	-420
chr3	46490611	46498611	46498111	8000	46494611	-4000	4000	3500
chr3	98143479	98151479	98149949	8000	98147479	-4000	4000	2470
chr3	187287980	187295980	187291736	8000	187291980	-4000	4000	-244
chr3	108753410	108761410	108755779	8000	108757410	-4000	4000	-1631
chr3	98126721	98134721	98133559	8000	98130721	-4000	4000	2838
chr3	128462968	128470968	128462995	8000	128466968	-4000	4000	-3973
chr3	98259252	98267252	98264792	8000	98263252	-4000	4000	1540
chr3	137760315	137768315	137765468	8000	137764315	-4000	4000	1153
chr3	51703068	51711068	51703793	8000	51707068	-4000	4000	-3275
chr3	142959674	142967674	142962271	8000	142963674	-4000	4000	-1403
chr3	69119032	69127032	69122201	8000	69123032	-4000	4000	-831
chr3	139016926	139024926	139020256	8000	139020926	-4000	4000	-670
chr3	119143375	119151375	119147081	8000	119147375	-4000	4000	-294
chr3	98386666	98394666	98391582	8000	98390666	-4000	4000	916
chr3	109312517	109320517	109312683	8000	109316517	-4000	4000	-3834
chr3	119143375	119151375	119146264	8000	119147375	-4000	4000	-1111
chr3	44237886	44245886	44244178	8000	44241886	-4000	4000	2292
chr3	109333546	109341546	109337540	8000	109337546	-4000	4000	-6
chr3	114233578	114241578	114237078	8000	114237578	-4000	4000	-500
chr3	150937743	150945743	150943903	8000	150941743	-4000	4000	2160
chr3	190318541	190326541	190322027	8000	190322541	-4000	4000	-514
chr3	142959674	142967674	142963100	8000	142963674	-4000	4000	-574
chr3	98126721	98134721	98132974	8000	98130721	-4000	4000	2253
chr3	114233578	114241578	114236919	8000	114237578	-4000	4000	-659
chr3	52773595	52781595	52779611	8000	52777595	-4000	4000	2016
chr3	98493681	98501681	98498283	8000	98497681	-4000	4000	602
chr3	140674064	140682064	140678276	8000	140678064	-4000	4000	212
chr3	8741040	8749040	8745543	8000	8745040	-4000	4000	503
chr3	42681537	42689537	42689004	8000	42685537	-4000	4000	3467
chr3	44237886	44245886	44243580	8000	44241886	-4000	4000	1694
chr3	98126721	98134721	98132863	8000	98130721	-4000	4000	2142
chr3	190445901	190453901	190449738	8000	190449901	-4000	4000	-163
chr3	109312517	109320517	109312624	8000	109316517	-4000	4000	-3893
chr3	98493681	98501681	98498184	8000	98497681	-4000	4000	503
chr3	119143375	119151375	119148210	8000	119147375	-4000	4000	835
chr3	137760315	137768315	137765110	8000	137764315	-4000	4000	795
chr3	98083173	98091173	98087874	8000	98087173	-4000	4000	701
chr3	194395266	194403266	194397698	8000	194399266	-4000	4000	-1568
chr3	172444456	172452456	172448209	8000	172448456	-4000	4000	-247
chr3	109114134	109122134	109118032	8000	109118134	-4000	4000	-102
chr3	75660328	75668328	75665623	8000	75664328	-4000	4000	1295
chr3	142959674	142967674	142962294	8000	142963674	-4000	4000	-1380
chr3	119143375	119151375	119146710	8000	119147375	-4000	4000	-665
chr3	42871898	42879898	42874636	8000	42875898	-4000	4000	-1262
chr3	115619510	115627510	115623625	8000	115623510	-4000	4000	115
chr3	140674064	140682064	140678486	8000	140678064	-4000	4000	422
chr3	49795873	49803873	49798717	8000	49799873	-4000	4000	-1156
chr3	98349854	98357854	98354029	8000	98353854	-4000	4000	175
chr3	75660328	75668328	75665984	8000	75664328	-4000	4000	1656
chr3	137994735	138002735	137998863	8000	137998735	-4000	4000	128
chr3	44237886	44245886	44244320	8000	44241886	-4000	4000	2434
chr3	194395266	194403266	194397690	8000	194399266	-4000	4000	-1576
chr3	98162696	98170696	98169602	8000	98166696	-4000	4000	2906
chr3	196207437	196215437	196209492	8000	196211437	-4000	4000	-1945
chr3	44237886	44245886	44243806	8000	44241886	-4000	4000	1920
chr3	75660328	75668328	75666025	8000	75664328	-4000	4000	1697
chr3	54963088	54971088	54968482	8000	54967088	-4000	4000	1394
chr3	154426190	154434190	154429646	8000	154430190	-4000	4000	-544
chr3	137994735	138002735	137999032	8000	137998735	-4000	4000	297
chr3	137994735	138002735	137999033	8000	137998735	-4000	4000	298
chr3	98126721	98134721	98133072	8000	98130721	-4000	4000	2351
chr3	44237886	44245886	44242346	8000	44241886	-4000	4000	460
chr3	1088658	1096658	1092976	8000	1092658	-4000	4000	318
chr3	44237886	44245886	44243862	8000	44241886	-4000	4000	1976
chr3	75660328	75668328	75664485	8000	75664328	-4000	4000	157
chr3	75660328	75668328	75666035	8000	75664328	-4000	4000	1707
chr3	109312517	109320517	109314541	8000	109316517	-4000	4000	-1976
chr3	137760315	137768315	137765105	8000	137764315	-4000	4000	790
chr3	75660328	75668328	75665776	8000	75664328	-4000	4000	1448
chr3	140674064	140682064	140678271	8000	140678064	-4000	4000	207
chr3	52773595	52781595	52778400	8000	52777595	-4000	4000	805
chr3	69119032	69127032	69119160	8000	69123032	-4000	4000	-3872
chr3	51899353	51907353	51903069	8000	51903353	-4000	4000	-284
chr3	184027544	184035544	184035182	8000	184031544	-4000	4000	3638
chr3	51703068	51711068	51709232	8000	51707068	-4000	4000	2164
chr3	75660328	75668328	75665732	8000	75664328	-4000	4000	1404
chr3	68000247	68008247	68006594	8000	68004247	-4000	4000	2347
chr3	129524639	129532639	129528669	8000	129528639	-4000	4000	30
chr3	129524639	129532639	129532625	8000	129528639	-4000	4000	3986
chr3	138943137	138951137	138950542	8000	138947137	-4000	4000	3405
chr3	42681537	42689537	42688701	8000	42685537	-4000	4000	3164
chr3	191326526	191334526	191329697	8000	191330526	-4000	4000	-829
chr3	51857615	51865615	51863200	8000	51861615	-4000	4000	1585
chr3	126513773	126521773	126517703	8000	126517773	-4000	4000	-70
chr3	107373439	107381439	107377427	8000	107377439	-4000	4000	-12
chr3	68000247	68008247	68006546	8000	68004247	-4000	4000	2299
chr3	139040892	139048892	139044217	8000	139044892	-4000	4000	-675
chr3	42698824	42706824	42698897	8000	42702824	-4000	4000	-3927
chr3	186609060	186617060	186613327	8000	186613060	-4000	4000	267
chr3	114233578	114241578	114236668	8000	114237578	-4000	4000	-910
chr3	98349854	98357854	98354768	8000	98353854	-4000	4000	914
chr3	75660328	75668328	75665732	8000	75664328	-4000	4000	1404
chr3	115619510	115627510	115623510	8000	115623510	-4000	4000	0
chr3	98162696	98170696	98169388	8000	98166696	-4000	4000	2692
chr3	98493681	98501681	98497762	8000	98497681	-4000	4000	81
chr3	13876071	13884071	13879760	8000	13880071	-4000	4000	-311
chr3	42406610	42414610	42406909	8000	42410610	-4000	4000	-3701
chr3	42871898	42879898	42874427	8000	42875898	-4000	4000	-1471
chr3	44237886	44245886	44244349	8000	44241886	-4000	4000	2463
chr3	51857615	51865615	51861669	8000	51861615	-4000	4000	54
chr3	62370324	62378324	62372113	8000	62374324	-4000	4000	-2211
chr3	69119032	69127032	69119651	8000	69123032	-4000	4000	-3381
chr3	73057659	73065659	73063698	8000	73061659	-4000	4000	2039
chr3	73057659	73065659	73065060	8000	73061659	-4000	4000	3401
chr3	75660328	75668328	75666098	8000	75664328	-4000	4000	1770
chr3	98259252	98267252	98265103	8000	98263252	-4000	4000	1851
chr3	98527978	98535978	98532143	8000	98531978	-4000	4000	165
chr3	109333546	109341546	109337540	8000	109337546	-4000	4000	-6
chr3	172444456	172452456	172445442	8000	172448456	-4000	4000	-3014
chr3	184049047	184057047	184054863	8000	184053047	-4000	4000	1816
chr3	184093064	184101064	184100557	8000	184097064	-4000	4000	3493
chr3	186609060	186617060	186613131	8000	186613060	-4000	4000	71
chr3	194395266	194403266	194396631	8000	194399266	-4000	4000	-2635
chr3	62370324	62378324	62371322	8000	62374324	-4000	4000	-3002
chr3	151810073	151818073	151814226	8000	151814073	-4000	4000	153
chr3	98493681	98501681	98498304	8000	98497681	-4000	4000	623
chr3	187287980	187295980	187291654	8000	187291980	-4000	4000	-326
chr3	98493681	98501681	98498462	8000	98497681	-4000	4000	781
chr3	109312517	109320517	109312624	8000	109316517	-4000	4000	-3893
chr3	109333546	109341546	109333883	8000	109337546	-4000	4000	-3663
chr3	191457163	191465163	191461249	8000	191461163	-4000	4000	86
chr3	19144510	19152510	19148666	8000	19148510	-4000	4000	156
chr3	51871601	51879601	51873839	8000	51875601	-4000	4000	-1762
chr3	68000247	68008247	68006513	8000	68004247	-4000	4000	2266
chr3	98083173	98091173	98088056	8000	98087173	-4000	4000	883
chr3	98126721	98134721	98132851	8000	98130721	-4000	4000	2130
chr3	98126721	98134721	98132991	8000	98130721	-4000	4000	2270
chr3	98126721	98134721	98133448	8000	98130721	-4000	4000	2727
chr3	98143479	98151479	98149608	8000	98147479	-4000	4000	2129
chr3	98162696	98170696	98169577	8000	98166696	-4000	4000	2881
chr3	98259252	98267252	98264705	8000	98263252	-4000	4000	1453
chr3	100605601	100613601	100609769	8000	100609601	-4000	4000	168
chr3	127189131	127197131	127196656	8000	127193131	-4000	4000	3525
chr3	139002268	139010268	139006041	8000	139006268	-4000	4000	-227
chr3	139016926	139024926	139020405	8000	139020926	-4000	4000	-521
chr3	150937743	150945743	150943870	8000	150941743	-4000	4000	2127
chr3	172444456	172452456	172448050	8000	172448456	-4000	4000	-406
chr3	186609060	186617060	186613231	8000	186613060	-4000	4000	171
chr3	42406610	42414610	42407294	8000	42410610	-4000	4000	-3316
chr3	107373439	107381439	107378507	8000	107377439	-4000	4000	1068
chr3	75660328	75668328	75665138	8000	75664328	-4000	4000	810
chr3	98126721	98134721	98133305	8000	98130721	-4000	4000	2584
chr3	98126721	98134721	98133540	8000	98130721	-4000	4000	2819
chr3	98143479	98151479	98149610	8000	98147479	-4000	4000	2131
chr3	119143375	119151375	119146249	8000	119147375	-4000	4000	-1126
chr3	75660328	75668328	75665667	8000	75664328	-4000	4000	1339
chr3	98143479	98151479	98149766	8000	98147479	-4000	4000	2287
chr3	48368219	48376219	48375363	8000	48372219	-4000	4000	3144
chr3	98386666	98394666	98391397	8000	98390666	-4000	4000	731
chr3	137760315	137768315	137764959	8000	137764315	-4000	4000	644
chr3	108753410	108761410	108755879	8000	108757410	-4000	4000	-1531
chr3	119143375	119151375	119146454	8000	119147375	-4000	4000	-921
chr3	138943137	138951137	138950459	8000	138947137	-4000	4000	3322
chr3	119143375	119151375	119147427	8000	119147375	-4000	4000	52
chr3	139016926	139024926	139020275	8000	139020926	-4000	4000	-651
chr3	142959674	142967674	142962124	8000	142963674	-4000	4000	-1550
chr3	142959674	142967674	142962715	8000	142963674	-4000	4000	-959
chr3	151729916	151737916	151734027	8000	151733916	-4000	4000	111
chr3	187698557	187706557	187698936	8000	187702557	-4000	4000	-3621
chr3	119143375	119151375	119146408	8000	119147375	-4000	4000	-967
chr3	98126721	98134721	98132719	8000	98130721	-4000	4000	1998
chr3	75660328	75668328	75665679	8000	75664328	-4000	4000	1351
chr3	139016926	139024926	139020076	8000	139020926	-4000	4000	-850
chr3	108753410	108761410	108756528	8000	108757410	-4000	4000	-882
chr3	154426190	154434190	154429640	8000	154430190	-4000	4000	-550
chr3	119143375	119151375	119146970	8000	119147375	-4000	4000	-405
chr3	119143375	119151375	119146971	8000	119147375	-4000	4000	-404
chr3	154426190	154434190	154427580	8000	154430190	-4000	4000	-2610
chr3	44237886	44245886	44244367	8000	44241886	-4000	4000	2481
chr3	44237886	44245886	44244094	8000	44241886	-4000	4000	2208
chr3	98493681	98501681	98497819	8000	98497681	-4000	4000	138
chr3	48368219	48376219	48372760	8000	48372219	-4000	4000	541
chr3	75660328	75668328	75664487	8000	75664328	-4000	4000	159
chr3	196207437	196215437	196210662	8000	196211437	-4000	4000	-775
chr3	139040892	139048892	139044060	8000	139044892	-4000	4000	-832
chr3	98083173	98091173	98087413	8000	98087173	-4000	4000	240
chr3	49187858	49195858	49189873	8000	49191858	-4000	4000	-1985
chr3	139016926	139024926	139020003	8000	139020926	-4000	4000	-923
chr3	98259252	98267252	98265242	8000	98263252	-4000	4000	1990
chr3	98278505	98286505	98283123	8000	98282505	-4000	4000	618
chr3	98278505	98286505	98283602	8000	98282505	-4000	4000	1097
chr3	98527978	98535978	98532234	8000	98531978	-4000	4000	256
chr3	73057659	73065659	73065117	8000	73061659	-4000	4000	3458
chr3	39048157	39056157	39052040	8000	39052157	-4000	4000	-117
chr3	139002268	139010268	139005988	8000	139006268	-4000	4000	-280
chr3	160673160	160681160	160677933	8000	160677160	-4000	4000	773
chr3	42871898	42879898	42875575	8000	42875898	-4000	4000	-323
chr3	98278505	98286505	98283157	8000	98282505	-4000	4000	652
chr4	73849296	73857296	73853894	8000	73853296	-4000	4000	598
chr4	86845384	86853384	86848974	8000	86849384	-4000	4000	-410
chr4	109844107	109852107	109851919	8000	109848107	-4000	4000	3812
chr4	42888713	42896713	42893307	8000	42892713	-4000	4000	594
chr4	74304470	74312470	74309124	8000	74308470	-4000	4000	654
chr4	73832640	73840640	73837241	8000	73836640	-4000	4000	601
chr4	93824753	93832753	93829918	8000	93828753	-4000	4000	1165
chr4	26486484	26494484	26490201	8000	26490484	-4000	4000	-283
chr4	146634893	146642893	146640659	8000	146638893	-4000	4000	1766
chr4	3437968	3445968	3439531	8000	3441968	-4000	4000	-2437
chr4	55588245	55596245	55592157	8000	55592245	-4000	4000	-88
chr4	79404228	79412228	79406561	8000	79408228	-4000	4000	-1667
chr4	190023257	190031257	190027138	8000	190027257	-4000	4000	-119
chr4	41744725	41752725	41746248	8000	41748725	-4000	4000	-2477
chr4	183318426	183326426	183319758	8000	183322426	-4000	4000	-2668
chr4	68811994	68819994	68816403	8000	68815994	-4000	4000	409
chr4	7430930	7438930	7433586	8000	7434930	-4000	4000	-1344
chr4	56817742	56825742	56820574	8000	56821742	-4000	4000	-1168
chr4	79404228	79412228	79408182	8000	79408228	-4000	4000	-46
chr4	188135441	188143441	188139881	8000	188139441	-4000	4000	440
chr4	79322061	79330061	79325605	8000	79326061	-4000	4000	-456
chr4	171808254	171816254	171814686	8000	171812254	-4000	4000	2432
chr4	146634893	146642893	146640148	8000	146638893	-4000	4000	1255
chr4	70330981	70338981	70335874	8000	70334981	-4000	4000	893
chr4	26486484	26494484	26490333	8000	26490484	-4000	4000	-151
chr4	145676146	145684146	145680344	8000	145680146	-4000	4000	198
chr4	185422249	185430249	185429395	8000	185426249	-4000	4000	3146
chr4	41744725	41752725	41747372	8000	41748725	-4000	4000	-1353
chr4	44444809	44452809	44447799	8000	44448809	-4000	4000	-1010
chr4	163469754	163477754	163471934	8000	163473754	-4000	4000	-1820
chr4	146634893	146642893	146641421	8000	146638893	-4000	4000	2528
chr4	9777634	9785634	9783174	8000	9781634	-4000	4000	1540
chr4	86845384	86853384	86849087	8000	86849384	-4000	4000	-297
chr4	93824753	93832753	93829497	8000	93828753	-4000	4000	744
chr4	9777634	9785634	9782986	8000	9781634	-4000	4000	1352
chr4	185422249	185430249	185422515	8000	185426249	-4000	4000	-3734
chr4	109844107	109852107	109844146	8000	109848107	-4000	4000	-3961
chr4	122374966	122382966	122381097	8000	122378966	-4000	4000	2131
chr4	163469754	163477754	163472900	8000	163473754	-4000	4000	-854
chr4	185014490	185022490	185020512	8000	185018490	-4000	4000	2022
chr4	46120054	46128054	46123839	8000	46124054	-4000	4000	-215
chr4	79322061	79330061	79325350	8000	79326061	-4000	4000	-711
chr4	52016363	52024363	52017470	8000	52020363	-4000	4000	-2893
chr4	42888713	42896713	42893306	8000	42892713	-4000	4000	593
chr4	48486252	48494252	48494141	8000	48490252	-4000	4000	3889
chr4	48479343	48487343	48484039	8000	48483343	-4000	4000	696
chr4	183318426	183326426	183318561	8000	183322426	-4000	4000	-3865
chr4	121761427	121769427	121761653	8000	121765427	-4000	4000	-3774
chr4	163469754	163477754	163472672	8000	163473754	-4000	4000	-1082
chr4	79404228	79412228	79407009	8000	79408228	-4000	4000	-1219
chr4	68811994	68819994	68816209	8000	68815994	-4000	4000	215
chr4	144642156	144650156	144646580	8000	144646156	-4000	4000	424
chr4	146634893	146642893	146640364	8000	146638893	-4000	4000	1471
chr4	7430930	7438930	7433978	8000	7434930	-4000	4000	-952
chr4	17511165	17519165	17515502	8000	17515165	-4000	4000	337
chr4	3240369	3248369	3241480	8000	3244369	-4000	4000	-2889
chr4	9777634	9785634	9782681	8000	9781634	-4000	4000	1047
chr4	79404228	79412228	79406791	8000	79408228	-4000	4000	-1437
chr4	185014490	185022490	185018951	8000	185018490	-4000	4000	461
chr4	79404228	79412228	79408006	8000	79408228	-4000	4000	-222
chr4	163469754	163477754	163471674	8000	163473754	-4000	4000	-2080
chr4	122617066	122625066	122621014	8000	122621066	-4000	4000	-52
chr4	67750388	67758388	67754285	8000	67754388	-4000	4000	-103
chr4	70330981	70338981	70335180	8000	70334981	-4000	4000	199
chr4	79322061	79330061	79325212	8000	79326061	-4000	4000	-849
chr4	119131832	119139832	119136546	8000	119135832	-4000	4000	714
chr4	79322061	79330061	79325674	8000	79326061	-4000	4000	-387
chr4	41744725	41752725	41747536	8000	41748725	-4000	4000	-1189
chr4	17511165	17519165	17515477	8000	17515165	-4000	4000	312
chr4	48486252	48494252	48492851	8000	48490252	-4000	4000	2599
chr4	48486252	48494252	48494201	8000	48490252	-4000	4000	3949
chr4	74034807	74042807	74037004	8000	74038807	-4000	4000	-1803
chr4	93824753	93832753	93828931	8000	93828753	-4000	4000	178
chr4	184217230	184225230	184217852	8000	184221230	-4000	4000	-3378
chr4	73832640	73840640	73836794	8000	73836640	-4000	4000	154
chr4	146634893	146642893	146640063	8000	146638893	-4000	4000	1170
chr4	44674556	44682556	44680531	8000	44678556	-4000	4000	1975
chr4	109844107	109852107	109851843	8000	109848107	-4000	4000	3736
chr4	42888713	42896713	42893440	8000	42892713	-4000	4000	727
chr4	9239879	9247879	9239944	8000	9243879	-4000	4000	-3935
chr4	41744725	41752725	41744734	8000	41748725	-4000	4000	-3991
chr4	42393488	42401488	42398110	8000	42397488	-4000	4000	622
chr4	44674556	44682556	44678667	8000	44678556	-4000	4000	111
chr4	98139476	98147476	98143198	8000	98143476	-4000	4000	-278
chr4	121761427	121769427	121761658	8000	121765427	-4000	4000	-3769
chr4	73849296	73857296	73854082	8000	73853296	-4000	4000	786
chr4	92299966	92307966	92304613	8000	92303966	-4000	4000	647
chr4	79322061	79330061	79325649	8000	79326061	-4000	4000	-412
chr4	163469754	163477754	163472087	8000	163473754	-4000	4000	-1667
chr4	163469754	163477754	163473290	8000	163473754	-4000	4000	-464
chr4	95836093	95844093	95840932	8000	95840093	-4000	4000	839
chr4	79404228	79412228	79407874	8000	79408228	-4000	4000	-354
chr4	44674556	44682556	44680841	8000	44678556	-4000	4000	2285
chr4	122452725	122460725	122453822	8000	122456725	-4000	4000	-2903
chr4	188135441	188143441	188139948	8000	188139441	-4000	4000	507
chr4	42393488	42401488	42401127	8000	42397488	-4000	4000	3639
chr4	70330981	70338981	70335384	8000	70334981	-4000	4000	403
chr4	41977756	41985756	41982197	8000	41981756	-4000	4000	441
chr4	42393488	42401488	42401348	8000	42397488	-4000	4000	3860
chr4	44444809	44452809	44447808	8000	44448809	-4000	4000	-1001
chr4	70330981	70338981	70336291	8000	70334981	-4000	4000	1310
chr4	70330981	70338981	70335880	8000	70334981	-4000	4000	899
chr4	176191585	176199585	176195508	8000	176195585	-4000	4000	-77
chr4	41977756	41985756	41982166	8000	41981756	-4000	4000	410
chr4	41744725	41752725	41748402	8000	41748725	-4000	4000	-323
chr4	86845384	86853384	86849014	8000	86849384	-4000	4000	-370
chr4	3437968	3445968	3439607	8000	3441968	-4000	4000	-2361
chr4	9777634	9785634	9782710	8000	9781634	-4000	4000	1076
chr4	9777634	9785634	9783491	8000	9781634	-4000	4000	1857
chr4	41977756	41985756	41981906	8000	41981756	-4000	4000	150
chr4	48486252	48494252	48488936	8000	48490252	-4000	4000	-1316
chr4	68811994	68819994	68818049	8000	68815994	-4000	4000	2055
chr4	69991966	69999966	69999680	8000	69995966	-4000	4000	3714
chr4	155862277	155870277	155866254	8000	155866277	-4000	4000	-23
chr4	163469754	163477754	163473519	8000	163473754	-4000	4000	-235
chr4	171808254	171816254	171814426	8000	171812254	-4000	4000	2172
chr4	176191585	176199585	176192828	8000	176195585	-4000	4000	-2757
chr4	48486252	48494252	48488803	8000	48490252	-4000	4000	-1449
chr4	70330981	70338981	70335007	8000	70334981	-4000	4000	26
chr4	146634893	146642893	146641106	8000	146638893	-4000	4000	2213
chr4	93824753	93832753	93829692	8000	93828753	-4000	4000	939
chr4	146634893	146642893	146640335	8000	146638893	-4000	4000	1442
chr4	46120054	46128054	46123902	8000	46124054	-4000	4000	-152
chr4	3437968	3445968	3444154	8000	3441968	-4000	4000	2186
chr4	26486484	26494484	26489395	8000	26490484	-4000	4000	-1089
chr4	44674556	44682556	44680735	8000	44678556	-4000	4000	2179
chr4	52016363	52024363	52024016	8000	52020363	-4000	4000	3653
chr4	70588256	70596256	70592297	8000	70592256	-4000	4000	41
chr4	99507012	99515012	99513117	8000	99511012	-4000	4000	2105
chr4	146634893	146642893	146639907	8000	146638893	-4000	4000	1014
chr4	146634893	146642893	146640572	8000	146638893	-4000	4000	1679
chr4	146634893	146642893	146640684	8000	146638893	-4000	4000	1791
chr4	64405468	64413468	64409415	8000	64409468	-4000	4000	-53
chr4	52016363	52024363	52017310	8000	52020363	-4000	4000	-3053
chr4	64405468	64413468	64409215	8000	64409468	-4000	4000	-253
chr4	95836093	95844093	95840833	8000	95840093	-4000	4000	740
chr4	163469754	163477754	163473557	8000	163473754	-4000	4000	-197
chr4	121761427	121769427	121761565	8000	121765427	-4000	4000	-3862
chr4	9440414	9448414	9444560	8000	9444414	-4000	4000	146
chr4	26486484	26494484	26489432	8000	26490484	-4000	4000	-1052
chr4	4222929	4230929	4226561	8000	4226929	-4000	4000	-368
chr4	9777634	9785634	9783329	8000	9781634	-4000	4000	1695
chr4	95836093	95844093	95841237	8000	95840093	-4000	4000	1144
chr4	146634893	146642893	146640356	8000	146638893	-4000	4000	1463
chr4	109844107	109852107	109851834	8000	109848107	-4000	4000	3727
chr4	183318426	183326426	183319606	8000	183322426	-4000	4000	-2820
chr4	163469754	163477754	163472784	8000	163473754	-4000	4000	-970
chr4	176191585	176199585	176192731	8000	176195585	-4000	4000	-2854
chr4	112512180	112520180	112515139	8000	112516180	-4000	4000	-1041
chr4	68947804	68955804	68951695	8000	68951804	-4000	4000	-109
chr4	93824753	93832753	93829877	8000	93828753	-4000	4000	1124
chr4	145676146	145684146	145680281	8000	145680146	-4000	4000	135
chr4	41977756	41985756	41982326	8000	41981756	-4000	4000	570
chr4	73849296	73857296	73854084	8000	73853296	-4000	4000	788
chr4	146634893	146642893	146640067	8000	146638893	-4000	4000	1174
chr4	98139476	98147476	98143163	8000	98143476	-4000	4000	-313
chr5	177992242	178000242	177992415	8000	177996242	-4000	4000	-3827
chr5	141219372	141227372	141225125	8000	141223372	-4000	4000	1753
chr5	157055119	157063119	157055417	8000	157059119	-4000	4000	-3702
chr5	180736058	180744058	180739899	8000	180740058	-4000	4000	-159
chr5	146512190	146520190	146515736	8000	146516190	-4000	4000	-454
chr5	33980693	33988693	33984504	8000	33984693	-4000	4000	-189
chr5	175440182	175448182	175442486	8000	175444182	-4000	4000	-1696
chr5	33932386	33940386	33936923	8000	33936386	-4000	4000	537
chr5	148308419	148316419	148315764	8000	148312419	-4000	4000	3345
chr5	141047374	141055374	141053185	8000	141051374	-4000	4000	1811
chr5	111066062	111074062	111070487	8000	111070062	-4000	4000	425
chr5	141219372	141227372	141225081	8000	141223372	-4000	4000	1709
chr5	111066062	111074062	111071837	8000	111070062	-4000	4000	1775
chr5	137863858	137871858	137870976	8000	137867858	-4000	4000	3118
chr5	1221381	1229381	1221819	8000	1225381	-4000	4000	-3562
chr5	154474227	154482227	154475562	8000	154478227	-4000	4000	-2665
chr5	161543063	161551063	161546674	8000	161547063	-4000	4000	-389
chr5	141047374	141055374	141053289	8000	141051374	-4000	4000	1915
chr5	141219372	141227372	141224798	8000	141223372	-4000	4000	1426
chr5	148198794	148206794	148202996	8000	148202794	-4000	4000	202
chr5	180736058	180744058	180739207	8000	180740058	-4000	4000	-851
chr5	95616087	95624087	95621526	8000	95620087	-4000	4000	1439
chr5	180736058	180744058	180739345	8000	180740058	-4000	4000	-713
chr5	170349487	170357487	170353913	8000	170353487	-4000	4000	426
chr5	180984846	180992846	180988904	8000	180988846	-4000	4000	58
chr5	141047374	141055374	141052118	8000	141051374	-4000	4000	744
chr5	76949045	76957045	76955864	8000	76953045	-4000	4000	2819
chr5	73116569	73124569	73123428	8000	73120569	-4000	4000	2859
chr5	141047374	141055374	141053788	8000	141051374	-4000	4000	2414
chr5	33980693	33988693	33982370	8000	33984693	-4000	4000	-2323
chr5	54451699	54459699	54455794	8000	54455699	-4000	4000	95
chr5	121847882	121855882	121852119	8000	121851882	-4000	4000	237
chr5	177992242	178000242	177995974	8000	177996242	-4000	4000	-268
chr5	63958507	63966507	63960723	8000	63962507	-4000	4000	-1784
chr5	41067342	41075342	41070874	8000	41071342	-4000	4000	-468
chr5	141219372	141227372	141224904	8000	141223372	-4000	4000	1532
chr5	157667533	157675533	157671668	8000	157671533	-4000	4000	135
chr5	138871368	138879368	138874429	8000	138875368	-4000	4000	-939
chr5	150286093	150294093	150289638	8000	150290093	-4000	4000	-455
chr5	121847882	121855882	121852147	8000	121851882	-4000	4000	265
chr5	63958507	63966507	63960810	8000	63962507	-4000	4000	-1697
chr5	141047374	141055374	141051657	8000	141051374	-4000	4000	283
chr5	141219372	141227372	141224805	8000	141223372	-4000	4000	1433
chr5	180736058	180744058	180739997	8000	180740058	-4000	4000	-61
chr5	177992242	178000242	177994243	8000	177996242	-4000	4000	-1999
chr5	80315625	80323625	80321780	8000	80319625	-4000	4000	2155
chr5	102495016	102503016	102498698	8000	102499016	-4000	4000	-318
chr5	33932386	33940386	33937417	8000	33936386	-4000	4000	1031
chr5	33932386	33940386	33936981	8000	33936386	-4000	4000	595
chr5	180736058	180744058	180739708	8000	180740058	-4000	4000	-350
chr5	141219372	141227372	141224721	8000	141223372	-4000	4000	1349
chr5	180895077	180903077	180899184	8000	180899077	-4000	4000	107
chr5	187495	195495	192266	8000	191495	-4000	4000	771
chr5	73169193	73177193	73173839	8000	73173193	-4000	4000	646
chr5	141047374	141055374	141053687	8000	141051374	-4000	4000	2313
chr5	187495	195495	191592	8000	191495	-4000	4000	97
chr5	141219372	141227372	141225690	8000	141223372	-4000	4000	2318
chr5	161543063	161551063	161546674	8000	161547063	-4000	4000	-389
chr5	33932386	33940386	33937100	8000	33936386	-4000	4000	714
chr5	141047374	141055374	141052481	8000	141051374	-4000	4000	1107
chr5	141047374	141055374	141051579	8000	141051374	-4000	4000	205
chr5	132669986	132677986	132674048	8000	132673986	-4000	4000	62
chr5	135950983	135958983	135951459	8000	135954983	-4000	4000	-3524
chr5	102292284	102300284	102295941	8000	102296284	-4000	4000	-343
chr5	157456213	157464213	157463266	8000	157460213	-4000	4000	3053
chr5	77634713	77642713	77637198	8000	77638713	-4000	4000	-1515
chr5	143808161	143816161	143812192	8000	143812161	-4000	4000	31
chr5	57478811	57486811	57481725	8000	57482811	-4000	4000	-1086
chr5	57478811	57486811	57481727	8000	57482811	-4000	4000	-1084
chr5	140356194	140364194	140364092	8000	140360194	-4000	4000	3898
chr5	157162264	157170264	157162505	8000	157166264	-4000	4000	-3759
chr5	138871368	138879368	138874400	8000	138875368	-4000	4000	-968
chr5	151299766	151307766	151303226	8000	151303766	-4000	4000	-540
chr5	157162264	157170264	157163204	8000	157166264	-4000	4000	-3060
chr5	35044135	35052135	35049317	8000	35048135	-4000	4000	1182
chr5	54451699	54459699	54456153	8000	54455699	-4000	4000	454
chr5	180736058	180744058	180739248	8000	180740058	-4000	4000	-810
chr5	187495	195495	195161	8000	191495	-4000	4000	3666
chr5	64502015	64510015	64507804	8000	64506015	-4000	4000	1789
chr5	41067342	41075342	41070919	8000	41071342	-4000	4000	-423
chr5	102292284	102300284	102295935	8000	102296284	-4000	4000	-349
chr5	80315625	80323625	80320498	8000	80319625	-4000	4000	873
chr5	177992242	178000242	177993031	8000	177996242	-4000	4000	-3211
chr5	187495	195495	195029	8000	191495	-4000	4000	3534
chr5	141047374	141055374	141052939	8000	141051374	-4000	4000	1565
chr5	151343590	151351590	151347303	8000	151347590	-4000	4000	-287
chr5	157162264	157170264	157163300	8000	157166264	-4000	4000	-2964
chr5	135891841	135899841	135895735	8000	135895841	-4000	4000	-106
chr5	135531964	135539964	135535513	8000	135535964	-4000	4000	-451
chr5	173231311	173239311	173233087	8000	173235311	-4000	4000	-2224
chr5	80315625	80323625	80320291	8000	80319625	-4000	4000	666
chr5	180736058	180744058	180739594	8000	180740058	-4000	4000	-464
chr5	57478811	57486811	57481975	8000	57482811	-4000	4000	-836
chr5	73116569	73124569	73123609	8000	73120569	-4000	4000	3040
chr5	141047374	141055374	141051657	8000	141051374	-4000	4000	283
chr5	176626556	176634556	176629736	8000	176630556	-4000	4000	-820
chr5	157162264	157170264	157162738	8000	157166264	-4000	4000	-3526
chr5	63958507	63966507	63961427	8000	63962507	-4000	4000	-1080
chr5	141047374	141055374	141052799	8000	141051374	-4000	4000	1425
chr5	33980693	33988693	33984398	8000	33984693	-4000	4000	-295
chr5	175440182	175448182	175441552	8000	175444182	-4000	4000	-2630
chr5	141047374	141055374	141052295	8000	141051374	-4000	4000	921
chr5	180895077	180903077	180899355	8000	180899077	-4000	4000	278
chr5	138871368	138879368	138873794	8000	138875368	-4000	4000	-1574
chr5	63958507	63966507	63961186	8000	63962507	-4000	4000	-1321
chr5	63958507	63966507	63961070	8000	63962507	-4000	4000	-1437
chr5	63958507	63966507	63961576	8000	63962507	-4000	4000	-931
chr5	141047374	141055374	141051697	8000	141051374	-4000	4000	323
chr5	138079990	138087990	138084195	8000	138083990	-4000	4000	205
chr5	141219372	141227372	141225785	8000	141223372	-4000	4000	2413
chr5	54451699	54459699	54455901	8000	54455699	-4000	4000	202
chr5	35044135	35052135	35047972	8000	35048135	-4000	4000	-163
chr5	79107809	79115809	79115809	8000	79111809	-4000	4000	4000
chr5	141047374	141055374	141053096	8000	141051374	-4000	4000	1722
chr5	149940793	149948793	149944322	8000	149944793	-4000	4000	-471
chr5	154474227	154482227	154475830	8000	154478227	-4000	4000	-2397
chr5	51379448	51387448	51383506	8000	51383448	-4000	4000	58
chr5	80315625	80323625	80320131	8000	80319625	-4000	4000	506
chr5	76949045	76957045	76955863	8000	76953045	-4000	4000	2818
chr5	111066062	111074062	111071888	8000	111070062	-4000	4000	1826
chr5	138079990	138087990	138087891	8000	138083990	-4000	4000	3901
chr5	141047374	141055374	141051893	8000	141051374	-4000	4000	519
chr5	146512190	146520190	146515288	8000	146516190	-4000	4000	-902
chr5	102495016	102503016	102498729	8000	102499016	-4000	4000	-287
chr5	1221381	1229381	1225439	8000	1225381	-4000	4000	58
chr5	33980693	33988693	33984422	8000	33984693	-4000	4000	-271
chr5	141219372	141227372	141224883	8000	141223372	-4000	4000	1511
chr5	151920851	151928851	151924731	8000	151924851	-4000	4000	-120
chr5	176626556	176634556	176629698	8000	176630556	-4000	4000	-858
chr5	157162264	157170264	157162945	8000	157166264	-4000	4000	-3319
chr5	157162264	157170264	157166081	8000	157166264	-4000	4000	-183
chr5	80315625	80323625	80321199	8000	80319625	-4000	4000	1574
chr5	132552838	132560838	132557198	8000	132556838	-4000	4000	360
chr5	141219372	141227372	141225690	8000	141223372	-4000	4000	2318
chr5	33932386	33940386	33936581	8000	33936386	-4000	4000	195
chr5	33980693	33988693	33984215	8000	33984693	-4000	4000	-478
chr5	157162264	157170264	157162486	8000	157166264	-4000	4000	-3778
chr5	135531964	135539964	135535148	8000	135535964	-4000	4000	-816
chr5	135950983	135958983	135951212	8000	135954983	-4000	4000	-3771
chr5	141219372	141227372	141223464	8000	141223372	-4000	4000	92
chr5	146512190	146520190	146515819	8000	146516190	-4000	4000	-371
chr5	1197595	1205595	1201794	8000	1201595	-4000	4000	199
chr5	187495	195495	195038	8000	191495	-4000	4000	3543
chr5	57478811	57486811	57481747	8000	57482811	-4000	4000	-1064
chr5	57478811	57486811	57482011	8000	57482811	-4000	4000	-800
chr5	73116569	73124569	73123739	8000	73120569	-4000	4000	3170
chr5	73169193	73177193	73173537	8000	73173193	-4000	4000	344
chr5	132056655	132064655	132062693	8000	132060655	-4000	4000	2038
chr5	177396661	177404661	177402561	8000	177400661	-4000	4000	1900
chr5	141047374	141055374	141053775	8000	141051374	-4000	4000	2401
chr5	157162264	157170264	157165812	8000	157166264	-4000	4000	-452
chr5	157456213	157464213	157460492	8000	157460213	-4000	4000	279
chr5	57478811	57486811	57482065	8000	57482811	-4000	4000	-746
chr6	26236393	26244393	26240436	8000	26240393	-4000	4000	43
chr6	28255297	28263297	28259819	8000	28259297	-4000	4000	522
chr6	27308273	27316273	27309148	8000	27312273	-4000	4000	-3125
chr6	41224339	41232339	41228785	8000	41228339	-4000	4000	446
chr6	41331608	41339608	41336270	8000	41335608	-4000	4000	662
chr6	31135066	31143066	31142453	8000	31139066	-4000	4000	3387
chr6	27908396	27916396	27911821	8000	27912396	-4000	4000	-575
chr6	29483956	29491956	29487207	8000	29487956	-4000	4000	-749
chr6	31524962	31532962	31531101	8000	31528962	-4000	4000	2139
chr6	132566322	132574322	132570319	8000	132570322	-4000	4000	-3
chr6	26016451	26024451	26020958	8000	26020451	-4000	4000	507
chr6	26029618	26037618	26031821	8000	26033618	-4000	4000	-1797
chr6	26029618	26037618	26033205	8000	26033618	-4000	4000	-413
chr6	68631282	68639282	68639229	8000	68635282	-4000	4000	3947
chr6	29435306	29443306	29440199	8000	29439306	-4000	4000	893
chr6	26029618	26037618	26031843	8000	26033618	-4000	4000	-1775
chr6	29653002	29661002	29659407	8000	29657002	-4000	4000	2405
chr6	53144841	53152841	53145668	8000	53148841	-4000	4000	-3173
chr6	155451839	155459839	155454818	8000	155455839	-4000	4000	-1021
chr6	43291694	43299694	43298701	8000	43295694	-4000	4000	3007
chr6	27953241	27961241	27957987	8000	27957241	-4000	4000	746
chr6	27811022	27819022	27814470	8000	27815022	-4000	4000	-552
chr6	49965625	49973625	49968849	8000	49969625	-4000	4000	-776
chr6	137490394	137498394	137492744	8000	137494394	-4000	4000	-1650
chr6	98830574	98838574	98836138	8000	98834574	-4000	4000	1564
chr6	43291694	43299694	43298284	8000	43295694	-4000	4000	2590
chr6	28524215	28532215	28531876	8000	28528215	-4000	4000	3661
chr6	26246635	26254635	26251719	8000	26250635	-4000	4000	1084
chr6	132585741	132593741	132588888	8000	132589741	-4000	4000	-853
chr6	27811022	27819022	27814720	8000	27815022	-4000	4000	-302
chr6	26242996	26250996	26250391	8000	26246996	-4000	4000	3395
chr6	26268931	26276931	26273044	8000	26272931	-4000	4000	113
chr6	27908396	27916396	27911653	8000	27912396	-4000	4000	-743
chr6	133885113	133893113	133891749	8000	133889113	-4000	4000	2636
chr6	167153980	167161980	167157447	8000	167157980	-4000	4000	-533
chr6	27811022	27819022	27814571	8000	27815022	-4000	4000	-451
chr6	26029618	26037618	26031667	8000	26033618	-4000	4000	-1951
chr6	132534290	132542290	132538558	8000	132538290	-4000	4000	268
chr6	132620275	132628275	132624275	8000	132624275	-4000	4000	0
chr6	167992241	168000241	167995915	8000	167996241	-4000	4000	-326
chr6	27143106	27151106	27147488	8000	27147106	-4000	4000	382
chr6	77459491	77467491	77462684	8000	77463491	-4000	4000	-807
chr6	150065121	150073121	150065951	8000	150069121	-4000	4000	-3170
chr6	26029618	26037618	26031824	8000	26033618	-4000	4000	-1794
chr6	26246635	26254635	26251998	8000	26250635	-4000	4000	1363
chr6	73358658	73366658	73363604	8000	73362658	-4000	4000	946
chr6	26099933	26107933	26104250	8000	26103933	-4000	4000	317
chr6	27861317	27869317	27865582	8000	27865317	-4000	4000	265
chr6	26039713	26047713	26043444	8000	26043713	-4000	4000	-269
chr6	27868346	27876346	27873470	8000	27872346	-4000	4000	1124
chr6	31568054	31576054	31573834	8000	31572054	-4000	4000	1780
chr6	132548693	132556693	132553145	8000	132552693	-4000	4000	452
chr6	26268931	26276931	26272225	8000	26272931	-4000	4000	-706
chr6	26029618	26037618	26031709	8000	26033618	-4000	4000	-1909
chr6	29483956	29491956	29486895	8000	29487956	-4000	4000	-1061
chr6	52182375	52190375	52189387	8000	52186375	-4000	4000	3012
chr6	26029618	26037618	26033292	8000	26033618	-4000	4000	-326
chr6	26029618	26037618	26031739	8000	26033618	-4000	4000	-1879
chr6	46789389	46797389	46793570	8000	46793389	-4000	4000	181
chr6	27308273	27316273	27311035	8000	27312273	-4000	4000	-1238
chr6	31714594	31722594	31719001	8000	31718594	-4000	4000	407
chr6	83849360	83857360	83857257	8000	83853360	-4000	4000	3897
chr6	132566322	132574322	132571098	8000	132570322	-4000	4000	776
chr6	27889425	27897425	27892868	8000	27893425	-4000	4000	-557
chr6	26246635	26254635	26251879	8000	26250635	-4000	4000	1244
chr6	27143106	27151106	27147405	8000	27147106	-4000	4000	299
chr6	27811022	27819022	27815306	8000	27815022	-4000	4000	284
chr6	68631282	68639282	68638716	8000	68635282	-4000	4000	3434
chr6	27868346	27876346	27871965	8000	27872346	-4000	4000	-381
chr6	28255297	28263297	28259967	8000	28259297	-4000	4000	670
chr6	30951636	30959636	30951759	8000	30955636	-4000	4000	-3877
chr6	31135066	31143066	31138675	8000	31139066	-4000	4000	-391
chr6	109974256	109982256	109979133	8000	109978256	-4000	4000	877
chr6	27811022	27819022	27814467	8000	27815022	-4000	4000	-555
chr6	30951636	30959636	30951929	8000	30955636	-4000	4000	-3707
chr6	155451839	155459839	155455881	8000	155455839	-4000	4000	42
chr6	27953241	27961241	27957386	8000	27957241	-4000	4000	145
chr6	49783285	49791285	49786116	8000	49787285	-4000	4000	-1169
chr6	26242996	26250996	26250277	8000	26246996	-4000	4000	3281
chr6	133885113	133893113	133889643	8000	133889113	-4000	4000	530
chr6	29435306	29443306	29440172	8000	29439306	-4000	4000	866
chr6	26029618	26037618	26031769	8000	26033618	-4000	4000	-1849
chr6	49783285	49791285	49786461	8000	49787285	-4000	4000	-824
chr6	26029618	26037618	26031745	8000	26033618	-4000	4000	-1873
chr6	26099933	26107933	26104016	8000	26103933	-4000	4000	83
chr6	26246635	26254635	26251855	8000	26250635	-4000	4000	1220
chr6	43291694	43299694	43298563	8000	43295694	-4000	4000	2869
chr6	108162022	108170022	108168060	8000	108166022	-4000	4000	2038
chr6	26242996	26250996	26250290	8000	26246996	-4000	4000	3294
chr6	28255297	28263297	28259678	8000	28259297	-4000	4000	381
chr6	27308273	27316273	27310219	8000	27312273	-4000	4000	-2054
chr6	26268931	26276931	26273332	8000	26272931	-4000	4000	401
chr6	167992241	168000241	167996414	8000	167996241	-4000	4000	173
chr6	146023646	146031646	146029445	8000	146027646	-4000	4000	1799
chr6	49783285	49791285	49786132	8000	49787285	-4000	4000	-1153
chr6	35508896	35516896	35509638	8000	35512896	-4000	4000	-3258
chr6	132566322	132574322	132570437	8000	132570322	-4000	4000	115
chr6	41331608	41339608	41336367	8000	41335608	-4000	4000	759
chr6	26029618	26037618	26031841	8000	26033618	-4000	4000	-1777
chr6	26039713	26047713	26043263	8000	26043713	-4000	4000	-450
chr6	30979718	30987718	30987621	8000	30983718	-4000	4000	3903
chr6	27889425	27897425	27890710	8000	27893425	-4000	4000	-2715
chr6	41038467	41046467	41043983	8000	41042467	-4000	4000	1516
chr6	89890469	89898469	89894531	8000	89894469	-4000	4000	62
chr6	49783285	49791285	49787005	8000	49787285	-4000	4000	-280
chr6	54303859	54311859	54308633	8000	54307859	-4000	4000	774
chr6	29083313	29091313	29086856	8000	29087313	-4000	4000	-457
chr6	41224339	41232339	41228881	8000	41228339	-4000	4000	542
chr6	109974256	109982256	109980185	8000	109978256	-4000	4000	1929
chr6	27908396	27916396	27911689	8000	27912396	-4000	4000	-707
chr6	27868346	27876346	27872322	8000	27872346	-4000	4000	-24
chr6	50709526	50717526	50713886	8000	50713526	-4000	4000	360
chr6	132534290	132542290	132538383	8000	132538290	-4000	4000	93
chr6	26104135	26112135	26108020	8000	26108135	-4000	4000	-115
chr6	136918301	136926301	136924119	8000	136922301	-4000	4000	1818
chr6	89890469	89898469	89894565	8000	89894469	-4000	4000	96
chr6	89890469	89898469	89894894	8000	89894469	-4000	4000	425
chr6	26029618	26037618	26031817	8000	26033618	-4000	4000	-1801
chr6	25722562	25730562	25726074	8000	25726562	-4000	4000	-488
chr6	25722562	25730562	25726164	8000	25726562	-4000	4000	-398
chr6	43239481	43247481	43246766	8000	43243481	-4000	4000	3285
chr6	26016451	26024451	26017540	8000	26020451	-4000	4000	-2911
chr6	32403181	32411181	32405180	8000	32407181	-4000	4000	-2001
chr6	142143122	142151122	142147285	8000	142147122	-4000	4000	163
chr6	27811022	27819022	27815435	8000	27815022	-4000	4000	413
chr6	27889425	27897425	27892792	8000	27893425	-4000	4000	-633
chr6	29435306	29443306	29440486	8000	29439306	-4000	4000	1180
chr6	27868346	27876346	27873404	8000	27872346	-4000	4000	1058
chr6	30951636	30959636	30951916	8000	30955636	-4000	4000	-3720
chr6	22565566	22573566	22569587	8000	22569566	-4000	4000	21
chr6	29083313	29091313	29087239	8000	29087313	-4000	4000	-74
chr6	31714594	31722594	31717719	8000	31718594	-4000	4000	-875
chr6	26236393	26244393	26240503	8000	26240393	-4000	4000	110
chr6	31568054	31576054	31574010	8000	31572054	-4000	4000	1956
chr6	77459491	77467491	77462516	8000	77463491	-4000	4000	-975
chr6	50709526	50717526	50715493	8000	50713526	-4000	4000	1967
chr6	167153980	167161980	167156994	8000	167157980	-4000	4000	-986
chr6	26016451	26024451	26020500	8000	26020451	-4000	4000	49
chr6	26039713	26047713	26043295	8000	26043713	-4000	4000	-418
chr6	26039713	26047713	26043376	8000	26043713	-4000	4000	-337
chr6	26104135	26112135	26108090	8000	26108135	-4000	4000	-45
chr6	27868346	27876346	27872278	8000	27872346	-4000	4000	-68
chr6	131697401	131705401	131701197	8000	131701401	-4000	4000	-204
chr6	155451839	155459839	155455817	8000	155455839	-4000	4000	-22
chr6	26242996	26250996	26250438	8000	26246996	-4000	4000	3442
chr6	29391631	29399631	29397415	8000	29395631	-4000	4000	1784
chr6	27868346	27876346	27872240	8000	27872346	-4000	4000	-106
chr6	150065121	150073121	150066097	8000	150069121	-4000	4000	-3024
chr6	43291694	43299694	43298448	8000	43295694	-4000	4000	2754
chr6	99602774	99610774	99609290	8000	99606774	-4000	4000	2516
chr6	28255297	28263297	28260369	8000	28259297	-4000	4000	1072
chr6	27803929	27811929	27807515	8000	27807929	-4000	4000	-414
chr6	29483956	29491956	29486967	8000	29487956	-4000	4000	-989
chr6	29483956	29491956	29487555	8000	29487956	-4000	4000	-401
chr6	31568054	31576054	31573325	8000	31572054	-4000	4000	1271
chr6	28255297	28263297	28259356	8000	28259297	-4000	4000	59
chr6	35508896	35516896	35511651	8000	35512896	-4000	4000	-1245
chr6	132732935	132740935	132734486	8000	132736935	-4000	4000	-2449
chr6	27308273	27316273	27311122	8000	27312273	-4000	4000	-1151
chr6	41038467	41046467	41042678	8000	41042467	-4000	4000	211
chr6	27811022	27819022	27815152	8000	27815022	-4000	4000	130
chr6	109974256	109982256	109980176	8000	109978256	-4000	4000	1920
chr6	29166907	29174907	29173844	8000	29170907	-4000	4000	2937
chr6	146023646	146031646	146029440	8000	146027646	-4000	4000	1794
chr6	27143106	27151106	27146681	8000	27147106	-4000	4000	-425
chr6	27143106	27151106	27146802	8000	27147106	-4000	4000	-304
chr6	29483956	29491956	29486958	8000	29487956	-4000	4000	-998
chr6	27803929	27811929	27807867	8000	27807929	-4000	4000	-62
chr6	30159206	30167206	30160914	8000	30163206	-4000	4000	-2292
chr6	134946115	134954115	134949937	8000	134950115	-4000	4000	-178
chr6	149919121	149927121	149923021	8000	149923121	-4000	4000	-100
chr6	98830574	98838574	98835380	8000	98834574	-4000	4000	806
chr6	25722562	25730562	25726359	8000	25726562	-4000	4000	-203
chr6	26185112	26193112	26188959	8000	26189112	-4000	4000	-153
chr6	29483956	29491956	29487201	8000	29487956	-4000	4000	-755
chr6	134946115	134954115	134950038	8000	134950115	-4000	4000	-77
chr6	26039713	26047713	26043342	8000	26043713	-4000	4000	-371
chr6	28255297	28263297	28259516	8000	28259297	-4000	4000	219
chr6	26029618	26037618	26031841	8000	26033618	-4000	4000	-1777
chr6	27861317	27869317	27865787	8000	27865317	-4000	4000	470
chr6	29581121	29589121	29588056	8000	29585121	-4000	4000	2935
chr6	25722562	25730562	25727222	8000	25726562	-4000	4000	660
chr6	27861317	27869317	27865358	8000	27865317	-4000	4000	41
chr6	27868346	27876346	27873203	8000	27872346	-4000	4000	857
chr6	29083313	29091313	29087213	8000	29087313	-4000	4000	-100
chr6	29483956	29491956	29487407	8000	29487956	-4000	4000	-549
chr6	26268931	26276931	26271160	8000	26272931	-4000	4000	-1771
chr6	28255297	28263297	28259401	8000	28259297	-4000	4000	104
chr6	26268931	26276931	26271347	8000	26272931	-4000	4000	-1584
chr6	89890469	89898469	89895258	8000	89894469	-4000	4000	789
chr6	27803929	27811929	27807811	8000	27807929	-4000	4000	-118
chr6	29391631	29399631	29396887	8000	29395631	-4000	4000	1256
chr6	166164700	166172700	166166714	8000	166168700	-4000	4000	-1986
chr6	26242996	26250996	26246846	8000	26246996	-4000	4000	-150
chr6	27953241	27961241	27957502	8000	27957241	-4000	4000	261
chr6	30159206	30167206	30163954	8000	30163206	-4000	4000	748
chr6	88043841	88051841	88047947	8000	88047841	-4000	4000	106
chr6	27143106	27151106	27147262	8000	27147106	-4000	4000	156
chr6	27308273	27316273	27311162	8000	27312273	-4000	4000	-1111
chr6	26029618	26037618	26033212	8000	26033618	-4000	4000	-406
chr6	27143106	27151106	27147138	8000	27147106	-4000	4000	32
chr6	27143106	27151106	27147341	8000	27147106	-4000	4000	235
chr6	52182375	52190375	52189166	8000	52186375	-4000	4000	2791
chr6	27889425	27897425	27893026	8000	27893425	-4000	4000	-399
chr6	26039713	26047713	26043367	8000	26043713	-4000	4000	-346
chr6	28255297	28263297	28259592	8000	28259297	-4000	4000	295
chr6	53144841	53152841	53145671	8000	53148841	-4000	4000	-3170
chr6	116761719	116769719	116762066	8000	116765719	-4000	4000	-3653
chr6	41150347	41158347	41153875	8000	41154347	-4000	4000	-472
chr6	50045929	50053929	50048601	8000	50049929	-4000	4000	-1328
chr6	25722562	25730562	25726294	8000	25726562	-4000	4000	-268
chr6	26029618	26037618	26031908	8000	26033618	-4000	4000	-1710
chr6	132566322	132574322	132571317	8000	132570322	-4000	4000	995
chr6	167153980	167161980	167157387	8000	167157980	-4000	4000	-593
chr6	26099933	26107933	26107621	8000	26103933	-4000	4000	3688
chr6	26268931	26276931	26271254	8000	26272931	-4000	4000	-1677
chr6	30979718	30987718	30986841	8000	30983718	-4000	4000	3123
chr6	32403181	32411181	32404962	8000	32407181	-4000	4000	-2219
chr6	27803929	27811929	27807897	8000	27807929	-4000	4000	-32
chr6	39318968	39326968	39319043	8000	39322968	-4000	4000	-3925
chr6	73358658	73366658	73363253	8000	73362658	-4000	4000	595
chr6	27803929	27811929	27808591	8000	27807929	-4000	4000	662
chr6	132585741	132593741	132588896	8000	132589741	-4000	4000	-845
chr6	29166907	29174907	29174343	8000	29170907	-4000	4000	3436
chr6	27953241	27961241	27957795	8000	27957241	-4000	4000	554
chr6	25722562	25730562	25726116	8000	25726562	-4000	4000	-446
chr6	26016451	26024451	26022039	8000	26020451	-4000	4000	1588
chr6	26023283	26031283	26027030	8000	26027283	-4000	4000	-253
chr6	26039713	26047713	26045417	8000	26043713	-4000	4000	1704
chr6	26242996	26250996	26250287	8000	26246996	-4000	4000	3291
chr6	26246635	26254635	26251879	8000	26250635	-4000	4000	1244
chr6	27143106	27151106	27147225	8000	27147106	-4000	4000	119
chr6	27803929	27811929	27810226	8000	27807929	-4000	4000	2297
chr6	27811022	27819022	27814343	8000	27815022	-4000	4000	-679
chr6	27889425	27897425	27893616	8000	27893425	-4000	4000	191
chr6	29166907	29174907	29173994	8000	29170907	-4000	4000	3087
chr6	29483956	29491956	29487220	8000	29487956	-4000	4000	-736
chr6	54303859	54311859	54308691	8000	54307859	-4000	4000	832
chr6	134946115	134954115	134950060	8000	134950115	-4000	4000	-55
chr6	137490394	137498394	137493701	8000	137494394	-4000	4000	-693
chr6	160117815	160125815	160122004	8000	160121815	-4000	4000	189
chr6	162723132	162731132	162728379	8000	162727132	-4000	4000	1247
chr6	27908396	27916396	27911610	8000	27912396	-4000	4000	-786
chr6	68631282	68639282	68639082	8000	68635282	-4000	4000	3800
chr6	32367912	32375912	32371778	8000	32371912	-4000	4000	-134
chr6	26236393	26244393	26240571	8000	26240393	-4000	4000	178
chr6	27308273	27316273	27311197	8000	27312273	-4000	4000	-1076
chr6	89890469	89898469	89895304	8000	89894469	-4000	4000	835
chr6	132566322	132574322	132571239	8000	132570322	-4000	4000	917
chr6	160117815	160125815	160122230	8000	160121815	-4000	4000	415
chr6	27953241	27961241	27957336	8000	27957241	-4000	4000	95
chr6	132534290	132542290	132538497	8000	132538290	-4000	4000	207
chr6	31702904	31710904	31706911	8000	31706904	-4000	4000	7
chr6	89890469	89898469	89895719	8000	89894469	-4000	4000	1250
chr6	41150347	41158347	41154276	8000	41154347	-4000	4000	-71
chr6	4083344	4091344	4087536	8000	4087344	-4000	4000	192
chr6	25722562	25730562	25727082	8000	25726562	-4000	4000	520
chr6	29435306	29443306	29440063	8000	29439306	-4000	4000	757
chr6	30951636	30959636	30951912	8000	30955636	-4000	4000	-3724
chr6	50709526	50717526	50715299	8000	50713526	-4000	4000	1773
chr6	52905698	52913698	52905854	8000	52909698	-4000	4000	-3844
chr6	89890469	89898469	89894580	8000	89894469	-4000	4000	111
chr6	99602774	99610774	99609268	8000	99606774	-4000	4000	2494
chr6	133885113	133893113	133889477	8000	133889113	-4000	4000	364
chr6	137490394	137498394	137493688	8000	137494394	-4000	4000	-706
chr6	138791911	138799911	138792879	8000	138795911	-4000	4000	-3032
chr6	146023646	146031646	146029748	8000	146027646	-4000	4000	2102
chr6	154006496	154014496	154010794	8000	154010496	-4000	4000	298
chr6	155451839	155459839	155455865	8000	155455839	-4000	4000	26
chr6	160698238	160706238	160702326	8000	160702238	-4000	4000	88
chr6	28255297	28263297	28260448	8000	28259297	-4000	4000	1151
chr6	43291694	43299694	43299448	8000	43295694	-4000	4000	3754
chr6	27143106	27151106	27146837	8000	27147106	-4000	4000	-269
chr6	49965625	49973625	49968804	8000	49969625	-4000	4000	-821
chr6	152746797	152754797	152752259	8000	152750797	-4000	4000	1462
chr6	27889425	27897425	27893732	8000	27893425	-4000	4000	307
chr6	26029618	26037618	26031841	8000	26033618	-4000	4000	-1777
chr6	26039713	26047713	26045498	8000	26043713	-4000	4000	1785
chr6	29083313	29091313	29086325	8000	29087313	-4000	4000	-988
chr6	31702904	31710904	31703050	8000	31706904	-4000	4000	-3854
chr6	35733032	35741032	35738095	8000	35737032	-4000	4000	1063
chr6	117261558	117269558	117268194	8000	117265558	-4000	4000	2636
chr6	26242996	26250996	26250433	8000	26246996	-4000	4000	3437
chr6	50709526	50717526	50713908	8000	50713526	-4000	4000	382
chr6	89890469	89898469	89894558	8000	89894469	-4000	4000	89
chr6	27143106	27151106	27147470	8000	27147106	-4000	4000	364
chr6	49960164	49968164	49960423	8000	49964164	-4000	4000	-3741
chr6	35793344	35801344	35797238	8000	35797344	-4000	4000	-106
chr6	49965625	49973625	49969620	8000	49969625	-4000	4000	-5
chr6	10878041	10886041	10881779	8000	10882041	-4000	4000	-262
chr6	26029618	26037618	26031751	8000	26033618	-4000	4000	-1867
chr6	27861317	27869317	27865668	8000	27865317	-4000	4000	351
chr6	29083313	29091313	29087288	8000	29087313	-4000	4000	-25
chr6	31714594	31722594	31720182	8000	31718594	-4000	4000	1588
chr6	35733032	35741032	35737235	8000	35737032	-4000	4000	203
chr6	132534290	132542290	132538487	8000	132538290	-4000	4000	197
chr6	137490394	137498394	137493850	8000	137494394	-4000	4000	-544
chr6	27868346	27876346	27871866	8000	27872346	-4000	4000	-480
chr6	29435306	29443306	29440648	8000	29439306	-4000	4000	1342
chr6	26023283	26031283	26027096	8000	26027283	-4000	4000	-187
chr6	62282225	62290225	62286033	8000	62286225	-4000	4000	-192
chr6	131697401	131705401	131700573	8000	131701401	-4000	4000	-828
chr6	146594967	146602967	146599032	8000	146598967	-4000	4000	65
chr6	26236393	26244393	26240622	8000	26240393	-4000	4000	229
chr6	73358658	73366658	73362871	8000	73362658	-4000	4000	213
chr6	27889425	27897425	27893024	8000	27893425	-4000	4000	-401
chr6	77459491	77467491	77462600	8000	77463491	-4000	4000	-891
chr6	54303859	54311859	54308518	8000	54307859	-4000	4000	659
chr6	26099933	26107933	26104007	8000	26103933	-4000	4000	74
chr6	27811022	27819022	27814609	8000	27815022	-4000	4000	-413
chr6	132585741	132593741	132589161	8000	132589741	-4000	4000	-580
chr6	131697401	131705401	131700988	8000	131701401	-4000	4000	-413
chr6	54303859	54311859	54308626	8000	54307859	-4000	4000	767
chr6	27308273	27316273	27309482	8000	27312273	-4000	4000	-2791
chr6	46789389	46797389	46793702	8000	46793389	-4000	4000	313
chr6	132548693	132556693	132553486	8000	132552693	-4000	4000	793
chr6	35733032	35741032	35737165	8000	35737032	-4000	4000	133
chr6	132566322	132574322	132570712	8000	132570322	-4000	4000	390
chr6	109974256	109982256	109979627	8000	109978256	-4000	4000	1371
chr6	73358658	73366658	73362681	8000	73362658	-4000	4000	23
chr6	27308273	27316273	27310120	8000	27312273	-4000	4000	-2153
chr6	27803929	27811929	27808542	8000	27807929	-4000	4000	613
chr6	29483956	29491956	29487270	8000	29487956	-4000	4000	-686
chr6	29483956	29491956	29487416	8000	29487956	-4000	4000	-540
chr6	49783285	49791285	49787275	8000	49787285	-4000	4000	-10
chr6	26268931	26276931	26270991	8000	26272931	-4000	4000	-1940
chr6	41224339	41232339	41228451	8000	41228339	-4000	4000	112
chr6	30979718	30987718	30986757	8000	30983718	-4000	4000	3039
chr6	26268931	26276931	26273059	8000	26272931	-4000	4000	128
chr6	27868346	27876346	27873256	8000	27872346	-4000	4000	910
chr6	27308273	27316273	27309778	8000	27312273	-4000	4000	-2495
chr6	27308273	27316273	27309991	8000	27312273	-4000	4000	-2282
chr6	27308273	27316273	27310383	8000	27312273	-4000	4000	-1890
chr6	77459491	77467491	77462870	8000	77463491	-4000	4000	-621
chr6	22565566	22573566	22569774	8000	22569566	-4000	4000	208
chr6	26029618	26037618	26031728	8000	26033618	-4000	4000	-1890
chr6	26039713	26047713	26043441	8000	26043713	-4000	4000	-272
chr6	26099933	26107933	26107621	8000	26103933	-4000	4000	3688
chr6	27803929	27811929	27808438	8000	27807929	-4000	4000	509
chr6	30951636	30959636	30953313	8000	30955636	-4000	4000	-2323
chr6	39318968	39326968	39319134	8000	39322968	-4000	4000	-3834
chr6	77459491	77467491	77462892	8000	77463491	-4000	4000	-599
chr6	99602774	99610774	99608745	8000	99606774	-4000	4000	1971
chr6	109974256	109982256	109980276	8000	109978256	-4000	4000	2020
chr6	30979718	30987718	30986574	8000	30983718	-4000	4000	2856
chr6	27143106	27151106	27146792	8000	27147106	-4000	4000	-314
chr6	26029618	26037618	26031887	8000	26033618	-4000	4000	-1731
chr6	35508896	35516896	35512680	8000	35512896	-4000	4000	-216
chr6	35793344	35801344	35795147	8000	35797344	-4000	4000	-2197
chr6	68631282	68639282	68639217	8000	68635282	-4000	4000	3935
chr7	122991700	122999700	122994804	8000	122995700	-4000	4000	-896
chr7	48920547	48928547	48925007	8000	48924547	-4000	4000	460
chr7	141837487	141845487	141837998	8000	141841487	-4000	4000	-3489
chr7	53031633	53039633	53036147	8000	53035633	-4000	4000	514
chr7	25224486	25232486	25225076	8000	25228486	-4000	4000	-3410
chr7	143473873	143481873	143478098	8000	143477873	-4000	4000	225
chr7	27196091	27204091	27198205	8000	27200091	-4000	4000	-1886
chr7	122991700	122999700	122995599	8000	122995700	-4000	4000	-101
chr7	144105583	144113583	144110245	8000	144109583	-4000	4000	662
chr7	20782886	20790886	20784695	8000	20786886	-4000	4000	-2191
chr7	88791737	88799737	88794284	8000	88795737	-4000	4000	-1453
chr7	55858755	55866755	55861961	8000	55862755	-4000	4000	-794
chr7	101197038	101205038	101198292	8000	101201038	-4000	4000	-2746
chr7	20782886	20790886	20784662	8000	20786886	-4000	4000	-2224
chr7	48920547	48928547	48925877	8000	48924547	-4000	4000	1330
chr7	48920547	48928547	48925160	8000	48924547	-4000	4000	613
chr7	31336726	31344726	31339038	8000	31340726	-4000	4000	-1688
chr7	142929746	142937746	142933453	8000	142933746	-4000	4000	-293
chr7	143931233	143939233	143936003	8000	143935233	-4000	4000	770
chr7	18023846	18031846	18027637	8000	18027846	-4000	4000	-209
chr7	53031633	53039633	53036419	8000	53035633	-4000	4000	786
chr7	73324082	73332082	73325571	8000	73328082	-4000	4000	-2511
chr7	130376339	130384339	130383413	8000	130380339	-4000	4000	3074
chr7	143048341	143056341	143053257	8000	143052341	-4000	4000	916
chr7	143931233	143939233	143935640	8000	143935233	-4000	4000	407
chr7	130262863	130270863	130270717	8000	130266863	-4000	4000	3854
chr7	130376339	130384339	130383423	8000	130380339	-4000	4000	3084
chr7	19769617	19777617	19772622	8000	19773617	-4000	4000	-995
chr7	97001553	97009553	97007699	8000	97005553	-4000	4000	2146
chr7	124472371	124480371	124476711	8000	124476371	-4000	4000	340
chr7	130376339	130384339	130383443	8000	130380339	-4000	4000	3104
chr7	128357685	128365685	128359810	8000	128361685	-4000	4000	-1875
chr7	100479927	100487927	100487108	8000	100483927	-4000	4000	3181
chr7	142254058	142262058	142255630	8000	142258058	-4000	4000	-2428
chr7	27098686	27106686	27100847	8000	27102686	-4000	4000	-1839
chr7	88791737	88799737	88794327	8000	88795737	-4000	4000	-1410
chr7	1228872	1236872	1235864	8000	1232872	-4000	4000	2992
chr7	53031633	53039633	53035791	8000	53035633	-4000	4000	158
chr7	151183832	151191832	151186850	8000	151187832	-4000	4000	-982
chr7	121321367	121329367	121329303	8000	121325367	-4000	4000	3936
chr7	97728084	97736084	97732624	8000	97732084	-4000	4000	540
chr7	117424123	117432123	117426854	8000	117428123	-4000	4000	-1269
chr7	48920547	48928547	48925208	8000	48924547	-4000	4000	661
chr7	48920547	48928547	48925547	8000	48924547	-4000	4000	1000
chr7	155066324	155074324	155071474	8000	155070324	-4000	4000	1150
chr7	155066324	155074324	155071149	8000	155070324	-4000	4000	825
chr7	141786217	141794217	141791291	8000	141790217	-4000	4000	1074
chr7	19141421	19149421	19145320	8000	19145421	-4000	4000	-101
chr7	48920547	48928547	48924911	8000	48924547	-4000	4000	364
chr7	124472371	124480371	124476376	8000	124476371	-4000	4000	5
chr7	27092000	27100000	27095724	8000	27096000	-4000	4000	-276
chr7	27196091	27204091	27196970	8000	27200091	-4000	4000	-3121
chr7	1228872	1236872	1233633	8000	1232872	-4000	4000	761
chr7	31336726	31344726	31339141	8000	31340726	-4000	4000	-1585
chr7	31336726	31344726	31339285	8000	31340726	-4000	4000	-1441
chr7	143218037	143226037	143222214	8000	143222037	-4000	4000	177
chr7	122991700	122999700	122994995	8000	122995700	-4000	4000	-705
chr7	101016072	101024072	101018635	8000	101020072	-4000	4000	-1437
chr7	73324082	73332082	73325571	8000	73328082	-4000	4000	-2511
chr7	141969773	141977773	141973390	8000	141973773	-4000	4000	-383
chr7	143473873	143481873	143478580	8000	143477873	-4000	4000	707
chr7	27092000	27100000	27095330	8000	27096000	-4000	4000	-670
chr7	88791737	88799737	88794855	8000	88795737	-4000	4000	-882
chr7	53031633	53039633	53036530	8000	53035633	-4000	4000	897
chr7	31336726	31344726	31338553	8000	31340726	-4000	4000	-2173
chr7	122991700	122999700	122994953	8000	122995700	-4000	4000	-747
chr7	144105583	144113583	144109752	8000	144109583	-4000	4000	169
chr7	143312111	143320111	143316288	8000	143316111	-4000	4000	177
chr7	155066324	155074324	155071209	8000	155070324	-4000	4000	885
chr7	48920547	48928547	48924975	8000	48924547	-4000	4000	428
chr7	18023846	18031846	18027659	8000	18027846	-4000	4000	-187
chr7	130730207	130738207	130732961	8000	130734207	-4000	4000	-1246
chr7	124029067	124037067	124032773	8000	124033067	-4000	4000	-294
chr7	31336726	31344726	31339045	8000	31340726	-4000	4000	-1681
chr7	121321367	121329367	121329334	8000	121325367	-4000	4000	3967
chr7	2472894	2480894	2475680	8000	2476894	-4000	4000	-1214
chr7	130262863	130270863	130269666	8000	130266863	-4000	4000	2803
chr7	31336726	31344726	31338307	8000	31340726	-4000	4000	-2419
chr7	141837487	141845487	141838068	8000	141841487	-4000	4000	-3419
chr7	88755700	88763700	88759901	8000	88759700	-4000	4000	201
chr7	27176013	27184013	27182904	8000	27180013	-4000	4000	2891
chr7	50091883	50099883	50096361	8000	50095883	-4000	4000	478
chr7	88791737	88799737	88794266	8000	88795737	-4000	4000	-1471
chr7	48920547	48928547	48924887	8000	48924547	-4000	4000	340
chr7	18023846	18031846	18027324	8000	18027846	-4000	4000	-522
chr7	27176013	27184013	27182664	8000	27180013	-4000	4000	2651
chr7	130202344	130210344	130205448	8000	130206344	-4000	4000	-896
chr7	31336726	31344726	31337482	8000	31340726	-4000	4000	-3244
chr7	44137332	44145332	44145090	8000	44141332	-4000	4000	3758
chr7	73324082	73332082	73324407	8000	73328082	-4000	4000	-3675
chr7	130376339	130384339	130381734	8000	130380339	-4000	4000	1395
chr7	45884360	45892360	45888754	8000	45888360	-4000	4000	394
chr7	155066324	155074324	155071514	8000	155070324	-4000	4000	1190
chr7	155066324	155074324	155070836	8000	155070324	-4000	4000	512
chr7	143023132	143031132	143026856	8000	143027132	-4000	4000	-276
chr7	124472371	124480371	124476433	8000	124476371	-4000	4000	62
chr7	25224486	25232486	25225052	8000	25228486	-4000	4000	-3434
chr7	31336726	31344726	31339201	8000	31340726	-4000	4000	-1525
chr7	43993897	44001897	44001271	8000	43997897	-4000	4000	3374
chr7	142254058	142262058	142257867	8000	142258058	-4000	4000	-191
chr7	23706203	23714203	23712138	8000	23710203	-4000	4000	1935
chr7	27098686	27106686	27102120	8000	27102686	-4000	4000	-566
chr7	117424123	117432123	117427452	8000	117428123	-4000	4000	-671
chr7	130376339	130384339	130380512	8000	130380339	-4000	4000	173
chr7	142929746	142937746	142933505	8000	142933746	-4000	4000	-241
chr7	64041434	64049434	64045542	8000	64045434	-4000	4000	108
chr7	5875827	5883827	5880937	8000	5879827	-4000	4000	1110
chr7	122991700	122999700	122994783	8000	122995700	-4000	4000	-917
chr7	117424123	117432123	117427504	8000	117428123	-4000	4000	-619
chr7	143439453	143447453	143444304	8000	143443453	-4000	4000	851
chr7	130376339	130384339	130383430	8000	130380339	-4000	4000	3091
chr7	97001553	97009553	97006368	8000	97005553	-4000	4000	815
chr7	27196091	27204091	27199190	8000	27200091	-4000	4000	-901
chr7	19141421	19149421	19145038	8000	19145421	-4000	4000	-383
chr7	88755700	88763700	88759849	8000	88759700	-4000	4000	149
chr7	1228872	1236872	1233651	8000	1232872	-4000	4000	779
chr7	1228872	1236872	1233652	8000	1232872	-4000	4000	780
chr7	148586766	148594766	148591018	8000	148590766	-4000	4000	252
chr7	88791737	88799737	88794718	8000	88795737	-4000	4000	-1019
chr7	75488320	75496320	75495146	8000	75492320	-4000	4000	2826
chr7	128357685	128365685	128359420	8000	128361685	-4000	4000	-2265
chr7	72965466	72973466	72969934	8000	72969466	-4000	4000	468
chr7	27176013	27184013	27182696	8000	27180013	-4000	4000	2683
chr7	44137332	44145332	44140739	8000	44141332	-4000	4000	-593
chr7	141786217	141794217	141790569	8000	141790217	-4000	4000	352
chr7	141837487	141845487	141838040	8000	141841487	-4000	4000	-3447
chr7	124029067	124037067	124032158	8000	124033067	-4000	4000	-909
chr7	27238700	27246700	27245155	8000	27242700	-4000	4000	2455
chr7	15558015	15566015	15561963	8000	15562015	-4000	4000	-52
chr7	27176013	27184013	27182885	8000	27180013	-4000	4000	2872
chr7	31336726	31344726	31338616	8000	31340726	-4000	4000	-2110
chr7	48920547	48928547	48925480	8000	48924547	-4000	4000	933
chr7	97728084	97736084	97734839	8000	97732084	-4000	4000	2755
chr7	122991700	122999700	122995468	8000	122995700	-4000	4000	-232
chr7	130730207	130738207	130733404	8000	130734207	-4000	4000	-803
chr7	141786217	141794217	141790880	8000	141790217	-4000	4000	663
chr7	142935343	142943343	142941216	8000	142939343	-4000	4000	1873
chr7	143048341	143056341	143052637	8000	143052341	-4000	4000	296
chr7	143218037	143226037	143222332	8000	143222037	-4000	4000	295
chr7	141786217	141794217	141790497	8000	141790217	-4000	4000	280
chr7	143023132	143031132	143026971	8000	143027132	-4000	4000	-161
chr7	100716468	100724468	100723052	8000	100720468	-4000	4000	2584
chr7	142929746	142937746	142933709	8000	142933746	-4000	4000	-37
chr7	143996320	144004320	144004206	8000	144000320	-4000	4000	3886
chr7	141969773	141977773	141973270	8000	141973773	-4000	4000	-503
chr7	143048341	143056341	143052685	8000	143052341	-4000	4000	344
chr7	155066324	155074324	155071069	8000	155070324	-4000	4000	745
chr7	19141421	19149421	19145516	8000	19145421	-4000	4000	95
chr7	73324082	73332082	73328200	8000	73328082	-4000	4000	118
chr7	122991700	122999700	122994793	8000	122995700	-4000	4000	-907
chr7	27098686	27106686	27100803	8000	27102686	-4000	4000	-1883
chr7	101197038	101205038	101198733	8000	101201038	-4000	4000	-2305
chr7	27092000	27100000	27095331	8000	27096000	-4000	4000	-669
chr7	144105583	144113583	144110195	8000	144109583	-4000	4000	612
chr7	19141421	19149421	19145084	8000	19145421	-4000	4000	-337
chr7	19141421	19149421	19145162	8000	19145421	-4000	4000	-259
chr7	144044948	144052948	144050605	8000	144048948	-4000	4000	1657
chr7	44137332	44145332	44145135	8000	44141332	-4000	4000	3803
chr7	72965466	72973466	72970763	8000	72969466	-4000	4000	1297
chr7	100729595	100737595	100736604	8000	100733595	-4000	4000	3009
chr7	73324082	73332082	73325571	8000	73328082	-4000	4000	-2511
chr7	142935343	142943343	142939738	8000	142939343	-4000	4000	395
chr7	142958363	142966363	142960939	8000	142962363	-4000	4000	-1424
chr7	141837487	141845487	141841123	8000	141841487	-4000	4000	-364
chr8	22038398	22046398	22046182	8000	22042398	-4000	4000	3784
chr8	98422958	98430958	98428403	8000	98426958	-4000	4000	1445
chr8	81691058	81699058	81694541	8000	81695058	-4000	4000	-517
chr8	144350914	144358914	144355625	8000	144354914	-4000	4000	711
chr8	58496163	58504163	58498417	8000	58500163	-4000	4000	-1746
chr8	142913843	142921843	142915070	8000	142917843	-4000	4000	-2773
chr8	87870015	87878015	87873014	8000	87874015	-4000	4000	-1001
chr8	53247637	53255637	53250805	8000	53251637	-4000	4000	-832
chr8	70067693	70075693	70069245	8000	70071693	-4000	4000	-2448
chr8	87870015	87878015	87873859	8000	87874015	-4000	4000	-156
chr8	142875846	142883846	142875848	8000	142879846	-4000	4000	-3998
chr8	24436930	24444930	24442507	8000	24440930	-4000	4000	1577
chr8	81691058	81699058	81694053	8000	81695058	-4000	4000	-1005
chr8	98422958	98430958	98429234	8000	98426958	-4000	4000	2276
chr8	139700109	139708109	139702739	8000	139704109	-4000	4000	-1370
chr8	10521532	10529532	10525626	8000	10525532	-4000	4000	94
chr8	58496163	58504163	58496694	8000	58500163	-4000	4000	-3469
chr8	106766244	106774244	106770178	8000	106770244	-4000	4000	-66
chr8	87870015	87878015	87873675	8000	87874015	-4000	4000	-340
chr8	106766244	106774244	106770213	8000	106770244	-4000	4000	-31
chr8	144350914	144358914	144356486	8000	144354914	-4000	4000	1572
chr8	142875846	142883846	142876355	8000	142879846	-4000	4000	-3491
chr8	33596023	33604023	33597368	8000	33600023	-4000	4000	-2655
chr8	142913843	142921843	142914847	8000	142917843	-4000	4000	-2996
chr8	142913843	142921843	142917195	8000	142917843	-4000	4000	-648
chr8	15234431	15242431	15237597	8000	15238431	-4000	4000	-834
chr8	142875846	142883846	142879764	8000	142879846	-4000	4000	-82
chr8	108783594	108791594	108785046	8000	108787594	-4000	4000	-2548
chr8	98422958	98430958	98428338	8000	98426958	-4000	4000	1380
chr8	144332482	144340482	144332666	8000	144336482	-4000	4000	-3816
chr8	56109982	56117982	56113565	8000	56113982	-4000	4000	-417
chr8	109971771	109979771	109972727	8000	109975771	-4000	4000	-3044
chr8	20179206	20187206	20180991	8000	20183206	-4000	4000	-2215
chr8	31029715	31037715	31032496	8000	31033715	-4000	4000	-1219
chr8	31029715	31037715	31032260	8000	31033715	-4000	4000	-1455
chr8	41646817	41654817	41654171	8000	41650817	-4000	4000	3354
chr8	87870015	87878015	87872714	8000	87874015	-4000	4000	-1301
chr8	39834227	39842227	39838153	8000	39838227	-4000	4000	-74
chr8	24909758	24917758	24917299	8000	24913758	-4000	4000	3541
chr8	109971771	109979771	109974162	8000	109975771	-4000	4000	-1609
chr8	36780324	36788324	36784410	8000	36784324	-4000	4000	86
chr8	87870015	87878015	87872992	8000	87874015	-4000	4000	-1023
chr8	66122896	66130896	66127399	8000	66126896	-4000	4000	503
chr8	70067693	70075693	70069268	8000	70071693	-4000	4000	-2425
chr8	131036909	131044909	131039632	8000	131040909	-4000	4000	-1277
chr8	108783594	108791594	108784314	8000	108787594	-4000	4000	-3280
chr8	144332482	144340482	144336094	8000	144336482	-4000	4000	-388
chr8	109971771	109979771	109972435	8000	109975771	-4000	4000	-3336
chr8	143156711	143164711	143158428	8000	143160711	-4000	4000	-2283
chr8	24909758	24917758	24917353	8000	24913758	-4000	4000	3595
chr8	38146992	38154992	38150849	8000	38150992	-4000	4000	-143
chr8	109971771	109979771	109972303	8000	109975771	-4000	4000	-3468
chr8	109971771	109979771	109972635	8000	109975771	-4000	4000	-3136
chr8	6934306	6942306	6936796	8000	6938306	-4000	4000	-1510
chr8	66174464	66182464	66176750	8000	66178464	-4000	4000	-1714
chr8	42373229	42381229	42376982	8000	42377229	-4000	4000	-247
chr8	109971771	109979771	109972434	8000	109975771	-4000	4000	-3337
chr8	87870015	87878015	87873431	8000	87874015	-4000	4000	-584
chr8	24952721	24960721	24954196	8000	24956721	-4000	4000	-2525
chr8	24909758	24917758	24914501	8000	24913758	-4000	4000	743
chr8	143704109	143712109	143706818	8000	143708109	-4000	4000	-1291
chr8	139700109	139708109	139702920	8000	139704109	-4000	4000	-1189
chr8	106766244	106774244	106769961	8000	106770244	-4000	4000	-283
chr8	24952721	24960721	24952898	8000	24956721	-4000	4000	-3823
chr8	24952721	24960721	24956225	8000	24956721	-4000	4000	-496
chr8	106766244	106774244	106769653	8000	106770244	-4000	4000	-591
chr8	70067693	70075693	70068529	8000	70071693	-4000	4000	-3164
chr8	86739675	86747675	86743667	8000	86743675	-4000	4000	-8
chr8	139700109	139708109	139702964	8000	139704109	-4000	4000	-1145
chr8	109971771	109979771	109974086	8000	109975771	-4000	4000	-1685
chr8	12130099	12138099	12137651	8000	12134099	-4000	4000	3552
chr8	39834227	39842227	39838159	8000	39838227	-4000	4000	-68
chr8	81443439	81451439	81447379	8000	81447439	-4000	4000	-60
chr8	163024	171024	166434	8000	167024	-4000	4000	-590
chr8	7890677	7898677	7894701	8000	7894677	-4000	4000	24
chr8	81457579	81465579	81459220	8000	81461579	-4000	4000	-2359
chr8	108783594	108791594	108784979	8000	108787594	-4000	4000	-2615
chr8	56109982	56117982	56113550	8000	56113982	-4000	4000	-432
chr8	26863278	26871278	26864475	8000	26867278	-4000	4000	-2803
chr8	41646817	41654817	41654263	8000	41650817	-4000	4000	3446
chr8	143704109	143712109	143707857	8000	143708109	-4000	4000	-252
chr8	38970228	38978228	38975077	8000	38974228	-4000	4000	849
chr8	55098028	55106028	55103137	8000	55102028	-4000	4000	1109
chr8	87870015	87878015	87873385	8000	87874015	-4000	4000	-630
chr8	142913843	142921843	142915174	8000	142917843	-4000	4000	-2669
chr8	70067693	70075693	70069261	8000	70071693	-4000	4000	-2432
chr8	87870015	87878015	87873609	8000	87874015	-4000	4000	-406
chr8	81457579	81465579	81459181	8000	81461579	-4000	4000	-2398
chr8	26863278	26871278	26864353	8000	26867278	-4000	4000	-2925
chr8	6934306	6942306	6936093	8000	6938306	-4000	4000	-2213
chr8	11970599	11978599	11973968	8000	11974599	-4000	4000	-631
chr8	20179206	20187206	20180953	8000	20183206	-4000	4000	-2253
chr8	131036909	131044909	131039667	8000	131040909	-4000	4000	-1242
chr8	10521532	10529532	10525696	8000	10525532	-4000	4000	164
chr8	86862415	86870415	86866550	8000	86866415	-4000	4000	135
chr8	38146992	38154992	38148737	8000	38150992	-4000	4000	-2255
chr8	42373229	42381229	42374762	8000	42377229	-4000	4000	-2467
chr8	132081655	132089655	132089524	8000	132085655	-4000	4000	3869
chr8	87870015	87878015	87872987	8000	87874015	-4000	4000	-1028
chr8	81691058	81699058	81693896	8000	81695058	-4000	4000	-1162
chr8	24909758	24917758	24914435	8000	24913758	-4000	4000	677
chr8	30140665	30148665	30144490	8000	30144665	-4000	4000	-175
chr8	31029715	31037715	31031922	8000	31033715	-4000	4000	-1793
chr8	31029715	31037715	31032390	8000	31033715	-4000	4000	-1325
chr8	42373229	42381229	42374197	8000	42377229	-4000	4000	-3032
chr8	48731311	48739311	48735154	8000	48735311	-4000	4000	-157
chr8	66122896	66130896	66127283	8000	66126896	-4000	4000	387
chr8	31029715	31037715	31032202	8000	31033715	-4000	4000	-1513
chr8	142913843	142921843	142917193	8000	142917843	-4000	4000	-650
chr8	66174464	66182464	66176824	8000	66178464	-4000	4000	-1640
chr8	109971771	109979771	109972459	8000	109975771	-4000	4000	-3312
chr8	24909758	24917758	24917060	8000	24913758	-4000	4000	3302
chr8	24952721	24960721	24956277	8000	24956721	-4000	4000	-444
chr8	42373229	42381229	42375770	8000	42377229	-4000	4000	-1459
chr8	70067693	70075693	70069195	8000	70071693	-4000	4000	-2498
chr8	142913843	142921843	142914308	8000	142917843	-4000	4000	-3535
chr8	58496163	58504163	58496806	8000	58500163	-4000	4000	-3357
chr8	109082585	109090585	109087902	8000	109086585	-4000	4000	1317
chr8	6831524	6839524	6832719	8000	6835524	-4000	4000	-2805
chr8	10521532	10529532	10529415	8000	10525532	-4000	4000	3883
chr8	98422958	98430958	98428660	8000	98426958	-4000	4000	1702
chr8	38146992	38154992	38150849	8000	38150992	-4000	4000	-143
chr8	87870015	87878015	87872983	8000	87874015	-4000	4000	-1032
chr8	24909758	24917758	24914292	8000	24913758	-4000	4000	534
chr8	41646817	41654817	41654179	8000	41650817	-4000	4000	3362
chr8	87870015	87878015	87873263	8000	87874015	-4000	4000	-752
chr8	39834227	39842227	39838176	8000	39838227	-4000	4000	-51
chr8	131036909	131044909	131039703	8000	131040909	-4000	4000	-1206
chr8	66122896	66130896	66128447	8000	66126896	-4000	4000	1551
chr8	70067693	70075693	70068254	8000	70071693	-4000	4000	-3439
chr8	66174464	66182464	66174683	8000	66178464	-4000	4000	-3781
chr8	109971771	109979771	109972687	8000	109975771	-4000	4000	-3084
chr8	106766244	106774244	106769629	8000	106770244	-4000	4000	-615
chr8	20179206	20187206	20179253	8000	20183206	-4000	4000	-3953
chr8	81691058	81699058	81694314	8000	81695058	-4000	4000	-744
chr8	56109982	56117982	56113721	8000	56113982	-4000	4000	-261
chr8	144350914	144358914	144357049	8000	144354914	-4000	4000	2135
chr8	108783594	108791594	108784299	8000	108787594	-4000	4000	-3295
chr8	86739675	86747675	86743672	8000	86743675	-4000	4000	-3
chr8	26863278	26871278	26864637	8000	26867278	-4000	4000	-2641
chr8	81691058	81699058	81694280	8000	81695058	-4000	4000	-778
chr8	144350914	144358914	144356328	8000	144354914	-4000	4000	1414
chr8	87870015	87878015	87873212	8000	87874015	-4000	4000	-803
chr8	108783594	108791594	108784266	8000	108787594	-4000	4000	-3328
chr8	24909758	24917758	24917614	8000	24913758	-4000	4000	3856
chr8	38146992	38154992	38150849	8000	38150992	-4000	4000	-143
chr8	87870015	87878015	87873256	8000	87874015	-4000	4000	-759
chr8	142875846	142883846	142879627	8000	142879846	-4000	4000	-219
chr8	87870015	87878015	87873746	8000	87874015	-4000	4000	-269
chr8	106766244	106774244	106769663	8000	106770244	-4000	4000	-581
chr8	23702756	23710756	23702842	8000	23706756	-4000	4000	-3914
chr8	56109982	56117982	56113223	8000	56113982	-4000	4000	-759
chr8	131036909	131044909	131039399	8000	131040909	-4000	4000	-1510
chr8	131036909	131044909	131039716	8000	131040909	-4000	4000	-1193
chr8	142875846	142883846	142877212	8000	142879846	-4000	4000	-2634
chr8	24952721	24960721	24955729	8000	24956721	-4000	4000	-992
chr8	108783594	108791594	108784689	8000	108787594	-4000	4000	-2905
chr8	26863278	26871278	26864378	8000	26867278	-4000	4000	-2900
chr9	2713510	2721510	2717849	8000	2717510	-4000	4000	339
chr9	32779540	32787540	32786436	8000	32783540	-4000	4000	2896
chr9	104523209	104531209	104526758	8000	104527209	-4000	4000	-451
chr9	104523209	104531209	104526684	8000	104527209	-4000	4000	-525
chr9	135557756	135565756	135562839	8000	135561756	-4000	4000	1083
chr9	34660048	34668048	34660533	8000	34664048	-4000	4000	-3515
chr9	34660048	34668048	34660534	8000	34664048	-4000	4000	-3514
chr9	21162660	21170660	21166205	8000	21166660	-4000	4000	-455
chr9	21198205	21206205	21201727	8000	21202205	-4000	4000	-478
chr9	65732555	65740555	65737154	8000	65736555	-4000	4000	599
chr9	69816817	69824817	69820965	8000	69820817	-4000	4000	148
chr9	35954154	35962154	35957987	8000	35958154	-4000	4000	-167
chr9	132578606	132586606	132582845	8000	132582606	-4000	4000	239
chr9	65732555	65740555	65733028	8000	65736555	-4000	4000	-3527
chr9	136201128	136209128	136208494	8000	136205128	-4000	4000	3366
chr9	122473926	122481926	122477152	8000	122477926	-4000	4000	-774
chr9	104690518	104698518	104694848	8000	104694518	-4000	4000	330
chr9	122523296	122531296	122526561	8000	122527296	-4000	4000	-735
chr9	97849226	97857226	97856102	8000	97853226	-4000	4000	2876
chr9	34625045	34633045	34625788	8000	34629045	-4000	4000	-3257
chr9	21301313	21309313	21304987	8000	21305313	-4000	4000	-326
chr9	42179659	42187659	42186336	8000	42183659	-4000	4000	2677
chr9	134876810	134884810	134882637	8000	134880810	-4000	4000	1827
chr9	100574079	100582079	100577044	8000	100578079	-4000	4000	-1035
chr9	124447425	124455425	124452659	8000	124451425	-4000	4000	1234
chr9	122523296	122531296	122526943	8000	122527296	-4000	4000	-353
chr9	6324375	6332375	6330045	8000	6328375	-4000	4000	1670
chr9	21381398	21389398	21384883	8000	21385398	-4000	4000	-515
chr9	36165388	36173388	36170438	8000	36169388	-4000	4000	1050
chr9	104523209	104531209	104526329	8000	104527209	-4000	4000	-880
chr9	2713510	2721510	2717879	8000	2717510	-4000	4000	369
chr9	104500263	104508263	104504764	8000	104504263	-4000	4000	501
chr9	104532856	104540856	104536257	8000	104536856	-4000	4000	-599
chr9	104565168	104573168	104570101	8000	104569168	-4000	4000	933
chr9	108851986	108859986	108855031	8000	108855986	-4000	4000	-955
chr9	34725488	34733488	34728074	8000	34729488	-4000	4000	-1414
chr9	35037095	35045095	35043033	8000	35041095	-4000	4000	1938
chr9	136744453	136752453	136748528	8000	136748453	-4000	4000	75
chr9	65281209	65289209	65283967	8000	65285209	-4000	4000	-1242
chr9	65732555	65740555	65737556	8000	65736555	-4000	4000	1001
chr9	35037095	35045095	35043845	8000	35041095	-4000	4000	2750
chr9	6324375	6332375	6329975	8000	6328375	-4000	4000	1600
chr9	32779540	32787540	32784681	8000	32783540	-4000	4000	1141
chr9	104595413	104603413	104598785	8000	104599413	-4000	4000	-628
chr9	21137832	21145832	21141049	8000	21141832	-4000	4000	-783
chr9	21224222	21232222	21227651	8000	21228222	-4000	4000	-571
chr9	21224222	21232222	21228015	8000	21228222	-4000	4000	-207
chr9	108851986	108859986	108854892	8000	108855986	-4000	4000	-1094
chr9	94324644	94332644	94325903	8000	94328644	-4000	4000	-2741
chr9	108858266	108866266	108863299	8000	108862266	-4000	4000	1033
chr9	21236005	21244005	21239925	8000	21240005	-4000	4000	-80
chr9	64365394	64373394	64367932	8000	64369394	-4000	4000	-1462
chr9	21073942	21081942	21077757	8000	21077942	-4000	4000	-185
chr9	100574079	100582079	100576750	8000	100578079	-4000	4000	-1329
chr9	135557756	135565756	135562856	8000	135561756	-4000	4000	1100
chr9	21236005	21244005	21239902	8000	21240005	-4000	4000	-103
chr9	108851986	108859986	108855972	8000	108855986	-4000	4000	-14
chr9	61186003	61194003	61192549	8000	61190003	-4000	4000	2546
chr9	41124681	41132681	41127246	8000	41128681	-4000	4000	-1435
chr9	81984772	81992772	81990463	8000	81988772	-4000	4000	1691
chr9	19045358	19053358	19050616	8000	19049358	-4000	4000	1258
chr9	122610738	122618738	122614962	8000	122614738	-4000	4000	224
chr9	35037095	35045095	35044017	8000	35041095	-4000	4000	2922
chr9	39351669	39359669	39358744	8000	39355669	-4000	4000	3075
chr9	122671130	122679130	122675941	8000	122675130	-4000	4000	811
chr9	135517438	135525438	135521533	8000	135521438	-4000	4000	95
chr9	122506802	122514802	122511356	8000	122510802	-4000	4000	554
chr9	81984772	81992772	81991554	8000	81988772	-4000	4000	2782
chr9	104500263	104508263	104504560	8000	104504263	-4000	4000	297
chr9	61186003	61194003	61193138	8000	61190003	-4000	4000	3135
chr9	69010113	69018113	69013892	8000	69014113	-4000	4000	-221
chr9	21183671	21191671	21187339	8000	21187671	-4000	4000	-332
chr9	42179659	42187659	42186033	8000	42183659	-4000	4000	2374
chr9	41124681	41132681	41127360	8000	41128681	-4000	4000	-1321
chr9	65281209	65289209	65283354	8000	65285209	-4000	4000	-1855
chr9	87878877	87886877	87886515	8000	87882877	-4000	4000	3638
chr9	14718733	14726733	14719821	8000	14722733	-4000	4000	-2912
chr9	36165388	36173388	36170530	8000	36169388	-4000	4000	1142
chr9	81984772	81992772	81992724	8000	81988772	-4000	4000	3952
chr9	68298867	68306867	68302973	8000	68302867	-4000	4000	106
chr9	104523209	104531209	104526888	8000	104527209	-4000	4000	-321
chr9	104601627	104609627	104605014	8000	104605627	-4000	4000	-613
chr9	21364962	21372962	21367944	8000	21368962	-4000	4000	-1018
chr9	104532856	104540856	104536346	8000	104536856	-4000	4000	-510
chr9	122784933	122792933	122789275	8000	122788933	-4000	4000	342
chr9	132578606	132586606	132582998	8000	132582606	-4000	4000	392
chr9	81984772	81992772	81992611	8000	81988772	-4000	4000	3839
chr9	101734647	101742647	101737311	8000	101738647	-4000	4000	-1336
chr9	105658457	105666457	105662478	8000	105662457	-4000	4000	21
chr9	114417	122417	121439	8000	118417	-4000	4000	3022
chr9	35866401	35874401	35870178	8000	35870401	-4000	4000	-223
chr9	104614204	104622204	104617394	8000	104618204	-4000	4000	-810
chr9	104532856	104540856	104535966	8000	104536856	-4000	4000	-890
chr9	133632363	133640363	133636383	8000	133636363	-4000	4000	20
chr9	21381398	21389398	21385236	8000	21385398	-4000	4000	-162
chr9	21224222	21232222	21228029	8000	21228222	-4000	4000	-193
chr9	21381398	21389398	21384862	8000	21385398	-4000	4000	-536
chr9	81984772	81992772	81990855	8000	81988772	-4000	4000	2083
chr9	129616776	129624776	129619774	8000	129620776	-4000	4000	-1002
chr9	104565168	104573168	104569972	8000	104569168	-4000	4000	804
chr9	122610738	122618738	122615331	8000	122614738	-4000	4000	593
chr9	101734647	101742647	101737575	8000	101738647	-4000	4000	-1072
chr9	14718733	14726733	14720006	8000	14722733	-4000	4000	-2727
chr9	21364962	21372962	21367849	8000	21368962	-4000	4000	-1113
chr9	122625573	122633573	122628839	8000	122629573	-4000	4000	-734
chr9	114417	122417	116959	8000	118417	-4000	4000	-1458
chr9	21364962	21372962	21367502	8000	21368962	-4000	4000	-1460
chr9	69010113	69018113	69013789	8000	69014113	-4000	4000	-324
chr9	34660048	34668048	34661487	8000	34664048	-4000	4000	-2561
chr9	21162660	21170660	21166407	8000	21166660	-4000	4000	-253
chr9	122719990	122727990	122724262	8000	122723990	-4000	4000	272
chr9	21073942	21081942	21077644	8000	21077942	-4000	4000	-298
chr9	35866401	35874401	35870124	8000	35870401	-4000	4000	-277
chr9	21183671	21191671	21186956	8000	21187671	-4000	4000	-715
chr9	71442904	71450904	71446781	8000	71446904	-4000	4000	-123
chr9	108858266	108866266	108863093	8000	108862266	-4000	4000	827
chr9	122549112	122557112	122553271	8000	122553112	-4000	4000	159
chr9	122506802	122514802	122511718	8000	122510802	-4000	4000	916
chr9	21073942	21081942	21077515	8000	21077942	-4000	4000	-427
chr9	35866401	35874401	35869721	8000	35870401	-4000	4000	-680
chr9	122719990	122727990	122724469	8000	122723990	-4000	4000	479
chr9	69010113	69018113	69013395	8000	69014113	-4000	4000	-718
chr9	104614204	104622204	104617401	8000	104618204	-4000	4000	-803
chr9	101024727	101032727	101028956	8000	101028727	-4000	4000	229
chr9	108851986	108859986	108855251	8000	108855986	-4000	4000	-735
chr9	21203143	21211143	21207103	8000	21207143	-4000	4000	-40
chr9	122784933	122792933	122789003	8000	122788933	-4000	4000	70
chr9	135517438	135525438	135524862	8000	135521438	-4000	4000	3424
chr9	6324375	6332375	6331219	8000	6328375	-4000	4000	2844
chr9	21478313	21486313	21481400	8000	21482313	-4000	4000	-913
chr9	122473926	122481926	122477893	8000	122477926	-4000	4000	-33
chr9	2713510	2721510	2718729	8000	2717510	-4000	4000	1219
chr9	21203143	21211143	21206845	8000	21207143	-4000	4000	-298
chr9	122784933	122792933	122789668	8000	122788933	-4000	4000	735
chr9	132406043	132414043	132410399	8000	132410043	-4000	4000	356
chr9	61186003	61194003	61192474	8000	61190003	-4000	4000	2471
chr9	21224222	21232222	21227496	8000	21228222	-4000	4000	-726
chr9	21224222	21232222	21227708	8000	21228222	-4000	4000	-514
chr9	21301313	21309313	21304749	8000	21305313	-4000	4000	-564
chr9	21347378	21355378	21350380	8000	21351378	-4000	4000	-998
chr9	21405117	21413117	21409747	8000	21409117	-4000	4000	630
chr9	69010113	69018113	69013946	8000	69014113	-4000	4000	-167
chr9	21364962	21372962	21367457	8000	21368962	-4000	4000	-1505
chr9	32779540	32787540	32787357	8000	32783540	-4000	4000	3817
chr9	35037095	35045095	35042873	8000	35041095	-4000	4000	1778
chr9	35037095	35045095	35043270	8000	35041095	-4000	4000	2175
chr9	35037095	35045095	35043368	8000	35041095	-4000	4000	2273
chr9	35954154	35962154	35957374	8000	35958154	-4000	4000	-780
chr9	36165388	36173388	36169688	8000	36169388	-4000	4000	300
chr9	137247261	137255261	137252513	8000	137251261	-4000	4000	1252
chr9	36165388	36173388	36170595	8000	36169388	-4000	4000	1207
chr9	65732555	65740555	65737408	8000	65736555	-4000	4000	853
chr9	122523296	122531296	122526652	8000	122527296	-4000	4000	-644
chr9	111326224	111334224	111327789	8000	111330224	-4000	4000	-2435
chr9	135698185	135706185	135698470	8000	135702185	-4000	4000	-3715
chr9	21073942	21081942	21077626	8000	21077942	-4000	4000	-316
chr9	21203143	21211143	21206601	8000	21207143	-4000	4000	-542
chr9	100574079	100582079	100578141	8000	100578079	-4000	4000	62
chr9	35037095	35045095	35043980	8000	35041095	-4000	4000	2885
chr9	104601627	104609627	104605328	8000	104605627	-4000	4000	-299
chr9	77015655	77023655	77020049	8000	77019655	-4000	4000	394
chr9	108851986	108859986	108855667	8000	108855986	-4000	4000	-319
chr9	21203143	21211143	21206600	8000	21207143	-4000	4000	-543
chr9	32779540	32787540	32785048	8000	32783540	-4000	4000	1508
chr9	122515141	122523141	122519531	8000	122519141	-4000	4000	390
chr9	21073942	21081942	21077876	8000	21077942	-4000	4000	-66
chr9	122523296	122531296	122526562	8000	122527296	-4000	4000	-734
chr9	14718733	14726733	14722328	8000	14722733	-4000	4000	-405
chr9	135698185	135706185	135699522	8000	135702185	-4000	4000	-2663
chr9	122155908	122163908	122159976	8000	122159908	-4000	4000	68
chr9	135517438	135525438	135521570	8000	135521438	-4000	4000	132
chr9	104565168	104573168	104569805	8000	104569168	-4000	4000	637
chr9	21224222	21232222	21227805	8000	21228222	-4000	4000	-417
chr9	6324375	6332375	6330991	8000	6328375	-4000	4000	2616
chr9	21478313	21486313	21481514	8000	21482313	-4000	4000	-799
chr9	34725488	34733488	34726879	8000	34729488	-4000	4000	-2609
chr9	135557756	135565756	135564247	8000	135561756	-4000	4000	2491
chr9	104595413	104603413	104598509	8000	104599413	-4000	4000	-904
chr9	136744453	136752453	136748432	8000	136748453	-4000	4000	-21
chr9	68298867	68306867	68303913	8000	68302867	-4000	4000	1046
chr9	27520290	27528290	27524615	8000	27524290	-4000	4000	325
chr9	68298867	68306867	68303897	8000	68302867	-4000	4000	1030
chr9	40219285	40227285	40223529	8000	40223285	-4000	4000	244
chr9	101734647	101742647	101737486	8000	101738647	-4000	4000	-1161
chr9	21213311	21221311	21217073	8000	21217311	-4000	4000	-238
chr9	104614204	104622204	104617803	8000	104618204	-4000	4000	-401
chr9	6324375	6332375	6330070	8000	6328375	-4000	4000	1695
chr9	14718733	14726733	14722629	8000	14722733	-4000	4000	-104
chr9	21073942	21081942	21077166	8000	21077942	-4000	4000	-776
chr9	21213311	21221311	21217192	8000	21217311	-4000	4000	-119
chr9	21224222	21232222	21227956	8000	21228222	-4000	4000	-266
chr9	21224222	21232222	21228098	8000	21228222	-4000	4000	-124
chr9	35037095	35045095	35044907	8000	35041095	-4000	4000	3812
chr9	36165388	36173388	36169866	8000	36169388	-4000	4000	478
chr9	68536883	68544883	68537416	8000	68540883	-4000	4000	-3467
chr9	69010113	69018113	69013998	8000	69014113	-4000	4000	-115
chr9	81984772	81992772	81991982	8000	81988772	-4000	4000	3210
chr9	87878877	87886877	87886424	8000	87882877	-4000	4000	3547
chr9	96924310	96932310	96928994	8000	96928310	-4000	4000	684
chr9	104601627	104609627	104604912	8000	104605627	-4000	4000	-715
chr9	104614204	104622204	104618180	8000	104618204	-4000	4000	-24
chr9	104690518	104698518	104694557	8000	104694518	-4000	4000	39
chr9	104690518	104698518	104695211	8000	104694518	-4000	4000	693
chr9	108851986	108859986	108855819	8000	108855986	-4000	4000	-167
chr9	111326224	111334224	111327643	8000	111330224	-4000	4000	-2581
chr9	122473926	122481926	122477117	8000	122477926	-4000	4000	-809
chr9	122610738	122618738	122615552	8000	122614738	-4000	4000	814
chr9	21478313	21486313	21481119	8000	21482313	-4000	4000	-1194
chr9	104565168	104573168	104569991	8000	104569168	-4000	4000	823
chr9	104565168	104573168	104570103	8000	104569168	-4000	4000	935
chr9	104565168	104573168	104570104	8000	104569168	-4000	4000	936
chr9	5181647	5189647	5185437	8000	5185647	-4000	4000	-210
chr9	21436439	21444439	21440442	8000	21440439	-4000	4000	3
chr9	21436439	21444439	21441212	8000	21440439	-4000	4000	773
chr9	32779540	32787540	32784774	8000	32783540	-4000	4000	1234
chr9	34660048	34668048	34662040	8000	34664048	-4000	4000	-2008
chr9	65732555	65740555	65737227	8000	65736555	-4000	4000	672
chr9	81984772	81992772	81992261	8000	81988772	-4000	4000	3489
chr9	88134475	88142475	88134858	8000	88138475	-4000	4000	-3617
chr9	100574079	100582079	100576612	8000	100578079	-4000	4000	-1467
chr9	111326224	111334224	111327757	8000	111330224	-4000	4000	-2467
chr9	111326224	111334224	111328355	8000	111330224	-4000	4000	-1869
chr9	122625573	122633573	122629227	8000	122629573	-4000	4000	-346
chr9	122671130	122679130	122675180	8000	122675130	-4000	4000	50
chr9	104500263	104508263	104504546	8000	104504263	-4000	4000	283
chr9	14718733	14726733	14722338	8000	14722733	-4000	4000	-395
chr9	35037095	35045095	35043677	8000	35041095	-4000	4000	2582
chr9	108858266	108866266	108863049	8000	108862266	-4000	4000	783
chr9	104601627	104609627	104605322	8000	104605627	-4000	4000	-305
chr9	27293150	27301150	27296630	8000	27297150	-4000	4000	-520
chr9	69010113	69018113	69013883	8000	69014113	-4000	4000	-230
chr9	122523296	122531296	122526616	8000	122527296	-4000	4000	-680
chr9	21198205	21206205	21202188	8000	21202205	-4000	4000	-17
chr9	81984772	81992772	81992192	8000	81988772	-4000	4000	3420
chr9	5886889	5894889	5892543	8000	5890889	-4000	4000	1654
chr9	21405117	21413117	21409273	8000	21409117	-4000	4000	156
chr9	36165388	36173388	36169594	8000	36169388	-4000	4000	206
chr9	81984772	81992772	81990970	8000	81988772	-4000	4000	2198
chr9	136754543	136762543	136757058	8000	136758543	-4000	4000	-1485
chr9	104565168	104573168	104569378	8000	104569168	-4000	4000	210
chr9	21162660	21170660	21166062	8000	21166660	-4000	4000	-598
chr9	77015655	77023655	77019698	8000	77019655	-4000	4000	43
chr9	104523209	104531209	104526850	8000	104527209	-4000	4000	-359
chr9	21236005	21244005	21239567	8000	21240005	-4000	4000	-438
chr9	134876810	134884810	134880905	8000	134880810	-4000	4000	95
chr9	21213311	21221311	21216923	8000	21217311	-4000	4000	-388
chr9	5227419	5235419	5233728	8000	5231419	-4000	4000	2309
chr9	21381398	21389398	21385029	8000	21385398	-4000	4000	-369
chr9	65732555	65740555	65737143	8000	65736555	-4000	4000	588
chr9	122523296	122531296	122526919	8000	122527296	-4000	4000	-377
chr9	21364962	21372962	21367457	8000	21368962	-4000	4000	-1505
chr9	21162660	21170660	21166508	8000	21166660	-4000	4000	-152
chr9	110664779	110672779	110668919	8000	110668779	-4000	4000	140
chr9	21198205	21206205	21201827	8000	21202205	-4000	4000	-378
chr9	34660048	34668048	34662020	8000	34664048	-4000	4000	-2028
chr9	112886876	112894876	112889578	8000	112890876	-4000	4000	-1298
chr9	21183671	21191671	21186889	8000	21187671	-4000	4000	-782
chr9	27520290	27528290	27524399	8000	27524290	-4000	4000	109
chr9	39351669	39359669	39358850	8000	39355669	-4000	4000	3181
chr9	105658457	105666457	105662908	8000	105662457	-4000	4000	451
chr9	14718733	14726733	14719982	8000	14722733	-4000	4000	-2751
chr9	14718733	14726733	14720355	8000	14722733	-4000	4000	-2378
chr9	34393828	34401828	34401100	8000	34397828	-4000	4000	3272
chr9	74884094	74892094	74888036	8000	74888094	-4000	4000	-58
chr9	108858266	108866266	108863517	8000	108862266	-4000	4000	1251
chr9	35037095	35045095	35044470	8000	35041095	-4000	4000	3375
chr9	122796123	122804123	122800271	8000	122800123	-4000	4000	148
chr9	21436439	21444439	21441025	8000	21440439	-4000	4000	586
chr9	68536883	68544883	68540650	8000	68540883	-4000	4000	-233
chr9	100574079	100582079	100576957	8000	100578079	-4000	4000	-1122
chr9	137873782	137881782	137879117	8000	137877782	-4000	4000	1335
chr9	35866401	35874401	35870159	8000	35870401	-4000	4000	-242
chr9	21381398	21389398	21385065	8000	21385398	-4000	4000	-333
chr9	135698185	135706185	135699000	8000	135702185	-4000	4000	-3185
chr9	6324375	6332375	6330015	8000	6328375	-4000	4000	1640
chr9	108858266	108866266	108863339	8000	108862266	-4000	4000	1073
chr9	122506802	122514802	122511314	8000	122510802	-4000	4000	512
chr9	122473926	122481926	122477822	8000	122477926	-4000	4000	-104
chr9	122784933	122792933	122789482	8000	122788933	-4000	4000	549
chr9	130660594	130668594	130668304	8000	130664594	-4000	4000	3710
chr9	34725488	34733488	34725694	8000	34729488	-4000	4000	-3794
chr10	79606939	79614939	79612415	8000	79610939	-4000	4000	1476
chr10	133083924	133091924	133084926	8000	133087924	-4000	4000	-2998
chr10	84221544	84229544	84224928	8000	84225544	-4000	4000	-616
chr10	131307721	131315721	131308248	8000	131311721	-4000	4000	-3473
chr10	116541931	116549931	116547345	8000	116545931	-4000	4000	1414
chr10	70781401	70789401	70781929	8000	70785401	-4000	4000	-3472
chr10	100326264	100334264	100329966	8000	100330264	-4000	4000	-298
chr10	66922036	66930036	66927933	8000	66926036	-4000	4000	1897
chr10	118591648	118599648	118594689	8000	118595648	-4000	4000	-959
chr10	49605095	49613095	49612037	8000	49609095	-4000	4000	2942
chr10	133622795	133630795	133626676	8000	133626795	-4000	4000	-119
chr10	47344363	47352363	47349699	8000	47348363	-4000	4000	1336
chr10	47344363	47352363	47349976	8000	47348363	-4000	4000	1613
chr10	123131970	123139970	123137378	8000	123135970	-4000	4000	1408
chr10	95065497	95073497	95069297	8000	95069497	-4000	4000	-200
chr10	133083924	133091924	133084906	8000	133087924	-4000	4000	-3018
chr10	84169801	84177801	84173920	8000	84173801	-4000	4000	119
chr10	102833472	102841472	102837211	8000	102837472	-4000	4000	-261
chr10	127888941	127896941	127892631	8000	127892941	-4000	4000	-310
chr10	72950806	72958806	72954539	8000	72954806	-4000	4000	-267
chr10	94934658	94942658	94942435	8000	94938658	-4000	4000	3777
chr10	84226666	84234666	84234173	8000	84230666	-4000	4000	3507
chr10	17947839	17955839	17953367	8000	17951839	-4000	4000	1528
chr10	96355365	96363365	96358946	8000	96359365	-4000	4000	-419
chr10	88755982	88763982	88762284	8000	88759982	-4000	4000	2302
chr10	66922036	66930036	66926520	8000	66926036	-4000	4000	484
chr10	84221544	84229544	84225043	8000	84225544	-4000	4000	-501
chr10	49130021	49138021	49132150	8000	49134021	-4000	4000	-1871
chr10	122695846	122703846	122698207	8000	122699846	-4000	4000	-1639
chr10	23188312	23196312	23193947	8000	23192312	-4000	4000	1635
chr10	47318454	47326454	47325503	8000	47322454	-4000	4000	3049
chr10	90917087	90925087	90921043	8000	90921087	-4000	4000	-44
chr10	127733185	127741185	127738601	8000	127737185	-4000	4000	1416
chr10	49605095	49613095	49611984	8000	49609095	-4000	4000	2889
chr10	117193489	117201489	117197500	8000	117197489	-4000	4000	11
chr10	47344363	47352363	47348557	8000	47348363	-4000	4000	194
chr10	117193489	117201489	117197487	8000	117197489	-4000	4000	-2
chr10	122695846	122703846	122697853	8000	122699846	-4000	4000	-1993
chr10	116586385	116594385	116592537	8000	116590385	-4000	4000	2152
chr10	116586385	116594385	116591826	8000	116590385	-4000	4000	1441
chr10	94684154	94692154	94688229	8000	94688154	-4000	4000	75
chr10	93608537	93616537	93613037	8000	93612537	-4000	4000	500
chr10	125771821	125779821	125772623	8000	125775821	-4000	4000	-3198
chr10	84226666	84234666	84234346	8000	84230666	-4000	4000	3680
chr10	48910232	48918232	48913601	8000	48914232	-4000	4000	-631
chr10	1733525	1741525	1737051	8000	1737525	-4000	4000	-474
chr10	103454900	103462900	103455643	8000	103458900	-4000	4000	-3257
chr10	125679163	125687163	125683029	8000	125683163	-4000	4000	-134
chr10	70781401	70789401	70781998	8000	70785401	-4000	4000	-3403
chr10	96300409	96308409	96304547	8000	96304409	-4000	4000	138
chr10	47344363	47352363	47349817	8000	47348363	-4000	4000	1454
chr10	102222299	102230299	102229004	8000	102226299	-4000	4000	2705
chr10	122906610	122914610	122912951	8000	122910610	-4000	4000	2341
chr10	43367636	43375636	43373650	8000	43371636	-4000	4000	2014
chr10	84221544	84229544	84222257	8000	84225544	-4000	4000	-3287
chr10	79606939	79614939	79613962	8000	79610939	-4000	4000	3023
chr10	96300409	96308409	96304376	8000	96304409	-4000	4000	-33
chr10	69569422	69577422	69573000	8000	69573422	-4000	4000	-422
chr10	47344363	47352363	47350297	8000	47348363	-4000	4000	1934
chr10	102222299	102230299	102230230	8000	102226299	-4000	4000	3931
chr10	102222299	102230299	102226488	8000	102226299	-4000	4000	189
chr10	46461958	46469958	46462654	8000	46465958	-4000	4000	-3304
chr10	47344363	47352363	47350894	8000	47348363	-4000	4000	2531
chr10	133083924	133091924	133088986	8000	133087924	-4000	4000	1062
chr10	68228113	68236113	68231345	8000	68232113	-4000	4000	-768
chr10	122695846	122703846	122699643	8000	122699846	-4000	4000	-203
chr10	88660441	88668441	88667687	8000	88664441	-4000	4000	3246
chr10	35601341	35609341	35607720	8000	35605341	-4000	4000	2379
chr10	26212665	26220665	26219114	8000	26216665	-4000	4000	2449
chr10	101225463	101233463	101227771	8000	101229463	-4000	4000	-1692
chr10	66922036	66930036	66926554	8000	66926036	-4000	4000	518
chr10	125771821	125779821	125772683	8000	125775821	-4000	4000	-3138
chr10	103454900	103462900	103455553	8000	103458900	-4000	4000	-3347
chr10	66922036	66930036	66927220	8000	66926036	-4000	4000	1184
chr10	71733824	71741824	71734271	8000	71737824	-4000	4000	-3553
chr10	100326264	100334264	100330059	8000	100330264	-4000	4000	-205
chr10	117134301	117142301	117137881	8000	117138301	-4000	4000	-420
chr10	97568499	97576499	97570451	8000	97572499	-4000	4000	-2048
chr10	93753840	93761840	93758762	8000	93757840	-4000	4000	922
chr10	26212665	26220665	26216779	8000	26216665	-4000	4000	114
chr10	49130021	49138021	49133834	8000	49134021	-4000	4000	-187
chr10	117193489	117201489	117197497	8000	117197489	-4000	4000	8
chr10	81871194	81879194	81875679	8000	81875194	-4000	4000	485
chr10	49130021	49138021	49131957	8000	49134021	-4000	4000	-2064
chr10	81871194	81879194	81877994	8000	81875194	-4000	4000	2800
chr10	48910232	48918232	48914004	8000	48914232	-4000	4000	-228
chr10	103454900	103462900	103458797	8000	103458900	-4000	4000	-103
chr10	49605095	49613095	49611956	8000	49609095	-4000	4000	2861
chr10	93056798	93064798	93058494	8000	93060798	-4000	4000	-2304
chr10	49605095	49613095	49611844	8000	49609095	-4000	4000	2749
chr10	84237546	84245546	84241381	8000	84241546	-4000	4000	-165
chr10	30625762	30633762	30626831	8000	30629762	-4000	4000	-2931
chr10	47318454	47326454	47325788	8000	47322454	-4000	4000	3334
chr10	116423847	116431847	116427937	8000	116427847	-4000	4000	90
chr10	35601341	35609341	35605595	8000	35605341	-4000	4000	254
chr10	88755982	88763982	88762235	8000	88759982	-4000	4000	2253
chr10	94934658	94942658	94941925	8000	94938658	-4000	4000	3267
chr10	96355365	96363365	96359096	8000	96359365	-4000	4000	-269
chr10	84169801	84177801	84176565	8000	84173801	-4000	4000	2764
chr10	122695846	122703846	122699739	8000	122699846	-4000	4000	-107
chr10	17748201	17756201	17752299	8000	17752201	-4000	4000	98
chr10	102222299	102230299	102227663	8000	102226299	-4000	4000	1364
chr10	122906610	122914610	122911712	8000	122910610	-4000	4000	1102
chr10	17947839	17955839	17953403	8000	17951839	-4000	4000	1564
chr10	17947839	17955839	17953404	8000	17951839	-4000	4000	1565
chr10	88660441	88668441	88667660	8000	88664441	-4000	4000	3219
chr10	30625762	30633762	30626115	8000	30629762	-4000	4000	-3647
chr10	46461958	46469958	46462595	8000	46465958	-4000	4000	-3363
chr10	66922036	66930036	66928340	8000	66926036	-4000	4000	2304
chr10	72889584	72897584	72893685	8000	72893584	-4000	4000	101
chr10	90854039	90862039	90857384	8000	90858039	-4000	4000	-655
chr10	94684154	94692154	94687781	8000	94688154	-4000	4000	-373
chr10	102222299	102230299	102226608	8000	102226299	-4000	4000	309
chr10	112279400	112287400	112284539	8000	112283400	-4000	4000	1139
chr10	116320448	116328448	116324967	8000	116324448	-4000	4000	519
chr10	117193489	117201489	117197671	8000	117197489	-4000	4000	182
chr10	127888941	127896941	127892770	8000	127892941	-4000	4000	-171
chr10	88755982	88763982	88762224	8000	88759982	-4000	4000	2242
chr10	88798730	88806730	88802813	8000	88802730	-4000	4000	83
chr10	118591648	118599648	118595028	8000	118595648	-4000	4000	-620
chr10	96300409	96308409	96304683	8000	96304409	-4000	4000	274
chr10	116586385	116594385	116592611	8000	116590385	-4000	4000	2226
chr10	116541931	116549931	116547357	8000	116545931	-4000	4000	1426
chr10	94934658	94942658	94942386	8000	94938658	-4000	4000	3728
chr10	84169801	84177801	84173831	8000	84173801	-4000	4000	30
chr10	84226666	84234666	84232433	8000	84230666	-4000	4000	1767
chr10	17947839	17955839	17953413	8000	17951839	-4000	4000	1574
chr10	47344363	47352363	47350539	8000	47348363	-4000	4000	2176
chr10	69569422	69577422	69572880	8000	69573422	-4000	4000	-542
chr10	72950806	72958806	72954565	8000	72954806	-4000	4000	-241
chr10	117193489	117201489	117197537	8000	117197489	-4000	4000	48
chr10	69569422	69577422	69572806	8000	69573422	-4000	4000	-616
chr10	66922036	66930036	66927497	8000	66926036	-4000	4000	1461
chr10	79606939	79614939	79613247	8000	79610939	-4000	4000	2308
chr10	49130021	49138021	49132091	8000	49134021	-4000	4000	-1930
chr10	49605095	49613095	49611024	8000	49609095	-4000	4000	1929
chr10	47318454	47326454	47325643	8000	47322454	-4000	4000	3189
chr10	125679163	125687163	125683005	8000	125683163	-4000	4000	-158
chr10	122695846	122703846	122698090	8000	122699846	-4000	4000	-1756
chr10	5181187	5189187	5185136	8000	5185187	-4000	4000	-51
chr10	102222299	102230299	102229216	8000	102226299	-4000	4000	2917
chr10	93608537	93616537	93612715	8000	93612537	-4000	4000	178
chr10	46461958	46469958	46462338	8000	46465958	-4000	4000	-3620
chr10	48910232	48918232	48913757	8000	48914232	-4000	4000	-475
chr10	99528942	99536942	99535016	8000	99532942	-4000	4000	2074
chr10	84169801	84177801	84173795	8000	84173801	-4000	4000	-6
chr10	47344363	47352363	47348662	8000	47348363	-4000	4000	299
chr10	96355365	96363365	96358899	8000	96359365	-4000	4000	-466
chr10	93056798	93064798	93064401	8000	93060798	-4000	4000	3603
chr10	96300409	96308409	96304511	8000	96304409	-4000	4000	102
chr10	5181187	5189187	5185048	8000	5185187	-4000	4000	-139
chr10	88798730	88806730	88802886	8000	88802730	-4000	4000	156
chr11	94300580	94308580	94306634	8000	94304580	-4000	4000	2054
chr11	7084998	7092998	7090251	8000	7088998	-4000	4000	1253
chr11	66417004	66425004	66423875	8000	66421004	-4000	4000	2871
chr11	54702832	54710832	54707054	8000	54706832	-4000	4000	222
chr11	116833622	116841622	116835925	8000	116837622	-4000	4000	-1697
chr11	6166326	6174326	6170149	8000	6170326	-4000	4000	-177
chr11	6166326	6174326	6169366	8000	6170326	-4000	4000	-960
chr11	126999460	127007460	127000562	8000	127003460	-4000	4000	-2898
chr11	124022798	124030798	124023705	8000	124026798	-4000	4000	-3093
chr11	105019168	105027168	105026352	8000	105023168	-4000	4000	3184
chr11	7084998	7092998	7089234	8000	7088998	-4000	4000	236
chr11	54599998	54607998	54603129	8000	54603998	-4000	4000	-869
chr11	55550307	55558307	55554516	8000	55554307	-4000	4000	209
chr11	6779020	6787020	6785431	8000	6783020	-4000	4000	2411
chr11	30227014	30235014	30233690	8000	30231014	-4000	4000	2676
chr11	55363974	55371974	55368016	8000	55367974	-4000	4000	42
chr11	55658201	55666201	55665186	8000	55662201	-4000	4000	2985
chr11	94300580	94308580	94305776	8000	94304580	-4000	4000	1196
chr11	66417004	66425004	66424673	8000	66421004	-4000	4000	3669
chr11	6795689	6803689	6795768	8000	6799689	-4000	4000	-3921
chr11	66417004	66425004	66424709	8000	66421004	-4000	4000	3705
chr11	5042526	5050526	5046985	8000	5046526	-4000	4000	459
chr11	58208720	58216720	58215206	8000	58212720	-4000	4000	2486
chr11	56270154	56278154	56276105	8000	56274154	-4000	4000	1951
chr11	6841683	6849683	6846399	8000	6845683	-4000	4000	716
chr11	60036409	60044409	60040377	8000	60040409	-4000	4000	-32
chr11	56099687	56107687	56105462	8000	56103687	-4000	4000	1775
chr11	134270245	134278245	134277741	8000	134274245	-4000	4000	3496
chr11	56023654	56031654	56031371	8000	56027654	-4000	4000	3717
chr11	59452961	59460961	59457560	8000	59456961	-4000	4000	599
chr11	56414232	56422232	56417860	8000	56418232	-4000	4000	-372
chr11	54702832	54710832	54707116	8000	54706832	-4000	4000	284
chr11	55363974	55371974	55367922	8000	55367974	-4000	4000	-52
chr11	56230255	56238255	56233123	8000	56234255	-4000	4000	-1132
chr11	56288254	56296254	56290990	8000	56292254	-4000	4000	-1264
chr11	48212810	48220810	48217489	8000	48216810	-4000	4000	679
chr11	26719427	26727427	26723329	8000	26723427	-4000	4000	-98
chr11	26719427	26727427	26721532	8000	26723427	-4000	4000	-1895
chr11	59499576	59507576	59504092	8000	59503576	-4000	4000	516
chr11	104032640	104040640	104036887	8000	104036640	-4000	4000	247
chr11	124008997	124016997	124015988	8000	124012997	-4000	4000	2991
chr11	118967712	118975712	118971986	8000	118971712	-4000	4000	274
chr11	20156475	20164475	20159206	8000	20160475	-4000	4000	-1269
chr11	125784127	125792127	125789422	8000	125788127	-4000	4000	1295
chr11	55834752	55842752	55839548	8000	55838752	-4000	4000	796
chr11	5484685	5492685	5489170	8000	5488685	-4000	4000	485
chr11	56248254	56256254	56253174	8000	56252254	-4000	4000	920
chr11	5150757	5158757	5152231	8000	5154757	-4000	4000	-2526
chr11	59452961	59460961	59457417	8000	59456961	-4000	4000	456
chr11	66417004	66425004	66424914	8000	66421004	-4000	4000	3910
chr11	5787265	5795265	5788670	8000	5791265	-4000	4000	-2595
chr11	58355069	58363069	58358135	8000	58359069	-4000	4000	-934
chr11	56414232	56422232	56417563	8000	56418232	-4000	4000	-669
chr11	55550307	55558307	55554459	8000	55554307	-4000	4000	152
chr11	56270154	56278154	56275754	8000	56274154	-4000	4000	1600
chr11	5196682	5204682	5200057	8000	5200682	-4000	4000	-625
chr11	56270154	56278154	56276316	8000	56274154	-4000	4000	2162
chr11	55823219	55831219	55827628	8000	55827219	-4000	4000	409
chr11	622078	630078	626464	8000	626078	-4000	4000	386
chr11	5347508	5355508	5351819	8000	5351508	-4000	4000	311
chr11	90127515	90135515	90134694	8000	90131515	-4000	4000	3179
chr11	125676874	125684874	125677978	8000	125680874	-4000	4000	-2896
chr11	123973781	123981781	123976903	8000	123977781	-4000	4000	-878
chr11	55568128	55576128	55572345	8000	55572128	-4000	4000	217
chr11	124037325	124045325	124038950	8000	124041325	-4000	4000	-2375
chr11	5150757	5158757	5151538	8000	5154757	-4000	4000	-3219
chr11	124541333	124549333	124542771	8000	124545333	-4000	4000	-2562
chr11	295526	303526	299462	8000	299526	-4000	4000	-64
chr11	59452961	59460961	59457606	8000	59456961	-4000	4000	645
chr11	56539257	56547257	56542916	8000	56543257	-4000	4000	-341
chr11	124037325	124045325	124038740	8000	124041325	-4000	4000	-2585
chr11	58264260	58272260	58267896	8000	58268260	-4000	4000	-364
chr11	63365785	63373785	63373642	8000	63369785	-4000	4000	3857
chr11	56270154	56278154	56275657	8000	56274154	-4000	4000	1503
chr11	64931893	64939893	64932887	8000	64935893	-4000	4000	-3006
chr11	4951713	4959713	4955453	8000	4955713	-4000	4000	-260
chr11	5876629	5884629	5884577	8000	5880629	-4000	4000	3948
chr11	55910582	55918582	55913938	8000	55914582	-4000	4000	-644
chr11	124932412	124940412	124935934	8000	124936412	-4000	4000	-478
chr11	125899348	125907348	125899995	8000	125903348	-4000	4000	-3353
chr11	5196682	5204682	5200596	8000	5200682	-4000	4000	-86
chr11	7792942	7800942	7796409	8000	7796942	-4000	4000	-533
chr11	47582678	47590678	47589947	8000	47586678	-4000	4000	3269
chr11	56172618	56180618	56177353	8000	56176618	-4000	4000	735
chr11	124541333	124549333	124543148	8000	124545333	-4000	4000	-2185
chr11	7961447	7969447	7963348	8000	7965447	-4000	4000	-2099
chr11	55363974	55371974	55368481	8000	55367974	-4000	4000	507
chr11	56099687	56107687	56105379	8000	56103687	-4000	4000	1692
chr11	56288254	56296254	56290299	8000	56292254	-4000	4000	-1955
chr11	56288254	56296254	56290867	8000	56292254	-4000	4000	-1387
chr11	56342039	56350039	56346534	8000	56346039	-4000	4000	495
chr11	56539257	56547257	56543171	8000	56543257	-4000	4000	-86
chr11	57748675	57756675	57751074	8000	57752675	-4000	4000	-1601
chr11	64296358	64304358	64297228	8000	64300358	-4000	4000	-3130
chr11	71544420	71552420	71548869	8000	71548420	-4000	4000	449
chr11	89964502	89972502	89968657	8000	89968502	-4000	4000	155
chr11	124022798	124030798	124029631	8000	124026798	-4000	4000	2833
chr11	71544420	71552420	71548647	8000	71548420	-4000	4000	227
chr11	56695095	56703095	56700682	8000	56699095	-4000	4000	1587
chr11	58200142	58208142	58203593	8000	58204142	-4000	4000	-549
chr11	48241104	48249104	48245918	8000	48245104	-4000	4000	814
chr11	4633477	4641477	4640243	8000	4637477	-4000	4000	2766
chr11	4765938	4773938	4769289	8000	4769938	-4000	4000	-649
chr11	48484793	48492793	48489455	8000	48488793	-4000	4000	662
chr11	55550307	55558307	55554845	8000	55554307	-4000	4000	538
chr11	59422413	59430413	59422542	8000	59426413	-4000	4000	-3871
chr11	58185070	58193070	58191057	8000	58189070	-4000	4000	1987
chr11	58402874	58410874	58402894	8000	58406874	-4000	4000	-3980
chr11	95021258	95029258	95025536	8000	95025258	-4000	4000	278
chr11	66417004	66425004	66424448	8000	66421004	-4000	4000	3444
chr11	7084998	7092998	7090285	8000	7088998	-4000	4000	1287
chr11	56371624	56379624	56376216	8000	56375624	-4000	4000	592
chr11	56610874	56618874	56613017	8000	56614874	-4000	4000	-1857
chr11	4943605	4951605	4946569	8000	4947605	-4000	4000	-1036
chr11	55603645	55611645	55603975	8000	55607645	-4000	4000	-3670
chr11	56695095	56703095	56700528	8000	56699095	-4000	4000	1433
chr11	55363974	55371974	55368200	8000	55367974	-4000	4000	226
chr11	55658201	55666201	55665509	8000	55662201	-4000	4000	3308
chr11	1618138	1626138	1621829	8000	1622138	-4000	4000	-309
chr11	95045422	95053422	95049982	8000	95049422	-4000	4000	560
chr11	64296358	64304358	64300733	8000	64300358	-4000	4000	375
chr11	65941445	65949445	65947195	8000	65945445	-4000	4000	1750
chr11	93325971	93333971	93332288	8000	93329971	-4000	4000	2317
chr11	124022798	124030798	124030357	8000	124026798	-4000	4000	3559
chr11	3638316	3646316	3638737	8000	3642316	-4000	4000	-3579
chr11	56695095	56703095	56700719	8000	56699095	-4000	4000	1624
chr11	116833622	116841622	116836282	8000	116837622	-4000	4000	-1340
chr11	125676874	125684874	125677926	8000	125680874	-4000	4000	-2948
chr11	7792942	7800942	7796045	8000	7796942	-4000	4000	-897
chr11	116819304	116827304	116821686	8000	116823304	-4000	4000	-1618
chr11	4633477	4641477	4640554	8000	4637477	-4000	4000	3077
chr11	56573721	56581721	56577363	8000	56577721	-4000	4000	-358
chr11	49948391	49956391	49953029	8000	49952391	-4000	4000	638
chr11	56089308	56097308	56093774	8000	56093308	-4000	4000	466
chr11	55807367	55815367	55812361	8000	55811367	-4000	4000	994
chr11	55932400	55940400	55935959	8000	55936400	-4000	4000	-441
chr11	55932400	55940400	55935632	8000	55936400	-4000	4000	-768
chr11	48241104	48249104	48245413	8000	48245104	-4000	4000	309
chr11	14968351	14976351	14970076	8000	14972351	-4000	4000	-2275
chr11	104032640	104040640	104037604	8000	104036640	-4000	4000	964
chr11	55603645	55611645	55603982	8000	55607645	-4000	4000	-3663
chr11	85682195	85690195	85686135	8000	85686195	-4000	4000	-60
chr11	58355069	58363069	58358504	8000	58359069	-4000	4000	-565
chr11	4445295	4453295	4449621	8000	4449295	-4000	4000	326
chr11	7792942	7800942	7796722	8000	7796942	-4000	4000	-220
chr11	3641128	3649128	3641887	8000	3645128	-4000	4000	-3241
chr11	4541191	4549191	4545693	8000	4545191	-4000	4000	502
chr11	47348702	47356702	47355528	8000	47352702	-4000	4000	2826
chr11	56342039	56350039	56346554	8000	56346039	-4000	4000	515
chr11	6917002	6925002	6921639	8000	6921002	-4000	4000	637
chr11	55644327	55652327	55651572	8000	55648327	-4000	4000	3245
chr11	55807367	55815367	55811975	8000	55811367	-4000	4000	608
chr11	14968351	14976351	14968639	8000	14972351	-4000	4000	-3712
chr11	30227014	30235014	30233925	8000	30231014	-4000	4000	2911
chr11	66417004	66425004	66422742	8000	66421004	-4000	4000	1738
chr11	48241104	48249104	48245919	8000	48245104	-4000	4000	815
chr11	6767976	6775976	6768358	8000	6771976	-4000	4000	-3618
chr11	56414232	56422232	56417334	8000	56418232	-4000	4000	-898
chr11	66417004	66425004	66424382	8000	66421004	-4000	4000	3378
chr11	56288254	56296254	56290869	8000	56292254	-4000	4000	-1385
chr11	18168837	18176837	18174021	8000	18172837	-4000	4000	1184
chr11	5347508	5355508	5352088	8000	5351508	-4000	4000	580
chr11	123750518	123758518	123753855	8000	123754518	-4000	4000	-663
chr11	4845208	4853208	4848528	8000	4849208	-4000	4000	-680
chr11	55834752	55842752	55838862	8000	55838752	-4000	4000	110
chr11	55550307	55558307	55555042	8000	55554307	-4000	4000	735
chr11	5418111	5426111	5422670	8000	5422111	-4000	4000	559
chr11	58224918	58232918	58228283	8000	58228918	-4000	4000	-635
chr11	56371624	56379624	56376149	8000	56375624	-4000	4000	525
chr11	124022798	124030798	124023881	8000	124026798	-4000	4000	-2917
chr11	6888500	6896500	6892330	8000	6892500	-4000	4000	-170
chr11	5055627	5063627	5059317	8000	5059627	-4000	4000	-310
chr11	55769438	55777438	55774287	8000	55773438	-4000	4000	849
chr11	66417004	66425004	66422514	8000	66421004	-4000	4000	1510
chr11	4633477	4641477	4640417	8000	4637477	-4000	4000	2940
chr11	55550307	55558307	55554409	8000	55554307	-4000	4000	102
chr11	55791556	55799556	55795579	8000	55795556	-4000	4000	23
chr11	64931893	64939893	64935355	8000	64935893	-4000	4000	-538
chr11	2297997	2305997	2300748	8000	2301997	-4000	4000	-1249
chr11	55932400	55940400	55935645	8000	55936400	-4000	4000	-755
chr11	125742279	125750279	125747747	8000	125746279	-4000	4000	1468
chr11	22334381	22342381	22338601	8000	22338381	-4000	4000	220
chr11	6166326	6174326	6169513	8000	6170326	-4000	4000	-813
chr11	54599998	54607998	54603203	8000	54603998	-4000	4000	-795
chr11	55834752	55842752	55839612	8000	55838752	-4000	4000	860
chr11	62980967	62988967	62981373	8000	62984967	-4000	4000	-3594
chr11	125899348	125907348	125900300	8000	125903348	-4000	4000	-3048
chr11	20156475	20164475	20159243	8000	20160475	-4000	4000	-1232
chr11	58504105	58512105	58507410	8000	58508105	-4000	4000	-695
chr11	123750518	123758518	123754145	8000	123754518	-4000	4000	-373
chr11	62295075	62303075	62297597	8000	62299075	-4000	4000	-1478
chr11	56172618	56180618	56177282	8000	56176618	-4000	4000	664
chr11	57334352	57342352	57334526	8000	57338352	-4000	4000	-3826
chr11	7084998	7092998	7090727	8000	7088998	-4000	4000	1729
chr11	66417004	66425004	66424673	8000	66421004	-4000	4000	3669
chr11	125899348	125907348	125905277	8000	125903348	-4000	4000	1929
chr11	22334381	22342381	22341647	8000	22338381	-4000	4000	3266
chr11	55258155	55266155	55262242	8000	55262155	-4000	4000	87
chr11	4765938	4773938	4769175	8000	4769938	-4000	4000	-763
chr11	48241104	48249104	48245211	8000	48245104	-4000	4000	107
chr11	71561563	71569563	71565859	8000	71565563	-4000	4000	296
chr11	59709845	59717845	59713561	8000	59713845	-4000	4000	-284
chr11	125774828	125782828	125777311	8000	125778828	-4000	4000	-1517
chr11	5196682	5204682	5199859	8000	5200682	-4000	4000	-823
chr11	56099687	56107687	56105365	8000	56103687	-4000	4000	1678
chr11	62980967	62988967	62984652	8000	62984967	-4000	4000	-315
chr11	14968351	14976351	14968871	8000	14972351	-4000	4000	-3480
chr11	26719427	26727427	26721564	8000	26723427	-4000	4000	-1863
chr11	48241104	48249104	48245608	8000	48245104	-4000	4000	504
chr11	55910582	55918582	55913689	8000	55914582	-4000	4000	-893
chr11	5964494	5972494	5967923	8000	5968494	-4000	4000	-571
chr11	48484793	48492793	48489644	8000	48488793	-4000	4000	851
chr11	55363974	55371974	55368080	8000	55367974	-4000	4000	106
chr11	55910582	55918582	55913842	8000	55914582	-4000	4000	-740
chr11	55644327	55652327	55651777	8000	55648327	-4000	4000	3450
chr11	5750243	5758243	5754852	8000	5754243	-4000	4000	609
chr11	56610874	56618874	56612971	8000	56614874	-4000	4000	-1903
chr11	55965945	55973945	55968088	8000	55969945	-4000	4000	-1857
chr11	22334381	22342381	22338503	8000	22338381	-4000	4000	122
chr11	133841538	133849538	133845131	8000	133845538	-4000	4000	-407
chr11	4943605	4951605	4946587	8000	4947605	-4000	4000	-1018
chr11	68976986	68984986	68980467	8000	68980986	-4000	4000	-519
chr11	48212810	48220810	48217427	8000	48216810	-4000	4000	617
chr11	56288254	56296254	56290688	8000	56292254	-4000	4000	-1566
chr11	49978535	49986535	49981726	8000	49982535	-4000	4000	-809
chr11	58355069	58363069	58358713	8000	58359069	-4000	4000	-356
chr11	64931893	64939893	64935162	8000	64935893	-4000	4000	-731
chr11	4943605	4951605	4946301	8000	4947605	-4000	4000	-1304
chr11	4633477	4641477	4640555	8000	4637477	-4000	4000	3078
chr11	5750243	5758243	5755672	8000	5754243	-4000	4000	1429
chr11	55879297	55887297	55886215	8000	55883297	-4000	4000	2918
chr11	60036409	60044409	60043497	8000	60040409	-4000	4000	3088
chr11	124022798	124030798	124023171	8000	124026798	-4000	4000	-3627
chr11	58438236	58446236	58440103	8000	58442236	-4000	4000	-2133
chr11	125829316	125837316	125833349	8000	125833316	-4000	4000	33
chr11	7927268	7935268	7928164	8000	7931268	-4000	4000	-3104
chr11	56248254	56256254	56252395	8000	56252254	-4000	4000	141
chr11	4364386	4372386	4367483	8000	4368386	-4000	4000	-903
chr11	4541191	4549191	4545577	8000	4545191	-4000	4000	386
chr11	5042526	5050526	5046641	8000	5046526	-4000	4000	115
chr11	5674434	5682434	5680215	8000	5678434	-4000	4000	1781
chr11	55644327	55652327	55651163	8000	55648327	-4000	4000	2836
chr11	56610874	56618874	56613069	8000	56614874	-4000	4000	-1805
chr11	58200142	58208142	58203867	8000	58204142	-4000	4000	-275
chr11	60863542	60871542	60869680	8000	60867542	-4000	4000	2138
chr11	4915350	4923350	4915527	8000	4919350	-4000	4000	-3823
chr11	63365785	63373785	63369876	8000	63369785	-4000	4000	91
chr11	116833622	116841622	116837003	8000	116837622	-4000	4000	-619
chr11	122977834	122985834	122979432	8000	122981834	-4000	4000	-2402
chr11	55644327	55652327	55651378	8000	55648327	-4000	4000	3051
chr11	4951713	4959713	4955696	8000	4955713	-4000	4000	-17
chr11	58402874	58410874	58402882	8000	58406874	-4000	4000	-3992
chr11	123973781	123981781	123977575	8000	123977781	-4000	4000	-206
chr11	5964494	5972494	5968074	8000	5968494	-4000	4000	-420
chr11	6779020	6787020	6785904	8000	6783020	-4000	4000	2884
chr11	125899348	125907348	125900032	8000	125903348	-4000	4000	-3316
chr11	56342039	56350039	56346915	8000	56346039	-4000	4000	876
chr11	18168837	18176837	18173312	8000	18172837	-4000	4000	475
chr11	4990851	4998851	4992267	8000	4994851	-4000	4000	-2584
chr11	55815630	55823630	55820018	8000	55819630	-4000	4000	388
chr11	56270154	56278154	56276461	8000	56274154	-4000	4000	2307
chr11	4990851	4998851	4991482	8000	4994851	-4000	4000	-3369
chr11	56248254	56256254	56252484	8000	56252254	-4000	4000	230
chr11	89173875	89181875	89178499	8000	89177875	-4000	4000	624
chr11	295526	303526	299396	8000	299526	-4000	4000	-130
chr11	104032640	104040640	104038059	8000	104036640	-4000	4000	1419
chr11	123973781	123981781	123977488	8000	123977781	-4000	4000	-293
chr11	56136201	56144201	56137596	8000	56140201	-4000	4000	-2605
chr11	56136201	56144201	56137390	8000	56140201	-4000	4000	-2811
chr11	133841538	133849538	133842517	8000	133845538	-4000	4000	-3021
chr11	94300580	94308580	94305646	8000	94304580	-4000	4000	1066
chr11	119181457	119189457	119185831	8000	119185457	-4000	4000	374
chr11	124022798	124030798	124023433	8000	124026798	-4000	4000	-3365
chr11	59499576	59507576	59504481	8000	59503576	-4000	4000	905
chr11	56984914	56992914	56989680	8000	56988914	-4000	4000	766
chr11	1625775	1633775	1630577	8000	1629775	-4000	4000	802
chr11	55568128	55576128	55572496	8000	55572128	-4000	4000	368
chr11	58355069	58363069	58358741	8000	58359069	-4000	4000	-328
chr11	125899348	125907348	125900154	8000	125903348	-4000	4000	-3194
chr11	55807367	55815367	55811652	8000	55811367	-4000	4000	285
chr11	55932400	55940400	55936336	8000	55936400	-4000	4000	-64
chr11	58224918	58232918	58228538	8000	58228918	-4000	4000	-380
chr11	4445295	4453295	4450036	8000	4449295	-4000	4000	741
chr11	95021258	95029258	95026666	8000	95025258	-4000	4000	1408
chr11	63365785	63373785	63370083	8000	63369785	-4000	4000	298
chr11	20156475	20164475	20156493	8000	20160475	-4000	4000	-3982
chr11	85682195	85690195	85685546	8000	85686195	-4000	4000	-649
chr11	85682195	85690195	85685998	8000	85686195	-4000	4000	-197
chr11	4541191	4549191	4545727	8000	4545191	-4000	4000	536
chr11	55965945	55973945	55967586	8000	55969945	-4000	4000	-2359
chr11	56023654	56031654	56030940	8000	56027654	-4000	4000	3286
chr11	56089308	56097308	56093820	8000	56093308	-4000	4000	512
chr11	49978535	49986535	49981905	8000	49982535	-4000	4000	-630
chr11	7927268	7935268	7928004	8000	7931268	-4000	4000	-3264
chr11	56695095	56703095	56700855	8000	56699095	-4000	4000	1760
chr11	48241104	48249104	48245246	8000	48245104	-4000	4000	142
chr11	58504105	58512105	58507380	8000	58508105	-4000	4000	-725
chr11	4800380	4808380	4804190	8000	4804380	-4000	4000	-190
chr11	47582678	47590678	47584557	8000	47586678	-4000	4000	-2121
chr11	58224918	58232918	58228496	8000	58228918	-4000	4000	-422
chr11	64586641	64594641	64593756	8000	64590641	-4000	4000	3115
chr11	58200142	58208142	58203379	8000	58204142	-4000	4000	-763
chr11	20156475	20164475	20156641	8000	20160475	-4000	4000	-3834
chr11	123973781	123981781	123977157	8000	123977781	-4000	4000	-624
chr11	55932400	55940400	55935610	8000	55936400	-4000	4000	-790
chr11	62980967	62988967	62984593	8000	62984967	-4000	4000	-374
chr11	124420871	124428871	124424702	8000	124424871	-4000	4000	-169
chr11	4920339	4928339	4923606	8000	4924339	-4000	4000	-733
chr11	6767976	6775976	6768541	8000	6771976	-4000	4000	-3435
chr11	59841499	59849499	59845494	8000	59845499	-4000	4000	-5
chr11	54702832	54710832	54707739	8000	54706832	-4000	4000	907
chr11	89173875	89181875	89178073	8000	89177875	-4000	4000	198
chr11	6779020	6787020	6785449	8000	6783020	-4000	4000	2429
chr11	124008997	124016997	124016491	8000	124012997	-4000	4000	3494
chr11	123750518	123758518	123753846	8000	123754518	-4000	4000	-672
chr11	119181457	119189457	119187675	8000	119185457	-4000	4000	2218
chr11	64296358	64304358	64297129	8000	64300358	-4000	4000	-3229
chr11	5347508	5355508	5351818	8000	5351508	-4000	4000	310
chr11	64296358	64304358	64297441	8000	64300358	-4000	4000	-2917
chr11	3638316	3646316	3638601	8000	3642316	-4000	4000	-3715
chr11	56371624	56379624	56376154	8000	56375624	-4000	4000	530
chr11	55258155	55266155	55265150	8000	55262155	-4000	4000	2995
chr11	104032640	104040640	104036828	8000	104036640	-4000	4000	188
chr11	55631113	55639113	55638452	8000	55635113	-4000	4000	3339
chr11	5853690	5861690	5857002	8000	5857690	-4000	4000	-688
chr11	56414232	56422232	56417883	8000	56418232	-4000	4000	-349
chr11	68976986	68984986	68980804	8000	68980986	-4000	4000	-182
chr11	124316197	124324197	124319886	8000	124320197	-4000	4000	-311
chr11	55807367	55815367	55812208	8000	55811367	-4000	4000	841
chr11	56023654	56031654	56030595	8000	56027654	-4000	4000	2941
chr11	192761	200761	198069	8000	196761	-4000	4000	1308
chr11	101912522	101920522	101915316	8000	101916522	-4000	4000	-1206
chr11	56248254	56256254	56252963	8000	56252254	-4000	4000	709
chr11	95021258	95029258	95027057	8000	95025258	-4000	4000	1799
chr11	66022479	66030479	66025479	8000	66026479	-4000	4000	-1000
chr11	47445143	47453143	47448141	8000	47449143	-4000	4000	-1002
chr11	55258155	55266155	55265283	8000	55262155	-4000	4000	3128
chr11	55932400	55940400	55936037	8000	55936400	-4000	4000	-363
chr11	56573721	56581721	56577440	8000	56577721	-4000	4000	-281
chr11	4951713	4959713	4954849	8000	4955713	-4000	4000	-864
chr11	55550307	55558307	55555048	8000	55554307	-4000	4000	741
chr11	55910582	55918582	55914571	8000	55914582	-4000	4000	-11
chr11	89964502	89972502	89968654	8000	89968502	-4000	4000	152
chr11	5042526	5050526	5046982	8000	5046526	-4000	4000	456
chr11	4915350	4923350	4915441	8000	4919350	-4000	4000	-3909
chr11	124607428	124615428	124611661	8000	124611428	-4000	4000	233
chr11	55834752	55842752	55839529	8000	55838752	-4000	4000	777
chr11	64296358	64304358	64297333	8000	64300358	-4000	4000	-3025
chr11	55550307	55558307	55555190	8000	55554307	-4000	4000	883
chr11	119181457	119189457	119188676	8000	119185457	-4000	4000	3219
chr11	55769438	55777438	55774129	8000	55773438	-4000	4000	691
chr11	60863542	60871542	60870387	8000	60867542	-4000	4000	2845
chr11	66417004	66425004	66422518	8000	66421004	-4000	4000	1514
chr11	5484685	5492685	5488923	8000	5488685	-4000	4000	238
chr11	14968351	14976351	14968952	8000	14972351	-4000	4000	-3399
chr11	48212810	48220810	48216823	8000	48216810	-4000	4000	13
chr11	54702832	54710832	54707001	8000	54706832	-4000	4000	169
chr11	62980967	62988967	62984523	8000	62984967	-4000	4000	-444
chr11	63365785	63373785	63370374	8000	63369785	-4000	4000	589
chr11	116788420	116796420	116790796	8000	116792420	-4000	4000	-1624
chr11	5837952	5845952	5841018	8000	5841952	-4000	4000	-934
chr11	56659686	56667686	56664020	8000	56663686	-4000	4000	334
chr11	56695095	56703095	56701100	8000	56699095	-4000	4000	2005
chr11	6888500	6896500	6892432	8000	6892500	-4000	4000	-68
chr11	124562660	124570660	124570334	8000	124566660	-4000	4000	3674
chr11	44043981	44051981	44050579	8000	44047981	-4000	4000	2598
chr11	55834752	55842752	55839035	8000	55838752	-4000	4000	283
chr11	55834752	55842752	55839332	8000	55838752	-4000	4000	580
chr11	56156317	56164317	56159806	8000	56160317	-4000	4000	-511
chr11	58264260	58272260	58267472	8000	58268260	-4000	4000	-788
chr11	71523267	71531267	71527279	8000	71527267	-4000	4000	12
chr11	123802349	123810349	123805691	8000	123806349	-4000	4000	-658
chr11	56230255	56238255	56232722	8000	56234255	-4000	4000	-1533
chr11	56659686	56667686	56664204	8000	56663686	-4000	4000	518
chr11	5042526	5050526	5046843	8000	5046526	-4000	4000	317
chr11	5418111	5426111	5422281	8000	5422111	-4000	4000	170
chr11	56539257	56547257	56542433	8000	56543257	-4000	4000	-824
chr11	55644327	55652327	55651696	8000	55648327	-4000	4000	3369
chr11	64586641	64594641	64593658	8000	64590641	-4000	4000	3017
chr11	6195224	6203224	6200128	8000	6199224	-4000	4000	904
chr11	116833622	116841622	116837360	8000	116837622	-4000	4000	-262
chr11	123881670	123889670	123884530	8000	123885670	-4000	4000	-1140
chr11	116833622	116841622	116835819	8000	116837622	-4000	4000	-1803
chr11	109418190	109426190	109424148	8000	109422190	-4000	4000	1958
chr11	4541191	4549191	4545658	8000	4545191	-4000	4000	467
chr11	5787265	5795265	5788544	8000	5791265	-4000	4000	-2721
chr11	20595594	20603594	20599515	8000	20599594	-4000	4000	-79
chr11	55791556	55799556	55796176	8000	55795556	-4000	4000	620
chr11	55965945	55973945	55968245	8000	55969945	-4000	4000	-1700
chr11	56984914	56992914	56989074	8000	56988914	-4000	4000	160
chr11	4445295	4453295	4450034	8000	4449295	-4000	4000	739
chr11	55258155	55266155	55264897	8000	55262155	-4000	4000	2742
chr11	55568128	55576128	55573033	8000	55572128	-4000	4000	905
chr11	55932400	55940400	55936056	8000	55936400	-4000	4000	-344
chr11	55990625	55998625	55994493	8000	55994625	-4000	4000	-132
chr11	56230255	56238255	56232538	8000	56234255	-4000	4000	-1717
chr11	60863542	60871542	60869721	8000	60867542	-4000	4000	2179
chr11	66417004	66425004	66421284	8000	66421004	-4000	4000	280
chr11	4589750	4597750	4594739	8000	4593750	-4000	4000	989
chr11	6779020	6787020	6785950	8000	6783020	-4000	4000	2930
chr11	7084998	7092998	7090223	8000	7088998	-4000	4000	1225
chr11	48212810	48220810	48217233	8000	48216810	-4000	4000	423
chr11	56099687	56107687	56105468	8000	56103687	-4000	4000	1781
chr11	124316197	124324197	124320026	8000	124320197	-4000	4000	-171
chr11	2297997	2305997	2299567	8000	2301997	-4000	4000	-2430
chr11	3638316	3646316	3640063	8000	3642316	-4000	4000	-2253
chr11	56230255	56238255	56232753	8000	56234255	-4000	4000	-1502
chr11	58438236	58446236	58440024	8000	58442236	-4000	4000	-2212
chr11	95021258	95029258	95025918	8000	95025258	-4000	4000	660
chr11	113971075	113979075	113975254	8000	113975075	-4000	4000	179
chr11	116825706	116833706	116832805	8000	116829706	-4000	4000	3099
chr11	3228417	3236417	3228706	8000	3232417	-4000	4000	-3711
chr11	122977834	122985834	122981461	8000	122981834	-4000	4000	-373
chr11	55550307	55558307	55555398	8000	55554307	-4000	4000	1091
chr11	56270154	56278154	56276484	8000	56274154	-4000	4000	2330
chr11	56156317	56164317	56159472	8000	56160317	-4000	4000	-845
chr11	58208720	58216720	58215330	8000	58212720	-4000	4000	2610
chr11	54702832	54710832	54706972	8000	54706832	-4000	4000	140
chr11	64586641	64594641	64592870	8000	64590641	-4000	4000	2229
chr11	124179219	124187219	124185781	8000	124183219	-4000	4000	2562
chr11	59709845	59717845	59712966	8000	59713845	-4000	4000	-879
chr11	123973781	123981781	123977238	8000	123977781	-4000	4000	-543
chr11	124541333	124549333	124543294	8000	124545333	-4000	4000	-2039
chr11	1581283	1589283	1584748	8000	1585283	-4000	4000	-535
chr11	64551690	64559690	64556242	8000	64555690	-4000	4000	552
chr11	14968351	14976351	14968723	8000	14972351	-4000	4000	-3628
chr11	55550307	55558307	55554507	8000	55554307	-4000	4000	200
chr11	55965945	55973945	55968440	8000	55969945	-4000	4000	-1505
chr11	124008997	124016997	124015835	8000	124012997	-4000	4000	2838
chr11	124022798	124030798	124023273	8000	124026798	-4000	4000	-3525
chr11	6779020	6787020	6785643	8000	6783020	-4000	4000	2623
chr11	44043981	44051981	44048180	8000	44047981	-4000	4000	199
chr11	5982985	5990985	5986152	8000	5986985	-4000	4000	-833
chr11	6767976	6775976	6768928	8000	6771976	-4000	4000	-3048
chr11	59709845	59717845	59713141	8000	59713845	-4000	4000	-704
chr11	71561563	71569563	71565901	8000	71565563	-4000	4000	338
chr11	124008997	124016997	124016137	8000	124012997	-4000	4000	3140
chr11	104032640	104040640	104037309	8000	104036640	-4000	4000	669
chr11	5196682	5204682	5200681	8000	5200682	-4000	4000	-1
chr11	47582678	47590678	47589925	8000	47586678	-4000	4000	3247
chr11	56610874	56618874	56613053	8000	56614874	-4000	4000	-1821
chr11	89173875	89181875	89178034	8000	89177875	-4000	4000	159
chr11	6166326	6174326	6169499	8000	6170326	-4000	4000	-827
chr11	54599998	54607998	54603344	8000	54603998	-4000	4000	-654
chr11	90081950	90089950	90086854	8000	90085950	-4000	4000	904
chr11	111510778	111518778	111514886	8000	111514778	-4000	4000	108
chr11	123935617	123943617	123943261	8000	123939617	-4000	4000	3644
chr11	124022798	124030798	124023407	8000	124026798	-4000	4000	-3391
chr11	55258155	55266155	55265133	8000	55262155	-4000	4000	2978
chr11	4541191	4549191	4545376	8000	4545191	-4000	4000	185
chr11	56638439	56646439	56642292	8000	56642439	-4000	4000	-147
chr11	57334352	57342352	57338545	8000	57338352	-4000	4000	193
chr11	57334352	57342352	57338546	8000	57338352	-4000	4000	194
chr11	48241104	48249104	48245626	8000	48245104	-4000	4000	522
chr11	7792942	7800942	7796683	8000	7796942	-4000	4000	-259
chr11	13492181	13500181	13492241	8000	13496181	-4000	4000	-3940
chr11	55550307	55558307	55554669	8000	55554307	-4000	4000	362
chr11	59452961	59460961	59456987	8000	59456961	-4000	4000	26
chr11	48259861	48267861	48264016	8000	48263861	-4000	4000	155
chr11	56230255	56238255	56232409	8000	56234255	-4000	4000	-1846
chr11	102701769	102709769	102704716	8000	102705769	-4000	4000	-1053
chr11	6779020	6787020	6785940	8000	6783020	-4000	4000	2920
chr11	55823219	55831219	55827492	8000	55827219	-4000	4000	273
chr11	1693195	1701195	1697290	8000	1697195	-4000	4000	95
chr11	4943605	4951605	4946756	8000	4947605	-4000	4000	-849
chr11	48259861	48267861	48264046	8000	48263861	-4000	4000	185
chr11	55965945	55973945	55968165	8000	55969945	-4000	4000	-1780
chr11	89173875	89181875	89178105	8000	89177875	-4000	4000	230
chr11	48302223	48310223	48306929	8000	48306223	-4000	4000	706
chr11	4765938	4773938	4769172	8000	4769938	-4000	4000	-766
chr11	55823219	55831219	55828094	8000	55827219	-4000	4000	875
chr11	56342039	56350039	56346121	8000	56346039	-4000	4000	82
chr11	71544420	71552420	71548614	8000	71548420	-4000	4000	194
chr11	124008997	124016997	124016094	8000	124012997	-4000	4000	3097
chr11	109418190	109426190	109423740	8000	109422190	-4000	4000	1550
chr11	54599998	54607998	54603458	8000	54603998	-4000	4000	-540
chr11	55910582	55918582	55913809	8000	55914582	-4000	4000	-773
chr11	55823219	55831219	55827821	8000	55827219	-4000	4000	602
chr11	4445295	4453295	4449637	8000	4449295	-4000	4000	342
chr11	54599998	54607998	54603376	8000	54603998	-4000	4000	-622
chr11	44043981	44051981	44048488	8000	44047981	-4000	4000	507
chr11	5853690	5861690	5856844	8000	5857690	-4000	4000	-846
chr11	58402874	58410874	58403229	8000	58406874	-4000	4000	-3645
chr11	56099687	56107687	56105590	8000	56103687	-4000	4000	1903
chr11	5484685	5492685	5489404	8000	5488685	-4000	4000	719
chr11	56288254	56296254	56290558	8000	56292254	-4000	4000	-1696
chr11	66417004	66425004	66424005	8000	66421004	-4000	4000	3001
chr11	56414232	56422232	56417331	8000	56418232	-4000	4000	-901
chr11	46715196	46723196	46719725	8000	46719196	-4000	4000	529
chr11	66417004	66425004	66424773	8000	66421004	-4000	4000	3769
chr11	4364386	4372386	4368071	8000	4368386	-4000	4000	-315
chr11	56610874	56618874	56612675	8000	56614874	-4000	4000	-2199
chr11	55568128	55576128	55572637	8000	55572128	-4000	4000	509
chr11	55363974	55371974	55368537	8000	55367974	-4000	4000	563
chr11	56270154	56278154	56275640	8000	56274154	-4000	4000	1486
chr11	6195224	6203224	6199839	8000	6199224	-4000	4000	615
chr11	118967712	118975712	118971735	8000	118971712	-4000	4000	23
chr11	2157221	2165221	2159789	8000	2161221	-4000	4000	-1432
chr11	59507368	59515368	59515277	8000	59511368	-4000	4000	3909
chr11	4633477	4641477	4640574	8000	4637477	-4000	4000	3097
chr11	4800380	4808380	4804049	8000	4804380	-4000	4000	-331
chr11	4800380	4808380	4804148	8000	4804380	-4000	4000	-232
chr11	5042526	5050526	5047272	8000	5046526	-4000	4000	746
chr11	5982985	5990985	5986580	8000	5986985	-4000	4000	-405
chr11	6872625	6880625	6877293	8000	6876625	-4000	4000	668
chr11	7792942	7800942	7796235	8000	7796942	-4000	4000	-707
chr11	7792942	7800942	7796795	8000	7796942	-4000	4000	-147
chr11	18168837	18176837	18173765	8000	18172837	-4000	4000	928
chr11	47348702	47356702	47349904	8000	47352702	-4000	4000	-2798
chr11	47582678	47590678	47586728	8000	47586678	-4000	4000	50
chr11	48259861	48267861	48263953	8000	48263861	-4000	4000	92
chr11	48302223	48310223	48306440	8000	48306223	-4000	4000	217
chr11	55258155	55266155	55264954	8000	55262155	-4000	4000	2799
chr11	55823219	55831219	55827697	8000	55827219	-4000	4000	478
chr11	55834752	55842752	55839525	8000	55838752	-4000	4000	773
chr11	56136201	56144201	56137390	8000	56140201	-4000	4000	-2811
chr11	56156317	56164317	56159930	8000	56160317	-4000	4000	-387
chr11	56487370	56495370	56491349	8000	56491370	-4000	4000	-21
chr11	56984914	56992914	56989122	8000	56988914	-4000	4000	208
chr11	59499576	59507576	59503660	8000	59503576	-4000	4000	84
chr11	64586641	64594641	64591757	8000	64590641	-4000	4000	1116
chr11	68976986	68984986	68980949	8000	68980986	-4000	4000	-37
chr11	71523267	71531267	71527626	8000	71527267	-4000	4000	359
chr11	71561563	71569563	71566314	8000	71565563	-4000	4000	751
chr11	90081950	90089950	90087047	8000	90085950	-4000	4000	1097
chr11	102701769	102709769	102705721	8000	102705769	-4000	4000	-48
chr11	125899348	125907348	125900351	8000	125903348	-4000	4000	-2997
chr11	18168837	18176837	18173954	8000	18172837	-4000	4000	1117
chr11	55644327	55652327	55651611	8000	55648327	-4000	4000	3284
chr11	56023654	56031654	56030735	8000	56027654	-4000	4000	3081
chr11	123935617	123943617	123939863	8000	123939617	-4000	4000	246
chr11	55769438	55777438	55774246	8000	55773438	-4000	4000	808
chr11	58438236	58446236	58439624	8000	58442236	-4000	4000	-2612
chr11	65941445	65949445	65948074	8000	65945445	-4000	4000	2629
chr11	56984914	56992914	56988915	8000	56988914	-4000	4000	1
chr11	62980967	62988967	62983591	8000	62984967	-4000	4000	-1376
chr11	55363974	55371974	55368746	8000	55367974	-4000	4000	772
chr11	55791556	55799556	55796116	8000	55795556	-4000	4000	560
chr11	56342039	56350039	56346809	8000	56346039	-4000	4000	770
chr11	56230255	56238255	56232120	8000	56234255	-4000	4000	-2135
chr11	58208720	58216720	58215128	8000	58212720	-4000	4000	2408
chr11	113971075	113979075	113975282	8000	113975075	-4000	4000	207
chr11	124541333	124549333	124542815	8000	124545333	-4000	4000	-2518
chr11	6002946	6010946	6003107	8000	6006946	-4000	4000	-3839
chr11	6841683	6849683	6846586	8000	6845683	-4000	4000	903
chr11	124420871	124428871	124424729	8000	124424871	-4000	4000	-142
chr11	56099687	56107687	56105110	8000	56103687	-4000	4000	1423
chr11	3638316	3646316	3638804	8000	3642316	-4000	4000	-3512
chr11	4541191	4549191	4545987	8000	4545191	-4000	4000	796
chr11	4589750	4597750	4594197	8000	4593750	-4000	4000	447
chr11	5347508	5355508	5352108	8000	5351508	-4000	4000	600
chr11	5418111	5426111	5423060	8000	5422111	-4000	4000	949
chr11	5837952	5845952	5841579	8000	5841952	-4000	4000	-373
chr11	6917002	6925002	6921207	8000	6921002	-4000	4000	205
chr11	7792942	7800942	7796185	8000	7796942	-4000	4000	-757
chr11	7937708	7945708	7939513	8000	7941708	-4000	4000	-2195
chr11	14968351	14976351	14968604	8000	14972351	-4000	4000	-3747
chr11	26719427	26727427	26721647	8000	26723427	-4000	4000	-1780
chr11	55363974	55371974	55368231	8000	55367974	-4000	4000	257
chr11	55550307	55558307	55554739	8000	55554307	-4000	4000	432
chr11	55550307	55558307	55555221	8000	55554307	-4000	4000	914
chr11	55644327	55652327	55650956	8000	55648327	-4000	4000	2629
chr11	55791556	55799556	55796250	8000	55795556	-4000	4000	694
chr11	55807367	55815367	55812344	8000	55811367	-4000	4000	977
chr11	55965945	55973945	55968377	8000	55969945	-4000	4000	-1568
chr11	55990625	55998625	55994356	8000	55994625	-4000	4000	-269
chr11	56023654	56031654	56030427	8000	56027654	-4000	4000	2773
chr11	56089308	56097308	56093406	8000	56093308	-4000	4000	98
chr11	56099687	56107687	56105505	8000	56103687	-4000	4000	1818
chr11	56118373	56126373	56123258	8000	56122373	-4000	4000	885
chr11	56172618	56180618	56176899	8000	56176618	-4000	4000	281
chr11	56248254	56256254	56252447	8000	56252254	-4000	4000	193
chr11	56270154	56278154	56275766	8000	56274154	-4000	4000	1612
chr11	56270154	56278154	56275844	8000	56274154	-4000	4000	1690
chr11	56288254	56296254	56290543	8000	56292254	-4000	4000	-1711
chr11	56288254	56296254	56290697	8000	56292254	-4000	4000	-1557
chr11	56311144	56319144	56318342	8000	56315144	-4000	4000	3198
chr11	56311144	56319144	56318773	8000	56315144	-4000	4000	3629
chr11	56342039	56350039	56346885	8000	56346039	-4000	4000	846
chr11	56610874	56618874	56612831	8000	56614874	-4000	4000	-2043
chr11	56984914	56992914	56988949	8000	56988914	-4000	4000	35
chr11	58208720	58216720	58215250	8000	58212720	-4000	4000	2530
chr11	61199307	61207307	61203557	8000	61203307	-4000	4000	250
chr11	65350751	65358751	65357182	8000	65354751	-4000	4000	2431
chr11	66045161	66053161	66045319	8000	66049161	-4000	4000	-3842
chr11	71523267	71531267	71527548	8000	71527267	-4000	4000	281
chr11	71829200	71837200	71833251	8000	71833200	-4000	4000	51
chr11	102701769	102709769	102704688	8000	102705769	-4000	4000	-1081
chr11	104032640	104040640	104037532	8000	104036640	-4000	4000	892
chr11	104032640	104040640	104037849	8000	104036640	-4000	4000	1209
chr11	116788420	116796420	116790147	8000	116792420	-4000	4000	-2273
chr11	116819304	116827304	116821630	8000	116823304	-4000	4000	-1674
chr11	123802349	123810349	123805828	8000	123806349	-4000	4000	-521
chr11	123973781	123981781	123977449	8000	123977781	-4000	4000	-332
chr11	125742279	125750279	125748956	8000	125746279	-4000	4000	2677
chr11	6002946	6010946	6003075	8000	6006946	-4000	4000	-3871
chr11	47348702	47356702	47352630	8000	47352702	-4000	4000	-72
chr11	62980967	62988967	62983570	8000	62984967	-4000	4000	-1397
chr11	6166326	6174326	6170018	8000	6170326	-4000	4000	-308
chr11	116819304	116827304	116821373	8000	116823304	-4000	4000	-1931
chr11	122977834	122985834	122979302	8000	122981834	-4000	4000	-2532
chr11	6779020	6787020	6785419	8000	6783020	-4000	4000	2399
chr11	63140221	63148221	63143972	8000	63144221	-4000	4000	-249
chr11	123973781	123981781	123977617	8000	123977781	-4000	4000	-164
chr11	124037325	124045325	124038903	8000	124041325	-4000	4000	-2422
chr11	59499576	59507576	59503745	8000	59503576	-4000	4000	169
chr11	63011841	63019841	63014853	8000	63015841	-4000	4000	-988
chr11	124008997	124016997	124016063	8000	124012997	-4000	4000	3066
chr11	119181457	119189457	119185649	8000	119185457	-4000	4000	192
chr11	30227014	30235014	30233994	8000	30231014	-4000	4000	2980
chr11	59422413	59430413	59422828	8000	59426413	-4000	4000	-3585
chr11	5418111	5426111	5423053	8000	5422111	-4000	4000	942
chr11	124541333	124549333	124543001	8000	124545333	-4000	4000	-2332
chr11	8929006	8937006	8929451	8000	8933006	-4000	4000	-3555
chr11	55631113	55639113	55638752	8000	55635113	-4000	4000	3639
chr11	55791556	55799556	55796039	8000	55795556	-4000	4000	483
chr11	55823219	55831219	55827892	8000	55827219	-4000	4000	673
chr11	49948391	49956391	49952723	8000	49952391	-4000	4000	332
chr11	56487370	56495370	56490649	8000	56491370	-4000	4000	-721
chr11	5418111	5426111	5423098	8000	5422111	-4000	4000	987
chr11	56414232	56422232	56418200	8000	56418232	-4000	4000	-32
chr11	54599998	54607998	54603419	8000	54603998	-4000	4000	-579
chr11	4920339	4928339	4923926	8000	4924339	-4000	4000	-413
chr11	55823219	55831219	55827929	8000	55827219	-4000	4000	710
chr11	55823219	55831219	55827930	8000	55827219	-4000	4000	711
chr11	20156475	20164475	20159248	8000	20160475	-4000	4000	-1227
chr11	5674434	5682434	5679890	8000	5678434	-4000	4000	1456
chr11	66971277	66979277	66975623	8000	66975277	-4000	4000	346
chr11	5837952	5845952	5841632	8000	5841952	-4000	4000	-320
chr11	56539257	56547257	56543118	8000	56543257	-4000	4000	-139
chr11	59709845	59717845	59713351	8000	59713845	-4000	4000	-494
chr11	85682195	85690195	85685067	8000	85686195	-4000	4000	-1128
chr11	124420871	124428871	124424584	8000	124424871	-4000	4000	-287
chr11	56099687	56107687	56105744	8000	56103687	-4000	4000	2057
chr11	5418111	5426111	5422564	8000	5422111	-4000	4000	453
chr11	5196682	5204682	5200317	8000	5200682	-4000	4000	-365
chr11	44043981	44051981	44048494	8000	44047981	-4000	4000	513
chr11	47348702	47356702	47355439	8000	47352702	-4000	4000	2737
chr11	49978535	49986535	49981656	8000	49982535	-4000	4000	-879
chr11	56023654	56031654	56031234	8000	56027654	-4000	4000	3580
chr11	123935617	123943617	123943383	8000	123939617	-4000	4000	3766
chr11	124022798	124030798	124029966	8000	124026798	-4000	4000	3168
chr11	56414232	56422232	56417339	8000	56418232	-4000	4000	-893
chr11	58208720	58216720	58215554	8000	58212720	-4000	4000	2834
chr11	59452961	59460961	59457676	8000	59456961	-4000	4000	715
chr11	124008997	124016997	124016257	8000	124012997	-4000	4000	3260
chr11	18168837	18176837	18173869	8000	18172837	-4000	4000	1032
chr11	57533595	57541595	57541509	8000	57537595	-4000	4000	3914
chr11	56984914	56992914	56988973	8000	56988914	-4000	4000	59
chr11	2157221	2165221	2159821	8000	2161221	-4000	4000	-1400
chr11	57334352	57342352	57334539	8000	57338352	-4000	4000	-3813
chr11	2167815	2175815	2171729	8000	2171815	-4000	4000	-86
chr11	56118373	56126373	56123001	8000	56122373	-4000	4000	628
chr11	5837952	5845952	5841190	8000	5841952	-4000	4000	-762
chr11	65350751	65358751	65355892	8000	65354751	-4000	4000	1141
chr11	65350751	65358751	65357192	8000	65354751	-4000	4000	2441
chr11	55834752	55842752	55839633	8000	55838752	-4000	4000	881
chr11	56610874	56618874	56612952	8000	56614874	-4000	4000	-1922
chr11	56659686	56667686	56664611	8000	56663686	-4000	4000	925
chr11	124008997	124016997	124016013	8000	124012997	-4000	4000	3016
chr11	5876629	5884629	5884376	8000	5880629	-4000	4000	3747
chr11	6917002	6925002	6921717	8000	6921002	-4000	4000	715
chr11	55568128	55576128	55572876	8000	55572128	-4000	4000	748
chr11	56487370	56495370	56491163	8000	56491370	-4000	4000	-207
chr11	64296358	64304358	64300374	8000	64300358	-4000	4000	16
chr11	94397419	94405419	94401042	8000	94401419	-4000	4000	-377
chr11	122977834	122985834	122979385	8000	122981834	-4000	4000	-2449
chr11	104032640	104040640	104037999	8000	104036640	-4000	4000	1359
chr11	5042526	5050526	5047294	8000	5046526	-4000	4000	768
chr11	47582678	47590678	47589935	8000	47586678	-4000	4000	3257
chr11	56371624	56379624	56376192	8000	56375624	-4000	4000	568
chr11	295526	303526	299390	8000	299526	-4000	4000	-136
chr11	3214813	3222813	3218738	8000	3218813	-4000	4000	-75
chr11	7084998	7092998	7089295	8000	7088998	-4000	4000	297
chr11	56342039	56350039	56346608	8000	56346039	-4000	4000	569
chr11	124037325	124045325	124038748	8000	124041325	-4000	4000	-2577
chr11	133528501	133536501	133532324	8000	133532501	-4000	4000	-177
chr11	48212810	48220810	48217184	8000	48216810	-4000	4000	374
chr11	55815630	55823630	55819891	8000	55819630	-4000	4000	261
chr11	55834752	55842752	55839691	8000	55838752	-4000	4000	939
chr11	44043981	44051981	44048377	8000	44047981	-4000	4000	396
chr11	56230255	56238255	56232289	8000	56234255	-4000	4000	-1966
chr11	68976986	68984986	68980619	8000	68980986	-4000	4000	-367
chr11	5196682	5204682	5199983	8000	5200682	-4000	4000	-699
chr11	95021258	95029258	95025810	8000	95025258	-4000	4000	552
chr11	49978535	49986535	49981921	8000	49982535	-4000	4000	-614
chr11	5576877	5584877	5581820	8000	5580877	-4000	4000	943
chr11	48302223	48310223	48307120	8000	48306223	-4000	4000	897
chr11	62980967	62988967	62982010	8000	62984967	-4000	4000	-2957
chr11	3638316	3646316	3640101	8000	3642316	-4000	4000	-2215
chr11	4920339	4928339	4923680	8000	4924339	-4000	4000	-659
chr11	122112215	122120215	122116144	8000	122116215	-4000	4000	-71
chr11	47582678	47590678	47586802	8000	47586678	-4000	4000	124
chr11	48212810	48220810	48217350	8000	48216810	-4000	4000	540
chr11	63365785	63373785	63371174	8000	63369785	-4000	4000	1389
chr11	48259861	48267861	48264548	8000	48263861	-4000	4000	687
chr11	56638439	56646439	56641641	8000	56642439	-4000	4000	-798
chr11	56371624	56379624	56376244	8000	56375624	-4000	4000	620
chr11	64296358	64304358	64297154	8000	64300358	-4000	4000	-3204
chr11	49948391	49956391	49952785	8000	49952391	-4000	4000	394
chr11	55769438	55777438	55773496	8000	55773438	-4000	4000	58
chr11	58200142	58208142	58204107	8000	58204142	-4000	4000	-35
chr11	3641128	3649128	3641902	8000	3645128	-4000	4000	-3226
chr11	55644327	55652327	55651098	8000	55648327	-4000	4000	2771
chr11	47348702	47356702	47351464	8000	47352702	-4000	4000	-1238
chr11	54702832	54710832	54707243	8000	54706832	-4000	4000	411
chr11	56539257	56547257	56542768	8000	56543257	-4000	4000	-489
chr11	123935617	123943617	123943447	8000	123939617	-4000	4000	3830
chr11	66971277	66979277	66975379	8000	66975277	-4000	4000	102
chr11	54702832	54710832	54707609	8000	54706832	-4000	4000	777
chr11	55823219	55831219	55827449	8000	55827219	-4000	4000	230
chr11	18168837	18176837	18173675	8000	18172837	-4000	4000	838
chr11	113971075	113979075	113977549	8000	113975075	-4000	4000	2474
chr11	4445295	4453295	4450089	8000	4449295	-4000	4000	794
chr11	48259861	48267861	48264541	8000	48263861	-4000	4000	680
chr11	6872625	6880625	6876971	8000	6876625	-4000	4000	346
chr11	4943605	4951605	4946193	8000	4947605	-4000	4000	-1412
chr11	7937708	7945708	7939078	8000	7941708	-4000	4000	-2630
chr11	123939838	123947838	123943704	8000	123943838	-4000	4000	-134
chr11	7937708	7945708	7938717	8000	7941708	-4000	4000	-2991
chr11	5042526	5050526	5047210	8000	5046526	-4000	4000	684
chr11	5042526	5050526	5046927	8000	5046526	-4000	4000	401
chr11	123802349	123810349	123806030	8000	123806349	-4000	4000	-319
chr11	124008997	124016997	124016111	8000	124012997	-4000	4000	3114
chr11	123935617	123943617	123943189	8000	123939617	-4000	4000	3572
chr11	6166326	6174326	6169486	8000	6170326	-4000	4000	-840
chr11	6917002	6925002	6921851	8000	6921002	-4000	4000	849
chr11	55791556	55799556	55795626	8000	55795556	-4000	4000	70
chr11	48320920	48328920	48325119	8000	48324920	-4000	4000	199
chr11	55769438	55777438	55774120	8000	55773438	-4000	4000	682
chr11	56695095	56703095	56701040	8000	56699095	-4000	4000	1945
chr11	1625775	1633775	1630700	8000	1629775	-4000	4000	925
chr11	123750518	123758518	123753610	8000	123754518	-4000	4000	-908
chr11	114674527	114682527	114678500	8000	114678527	-4000	4000	-27
chr11	56311144	56319144	56318651	8000	56315144	-4000	4000	3507
chr11	4445295	4453295	4449822	8000	4449295	-4000	4000	527
chr11	7927268	7935268	7927822	8000	7931268	-4000	4000	-3446
chr11	54702832	54710832	54707196	8000	54706832	-4000	4000	364
chr11	124607428	124615428	124611642	8000	124611428	-4000	4000	214
chr11	56311144	56319144	56318338	8000	56315144	-4000	4000	3194
chr11	4915350	4923350	4915410	8000	4919350	-4000	4000	-3940
chr11	4951713	4959713	4955421	8000	4955713	-4000	4000	-292
chr11	55658201	55666201	55665847	8000	55662201	-4000	4000	3646
chr11	55791556	55799556	55795974	8000	55795556	-4000	4000	418
chr11	55834752	55842752	55838927	8000	55838752	-4000	4000	175
chr11	56610874	56618874	56612569	8000	56614874	-4000	4000	-2305
chr11	58200142	58208142	58204017	8000	58204142	-4000	4000	-125
chr11	66022479	66030479	66026197	8000	66026479	-4000	4000	-282
chr11	124022798	124030798	124030336	8000	124026798	-4000	4000	3538
chr11	7792942	7800942	7796894	8000	7796942	-4000	4000	-48
chr11	56539257	56547257	56543239	8000	56543257	-4000	4000	-18
chr11	56695095	56703095	56701301	8000	56699095	-4000	4000	2206
chr11	18408318	18416318	18412733	8000	18412318	-4000	4000	415
chr11	104032640	104040640	104037193	8000	104036640	-4000	4000	553
chr11	30227014	30235014	30233848	8000	30231014	-4000	4000	2834
chr11	44043981	44051981	44048078	8000	44047981	-4000	4000	97
chr11	55807367	55815367	55811748	8000	55811367	-4000	4000	381
chr11	123750518	123758518	123754207	8000	123754518	-4000	4000	-311
chr11	89173875	89181875	89178315	8000	89177875	-4000	4000	440
chr11	55807367	55815367	55812023	8000	55811367	-4000	4000	656
chr11	6872625	6880625	6876858	8000	6876625	-4000	4000	233
chr12	4375712	4383712	4379517	8000	4379712	-4000	4000	-195
chr12	47721567	47729567	47725397	8000	47725567	-4000	4000	-170
chr12	52549145	52557145	52550104	8000	52553145	-4000	4000	-3041
chr12	48468559	48476559	48472889	8000	48472559	-4000	4000	330
chr12	53099486	53107486	53100845	8000	53103486	-4000	4000	-2641
chr12	52648211	52656211	52648272	8000	52652211	-4000	4000	-3939
chr12	53099486	53107486	53102213	8000	53103486	-4000	4000	-1273
chr12	100353074	100361074	100357367	8000	100357074	-4000	4000	293
chr12	56358857	56366857	56362022	8000	56362857	-4000	4000	-835
chr12	56358857	56366857	56362761	8000	56362857	-4000	4000	-96
chr12	7707433	7715433	7715401	8000	7711433	-4000	4000	3968
chr12	52648211	52656211	52649924	8000	52652211	-4000	4000	-2287
chr12	52792117	52800117	52796013	8000	52796117	-4000	4000	-104
chr12	85276220	85284220	85280367	8000	85280220	-4000	4000	147
chr12	43548203	43556203	43551079	8000	43552203	-4000	4000	-1124
chr12	52845092	52853092	52846229	8000	52849092	-4000	4000	-2863
chr12	53099486	53107486	53105212	8000	53103486	-4000	4000	1726
chr12	68155740	68163740	68157955	8000	68159740	-4000	4000	-1785
chr12	27078578	27086578	27082315	8000	27082578	-4000	4000	-263
chr12	56990492	56998492	56996576	8000	56994492	-4000	4000	2084
chr12	55292569	55300569	55295074	8000	55296569	-4000	4000	-1495
chr12	4905905	4913905	4911560	8000	4909905	-4000	4000	1655
chr12	11265707	11273707	11267965	8000	11269707	-4000	4000	-1742
chr12	4905905	4913905	4912192	8000	4909905	-4000	4000	2287
chr12	56358857	56366857	56361737	8000	56362857	-4000	4000	-1120
chr12	55396529	55404529	55400743	8000	55400529	-4000	4000	214
chr12	5039879	5047879	5045015	8000	5043879	-4000	4000	1136
chr12	18734100	18742100	18737397	8000	18738100	-4000	4000	-703
chr12	49090801	49098801	49097705	8000	49094801	-4000	4000	2904
chr12	4441815	4449815	4445387	8000	4445815	-4000	4000	-428
chr12	5039879	5047879	5044749	8000	5043879	-4000	4000	870
chr12	11265707	11273707	11267651	8000	11269707	-4000	4000	-2056
chr12	21522296	21530296	21529064	8000	21526296	-4000	4000	2768
chr12	55422254	55430254	55427034	8000	55426254	-4000	4000	780
chr12	10006627	10014627	10012878	8000	10010627	-4000	4000	2251
chr12	48199292	48207292	48203122	8000	48203292	-4000	4000	-170
chr12	52792117	52800117	52795753	8000	52796117	-4000	4000	-364
chr12	55217025	55225025	55221363	8000	55221025	-4000	4000	338
chr12	56990492	56998492	56995628	8000	56994492	-4000	4000	1136
chr12	4441815	4449815	4445383	8000	4445815	-4000	4000	-432
chr12	52381652	52389652	52385206	8000	52385652	-4000	4000	-446
chr12	52549145	52557145	52550085	8000	52553145	-4000	4000	-3060
chr12	90951176	90959176	90953682	8000	90955176	-4000	4000	-1494
chr12	10432001	10440001	10435844	8000	10436001	-4000	4000	-157
chr12	4905905	4913905	4911583	8000	4909905	-4000	4000	1678
chr12	11265707	11273707	11267240	8000	11269707	-4000	4000	-2467
chr12	52648211	52656211	52648309	8000	52652211	-4000	4000	-3902
chr12	14692599	14700599	14696279	8000	14696599	-4000	4000	-320
chr12	12948147	12956147	12950040	8000	12952147	-4000	4000	-2107
chr12	100263079	100271079	100263825	8000	100267079	-4000	4000	-3254
chr12	10925236	10933236	10929247	8000	10929236	-4000	4000	11
chr12	4905905	4913905	4910017	8000	4909905	-4000	4000	112
chr12	110497655	110505655	110502052	8000	110501655	-4000	4000	397
chr12	11182937	11190937	11186106	8000	11186937	-4000	4000	-831
chr12	4905905	4913905	4912153	8000	4909905	-4000	4000	2248
chr12	55326043	55334043	55332208	8000	55330043	-4000	4000	2165
chr12	95992365	96000365	95995853	8000	95996365	-4000	4000	-512
chr12	4905905	4913905	4912424	8000	4909905	-4000	4000	2519
chr12	55240609	55248609	55248107	8000	55244609	-4000	4000	3498
chr12	52792117	52800117	52795612	8000	52796117	-4000	4000	-505
chr12	95992365	96000365	95995894	8000	95996365	-4000	4000	-471
chr12	52569843	52577843	52573345	8000	52573843	-4000	4000	-498
chr12	55326043	55334043	55332567	8000	55330043	-4000	4000	2524
chr12	21522296	21530296	21526909	8000	21526296	-4000	4000	613
chr12	52549145	52557145	52550085	8000	52553145	-4000	4000	-3060
chr12	21522296	21530296	21526910	8000	21526296	-4000	4000	614
chr12	5039879	5047879	5045402	8000	5043879	-4000	4000	1523
chr12	33435819	33443819	33439459	8000	33439819	-4000	4000	-360
chr12	52597538	52605538	52601216	8000	52601538	-4000	4000	-322
chr12	10450685	10458685	10451136	8000	10454685	-4000	4000	-3549
chr12	51884009	51892009	51888070	8000	51888009	-4000	4000	61
chr12	55122406	55130406	55130270	8000	55126406	-4000	4000	3864
chr12	57448323	57456323	57450066	8000	57452323	-4000	4000	-2257
chr12	118977541	118985541	118981888	8000	118981541	-4000	4000	347
chr12	55632892	55640892	55637537	8000	55636892	-4000	4000	645
chr12	47721567	47729567	47725419	8000	47725567	-4000	4000	-148
chr12	51342679	51350679	51342684	8000	51346679	-4000	4000	-3995
chr12	7783794	7791794	7789599	8000	7787794	-4000	4000	1805
chr12	55217025	55225025	55221316	8000	55221025	-4000	4000	291
chr12	55422254	55430254	55426704	8000	55426254	-4000	4000	450
chr12	122170221	122178221	122172270	8000	122174221	-4000	4000	-1951
chr12	11182937	11190937	11186337	8000	11186937	-4000	4000	-600
chr12	110497655	110505655	110502066	8000	110501655	-4000	4000	411
chr12	57448323	57456323	57455703	8000	57452323	-4000	4000	3380
chr12	69606907	69614907	69610548	8000	69610907	-4000	4000	-359
chr12	10006627	10014627	10010675	8000	10010627	-4000	4000	48
chr12	11306436	11314436	11308532	8000	11310436	-4000	4000	-1904
chr12	52363481	52371481	52367068	8000	52367481	-4000	4000	-413
chr12	48974322	48982322	48980530	8000	48978322	-4000	4000	2208
chr12	52648211	52656211	52650439	8000	52652211	-4000	4000	-1772
chr12	5039879	5047879	5045183	8000	5043879	-4000	4000	1304
chr12	52648211	52656211	52649042	8000	52652211	-4000	4000	-3169
chr12	52381652	52389652	52385263	8000	52385652	-4000	4000	-389
chr12	52773345	52781345	52773618	8000	52777345	-4000	4000	-3727
chr12	27078578	27086578	27082376	8000	27082578	-4000	4000	-202
chr12	113468280	113476280	113468346	8000	113472280	-4000	4000	-3934
chr12	52402335	52410335	52403791	8000	52406335	-4000	4000	-2544
chr12	10798627	10806627	10806567	8000	10802627	-4000	4000	3940
chr12	68155740	68163740	68158233	8000	68159740	-4000	4000	-1507
chr12	80703634	80711634	80708901	8000	80707634	-4000	4000	1267
chr12	57047198	57055198	57047356	8000	57051198	-4000	4000	-3842
chr12	52569843	52577843	52573347	8000	52573843	-4000	4000	-496
chr12	10803286	10811286	10809883	8000	10807286	-4000	4000	2597
chr12	4905905	4913905	4912749	8000	4909905	-4000	4000	2844
chr12	7707433	7715433	7715247	8000	7711433	-4000	4000	3814
chr12	52773345	52781345	52775421	8000	52777345	-4000	4000	-1924
chr12	45047099	45055099	45050554	8000	45051099	-4000	4000	-545
chr12	120323779	120331779	120325944	8000	120327779	-4000	4000	-1835
chr12	4905905	4913905	4911675	8000	4909905	-4000	4000	1770
chr12	10798627	10806627	10806130	8000	10802627	-4000	4000	3503
chr12	122770526	122778526	122777620	8000	122774526	-4000	4000	3094
chr12	29493686	29501686	29497620	8000	29497686	-4000	4000	-66
chr12	56990492	56998492	56995860	8000	56994492	-4000	4000	1368
chr12	4375712	4383712	4379644	8000	4379712	-4000	4000	-68
chr12	10006627	10014627	10013027	8000	10010627	-4000	4000	2400
chr12	55217025	55225025	55221280	8000	55221025	-4000	4000	255
chr12	55422254	55430254	55426990	8000	55426254	-4000	4000	736
chr12	100263079	100271079	100263778	8000	100267079	-4000	4000	-3301
chr12	118977541	118985541	118981956	8000	118981541	-4000	4000	415
chr12	5039879	5047879	5045103	8000	5043879	-4000	4000	1224
chr12	10798627	10806627	10806419	8000	10802627	-4000	4000	3792
chr12	5039879	5047879	5044785	8000	5043879	-4000	4000	906
chr12	51342679	51350679	51346654	8000	51346679	-4000	4000	-25
chr12	50392622	50400622	50396361	8000	50396622	-4000	4000	-261
chr12	51884009	51892009	51891321	8000	51888009	-4000	4000	3312
chr12	55545602	55553602	55551229	8000	55549602	-4000	4000	1627
chr12	90951176	90959176	90954453	8000	90955176	-4000	4000	-723
chr12	53419855	53427855	53425214	8000	53423855	-4000	4000	1359
chr12	55217025	55225025	55221806	8000	55221025	-4000	4000	781
chr12	55396529	55404529	55400783	8000	55400529	-4000	4000	254
chr12	53099486	53107486	53101151	8000	53103486	-4000	4000	-2335
chr12	52648211	52656211	52651796	8000	52652211	-4000	4000	-415
chr12	55217025	55225025	55221042	8000	55221025	-4000	4000	17
chr12	4905905	4913905	4911941	8000	4909905	-4000	4000	2036
chr12	52363481	52371481	52367103	8000	52367481	-4000	4000	-378
chr12	27078578	27086578	27081090	8000	27082578	-4000	4000	-1488
chr12	48967735	48975735	48968284	8000	48971735	-4000	4000	-3451
chr12	258873	266873	259958	8000	262873	-4000	4000	-2915
chr12	95992365	96000365	95994982	8000	95996365	-4000	4000	-1383
chr12	55466138	55474138	55469523	8000	55470138	-4000	4000	-615
chr12	119589774	119597774	119593915	8000	119593774	-4000	4000	141
chr12	47721567	47729567	47725386	8000	47725567	-4000	4000	-181
chr12	10925236	10933236	10930676	8000	10929236	-4000	4000	1440
chr12	10925236	10933236	10930750	8000	10929236	-4000	4000	1514
chr12	10803286	10811286	10809354	8000	10807286	-4000	4000	2068
chr12	90951176	90959176	90953599	8000	90955176	-4000	4000	-1577
chr12	29493686	29501686	29496592	8000	29497686	-4000	4000	-1094
chr12	55422254	55430254	55426358	8000	55426254	-4000	4000	104
chr12	55240609	55248609	55248121	8000	55244609	-4000	4000	3512
chr12	49090801	49098801	49091241	8000	49094801	-4000	4000	-3560
chr12	11351591	11359591	11353291	8000	11355591	-4000	4000	-2300
chr12	48324980	48332980	48329513	8000	48328980	-4000	4000	533
chr12	9823481	9831481	9827532	8000	9827481	-4000	4000	51
chr12	52569843	52577843	52569957	8000	52573843	-4000	4000	-3886
chr12	4905905	4913905	4913022	8000	4909905	-4000	4000	3117
chr12	49090801	49098801	49097694	8000	49094801	-4000	4000	2893
chr12	80703634	80711634	80708593	8000	80707634	-4000	4000	959
chr12	100263079	100271079	100263620	8000	100267079	-4000	4000	-3459
chr12	80703634	80711634	80707790	8000	80707634	-4000	4000	156
chr12	119589774	119597774	119594035	8000	119593774	-4000	4000	261
chr12	7707433	7715433	7715203	8000	7711433	-4000	4000	3770
chr12	5039879	5047879	5044481	8000	5043879	-4000	4000	602
chr12	55422254	55430254	55426892	8000	55426254	-4000	4000	638
chr12	80703634	80711634	80708105	8000	80707634	-4000	4000	471
chr12	99643753	99651753	99648374	8000	99647753	-4000	4000	621
chr12	53419855	53427855	53425784	8000	53423855	-4000	4000	1929
chr12	52402335	52410335	52405880	8000	52406335	-4000	4000	-455
chr12	52363481	52371481	52367240	8000	52367481	-4000	4000	-241
chr12	10006627	10014627	10012900	8000	10010627	-4000	4000	2273
chr12	11351591	11359591	11354555	8000	11355591	-4000	4000	-1036
chr12	12948147	12956147	12949599	8000	12952147	-4000	4000	-2548
chr12	49601639	49609639	49604519	8000	49605639	-4000	4000	-1120
chr12	52569843	52577843	52573360	8000	52573843	-4000	4000	-483
chr12	53099486	53107486	53105600	8000	53103486	-4000	4000	2114
chr12	55240609	55248609	55247496	8000	55244609	-4000	4000	2887
chr12	55632892	55640892	55637590	8000	55636892	-4000	4000	698
chr12	100263079	100271079	100263507	8000	100267079	-4000	4000	-3572
chr12	110497655	110505655	110502304	8000	110501655	-4000	4000	649
chr12	14692599	14700599	14696496	8000	14696599	-4000	4000	-103
chr12	4441815	4449815	4445265	8000	4445815	-4000	4000	-550
chr12	4905905	4913905	4912055	8000	4909905	-4000	4000	2150
chr12	11306436	11314436	11309372	8000	11310436	-4000	4000	-1064
chr12	80703634	80711634	80707714	8000	80707634	-4000	4000	80
chr12	80703634	80711634	80708031	8000	80707634	-4000	4000	397
chr12	5039879	5047879	5045911	8000	5043879	-4000	4000	2032
chr12	52363481	52371481	52367049	8000	52367481	-4000	4000	-432
chr12	52597538	52605538	52598947	8000	52601538	-4000	4000	-2591
chr12	4905905	4913905	4911625	8000	4909905	-4000	4000	1720
chr12	4905905	4913905	4912750	8000	4909905	-4000	4000	2845
chr12	5039879	5047879	5044663	8000	5043879	-4000	4000	784
chr12	5039879	5047879	5045281	8000	5043879	-4000	4000	1402
chr12	11351591	11359591	11354555	8000	11355591	-4000	4000	-1036
chr12	18734100	18742100	18738433	8000	18738100	-4000	4000	333
chr12	21522296	21530296	21526419	8000	21526296	-4000	4000	123
chr12	27078578	27086578	27082447	8000	27082578	-4000	4000	-131
chr12	48199292	48207292	48202813	8000	48203292	-4000	4000	-479
chr12	52614559	52622559	52616191	8000	52618559	-4000	4000	-2368
chr12	52792117	52800117	52796057	8000	52796117	-4000	4000	-60
chr12	55240609	55248609	55247459	8000	55244609	-4000	4000	2850
chr12	55326043	55334043	55332392	8000	55330043	-4000	4000	2349
chr12	55396529	55404529	55401283	8000	55400529	-4000	4000	754
chr12	55466138	55474138	55469646	8000	55470138	-4000	4000	-492
chr12	55488378	55496378	55492735	8000	55492378	-4000	4000	357
chr12	80703634	80711634	80708581	8000	80707634	-4000	4000	947
chr12	80712912	80720912	80717437	8000	80716912	-4000	4000	525
chr12	110497655	110505655	110503855	8000	110501655	-4000	4000	2200
chr12	51342679	51350679	51343807	8000	51346679	-4000	4000	-2872
chr12	56358857	56366857	56361413	8000	56362857	-4000	4000	-1444
chr12	80712912	80720912	80717347	8000	80716912	-4000	4000	435
chr12	53419855	53427855	53423934	8000	53423855	-4000	4000	79
chr12	4905905	4913905	4911646	8000	4909905	-4000	4000	1741
chr12	90951176	90959176	90953505	8000	90955176	-4000	4000	-1671
chr12	51884009	51892009	51891146	8000	51888009	-4000	4000	3137
chr12	110497655	110505655	110502189	8000	110501655	-4000	4000	534
chr12	14692599	14700599	14696512	8000	14696599	-4000	4000	-87
chr12	55326043	55334043	55332158	8000	55330043	-4000	4000	2115
chr12	55632892	55640892	55637267	8000	55636892	-4000	4000	375
chr12	69695476	69703476	69697802	8000	69699476	-4000	4000	-1674
chr12	48199292	48207292	48202960	8000	48203292	-4000	4000	-332
chr12	113468280	113476280	113471399	8000	113472280	-4000	4000	-881
chr12	68221810	68229810	68225737	8000	68225810	-4000	4000	-73
chr12	56358857	56366857	56361306	8000	56362857	-4000	4000	-1551
chr12	27078578	27086578	27081228	8000	27082578	-4000	4000	-1350
chr12	55292569	55300569	55294770	8000	55296569	-4000	4000	-1799
chr12	52381652	52389652	52385492	8000	52385652	-4000	4000	-160
chr12	5039879	5047879	5044793	8000	5043879	-4000	4000	914
chr12	48468559	48476559	48472708	8000	48472559	-4000	4000	149
chr12	51884009	51892009	51889284	8000	51888009	-4000	4000	1275
chr12	51884009	51892009	51891076	8000	51888009	-4000	4000	3067
chr12	113468280	113476280	113469243	8000	113472280	-4000	4000	-3037
chr12	10925236	10933236	10930817	8000	10929236	-4000	4000	1581
chr12	11265707	11273707	11268134	8000	11269707	-4000	4000	-1573
chr12	48468559	48476559	48472991	8000	48472559	-4000	4000	432
chr12	55396529	55404529	55401110	8000	55400529	-4000	4000	581
chr12	11306436	11314436	11308474	8000	11310436	-4000	4000	-1962
chr12	52648211	52656211	52651822	8000	52652211	-4000	4000	-389
chr12	10450685	10458685	10450970	8000	10454685	-4000	4000	-3715
chr12	55292569	55300569	55294899	8000	55296569	-4000	4000	-1670
chr12	49601639	49609639	49605321	8000	49605639	-4000	4000	-318
chr12	99643753	99651753	99649742	8000	99647753	-4000	4000	1989
chr12	27692447	27700447	27697199	8000	27696447	-4000	4000	752
chr12	53099486	53107486	53100741	8000	53103486	-4000	4000	-2745
chr12	8451962	8459962	8456048	8000	8455962	-4000	4000	86
chr12	80712912	80720912	80717275	8000	80716912	-4000	4000	363
chr12	68249604	68257604	68253441	8000	68253604	-4000	4000	-163
chr12	5039879	5047879	5045842	8000	5043879	-4000	4000	1963
chr12	119330712	119338712	119335152	8000	119334712	-4000	4000	440
chr12	4905905	4913905	4911463	8000	4909905	-4000	4000	1558
chr12	4441815	4449815	4444216	8000	4445815	-4000	4000	-1599
chr12	258873	266873	259794	8000	262873	-4000	4000	-3079
chr12	55292569	55300569	55295069	8000	55296569	-4000	4000	-1500
chr12	12948147	12956147	12950240	8000	12952147	-4000	4000	-1907
chr12	27078578	27086578	27082133	8000	27082578	-4000	4000	-445
chr12	101471336	101479336	101477614	8000	101475336	-4000	4000	2278
chr12	55240609	55248609	55248121	8000	55244609	-4000	4000	3512
chr13	19177824	19185824	19178253	8000	19181824	-4000	4000	-3571
chr13	27965315	27973315	27968730	8000	27969315	-4000	4000	-585
chr13	112063149	112071149	112071036	8000	112067149	-4000	4000	3887
chr13	112063149	112071149	112069171	8000	112067149	-4000	4000	2022
chr13	25168288	25176288	25169879	8000	25172288	-4000	4000	-2409
chr13	113663219	113671219	113667801	8000	113667219	-4000	4000	582
chr13	78599552	78607552	78601589	8000	78603552	-4000	4000	-1963
chr13	113154648	113162648	113160141	8000	113158648	-4000	4000	1493
chr13	27788483	27796483	27793679	8000	27792483	-4000	4000	1196
chr13	52735820	52743820	52739746	8000	52739820	-4000	4000	-74
chr13	32311363	32319363	32311787	8000	32315363	-4000	4000	-3576
chr13	51857969	51865969	51865457	8000	51861969	-4000	4000	3488
chr13	94708545	94716545	94712100	8000	94712545	-4000	4000	-445
chr13	113663219	113671219	113667442	8000	113667219	-4000	4000	223
chr13	51857969	51865969	51865374	8000	51861969	-4000	4000	3405
chr13	98173269	98181269	98176310	8000	98177269	-4000	4000	-959
chr13	112372355	112380355	112376417	8000	112376355	-4000	4000	62
chr13	52844641	52852641	52844790	8000	52848641	-4000	4000	-3851
chr13	25168288	25176288	25169811	8000	25172288	-4000	4000	-2477
chr13	49216338	49224338	49222269	8000	49220338	-4000	4000	1931
chr13	19177824	19185824	19178311	8000	19181824	-4000	4000	-3513
chr13	94708545	94716545	94711145	8000	94712545	-4000	4000	-1400
chr13	49216338	49224338	49222313	8000	49220338	-4000	4000	1975
chr13	94475682	94483682	94479222	8000	94479682	-4000	4000	-460
chr13	113663219	113671219	113667693	8000	113667219	-4000	4000	474
chr13	113663219	113671219	113667442	8000	113667219	-4000	4000	223
chr13	113654198	113662198	113654938	8000	113658198	-4000	4000	-3260
chr13	113654198	113662198	113658129	8000	113658198	-4000	4000	-69
chr13	46893076	46901076	46895660	8000	46897076	-4000	4000	-1416
chr13	113663219	113671219	113669744	8000	113667219	-4000	4000	2525
chr13	19177824	19185824	19178328	8000	19181824	-4000	4000	-3496
chr13	49216338	49224338	49222125	8000	49220338	-4000	4000	1787
chr13	27984693	27992693	27988524	8000	27988693	-4000	4000	-169
chr13	78599552	78607552	78599562	8000	78603552	-4000	4000	-3990
chr13	25168288	25176288	25169708	8000	25172288	-4000	4000	-2580
chr13	113663219	113671219	113667538	8000	113667219	-4000	4000	319
chr13	103062417	103070417	103066188	8000	103066417	-4000	4000	-229
chr13	24760169	24768169	24767271	8000	24764169	-4000	4000	3102
chr13	27788483	27796483	27793836	8000	27792483	-4000	4000	1353
chr13	27916000	27924000	27920542	8000	27920000	-4000	4000	542
chr13	98173269	98181269	98176701	8000	98177269	-4000	4000	-568
chr13	98173269	98181269	98176420	8000	98177269	-4000	4000	-849
chr13	98173269	98181269	98176341	8000	98177269	-4000	4000	-928
chr13	113663219	113671219	113669759	8000	113667219	-4000	4000	2540
chr13	27984693	27992693	27988607	8000	27988693	-4000	4000	-86
chr13	113663219	113671219	113667552	8000	113667219	-4000	4000	333
chr14	20056045	20064045	20060141	8000	20060045	-4000	4000	96
chr14	20637691	20645691	20641364	8000	20641691	-4000	4000	-327
chr14	60505146	60513146	60509696	8000	60509146	-4000	4000	550
chr14	20056045	20064045	20060488	8000	20060045	-4000	4000	443
chr14	19971591	19979591	19976493	8000	19975591	-4000	4000	902
chr14	19916607	19924607	19921446	8000	19920607	-4000	4000	839
chr14	24504265	24512265	24506193	8000	24508265	-4000	4000	-2072
chr14	56812693	56820693	56813387	8000	56816693	-4000	4000	-3306
chr14	77138734	77146734	77139434	8000	77142734	-4000	4000	-3300
chr14	44503283	44511283	44505860	8000	44507283	-4000	4000	-1423
chr14	20219710	20227710	20223866	8000	20223710	-4000	4000	156
chr14	19916607	19924607	19921356	8000	19920607	-4000	4000	749
chr14	35530164	35538164	35534439	8000	35534164	-4000	4000	275
chr14	63314935	63322935	63317800	8000	63318935	-4000	4000	-1135
chr14	18963434	18971434	18967694	8000	18967434	-4000	4000	260
chr14	20741887	20749887	20747895	8000	20745887	-4000	4000	2008
chr14	21155060	21163060	21155553	8000	21159060	-4000	4000	-3507
chr14	28762787	28770787	28767915	8000	28766787	-4000	4000	1128
chr14	28762787	28770787	28768422	8000	28766787	-4000	4000	1635
chr14	23038212	23046212	23042784	8000	23042212	-4000	4000	572
chr14	23115255	23123255	23117587	8000	23119255	-4000	4000	-1668
chr14	24126659	24134659	24132232	8000	24130659	-4000	4000	1573
chr14	28762787	28770787	28767377	8000	28766787	-4000	4000	590
chr14	60505146	60513146	60509601	8000	60509146	-4000	4000	455
chr14	19871142	19879142	19876786	8000	19875142	-4000	4000	1644
chr14	20235286	20243286	20242951	8000	20239286	-4000	4000	3665
chr14	21630940	21638940	21634714	8000	21634940	-4000	4000	-226
chr14	44503283	44511283	44504645	8000	44507283	-4000	4000	-2638
chr14	23038212	23046212	23043370	8000	23042212	-4000	4000	1158
chr14	20032038	20040038	20033962	8000	20036038	-4000	4000	-2076
chr14	19871142	19879142	19876321	8000	19875142	-4000	4000	1179
chr14	23038212	23046212	23042576	8000	23042212	-4000	4000	364
chr14	23404273	23412273	23405769	8000	23408273	-4000	4000	-2504
chr14	92318581	92326581	92325949	8000	92322581	-4000	4000	3368
chr14	60505146	60513146	60509899	8000	60509146	-4000	4000	753
chr14	23038212	23046212	23042911	8000	23042212	-4000	4000	699
chr14	35530164	35538164	35534413	8000	35534164	-4000	4000	249
chr14	19871142	19879142	19876865	8000	19875142	-4000	4000	1723
chr14	20741887	20749887	20747672	8000	20745887	-4000	4000	1785
chr14	70413107	70421107	70417023	8000	70417107	-4000	4000	-84
chr14	24066837	24074837	24068796	8000	24070837	-4000	4000	-2041
chr14	19916607	19924607	19920797	8000	19920607	-4000	4000	190
chr14	35530164	35538164	35536334	8000	35534164	-4000	4000	2170
chr14	20637691	20645691	20641517	8000	20641691	-4000	4000	-174
chr14	20056045	20064045	20060306	8000	20060045	-4000	4000	261
chr14	69570871	69578871	69571105	8000	69574871	-4000	4000	-3766
chr14	20887385	20895385	20891996	8000	20891385	-4000	4000	611
chr14	21630940	21638940	21634760	8000	21634940	-4000	4000	-180
chr14	20637691	20645691	20641191	8000	20641691	-4000	4000	-500
chr14	20741887	20749887	20747926	8000	20745887	-4000	4000	2039
chr14	44503283	44511283	44505922	8000	44507283	-4000	4000	-1361
chr14	23404273	23412273	23405645	8000	23408273	-4000	4000	-2628
chr14	94289268	94297268	94290510	8000	94293268	-4000	4000	-2758
chr14	44503283	44511283	44507044	8000	44507283	-4000	4000	-239
chr14	20995255	21003255	20996956	8000	20999255	-4000	4000	-2299
chr14	23038212	23046212	23042784	8000	23042212	-4000	4000	572
chr14	19871142	19879142	19876655	8000	19875142	-4000	4000	1513
chr14	20219710	20227710	20224337	8000	20223710	-4000	4000	627
chr14	20637691	20645691	20641458	8000	20641691	-4000	4000	-233
chr14	77419523	77427523	77422914	8000	77423523	-4000	4000	-609
chr14	46647781	46655781	46651777	8000	46651781	-4000	4000	-4
chr14	24066837	24074837	24073529	8000	24070837	-4000	4000	2692
chr14	19871142	19879142	19876315	8000	19875142	-4000	4000	1173
chr14	20637691	20645691	20641289	8000	20641691	-4000	4000	-402
chr14	77267206	77275206	77269314	8000	77271206	-4000	4000	-1892
chr14	38203904	38211904	38210142	8000	38207904	-4000	4000	2238
chr14	76822372	76830372	76828620	8000	76826372	-4000	4000	2248
chr14	23372773	23380773	23378847	8000	23376773	-4000	4000	2074
chr14	18597117	18605117	18601450	8000	18601117	-4000	4000	333
chr14	20056045	20064045	20060944	8000	20060045	-4000	4000	899
chr14	20235286	20243286	20242810	8000	20239286	-4000	4000	3524
chr14	28762787	28770787	28768935	8000	28766787	-4000	4000	2148
chr14	52263698	52271698	52268426	8000	52267698	-4000	4000	728
chr14	20637691	20645691	20641664	8000	20641691	-4000	4000	-27
chr14	21038316	21046316	21043363	8000	21042316	-4000	4000	1047
chr14	21038316	21046316	21043508	8000	21042316	-4000	4000	1192
chr14	60505146	60513146	60511261	8000	60509146	-4000	4000	2115
chr14	52263698	52271698	52267946	8000	52267698	-4000	4000	248
chr14	18597117	18605117	18601251	8000	18601117	-4000	4000	134
chr14	20219710	20227710	20223765	8000	20223710	-4000	4000	55
chr14	21053822	21061822	21058352	8000	21057822	-4000	4000	530
chr14	24504265	24512265	24508206	8000	24508265	-4000	4000	-59
chr14	23372773	23380773	23377321	8000	23376773	-4000	4000	548
chr14	21038316	21046316	21043172	8000	21042316	-4000	4000	856
chr14	20056045	20064045	20060336	8000	20060045	-4000	4000	291
chr14	46647781	46655781	46651589	8000	46651781	-4000	4000	-192
chr14	44503283	44511283	44506854	8000	44507283	-4000	4000	-429
chr14	20741887	20749887	20747946	8000	20745887	-4000	4000	2059
chr14	21630940	21638940	21634075	8000	21634940	-4000	4000	-865
chr14	44503283	44511283	44505523	8000	44507283	-4000	4000	-1760
chr14	46647781	46655781	46651765	8000	46651781	-4000	4000	-16
chr14	56812693	56820693	56813406	8000	56816693	-4000	4000	-3287
chr14	23038212	23046212	23043410	8000	23042212	-4000	4000	1198
chr14	19971591	19979591	19975887	8000	19975591	-4000	4000	296
chr14	20741887	20749887	20747955	8000	20745887	-4000	4000	2068
chr14	20637691	20645691	20641247	8000	20641691	-4000	4000	-444
chr14	21020109	21028109	21022396	8000	21024109	-4000	4000	-1713
chr14	21630940	21638940	21634815	8000	21634940	-4000	4000	-125
chr14	23372773	23380773	23373364	8000	23376773	-4000	4000	-3409
chr14	28762787	28770787	28768605	8000	28766787	-4000	4000	1818
chr14	92318581	92326581	92325865	8000	92322581	-4000	4000	3284
chr14	100319339	100327339	100326130	8000	100323339	-4000	4000	2791
chr14	19971591	19979591	19975687	8000	19975591	-4000	4000	96
chr14	28762787	28770787	28767843	8000	28766787	-4000	4000	1056
chr14	24066837	24074837	24069155	8000	24070837	-4000	4000	-1682
chr14	19871142	19879142	19876801	8000	19875142	-4000	4000	1659
chr14	19971591	19979591	19975814	8000	19975591	-4000	4000	223
chr14	20887385	20895385	20891984	8000	20891385	-4000	4000	599
chr14	20995255	21003255	21000980	8000	20999255	-4000	4000	1725
chr14	21038316	21046316	21043265	8000	21042316	-4000	4000	949
chr14	23372773	23380773	23373324	8000	23376773	-4000	4000	-3449
chr14	23372773	23380773	23377248	8000	23376773	-4000	4000	475
chr14	23372773	23380773	23378472	8000	23376773	-4000	4000	1699
chr14	44503283	44511283	44507143	8000	44507283	-4000	4000	-140
chr14	60505146	60513146	60509694	8000	60509146	-4000	4000	548
chr14	77138734	77146734	77139220	8000	77142734	-4000	4000	-3514
chr14	44503283	44511283	44504660	8000	44507283	-4000	4000	-2623
chr14	57489867	57497867	57493515	8000	57493867	-4000	4000	-352
chr14	100319339	100327339	100323340	8000	100323339	-4000	4000	1
chr14	20637691	20645691	20641584	8000	20641691	-4000	4000	-107
chr14	20995255	21003255	20997002	8000	20999255	-4000	4000	-2253
chr14	19871142	19879142	19877080	8000	19875142	-4000	4000	1938
chr14	19916607	19924607	19921343	8000	19920607	-4000	4000	736
chr14	18597117	18605117	18601450	8000	18601117	-4000	4000	333
chr14	20951487	20959487	20955916	8000	20955487	-4000	4000	429
chr14	23404273	23412273	23404730	8000	23408273	-4000	4000	-3543
chr14	18963434	18971434	18967782	8000	18967434	-4000	4000	348
chr14	19430341	19438341	19433993	8000	19434341	-4000	4000	-348
chr14	20032038	20040038	20034314	8000	20036038	-4000	4000	-1724
chr14	23372773	23380773	23379338	8000	23376773	-4000	4000	2565
chr14	77138734	77146734	77139418	8000	77142734	-4000	4000	-3316
chr14	44503283	44511283	44506129	8000	44507283	-4000	4000	-1154
chr14	20741887	20749887	20748007	8000	20745887	-4000	4000	2120
chr14	21630940	21638940	21634150	8000	21634940	-4000	4000	-790
chr14	69570871	69578871	69571051	8000	69574871	-4000	4000	-3820
chr14	20995255	21003255	20996796	8000	20999255	-4000	4000	-2459
chr14	23372773	23380773	23375734	8000	23376773	-4000	4000	-1039
chr14	20887385	20895385	20891698	8000	20891385	-4000	4000	313
chr14	18597117	18605117	18601924	8000	18601117	-4000	4000	807
chr14	52263698	52271698	52268346	8000	52267698	-4000	4000	648
chr14	94289268	94297268	94290467	8000	94293268	-4000	4000	-2801
chr14	23038212	23046212	23042534	8000	23042212	-4000	4000	322
chr14	23038212	23046212	23042846	8000	23042212	-4000	4000	634
chr14	23038212	23046212	23042907	8000	23042212	-4000	4000	695
chr14	21155060	21163060	21155785	8000	21159060	-4000	4000	-3275
chr14	19971591	19979591	19975952	8000	19975591	-4000	4000	361
chr14	88322907	88330907	88326470	8000	88326907	-4000	4000	-437
chr15	23643867	23651867	23645285	8000	23647867	-4000	4000	-2582
chr15	89217614	89225614	89218969	8000	89221614	-4000	4000	-2645
chr15	20537800	20545800	20541765	8000	20541800	-4000	4000	-35
chr15	59202843	59210843	59208187	8000	59206843	-4000	4000	1344
chr15	101799509	101807509	101806277	8000	101803509	-4000	4000	2768
chr15	26862911	26870911	26869289	8000	26866911	-4000	4000	2378
chr15	101919113	101927113	101922720	8000	101923113	-4000	4000	-393
chr15	59202843	59210843	59210533	8000	59206843	-4000	4000	3690
chr15	75720041	75728041	75727391	8000	75724041	-4000	4000	3350
chr15	101799509	101807509	101806094	8000	101803509	-4000	4000	2585
chr15	59202843	59210843	59208187	8000	59206843	-4000	4000	1344
chr15	74822627	74830627	74824362	8000	74826627	-4000	4000	-2265
chr15	23643867	23651867	23644682	8000	23647867	-4000	4000	-3185
chr15	41509887	41517887	41513745	8000	41513887	-4000	4000	-142
chr15	74822627	74830627	74824403	8000	74826627	-4000	4000	-2224
chr15	101799509	101807509	101805780	8000	101803509	-4000	4000	2271
chr15	23643867	23651867	23644347	8000	23647867	-4000	4000	-3520
chr15	74363646	74371646	74367626	8000	74367646	-4000	4000	-20
chr15	21436499	21444499	21440085	8000	21440499	-4000	4000	-414
chr15	24671775	24679775	24677606	8000	24675775	-4000	4000	1831
chr15	34750998	34758998	34752677	8000	34754998	-4000	4000	-2321
chr15	23643867	23651867	23645157	8000	23647867	-4000	4000	-2710
chr15	74744845	74752845	74749889	8000	74748845	-4000	4000	1044
chr15	34750998	34758998	34752694	8000	34754998	-4000	4000	-2304
chr15	41509887	41517887	41512260	8000	41513887	-4000	4000	-1627
chr15	101799509	101807509	101806414	8000	101803509	-4000	4000	2905
chr15	34339315	34347315	34343050	8000	34343315	-4000	4000	-265
chr15	28734384	28742384	28741214	8000	28738384	-4000	4000	2830
chr15	34750998	34758998	34753302	8000	34754998	-4000	4000	-1696
chr15	24671775	24679775	24676954	8000	24675775	-4000	4000	1179
chr15	28844675	28852675	28845909	8000	28848675	-4000	4000	-2766
chr15	24671775	24679775	24677470	8000	24675775	-4000	4000	1695
chr15	76332773	76340773	76338356	8000	76336773	-4000	4000	1583
chr15	74744845	74752845	74749832	8000	74748845	-4000	4000	987
chr15	45110172	45118172	45117745	8000	45114172	-4000	4000	3573
chr15	74822627	74830627	74825579	8000	74826627	-4000	4000	-1048
chr15	74744845	74752845	74750233	8000	74748845	-4000	4000	1388
chr15	23443243	23451243	23443967	8000	23447243	-4000	4000	-3276
chr15	41509887	41517887	41512796	8000	41513887	-4000	4000	-1091
chr15	45110172	45118172	45117824	8000	45114172	-4000	4000	3652
chr15	30548050	30556050	30555977	8000	30552050	-4000	4000	3927
chr15	24671775	24679775	24678942	8000	24675775	-4000	4000	3167
chr15	45110172	45118172	45117871	8000	45114172	-4000	4000	3699
chr15	24671775	24679775	24678748	8000	24675775	-4000	4000	2973
chr15	41509887	41517887	41512260	8000	41513887	-4000	4000	-1627
chr15	24671775	24679775	24675861	8000	24675775	-4000	4000	86
chr15	34339315	34347315	34341875	8000	34343315	-4000	4000	-1440
chr15	45110172	45118172	45117499	8000	45114172	-4000	4000	3327
chr15	74198705	74206705	74202163	8000	74202705	-4000	4000	-542
chr15	23643867	23651867	23645282	8000	23647867	-4000	4000	-2585
chr15	45248234	45256234	45253263	8000	45252234	-4000	4000	1029
chr15	74721536	74729536	74722602	8000	74725536	-4000	4000	-2934
chr15	78617295	78625295	78618856	8000	78621295	-4000	4000	-2439
chr15	74198705	74206705	74202193	8000	74202705	-4000	4000	-512
chr15	24671775	24679775	24677781	8000	24675775	-4000	4000	2006
chr15	26862911	26870911	26869228	8000	26866911	-4000	4000	2317
chr15	45110172	45118172	45117647	8000	45114172	-4000	4000	3475
chr15	76332773	76340773	76336940	8000	76336773	-4000	4000	167
chr15	74744845	74752845	74749738	8000	74748845	-4000	4000	893
chr15	74822627	74830627	74825653	8000	74826627	-4000	4000	-974
chr15	24671775	24679775	24679072	8000	24675775	-4000	4000	3297
chr15	24671775	24679775	24676666	8000	24675775	-4000	4000	891
chr15	101799509	101807509	101806121	8000	101803509	-4000	4000	2612
chr15	52108775	52116775	52109828	8000	52112775	-4000	4000	-2947
chr15	23643867	23651867	23644487	8000	23647867	-4000	4000	-3380
chr15	52787078	52795078	52788834	8000	52791078	-4000	4000	-2244
chr15	84880654	84888654	84887800	8000	84884654	-4000	4000	3146
chr15	74721536	74729536	74723008	8000	74725536	-4000	4000	-2528
chr15	23643867	23651867	23645018	8000	23647867	-4000	4000	-2849
chr15	23643867	23651867	23644848	8000	23647867	-4000	4000	-3019
chr15	52787078	52795078	52789079	8000	52791078	-4000	4000	-1999
chr15	45110172	45118172	45114644	8000	45114172	-4000	4000	472
chr15	78617295	78625295	78624962	8000	78621295	-4000	4000	3667
chr15	59202843	59210843	59206911	8000	59206843	-4000	4000	68
chr15	34750998	34758998	34752760	8000	34754998	-4000	4000	-2238
chr15	24671775	24679775	24676831	8000	24675775	-4000	4000	1056
chr15	74721536	74729536	74722291	8000	74725536	-4000	4000	-3245
chr15	44952687	44960687	44956716	8000	44956687	-4000	4000	29
chr15	23643867	23651867	23645490	8000	23647867	-4000	4000	-2377
chr15	74721536	74729536	74721827	8000	74725536	-4000	4000	-3709
chr16	31389335	31397335	31393321	8000	31393335	-4000	4000	-14
chr16	56585074	56593074	56589959	8000	56589074	-4000	4000	885
chr16	70169322	70177322	70174973	8000	70173322	-4000	4000	1651
chr16	10690930	10698930	10694694	8000	10694930	-4000	4000	-236
chr16	67976549	67984549	67978300	8000	67980549	-4000	4000	-2249
chr16	72059148	72067148	72060281	8000	72063148	-4000	4000	-2867
chr16	27062927	27070927	27067432	8000	27066927	-4000	4000	505
chr16	20352301	20360301	20359371	8000	20356301	-4000	4000	3070
chr16	11269629	11277629	11275721	8000	11273629	-4000	4000	2092
chr16	84236012	84244012	84236912	8000	84240012	-4000	4000	-3100
chr16	21210510	21218510	21211685	8000	21214510	-4000	4000	-2825
chr16	56861207	56869207	56865290	8000	56865207	-4000	4000	83
chr16	84187138	84195138	84194503	8000	84191138	-4000	4000	3365
chr16	84187138	84195138	84194108	8000	84191138	-4000	4000	2970
chr16	90088072	90096072	90095669	8000	90092072	-4000	4000	3597
chr16	11269629	11277629	11274131	8000	11273629	-4000	4000	502
chr16	23751026	23759026	23756167	8000	23755026	-4000	4000	1141
chr16	3491489	3499489	3493937	8000	3495489	-4000	4000	-1552
chr16	4784398	4792398	4785874	8000	4788398	-4000	4000	-2524
chr16	84236012	84244012	84236893	8000	84240012	-4000	4000	-3119
chr16	11277330	11285330	11281027	8000	11281330	-4000	4000	-303
chr16	23709226	23717226	23710991	8000	23713226	-4000	4000	-2235
chr16	11265533	11273533	11267890	8000	11269533	-4000	4000	-1643
chr16	149892	157892	154446	8000	153892	-4000	4000	554
chr16	10690930	10698930	10694614	8000	10694930	-4000	4000	-316
chr16	90088072	90096072	90095988	8000	90092072	-4000	4000	3916
chr16	5235802	5243802	5239841	8000	5239802	-4000	4000	39
chr16	25687959	25695959	25692424	8000	25691959	-4000	4000	465
chr16	67976549	67984549	67977773	8000	67980549	-4000	4000	-2776
chr16	4954330	4962330	4959366	8000	4958330	-4000	4000	1036
chr16	10690930	10698930	10694625	8000	10694930	-4000	4000	-305
chr16	23709226	23717226	23710992	8000	23713226	-4000	4000	-2234
chr16	69946705	69954705	69951349	8000	69950705	-4000	4000	644
chr16	556394	564394	563283	8000	560394	-4000	4000	2889
chr16	56561073	56569073	56567751	8000	56565073	-4000	4000	2678
chr16	25211731	25219731	25217298	8000	25215731	-4000	4000	1567
chr16	70169322	70177322	70174348	8000	70173322	-4000	4000	1026
chr16	11265533	11273533	11273288	8000	11269533	-4000	4000	3755
chr16	556394	564394	563320	8000	560394	-4000	4000	2926
chr16	27062927	27070927	27067199	8000	27066927	-4000	4000	272
chr16	84236012	84244012	84237103	8000	84240012	-4000	4000	-2909
chr16	29774256	29782256	29779634	8000	29778256	-4000	4000	1378
chr16	27062927	27070927	27066982	8000	27066927	-4000	4000	55
chr16	90088072	90096072	90094639	8000	90092072	-4000	4000	2567
chr16	49369804	49377804	49377782	8000	49373804	-4000	4000	3978
chr16	30019198	30027198	30023810	8000	30023198	-4000	4000	612
chr16	84236012	84244012	84237366	8000	84240012	-4000	4000	-2646
chr16	67880885	67888885	67882967	8000	67884885	-4000	4000	-1918
chr16	3252633	3260633	3254386	8000	3256633	-4000	4000	-2247
chr16	3351889	3359889	3356243	8000	3355889	-4000	4000	354
chr16	56647886	56655886	56653138	8000	56651886	-4000	4000	1252
chr16	67880885	67888885	67886101	8000	67884885	-4000	4000	1216
chr16	49277838	49285838	49281235	8000	49281838	-4000	4000	-603
chr16	57972435	57980435	57976457	8000	57976435	-4000	4000	22
chr16	10690930	10698930	10694652	8000	10694930	-4000	4000	-278
chr16	11265533	11273533	11267891	8000	11269533	-4000	4000	-1642
chr16	1484981	1492981	1485985	8000	1488981	-4000	4000	-2996
chr16	66797620	66805620	66802956	8000	66801620	-4000	4000	1336
chr16	90088072	90096072	90095389	8000	90092072	-4000	4000	3317
chr16	30019198	30027198	30023372	8000	30023198	-4000	4000	174
chr16	67880885	67888885	67883297	8000	67884885	-4000	4000	-1588
chr16	23751026	23759026	23757309	8000	23755026	-4000	4000	2283
chr16	556394	564394	564348	8000	560394	-4000	4000	3954
chr16	33841229	33849229	33845074	8000	33845229	-4000	4000	-155
chr16	4552340	4560340	4556737	8000	4556340	-4000	4000	397
chr16	66914917	66922917	66917667	8000	66918917	-4000	4000	-1250
chr16	66914917	66922917	66922316	8000	66918917	-4000	4000	3399
chr16	84187138	84195138	84195054	8000	84191138	-4000	4000	3916
chr16	90088072	90096072	90094611	8000	90092072	-4000	4000	2539
chr16	32248719	32256719	32254641	8000	32252719	-4000	4000	1922
chr16	84236012	84244012	84237421	8000	84240012	-4000	4000	-2591
chr16	67880885	67888885	67884098	8000	67884885	-4000	4000	-787
chr16	31523900	31531900	31528675	8000	31527900	-4000	4000	775
chr16	2794470	2802470	2799456	8000	2798470	-4000	4000	986
chr16	23751026	23759026	23757248	8000	23755026	-4000	4000	2222
chr16	33841229	33849229	33844827	8000	33845229	-4000	4000	-402
chr16	56585074	56593074	56590727	8000	56589074	-4000	4000	1653
chr16	22088538	22096538	22092640	8000	22092538	-4000	4000	102
chr16	3351889	3359889	3356666	8000	3355889	-4000	4000	777
chr16	11265533	11273533	11268961	8000	11269533	-4000	4000	-572
chr16	71996402	72004402	71998329	8000	72000402	-4000	4000	-2073
chr16	11265533	11273533	11267989	8000	11269533	-4000	4000	-1544
chr16	66575448	66583448	66579670	8000	66579448	-4000	4000	222
chr16	3252633	3260633	3256365	8000	3256633	-4000	4000	-268
chr16	56585074	56593074	56589556	8000	56589074	-4000	4000	482
chr16	67976549	67984549	67978561	8000	67980549	-4000	4000	-1988
chr16	74417478	74425478	74421326	8000	74421478	-4000	4000	-152
chr16	27062927	27070927	27067032	8000	27066927	-4000	4000	105
chr16	3252633	3260633	3256513	8000	3256633	-4000	4000	-120
chr16	21155441	21163441	21159421	8000	21159441	-4000	4000	-20
chr16	3200247	3208247	3205059	8000	3204247	-4000	4000	812
chr16	32248719	32256719	32253836	8000	32252719	-4000	4000	1117
chr16	176459	184459	180684	8000	180459	-4000	4000	225
chr16	67976549	67984549	67980102	8000	67980549	-4000	4000	-447
chr16	30019198	30027198	30025757	8000	30023198	-4000	4000	2559
chr16	31523900	31531900	31528529	8000	31527900	-4000	4000	629
chr16	11265533	11273533	11267988	8000	11269533	-4000	4000	-1545
chr16	10690930	10698930	10694612	8000	10694930	-4000	4000	-318
chr16	1953606	1961606	1954124	8000	1957606	-4000	4000	-3482
chr16	27062927	27070927	27067347	8000	27066927	-4000	4000	420
chr16	30019198	30027198	30025635	8000	30023198	-4000	4000	2437
chr17	3509852	3517852	3513709	8000	3513852	-4000	4000	-143
chr17	63869766	63877766	63872269	8000	63873766	-4000	4000	-1497
chr17	41136487	41144487	41140274	8000	41140487	-4000	4000	-213
chr17	19407125	19415125	19413387	8000	19411125	-4000	4000	2262
chr17	35190393	35198393	35193521	8000	35194393	-4000	4000	-872
chr17	7111700	7119700	7114225	8000	7115700	-4000	4000	-1475
chr17	41477151	41485151	41480888	8000	41481151	-4000	4000	-263
chr17	48993385	49001385	48997541	8000	48997385	-4000	4000	156
chr17	45840881	45848881	45846802	8000	45844881	-4000	4000	1921
chr17	74918950	74926950	74924929	8000	74922950	-4000	4000	1979
chr17	82367765	82375765	82374779	8000	82371765	-4000	4000	3014
chr17	35977497	35985497	35977683	8000	35981497	-4000	4000	-3814
chr17	8754559	8762559	8758324	8000	8758559	-4000	4000	-235
chr17	42679917	42687917	42685238	8000	42683917	-4000	4000	1321
chr17	35556819	35564819	35557669	8000	35560819	-4000	4000	-3150
chr17	18640427	18648427	18641345	8000	18644427	-4000	4000	-3082
chr17	41098209	41106209	41105888	8000	41102209	-4000	4000	3679
chr17	63892661	63900661	63895505	8000	63896661	-4000	4000	-1156
chr17	35190393	35198393	35194070	8000	35194393	-4000	4000	-323
chr17	41393608	41401608	41395534	8000	41397608	-4000	4000	-2074
chr17	74357868	74365868	74361793	8000	74361868	-4000	4000	-75
chr17	63869766	63877766	63872091	8000	63873766	-4000	4000	-1675
chr17	41098209	41106209	41105680	8000	41102209	-4000	4000	3471
chr17	7416324	7424324	7417129	8000	7420324	-4000	4000	-3195
chr17	41378306	41386306	41379373	8000	41382306	-4000	4000	-2933
chr17	6772215	6780215	6773122	8000	6776215	-4000	4000	-3093
chr17	41136487	41144487	41140171	8000	41140487	-4000	4000	-316
chr17	40011361	40019361	40016933	8000	40015361	-4000	4000	1572
chr17	4784964	4792964	4789835	8000	4788964	-4000	4000	871
chr17	63869766	63877766	63872555	8000	63873766	-4000	4000	-1211
chr17	35556819	35564819	35557525	8000	35560819	-4000	4000	-3294
chr17	53818927	53826927	53823764	8000	53822927	-4000	4000	837
chr17	63907341	63915341	63910609	8000	63911341	-4000	4000	-732
chr17	50830650	50838650	50835982	8000	50834650	-4000	4000	1332
chr17	52156017	52164017	52157894	8000	52160017	-4000	4000	-2123
chr17	41174221	41182221	41178133	8000	41178221	-4000	4000	-88
chr17	41026195	41034195	41027089	8000	41030195	-4000	4000	-3106
chr17	3394410	3402410	3398157	8000	3398410	-4000	4000	-253
chr17	3429841	3437841	3432999	8000	3433841	-4000	4000	-842
chr17	19407125	19415125	19412517	8000	19411125	-4000	4000	1392
chr17	29242859	29250859	29246871	8000	29246859	-4000	4000	12
chr17	41393608	41401608	41397362	8000	41397608	-4000	4000	-246
chr17	63892661	63900661	63895520	8000	63896661	-4000	4000	-1141
chr17	8083716	8091716	8086044	8000	8087716	-4000	4000	-1672
chr17	41222648	41230648	41227061	8000	41226648	-4000	4000	413
chr17	29242859	29250859	29250199	8000	29246859	-4000	4000	3340
chr17	36435566	36443566	36437717	8000	36439566	-4000	4000	-1849
chr17	40751331	40759331	40755195	8000	40755331	-4000	4000	-136
chr17	41420585	41428585	41424190	8000	41424585	-4000	4000	-395
chr17	63877944	63885944	63880273	8000	63881944	-4000	4000	-1671
chr17	82367765	82375765	82374569	8000	82371765	-4000	4000	2804
chr17	53818927	53826927	53823306	8000	53822927	-4000	4000	379
chr17	41831685	41839685	41837916	8000	41835685	-4000	4000	2231
chr17	41488546	41496546	41489486	8000	41492546	-4000	4000	-3060
chr17	3193519	3201519	3198376	8000	3197519	-4000	4000	857
chr17	63869766	63877766	63872304	8000	63873766	-4000	4000	-1462
chr17	8754559	8762559	8757301	8000	8758559	-4000	4000	-1258
chr17	35190393	35198393	35194181	8000	35194393	-4000	4000	-212
chr17	53818927	53826927	53824786	8000	53822927	-4000	4000	1859
chr17	58162982	58170982	58170020	8000	58166982	-4000	4000	3038
chr17	58276935	58284935	58277847	8000	58280935	-4000	4000	-3088
chr17	63892661	63900661	63895580	8000	63896661	-4000	4000	-1081
chr17	45840881	45848881	45846008	8000	45844881	-4000	4000	1127
chr17	63519334	63527334	63524206	8000	63523334	-4000	4000	872
chr17	45840881	45848881	45845277	8000	45844881	-4000	4000	396
chr17	41831685	41839685	41837853	8000	41835685	-4000	4000	2168
chr17	41436983	41444983	41440712	8000	41440983	-4000	4000	-271
chr17	41463386	41471386	41466097	8000	41467386	-4000	4000	-1289
chr17	40795959	40803959	40798265	8000	40799959	-4000	4000	-1694
chr17	63907341	63915341	63910847	8000	63911341	-4000	4000	-494
chr17	53818927	53826927	53823367	8000	53822927	-4000	4000	440
chr17	41436983	41444983	41438273	8000	41440983	-4000	4000	-2710
chr17	79726943	79734943	79731330	8000	79730943	-4000	4000	387
chr17	78142385	78150385	78146405	8000	78146385	-4000	4000	20
chr17	40795959	40803959	40799633	8000	40799959	-4000	4000	-326
chr17	74588283	74596283	74592060	8000	74592283	-4000	4000	-223
chr17	48718518	48726518	48724625	8000	48722518	-4000	4000	2107
chr17	41114373	41122373	41118042	8000	41118373	-4000	4000	-331
chr17	48719185	48727185	48726689	8000	48723185	-4000	4000	3504
chr17	52156017	52164017	52158033	8000	52160017	-4000	4000	-1984
chr17	58276935	58284935	58280739	8000	58280935	-4000	4000	-196
chr17	46829201	46837201	46833406	8000	46833201	-4000	4000	205
chr17	45840881	45848881	45845635	8000	45844881	-4000	4000	754
chr17	42679917	42687917	42685236	8000	42683917	-4000	4000	1319
chr17	40751331	40759331	40755207	8000	40755331	-4000	4000	-124
chr17	6431199	6439199	6433965	8000	6435199	-4000	4000	-1234
chr17	6431199	6439199	6433985	8000	6435199	-4000	4000	-1214
chr17	40699752	40707752	40703676	8000	40703752	-4000	4000	-76
chr17	40795959	40803959	40798274	8000	40799959	-4000	4000	-1685
chr17	41378306	41386306	41381146	8000	41382306	-4000	4000	-1160
chr17	40995906	41003906	40999601	8000	40999906	-4000	4000	-305
chr17	35556819	35564819	35557684	8000	35560819	-4000	4000	-3135
chr17	41477151	41485151	41477646	8000	41481151	-4000	4000	-3505
chr17	3429841	3437841	3433791	8000	3433841	-4000	4000	-50
chr17	41477151	41485151	41480841	8000	41481151	-4000	4000	-310
chr17	41477151	41485151	41481074	8000	41481151	-4000	4000	-77
chr17	74931898	74939898	74933374	8000	74935898	-4000	4000	-2524
chr17	53818927	53826927	53824740	8000	53822927	-4000	4000	1813
chr17	74588283	74596283	74592522	8000	74592283	-4000	4000	239
chr17	7477446	7485446	7481988	8000	7481446	-4000	4000	542
chr17	6431199	6439199	6434068	8000	6435199	-4000	4000	-1131
chr17	48527011	48535011	48530467	8000	48531011	-4000	4000	-544
chr17	40011361	40019361	40015517	8000	40015361	-4000	4000	156
chr17	42679917	42687917	42686975	8000	42683917	-4000	4000	3058
chr17	43938476	43946476	43941525	8000	43942476	-4000	4000	-951
chr17	63892661	63900661	63894972	8000	63896661	-4000	4000	-1689
chr17	41037450	41045450	41041052	8000	41041450	-4000	4000	-398
chr17	41378306	41386306	41379567	8000	41382306	-4000	4000	-2739
chr17	41098209	41106209	41105534	8000	41102209	-4000	4000	3325
chr17	8741219	8749219	8744614	8000	8745219	-4000	4000	-605
chr17	41831685	41839685	41832396	8000	41835685	-4000	4000	-3289
chr17	63907341	63915341	63909942	8000	63911341	-4000	4000	-1399
chr17	50830650	50838650	50836045	8000	50834650	-4000	4000	1395
chr17	3394410	3402410	3397685	8000	3398410	-4000	4000	-725
chr17	41393608	41401608	41397474	8000	41397608	-4000	4000	-134
chr17	41488546	41496546	41489442	8000	41492546	-4000	4000	-3104
chr17	63877944	63885944	63880755	8000	63881944	-4000	4000	-1189
chr17	53818927	53826927	53824526	8000	53822927	-4000	4000	1599
chr17	41156748	41164748	41160248	8000	41160748	-4000	4000	-500
chr17	74918950	74926950	74924864	8000	74922950	-4000	4000	1914
chr17	40699752	40707752	40700238	8000	40703752	-4000	4000	-3514
chr17	58276935	58284935	58279104	8000	58280935	-4000	4000	-1831
chr17	58162982	58170982	58170484	8000	58166982	-4000	4000	3502
chr17	8083716	8091716	8086053	8000	8087716	-4000	4000	-1663
chr17	40863223	40871223	40866689	8000	40867223	-4000	4000	-534
chr17	41568059	41576059	41568200	8000	41572059	-4000	4000	-3859
chr17	41420585	41428585	41423395	8000	41424585	-4000	4000	-1190
chr17	3193519	3201519	3197828	8000	3197519	-4000	4000	309
chr17	41164221	41172221	41167576	8000	41168221	-4000	4000	-645
chr17	7421616	7429616	7426506	8000	7425616	-4000	4000	890
chr17	41156748	41164748	41160261	8000	41160748	-4000	4000	-487
chr17	41056114	41064114	41059712	8000	41060114	-4000	4000	-402
chr17	41080150	41088150	41084984	8000	41084150	-4000	4000	834
chr17	81957840	81965840	81960700	8000	81961840	-4000	4000	-1140
chr17	40995906	41003906	40999619	8000	40999906	-4000	4000	-287
chr17	81161507	81169507	81166768	8000	81165507	-4000	4000	1261
chr17	40011361	40019361	40016511	8000	40015361	-4000	4000	1150
chr17	35190393	35198393	35193459	8000	35194393	-4000	4000	-934
chr17	41051230	41059230	41055058	8000	41055230	-4000	4000	-172
chr17	74363458	74371458	74370558	8000	74367458	-4000	4000	3100
chr17	10514542	10522542	10521337	8000	10518542	-4000	4000	2795
chr17	35556819	35564819	35557356	8000	35560819	-4000	4000	-3463
chr17	41056114	41064114	41059484	8000	41060114	-4000	4000	-630
chr17	74918950	74926950	74919984	8000	74922950	-4000	4000	-2966
chr17	34359233	34367233	34361879	8000	34363233	-4000	4000	-1354
chr17	34359233	34367233	34361880	8000	34363233	-4000	4000	-1353
chr17	39605777	39613777	39606084	8000	39609777	-4000	4000	-3693
chr17	10514542	10522542	10516053	8000	10518542	-4000	4000	-2489
chr17	74363458	74371458	74370558	8000	74367458	-4000	4000	3100
chr17	45840881	45848881	45845521	8000	45844881	-4000	4000	640
chr17	40778550	40786550	40780406	8000	40782550	-4000	4000	-2144
chr17	41488546	41496546	41489629	8000	41492546	-4000	4000	-2917
chr17	74363458	74371458	74367644	8000	74367458	-4000	4000	186
chr17	8120106	8128106	8120921	8000	8124106	-4000	4000	-3185
chr17	35864891	35872891	35872296	8000	35868891	-4000	4000	3405
chr17	81161507	81169507	81165985	8000	81165507	-4000	4000	478
chr17	35556819	35564819	35557464	8000	35560819	-4000	4000	-3355
chr17	41156748	41164748	41160175	8000	41160748	-4000	4000	-573
chr17	41222648	41230648	41226983	8000	41226648	-4000	4000	335
chr17	58162982	58170982	58170337	8000	58166982	-4000	4000	3355
chr17	12661890	12669890	12666006	8000	12665890	-4000	4000	116
chr17	41037450	41045450	41041123	8000	41041450	-4000	4000	-327
chr17	41346828	41354828	41346935	8000	41350828	-4000	4000	-3893
chr17	74918950	74926950	74924885	8000	74922950	-4000	4000	1935
chr17	19407125	19415125	19415035	8000	19411125	-4000	4000	3910
chr17	10514542	10522542	10516268	8000	10518542	-4000	4000	-2274
chr17	53818927	53826927	53823174	8000	53822927	-4000	4000	247
chr17	45840881	45848881	45846867	8000	45844881	-4000	4000	1986
chr17	41098209	41106209	41105991	8000	41102209	-4000	4000	3782
chr17	41568059	41576059	41568160	8000	41572059	-4000	4000	-3899
chr17	79726943	79734943	79731309	8000	79730943	-4000	4000	366
chr17	9901271	9909271	9904923	8000	9905271	-4000	4000	-348
chr17	81831050	81839050	81834620	8000	81835050	-4000	4000	-430
chr17	63877944	63885944	63881051	8000	63881944	-4000	4000	-893
chr17	74588283	74596283	74592091	8000	74592283	-4000	4000	-192
chr17	53818927	53826927	53825155	8000	53822927	-4000	4000	2228
chr17	42896797	42904797	42900988	8000	42900797	-4000	4000	191
chr17	3509852	3517852	3513867	8000	3513852	-4000	4000	15
chr17	63877944	63885944	63880296	8000	63881944	-4000	4000	-1648
chr17	8120106	8128106	8122382	8000	8124106	-4000	4000	-1724
chr17	36932785	36940785	36940717	8000	36936785	-4000	4000	3932
chr17	31293539	31301539	31295940	8000	31297539	-4000	4000	-1599
chr17	74918950	74926950	74920665	8000	74922950	-4000	4000	-2285
chr17	40778550	40786550	40779724	8000	40782550	-4000	4000	-2826
chr17	48964596	48972596	48967164	8000	48968596	-4000	4000	-1432
chr17	19407125	19415125	19411740	8000	19411125	-4000	4000	615
chr17	42679917	42687917	42683899	8000	42683917	-4000	4000	-18
chr17	41365813	41373813	41369505	8000	41369813	-4000	4000	-308
chr17	41477151	41485151	41479755	8000	41481151	-4000	4000	-1396
chr17	63869766	63877766	63872548	8000	63873766	-4000	4000	-1218
chr17	63877944	63885944	63880350	8000	63881944	-4000	4000	-1594
chr17	63907341	63915341	63909740	8000	63911341	-4000	4000	-1601
chr17	40699752	40707752	40700292	8000	40703752	-4000	4000	-3460
chr17	41378306	41386306	41382021	8000	41382306	-4000	4000	-285
chr17	79726943	79734943	79731275	8000	79730943	-4000	4000	332
chr17	58188726	58196726	58194991	8000	58192726	-4000	4000	2265
chr17	81659112	81667112	81665252	8000	81663112	-4000	4000	2140
chr17	3059607	3067607	3062689	8000	3063607	-4000	4000	-918
chr17	63907341	63915341	63910799	8000	63911341	-4000	4000	-542
chr17	41378306	41386306	41381157	8000	41382306	-4000	4000	-1149
chr17	41477151	41485151	41480936	8000	41481151	-4000	4000	-215
chr17	18373778	18381778	18380933	8000	18377778	-4000	4000	3155
chr17	40795959	40803959	40799808	8000	40799959	-4000	4000	-151
chr17	3429841	3437841	3432998	8000	3433841	-4000	4000	-843
chr17	41393608	41401608	41394025	8000	41397608	-4000	4000	-3583
chr17	35864891	35872891	35872343	8000	35868891	-4000	4000	3452
chr17	3059607	3067607	3063359	8000	3063607	-4000	4000	-248
chr17	3123551	3131551	3126752	8000	3127551	-4000	4000	-799
chr17	3394410	3402410	3397626	8000	3398410	-4000	4000	-784
chr17	4784964	4792964	4785953	8000	4788964	-4000	4000	-3011
chr17	4784964	4792964	4789235	8000	4788964	-4000	4000	271
chr17	4803013	4811013	4808289	8000	4807013	-4000	4000	1276
chr17	8754559	8762559	8756393	8000	8758559	-4000	4000	-2166
chr17	14232862	14240862	14236587	8000	14236862	-4000	4000	-275
chr17	18373778	18381778	18377938	8000	18377778	-4000	4000	160
chr17	39864202	39872202	39871574	8000	39868202	-4000	4000	3372
chr17	41098209	41106209	41105925	8000	41102209	-4000	4000	3716
chr17	41568059	41576059	41568621	8000	41572059	-4000	4000	-3438
chr17	53818927	53826927	53824494	8000	53822927	-4000	4000	1567
chr17	58162982	58170982	58169692	8000	58166982	-4000	4000	2710
chr17	58188726	58196726	58195035	8000	58192726	-4000	4000	2309
chr17	58276935	58284935	58278059	8000	58280935	-4000	4000	-2876
chr17	74527475	74535475	74531321	8000	74531475	-4000	4000	-154
chr17	74588283	74596283	74588754	8000	74592283	-4000	4000	-3529
chr17	74918950	74926950	74920615	8000	74922950	-4000	4000	-2335
chr17	50830650	50838650	50835839	8000	50834650	-4000	4000	1189
chr17	41393608	41401608	41394089	8000	41397608	-4000	4000	-3519
chr17	41026195	41034195	41026720	8000	41030195	-4000	4000	-3475
chr17	48527011	48535011	48529604	8000	48531011	-4000	4000	-1407
chr17	58188726	58196726	58195033	8000	58192726	-4000	4000	2307
chr17	53818927	53826927	53823843	8000	53822927	-4000	4000	916
chr17	41568059	41576059	41569968	8000	41572059	-4000	4000	-2091
chr17	3193519	3201519	3198323	8000	3197519	-4000	4000	804
chr17	41026195	41034195	41026822	8000	41030195	-4000	4000	-3373
chr17	41831685	41839685	41832396	8000	41835685	-4000	4000	-3289
chr17	63869766	63877766	63872139	8000	63873766	-4000	4000	-1627
chr17	41180911	41188911	41184421	8000	41184911	-4000	4000	-490
chr17	41346828	41354828	41346929	8000	41350828	-4000	4000	-3899
chr17	53818927	53826927	53823628	8000	53822927	-4000	4000	701
chr17	34266221	34274221	34271915	8000	34270221	-4000	4000	1694
chr17	34359233	34367233	34360505	8000	34363233	-4000	4000	-2728
chr17	35117615	35125615	35121683	8000	35121615	-4000	4000	68
chr17	35556819	35564819	35557253	8000	35560819	-4000	4000	-3566
chr17	41094142	41102142	41097300	8000	41098142	-4000	4000	-842
chr17	41378306	41386306	41382081	8000	41382306	-4000	4000	-225
chr17	41568059	41576059	41571499	8000	41572059	-4000	4000	-560
chr17	43938476	43946476	43941520	8000	43942476	-4000	4000	-956
chr17	74588283	74596283	74592384	8000	74592283	-4000	4000	101
chr17	40699752	40707752	40703140	8000	40703752	-4000	4000	-612
chr17	41233999	41241999	41238108	8000	41237999	-4000	4000	109
chr17	41463386	41471386	41467065	8000	41467386	-4000	4000	-321
chr17	63877944	63885944	63881086	8000	63881944	-4000	4000	-858
chr17	41708331	41716331	41715532	8000	41712331	-4000	4000	3201
chr17	41568059	41576059	41571783	8000	41572059	-4000	4000	-276
chr17	48718518	48726518	48722504	8000	48722518	-4000	4000	-14
chr17	42840580	42848580	42841554	8000	42844580	-4000	4000	-3026
chr17	42679917	42687917	42686933	8000	42683917	-4000	4000	3016
chr17	40751331	40759331	40754432	8000	40755331	-4000	4000	-899
chr17	41136487	41144487	41140247	8000	41140487	-4000	4000	-240
chr17	6827761	6835761	6830286	8000	6831761	-4000	4000	-1475
chr17	8120106	8128106	8121298	8000	8124106	-4000	4000	-2808
chr17	9901271	9909271	9904805	8000	9905271	-4000	4000	-466
chr17	8741219	8749219	8744528	8000	8745219	-4000	4000	-691
chr17	7351123	7359123	7356423	8000	7355123	-4000	4000	1300
chr17	35190393	35198393	35193740	8000	35194393	-4000	4000	-653
chr17	40863223	40871223	40866790	8000	40867223	-4000	4000	-433
chr17	41180911	41188911	41184487	8000	41184911	-4000	4000	-424
chr17	45840881	45848881	45846405	8000	45844881	-4000	4000	1524
chr17	79726943	79734943	79731319	8000	79730943	-4000	4000	376
chr17	7421616	7429616	7427010	8000	7425616	-4000	4000	1394
chr17	41393608	41401608	41394991	8000	41397608	-4000	4000	-2617
chr17	40011361	40019361	40015765	8000	40015361	-4000	4000	404
chr17	48719185	48727185	48726980	8000	48723185	-4000	4000	3795
chr17	3193519	3201519	3197567	8000	3197519	-4000	4000	48
chr17	63869766	63877766	63873608	8000	63873766	-4000	4000	-158
chr17	41136487	41144487	41140378	8000	41140487	-4000	4000	-109
chr17	41174221	41182221	41178022	8000	41178221	-4000	4000	-199
chr17	40778550	40786550	40780400	8000	40782550	-4000	4000	-2150
chr17	35556819	35564819	35558029	8000	35560819	-4000	4000	-2790
chr17	41164221	41172221	41167572	8000	41168221	-4000	4000	-649
chr17	41114373	41122373	41118203	8000	41118373	-4000	4000	-170
chr17	63892661	63900661	63895046	8000	63896661	-4000	4000	-1615
chr17	58276935	58284935	58279384	8000	58280935	-4000	4000	-1551
chr17	41245687	41253687	41250579	8000	41249687	-4000	4000	892
chr17	9901271	9909271	9905001	8000	9905271	-4000	4000	-270
chr17	63892661	63900661	63894992	8000	63896661	-4000	4000	-1669
chr17	36932785	36940785	36940727	8000	36936785	-4000	4000	3942
chr17	41037450	41045450	41041054	8000	41041450	-4000	4000	-396
chr17	48993385	49001385	48997919	8000	48997385	-4000	4000	534
chr17	53818927	53826927	53824834	8000	53822927	-4000	4000	1907
chr17	8741219	8749219	8744588	8000	8745219	-4000	4000	-631
chr17	41568059	41576059	41568209	8000	41572059	-4000	4000	-3850
chr17	41568059	41576059	41568269	8000	41572059	-4000	4000	-3790
chr17	41568059	41576059	41568350	8000	41572059	-4000	4000	-3709
chr17	41568059	41576059	41568571	8000	41572059	-4000	4000	-3488
chr17	41436983	41444983	41440469	8000	41440983	-4000	4000	-514
chr17	63877944	63885944	63881042	8000	63881944	-4000	4000	-902
chr17	18640427	18648427	18641337	8000	18644427	-4000	4000	-3090
chr17	74931898	74939898	74933462	8000	74935898	-4000	4000	-2436
chr17	40768162	40776162	40771747	8000	40772162	-4000	4000	-415
chr17	41037450	41045450	41041052	8000	41041450	-4000	4000	-398
chr17	7421616	7429616	7426051	8000	7425616	-4000	4000	435
chr17	35749239	35757239	35752504	8000	35753239	-4000	4000	-735
chr17	29925200	29933200	29929879	8000	29929200	-4000	4000	679
chr17	41136487	41144487	41139792	8000	41140487	-4000	4000	-695
chr17	41568059	41576059	41570011	8000	41572059	-4000	4000	-2048
chr17	48813229	48821229	48816998	8000	48817229	-4000	4000	-231
chr17	40778550	40786550	40779715	8000	40782550	-4000	4000	-2835
chr17	41233999	41241999	41238276	8000	41237999	-4000	4000	277
chr17	35143817	35151817	35149004	8000	35147817	-4000	4000	1187
chr17	40795959	40803959	40799633	8000	40799959	-4000	4000	-326
chr17	40751331	40759331	40754997	8000	40755331	-4000	4000	-334
chr17	41488546	41496546	41489418	8000	41492546	-4000	4000	-3128
chr17	3059607	3067607	3063217	8000	3063607	-4000	4000	-390
chr18	7227089	7235089	7232023	8000	7231089	-4000	4000	934
chr18	60368775	60376775	60371606	8000	60372775	-4000	4000	-1169
chr18	47031621	47039621	47033975	8000	47035621	-4000	4000	-1646
chr18	47031621	47039621	47034333	8000	47035621	-4000	4000	-1288
chr18	47031621	47039621	47034184	8000	47035621	-4000	4000	-1437
chr18	31756880	31764880	31760859	8000	31760880	-4000	4000	-21
chr18	11605596	11613596	11609809	8000	11609596	-4000	4000	213
chr18	47247660	47255660	47248578	8000	47251660	-4000	4000	-3082
chr18	59314649	59322649	59318545	8000	59318649	-4000	4000	-104
chr18	26129852	26137852	26134016	8000	26133852	-4000	4000	164
chr18	9881766	9889766	9887866	8000	9885766	-4000	4000	2100
chr18	52336197	52344197	52340731	8000	52340197	-4000	4000	534
chr18	57348557	57356557	57352849	8000	57352557	-4000	4000	292
chr18	7227089	7235089	7231364	8000	7231089	-4000	4000	275
chr18	9881766	9889766	9887586	8000	9885766	-4000	4000	1820
chr18	47031621	47039621	47035082	8000	47035621	-4000	4000	-539
chr18	46965912	46973912	46969280	8000	46969912	-4000	4000	-632
chr18	46653220	46661220	46657010	8000	46657220	-4000	4000	-210
chr18	46755257	46763257	46756497	8000	46759257	-4000	4000	-2760
chr18	47031621	47039621	47035354	8000	47035621	-4000	4000	-267
chr18	59314649	59322649	59318298	8000	59318649	-4000	4000	-351
chr18	77245848	77253848	77250806	8000	77249848	-4000	4000	958
chr18	7227089	7235089	7231526	8000	7231089	-4000	4000	437
chr18	60368775	60376775	60371986	8000	60372775	-4000	4000	-789
chr18	47031621	47039621	47034568	8000	47035621	-4000	4000	-1053
chr18	57348557	57356557	57352803	8000	57352557	-4000	4000	246
chr18	47031621	47039621	47033725	8000	47035621	-4000	4000	-1896
chr18	47031621	47039621	47034263	8000	47035621	-4000	4000	-1358
chr18	60368775	60376775	60371709	8000	60372775	-4000	4000	-1066
chr18	63893174	63901174	63895315	8000	63897174	-4000	4000	-1859
chr18	9881766	9889766	9887954	8000	9885766	-4000	4000	2188
chr18	47031621	47039621	47034946	8000	47035621	-4000	4000	-675
chr18	47031621	47039621	47033146	8000	47035621	-4000	4000	-2475
chr18	57348557	57356557	57354492	8000	57352557	-4000	4000	1935
chr18	43111691	43119691	43115451	8000	43115691	-4000	4000	-240
chr18	31158856	31166856	31162536	8000	31162856	-4000	4000	-320
chr18	46965912	46973912	46969126	8000	46969912	-4000	4000	-786
chr18	47031621	47039621	47034826	8000	47035621	-4000	4000	-795
chr18	72864146	72872146	72867423	8000	72868146	-4000	4000	-723
chr18	576380	584380	580508	8000	580380	-4000	4000	128
chr18	31756880	31764880	31760124	8000	31760880	-4000	4000	-756
chr18	57143087	57151087	57147583	8000	57147087	-4000	4000	496
chr18	576380	584380	580977	8000	580380	-4000	4000	597
chr18	77245848	77253848	77250869	8000	77249848	-4000	4000	1021
chr18	57143087	57151087	57147517	8000	57147087	-4000	4000	430
chr18	7227089	7235089	7231501	8000	7231089	-4000	4000	412
chr18	13820149	13828149	13826449	8000	13824149	-4000	4000	2300
chr18	43111691	43119691	43115581	8000	43115691	-4000	4000	-110
chr18	60368775	60376775	60371548	8000	60372775	-4000	4000	-1227
chr18	60368775	60376775	60372131	8000	60372775	-4000	4000	-644
chr18	31756880	31764880	31760117	8000	31760880	-4000	4000	-763
chr18	52336197	52344197	52340692	8000	52340197	-4000	4000	495
chr18	26129852	26137852	26134010	8000	26133852	-4000	4000	158
chr18	34220952	34228952	34223143	8000	34224952	-4000	4000	-1809
chr18	9881766	9889766	9888093	8000	9885766	-4000	4000	2327
chr18	59270086	59278086	59272499	8000	59274086	-4000	4000	-1587
chr18	47031621	47039621	47034232	8000	47035621	-4000	4000	-1389
chr18	57348557	57356557	57352786	8000	57352557	-4000	4000	229
chr19	54734513	54742513	54735283	8000	54738513	-4000	4000	-3230
chr19	470983	478983	474621	8000	474983	-4000	4000	-362
chr19	39264396	39272396	39268842	8000	39268396	-4000	4000	446
chr19	5451417	5459417	5455899	8000	5455417	-4000	4000	482
chr19	5451417	5459417	5456088	8000	5455417	-4000	4000	671
chr19	54812468	54820468	54819874	8000	54816468	-4000	4000	3406
chr19	54846443	54854443	54853747	8000	54850443	-4000	4000	3304
chr19	54870235	54878235	54875356	8000	54874235	-4000	4000	1121
chr19	48929699	48937699	48936125	8000	48933699	-4000	4000	2426
chr19	35224739	35232739	35228074	8000	35228739	-4000	4000	-665
chr19	39292407	39300407	39298241	8000	39296407	-4000	4000	1834
chr19	41840743	41848743	41847638	8000	41844743	-4000	4000	2895
chr19	43712076	43720076	43719669	8000	43716076	-4000	4000	3593
chr19	55928336	55936336	55932123	8000	55932336	-4000	4000	-213
chr19	10282955	10290955	10284564	8000	10286955	-4000	4000	-2391
chr19	5451417	5459417	5455656	8000	5455417	-4000	4000	239
chr19	42933207	42941207	42935468	8000	42937207	-4000	4000	-1739
chr19	42736481	42744481	42739056	8000	42740481	-4000	4000	-1425
chr19	41702976	41710976	41709737	8000	41706976	-4000	4000	2761
chr19	46120688	46128688	46124074	8000	46124688	-4000	4000	-614
chr19	35367068	35375068	35371562	8000	35371068	-4000	4000	494
chr19	43203299	43211299	43205481	8000	43207299	-4000	4000	-1818
chr19	14937489	14945489	14942064	8000	14941489	-4000	4000	575
chr19	49068699	49076699	49070638	8000	49072699	-4000	4000	-2061
chr19	50428892	50436892	50435823	8000	50432892	-4000	4000	2931
chr19	15724024	15732024	15729026	8000	15728024	-4000	4000	1002
chr19	45910778	45918778	45914561	8000	45914778	-4000	4000	-217
chr19	55359260	55367260	55359689	8000	55363260	-4000	4000	-3571
chr19	9111763	9119763	9114888	8000	9115763	-4000	4000	-875
chr19	35865287	35873287	35866306	8000	35869287	-4000	4000	-2981
chr19	10285952	10293952	10287604	8000	10289952	-4000	4000	-2348
chr19	5451417	5459417	5456642	8000	5455417	-4000	4000	1225
chr19	35367068	35375068	35371358	8000	35371068	-4000	4000	290
chr19	54812468	54820468	54818549	8000	54816468	-4000	4000	2081
chr19	691498	699498	694935	8000	695498	-4000	4000	-563
chr19	5451417	5459417	5455975	8000	5455417	-4000	4000	558
chr19	12747702	12755702	12755438	8000	12751702	-4000	4000	3736
chr19	12883201	12891201	12884802	8000	12887201	-4000	4000	-2399
chr19	35865287	35873287	35866418	8000	35869287	-4000	4000	-2869
chr19	43712076	43720076	43719223	8000	43716076	-4000	4000	3147
chr19	15006726	15014726	15011396	8000	15010726	-4000	4000	670
chr19	49357783	49365783	49359967	8000	49361783	-4000	4000	-1816
chr19	39079913	39087913	39085255	8000	39083913	-4000	4000	1342
chr19	54812468	54820468	54814033	8000	54816468	-4000	4000	-2435
chr19	49027890	49035890	49035698	8000	49031890	-4000	4000	3808
chr19	49068699	49076699	49070259	8000	49072699	-4000	4000	-2440
chr19	43203299	43211299	43204105	8000	43207299	-4000	4000	-3194
chr19	54902148	54910148	54909288	8000	54906148	-4000	4000	3140
chr19	51497800	51505800	51501460	8000	51501800	-4000	4000	-340
chr19	14471354	14479354	14472721	8000	14475354	-4000	4000	-2633
chr19	51497800	51505800	51498184	8000	51501800	-4000	4000	-3616
chr19	51386591	51394591	51387241	8000	51390591	-4000	4000	-3350
chr19	55359260	55367260	55362401	8000	55363260	-4000	4000	-859
chr19	54812468	54820468	54818401	8000	54816468	-4000	4000	1933
chr19	54765793	54773793	54773474	8000	54769793	-4000	4000	3681
chr19	51474622	51482622	51480447	8000	51478622	-4000	4000	1825
chr19	19269391	19277391	19270299	8000	19273391	-4000	4000	-3092
chr19	39734029	39742029	39734399	8000	39738029	-4000	4000	-3630
chr19	42591055	42599055	42594901	8000	42595055	-4000	4000	-154
chr19	49357783	49365783	49363983	8000	49361783	-4000	4000	2200
chr19	38384082	38392082	38391954	8000	38388082	-4000	4000	3872
chr19	43079045	43087045	43081174	8000	43083045	-4000	4000	-1871
chr19	54720442	54728442	54726080	8000	54724442	-4000	4000	1638
chr19	54846443	54854443	54852148	8000	54850443	-4000	4000	1705
chr19	53263723	53271723	53266816	8000	53267723	-4000	4000	-907
chr19	39700481	39708481	39706612	8000	39704481	-4000	4000	2131
chr19	51527856	51535856	51530806	8000	51531856	-4000	4000	-1050
chr19	12747702	12755702	12748024	8000	12751702	-4000	4000	-3678
chr19	1749506	1757506	1754711	8000	1753506	-4000	4000	1205
chr19	54734513	54742513	54738518	8000	54738513	-4000	4000	5
chr19	43022474	43030474	43025015	8000	43026474	-4000	4000	-1459
chr19	51527856	51535856	51531253	8000	51531856	-4000	4000	-603
chr19	51527856	51535856	51529734	8000	51531856	-4000	4000	-2122
chr19	57227009	57235009	57231076	8000	57231009	-4000	4000	67
chr19	691498	699498	694833	8000	695498	-4000	4000	-665
chr19	54902148	54910148	54906325	8000	54906148	-4000	4000	177
chr19	51527856	51535856	51529525	8000	51531856	-4000	4000	-2331
chr19	48929699	48937699	48935056	8000	48933699	-4000	4000	1357
chr19	4149631	4157631	4157220	8000	4153631	-4000	4000	3589
chr19	9111763	9119763	9115209	8000	9115763	-4000	4000	-554
chr19	42915563	42923563	42917829	8000	42919563	-4000	4000	-1734
chr19	12048967	12056967	12053251	8000	12052967	-4000	4000	284
chr19	14937489	14945489	14942292	8000	14941489	-4000	4000	803
chr19	39200263	39208263	39200350	8000	39204263	-4000	4000	-3913
chr19	49045111	49053111	49047644	8000	49049111	-4000	4000	-1467
chr19	35559658	35567658	35563617	8000	35563658	-4000	4000	-41
chr19	50715802	50723802	50716409	8000	50719802	-4000	4000	-3393
chr19	51527856	51535856	51529855	8000	51531856	-4000	4000	-2001
chr19	58030025	58038025	58037921	8000	58034025	-4000	4000	3896
chr19	50428892	50436892	50435846	8000	50432892	-4000	4000	2954
chr19	43265530	43273530	43267971	8000	43269530	-4000	4000	-1559
chr19	9122950	9130950	9126235	8000	9126950	-4000	4000	-715
chr19	9111763	9119763	9115415	8000	9115763	-4000	4000	-348
chr19	15724024	15732024	15728204	8000	15728024	-4000	4000	180
chr19	49357783	49365783	49363897	8000	49361783	-4000	4000	2114
chr19	53905278	53913278	53912960	8000	53909278	-4000	4000	3682
chr19	7759210	7767210	7766305	8000	7763210	-4000	4000	3095
chr19	50857568	50865568	50858550	8000	50861568	-4000	4000	-3018
chr19	35809299	35817299	35812422	8000	35813299	-4000	4000	-877
chr19	55359260	55367260	55359977	8000	55363260	-4000	4000	-3283
chr19	4149631	4157631	4154931	8000	4153631	-4000	4000	1300
chr19	35865287	35873287	35866441	8000	35869287	-4000	4000	-2846
chr19	53254292	53262292	53259195	8000	53258292	-4000	4000	903
chr19	55439300	55447300	55440678	8000	55443300	-4000	4000	-2622
chr19	43712076	43720076	43718845	8000	43716076	-4000	4000	2769
chr19	51386591	51394591	51387242	8000	51390591	-4000	4000	-3349
chr19	50857568	50865568	50859785	8000	50861568	-4000	4000	-1783
chr19	39292407	39300407	39298485	8000	39296407	-4000	4000	2078
chr19	15724024	15732024	15728737	8000	15728024	-4000	4000	713
chr19	55359260	55367260	55362968	8000	55363260	-4000	4000	-292
chr19	54846443	54854443	54852159	8000	54850443	-4000	4000	1716
chr19	50715802	50723802	50723473	8000	50719802	-4000	4000	3671
chr19	14937489	14945489	14942424	8000	14941489	-4000	4000	935
chr19	49016523	49024523	49024016	8000	49020523	-4000	4000	3493
chr19	49027890	49035890	49032221	8000	49031890	-4000	4000	331
chr19	51474622	51482622	51481550	8000	51478622	-4000	4000	2928
chr19	51527856	51535856	51530441	8000	51531856	-4000	4000	-1415
chr19	42851691	42859691	42854240	8000	42855691	-4000	4000	-1451
chr19	39598524	39606524	39604659	8000	39602524	-4000	4000	2135
chr19	39292407	39300407	39298605	8000	39296407	-4000	4000	2198
chr19	10009249	10017249	10013378	8000	10013249	-4000	4000	129
chr19	54902148	54910148	54906587	8000	54906148	-4000	4000	439
chr19	54799611	54807611	54806111	8000	54803611	-4000	4000	2500
chr19	51497800	51505800	51498254	8000	51501800	-4000	4000	-3546
chr19	54846443	54854443	54847792	8000	54850443	-4000	4000	-2651
chr19	39700481	39708481	39705967	8000	39704481	-4000	4000	1486
chr19	35559658	35567658	35560480	8000	35563658	-4000	4000	-3178
chr19	51527856	51535856	51531716	8000	51531856	-4000	4000	-140
chr19	50510690	50518690	50518454	8000	50514690	-4000	4000	3764
chr19	17456804	17464804	17460632	8000	17460804	-4000	4000	-172
chr19	53009921	53017921	53010501	8000	53013921	-4000	4000	-3420
chr19	43182536	43190536	43185109	8000	43186536	-4000	4000	-1427
chr19	35865287	35873287	35866214	8000	35869287	-4000	4000	-3073
chr19	39292407	39300407	39298232	8000	39296407	-4000	4000	1825
chr19	39292407	39300407	39298576	8000	39296407	-4000	4000	2169
chr19	42736481	42744481	42740432	8000	42740481	-4000	4000	-49
chr19	8694795	8702795	8698235	8000	8698795	-4000	4000	-560
chr19	55439300	55447300	55440651	8000	55443300	-4000	4000	-2649
chr19	19269391	19277391	19270398	8000	19273391	-4000	4000	-2993
chr19	40386181	40394181	40389540	8000	40390181	-4000	4000	-641
chr19	48751524	48759524	48756146	8000	48755524	-4000	4000	622
chr19	49016523	49024523	49022962	8000	49020523	-4000	4000	2439
chr19	8048318	8056318	8056178	8000	8052318	-4000	4000	3860
chr19	39598524	39606524	39604624	8000	39602524	-4000	4000	2100
chr19	14579084	14587084	14583137	8000	14583084	-4000	4000	53
chr19	42875822	42883822	42878003	8000	42879822	-4000	4000	-1819
chr19	43712076	43720076	43719213	8000	43716076	-4000	4000	3137
chr19	50510690	50518690	50513771	8000	50514690	-4000	4000	-919
chr19	11292139	11300139	11298870	8000	11296139	-4000	4000	2731
chr19	35367068	35375068	35371403	8000	35371068	-4000	4000	335
chr19	49039848	49047848	49044046	8000	49043848	-4000	4000	198
chr19	49419749	49427749	49423322	8000	49423749	-4000	4000	-427
chr19	51527856	51535856	51530817	8000	51531856	-4000	4000	-1039
chr19	53009921	53017921	53014508	8000	53013921	-4000	4000	587
chr19	4898896	4906896	4902694	8000	4902896	-4000	4000	-202
chr19	11292139	11300139	11298926	8000	11296139	-4000	4000	2787
chr19	32865767	32873767	32868509	8000	32869767	-4000	4000	-1258
chr19	46120688	46128688	46124128	8000	46124688	-4000	4000	-560
chr19	50510690	50518690	50513012	8000	50514690	-4000	4000	-1678
chr19	38808945	38816945	38812950	8000	38812945	-4000	4000	5
chr19	5716637	5724637	5720736	8000	5720637	-4000	4000	99
chr19	54734513	54742513	54735330	8000	54738513	-4000	4000	-3183
chr19	57473536	57481536	57473861	8000	57477536	-4000	4000	-3675
chr19	51474622	51482622	51481565	8000	51478622	-4000	4000	2943
chr19	49045111	49053111	49048827	8000	49049111	-4000	4000	-284
chr19	50510690	50518690	50512233	8000	50514690	-4000	4000	-2457
chr19	53958937	53966937	53963380	8000	53962937	-4000	4000	443
chr19	5451417	5459417	5455844	8000	5455417	-4000	4000	427
chr19	35367068	35375068	35372022	8000	35371068	-4000	4000	954
chr19	50715802	50723802	50716389	8000	50719802	-4000	4000	-3413
chr19	54799611	54807611	54806145	8000	54803611	-4000	4000	2534
chr19	15724024	15732024	15728526	8000	15728024	-4000	4000	502
chr19	10282955	10290955	10283750	8000	10286955	-4000	4000	-3205
chr19	9111763	9119763	9115136	8000	9115763	-4000	4000	-627
chr19	9111763	9119763	9115359	8000	9115763	-4000	4000	-404
chr19	17456804	17464804	17460560	8000	17460804	-4000	4000	-244
chr19	42736481	42744481	42740493	8000	42740481	-4000	4000	12
chr19	53009921	53017921	53015356	8000	53013921	-4000	4000	1435
chr19	53905278	53913278	53906365	8000	53909278	-4000	4000	-2913
chr19	39292407	39300407	39296861	8000	39296407	-4000	4000	454
chr19	49027890	49035890	49032216	8000	49031890	-4000	4000	326
chr19	19269391	19277391	19271044	8000	19273391	-4000	4000	-2347
chr19	51365003	51373003	51372601	8000	51369003	-4000	4000	3598
chr19	39598524	39606524	39605335	8000	39602524	-4000	4000	2811
chr19	43022474	43030474	43026354	8000	43026474	-4000	4000	-120
chr19	50510690	50518690	50517551	8000	50514690	-4000	4000	2861
chr19	53254292	53262292	53259135	8000	53258292	-4000	4000	843
chr19	55765118	55773118	55772836	8000	55769118	-4000	4000	3718
chr19	19269391	19277391	19270332	8000	19273391	-4000	4000	-3059
chr19	9122950	9130950	9126806	8000	9126950	-4000	4000	-144
chr19	10285952	10293952	10293695	8000	10289952	-4000	4000	3743
chr19	35354460	35362460	35358908	8000	35358460	-4000	4000	448
chr19	51497800	51505800	51498249	8000	51501800	-4000	4000	-3551
chr19	53263723	53271723	53267366	8000	53267723	-4000	4000	-357
chr19	50857568	50865568	50859803	8000	50861568	-4000	4000	-1765
chr19	40386181	40394181	40389702	8000	40390181	-4000	4000	-479
chr19	5451417	5459417	5456387	8000	5455417	-4000	4000	970
chr19	14081875	14089875	14088519	8000	14085875	-4000	4000	2644
chr19	15724024	15732024	15728156	8000	15728024	-4000	4000	132
chr19	17867945	17875945	17874507	8000	17871945	-4000	4000	2562
chr19	46225742	46233742	46230157	8000	46229742	-4000	4000	415
chr19	47882315	47890315	47886192	8000	47886315	-4000	4000	-123
chr19	50510690	50518690	50518396	8000	50514690	-4000	4000	3706
chr19	54812468	54820468	54819757	8000	54816468	-4000	4000	3289
chr19	6329612	6337612	6333467	8000	6333612	-4000	4000	-145
chr19	51386591	51394591	51387201	8000	51390591	-4000	4000	-3390
chr19	54765793	54773793	54773495	8000	54769793	-4000	4000	3702
chr19	39511113	39519113	39515929	8000	39515113	-4000	4000	816
chr19	42875822	42883822	42878060	8000	42879822	-4000	4000	-1762
chr19	49016523	49024523	49023993	8000	49020523	-4000	4000	3470
chr19	49061076	49069076	49061426	8000	49065076	-4000	4000	-3650
chr19	43079045	43087045	43081183	8000	43083045	-4000	4000	-1862
chr19	55439300	55447300	55440706	8000	55443300	-4000	4000	-2594
chr19	50510690	50518690	50518289	8000	50514690	-4000	4000	3599
chr19	54902148	54910148	54909388	8000	54906148	-4000	4000	3240
chr19	50715802	50723802	50716713	8000	50719802	-4000	4000	-3089
chr19	35347552	35355552	35352158	8000	35351552	-4000	4000	606
chr19	39241250	39249250	39244916	8000	39245250	-4000	4000	-334
chr19	39241250	39249250	39243675	8000	39245250	-4000	4000	-1575
chr19	10009249	10017249	10013583	8000	10013249	-4000	4000	334
chr19	50510690	50518690	50518351	8000	50514690	-4000	4000	3661
chr19	103104	111104	110808	8000	107104	-4000	4000	3704
chr19	54812468	54820468	54813928	8000	54816468	-4000	4000	-2540
chr19	54812468	54820468	54813929	8000	54816468	-4000	4000	-2539
chr19	10285952	10293952	10287127	8000	10289952	-4000	4000	-2825
chr19	10285952	10293952	10291220	8000	10289952	-4000	4000	1268
chr19	14937489	14945489	14941640	8000	14941489	-4000	4000	151
chr19	17456804	17464804	17460549	8000	17460804	-4000	4000	-255
chr19	17456804	17464804	17460683	8000	17460804	-4000	4000	-121
chr19	35139250	35147250	35141166	8000	35143250	-4000	4000	-2084
chr19	35559658	35567658	35563481	8000	35563658	-4000	4000	-177
chr19	35809299	35817299	35812516	8000	35813299	-4000	4000	-783
chr19	35865287	35873287	35871295	8000	35869287	-4000	4000	2008
chr19	39494895	39502895	39498980	8000	39498895	-4000	4000	85
chr19	43265530	43273530	43268016	8000	43269530	-4000	4000	-1514
chr19	48894744	48902744	48896432	8000	48898744	-4000	4000	-2312
chr19	49027890	49035890	49035647	8000	49031890	-4000	4000	3757
chr19	50766464	50774464	50771032	8000	50770464	-4000	4000	568
chr19	51527856	51535856	51530831	8000	51531856	-4000	4000	-1025
chr19	53820394	53828394	53823922	8000	53824394	-4000	4000	-472
chr19	54765793	54773793	54773449	8000	54769793	-4000	4000	3656
chr19	54799611	54807611	54806007	8000	54803611	-4000	4000	2396
chr19	54812468	54820468	54819867	8000	54816468	-4000	4000	3399
chr19	55928336	55936336	55932114	8000	55932336	-4000	4000	-222
chr19	8694795	8702795	8698149	8000	8698795	-4000	4000	-646
chr19	48894744	48902744	48895380	8000	48898744	-4000	4000	-3364
chr19	49061076	49069076	49061493	8000	49065076	-4000	4000	-3583
chr19	43712076	43720076	43719784	8000	43716076	-4000	4000	3708
chr19	49027890	49035890	49033033	8000	49031890	-4000	4000	1143
chr19	6429779	6437779	6432204	8000	6433779	-4000	4000	-1575
chr19	12747702	12755702	12753273	8000	12751702	-4000	4000	1571
chr19	42915563	42923563	42916387	8000	42919563	-4000	4000	-3176
chr19	35865287	35873287	35871919	8000	35869287	-4000	4000	2632
chr19	51527856	51535856	51531308	8000	51531856	-4000	4000	-548
chr19	5451417	5459417	5456582	8000	5455417	-4000	4000	1165
chr19	103104	111104	110648	8000	107104	-4000	4000	3544
chr19	4149631	4157631	4157085	8000	4153631	-4000	4000	3454
chr19	5451417	5459417	5456136	8000	5455417	-4000	4000	719
chr19	9122950	9130950	9126660	8000	9126950	-4000	4000	-290
chr19	9122950	9130950	9126828	8000	9126950	-4000	4000	-122
chr19	17867945	17875945	17872676	8000	17871945	-4000	4000	731
chr19	19258804	19266804	19266592	8000	19262804	-4000	4000	3788
chr19	32865767	32873767	32868461	8000	32869767	-4000	4000	-1306
chr19	39494895	39502895	39498926	8000	39498895	-4000	4000	31
chr19	39700481	39708481	39707215	8000	39704481	-4000	4000	2734
chr19	39734029	39742029	39734408	8000	39738029	-4000	4000	-3621
chr19	48040079	48048079	48040723	8000	48044079	-4000	4000	-3356
chr19	50857568	50865568	50858213	8000	50861568	-4000	4000	-3355
chr19	52449553	52457553	52451633	8000	52453553	-4000	4000	-1920
chr19	52449553	52457553	52451829	8000	52453553	-4000	4000	-1724
chr19	53628056	53636056	53634590	8000	53632056	-4000	4000	2534
chr19	54734513	54742513	54735323	8000	54738513	-4000	4000	-3190
chr19	54734513	54742513	54742101	8000	54738513	-4000	4000	3588
chr19	54812468	54820468	54814218	8000	54816468	-4000	4000	-2250
chr19	54812468	54820468	54818386	8000	54816468	-4000	4000	1918
chr19	57473536	57481536	57473944	8000	57477536	-4000	4000	-3592
chr19	49068699	49076699	49070754	8000	49072699	-4000	4000	-1945
chr19	53263723	53271723	53267112	8000	53267723	-4000	4000	-611
chr19	57227009	57235009	57232109	8000	57231009	-4000	4000	1100
chr19	50766464	50774464	50770705	8000	50770464	-4000	4000	241
chr19	4275266	4283266	4283132	8000	4279266	-4000	4000	3866
chr19	7759210	7767210	7766339	8000	7763210	-4000	4000	3129
chr19	11292139	11300139	11296291	8000	11296139	-4000	4000	152
chr19	48360367	48368367	48363928	8000	48364367	-4000	4000	-439
chr19	39700481	39708481	39706003	8000	39704481	-4000	4000	1522
chr19	9243344	9251344	9251175	8000	9247344	-4000	4000	3831
chr19	49039848	49047848	49044185	8000	49043848	-4000	4000	337
chr19	54799611	54807611	54806222	8000	54803611	-4000	4000	2611
chr19	50715802	50723802	50723535	8000	50719802	-4000	4000	3733
chr19	53263723	53271723	53267183	8000	53267723	-4000	4000	-540
chr19	15724024	15732024	15728641	8000	15728024	-4000	4000	617
chr19	54812468	54820468	54814275	8000	54816468	-4000	4000	-2193
chr19	50428892	50436892	50435801	8000	50432892	-4000	4000	2909
chr19	49016523	49024523	49022985	8000	49020523	-4000	4000	2462
chr19	50857568	50865568	50858591	8000	50861568	-4000	4000	-2977
chr19	54799611	54807611	54803614	8000	54803611	-4000	4000	3
chr19	10282955	10290955	10284087	8000	10286955	-4000	4000	-2868
chr19	35354460	35362460	35358923	8000	35358460	-4000	4000	463
chr19	48751524	48759524	48756331	8000	48755524	-4000	4000	807
chr19	54799611	54807611	54805965	8000	54803611	-4000	4000	2354
chr19	39241250	39249250	39244885	8000	39245250	-4000	4000	-365
chr19	54734513	54742513	54736486	8000	54738513	-4000	4000	-2027
chr19	15724024	15732024	15728089	8000	15728024	-4000	4000	65
chr19	19258804	19266804	19266568	8000	19262804	-4000	4000	3764
chr19	55533133	55541133	55536290	8000	55537133	-4000	4000	-843
chr19	14024148	14032148	14031931	8000	14028148	-4000	4000	3783
chr19	43712076	43720076	43719696	8000	43716076	-4000	4000	3620
chr19	48360367	48368367	48365837	8000	48364367	-4000	4000	1470
chr19	43182536	43190536	43186346	8000	43186536	-4000	4000	-190
chr19	4275266	4283266	4280125	8000	4279266	-4000	4000	859
chr19	38908186	38916186	38915479	8000	38912186	-4000	4000	3293
chr19	54846443	54854443	54852222	8000	54850443	-4000	4000	1779
chr19	46632541	46640541	46637555	8000	46636541	-4000	4000	1014
chr19	35809299	35817299	35812777	8000	35813299	-4000	4000	-522
chr19	54720442	54728442	54727647	8000	54724442	-4000	4000	3205
chr19	847014	855014	853386	8000	851014	-4000	4000	2372
chr19	42736481	42744481	42738776	8000	42740481	-4000	4000	-1705
chr19	5451417	5459417	5456792	8000	5455417	-4000	4000	1375
chr19	17456804	17464804	17460904	8000	17460804	-4000	4000	100
chr19	49357783	49365783	49365601	8000	49361783	-4000	4000	3818
chr19	372026	380026	373480	8000	376026	-4000	4000	-2546
chr19	10282955	10290955	10284047	8000	10286955	-4000	4000	-2908
chr19	45910778	45918778	45914358	8000	45914778	-4000	4000	-420
chr19	41702976	41710976	41709704	8000	41706976	-4000	4000	2728
chr19	8694795	8702795	8697530	8000	8698795	-4000	4000	-1265
chr19	35367068	35375068	35371944	8000	35371068	-4000	4000	876
chr19	8694795	8702795	8697746	8000	8698795	-4000	4000	-1049
chr19	54846443	54854443	54852066	8000	54850443	-4000	4000	1623
chr19	43182536	43190536	43183440	8000	43186536	-4000	4000	-3096
chr19	51474622	51482622	51478589	8000	51478622	-4000	4000	-33
chr19	6429779	6437779	6432149	8000	6433779	-4000	4000	-1630
chr19	35224739	35232739	35224889	8000	35228739	-4000	4000	-3850
chr19	42933207	42941207	42935463	8000	42937207	-4000	4000	-1744
chr19	35559658	35567658	35563431	8000	35563658	-4000	4000	-227
chr19	35354460	35362460	35359043	8000	35358460	-4000	4000	583
chr19	35559658	35567658	35560377	8000	35563658	-4000	4000	-3281
chr19	19258804	19266804	19260922	8000	19262804	-4000	4000	-1882
chr19	57473536	57481536	57474265	8000	57477536	-4000	4000	-3271
chr19	42875822	42883822	42878114	8000	42879822	-4000	4000	-1708
chr19	54765793	54773793	54769830	8000	54769793	-4000	4000	37
chr19	57227009	57235009	57232225	8000	57231009	-4000	4000	1216
chr19	54812468	54820468	54813280	8000	54816468	-4000	4000	-3188
chr19	53254292	53262292	53258617	8000	53258292	-4000	4000	325
chr19	54902148	54910148	54906657	8000	54906148	-4000	4000	509
chr19	3768228	3776228	3771700	8000	3772228	-4000	4000	-528
chr19	49759306	49767306	49763167	8000	49763306	-4000	4000	-139
chr19	33128090	33136090	33130362	8000	33132090	-4000	4000	-1728
chr19	38908186	38916186	38915734	8000	38912186	-4000	4000	3548
chr19	49027890	49035890	49032962	8000	49031890	-4000	4000	1072
chr19	49357783	49365783	49359478	8000	49361783	-4000	4000	-2305
chr19	50766464	50774464	50771389	8000	50770464	-4000	4000	925
chr19	4149631	4157631	4157068	8000	4153631	-4000	4000	3437
chr19	39241250	39249250	39243695	8000	39245250	-4000	4000	-1555
chr19	9243344	9251344	9251136	8000	9247344	-4000	4000	3792
chr19	56172008	56180008	56177156	8000	56176008	-4000	4000	1148
chr20	45883622	45891622	45884746	8000	45887622	-4000	4000	-2876
chr20	45203033	45211033	45207553	8000	45207033	-4000	4000	520
chr20	23487101	23495101	23491535	8000	23491101	-4000	4000	434
chr20	56244732	56252732	56249510	8000	56248732	-4000	4000	778
chr20	912334	920334	916166	8000	916334	-4000	4000	-168
chr20	63268694	63276694	63276635	8000	63272694	-4000	4000	3941
chr20	23031312	23039312	23035861	8000	23035312	-4000	4000	549
chr20	38720486	38728486	38728381	8000	38724486	-4000	4000	3895
chr20	23031312	23039312	23035855	8000	23035312	-4000	4000	543
chr20	56244732	56252732	56248792	8000	56248732	-4000	4000	60
chr20	1222044	1230044	1228493	8000	1226044	-4000	4000	2449
chr20	45698038	45706038	45705019	8000	45702038	-4000	4000	2981
chr20	57521652	57529652	57523871	8000	57525652	-4000	4000	-1781
chr20	912334	920334	915904	8000	916334	-4000	4000	-430
chr20	23031312	23039312	23036296	8000	23035312	-4000	4000	984
chr20	56521925	56529925	56526092	8000	56525925	-4000	4000	167
chr20	56244732	56252732	56249513	8000	56248732	-4000	4000	781
chr20	4245287	4253287	4248523	8000	4249287	-4000	4000	-764
chr20	35288425	35296425	35288496	8000	35292425	-4000	4000	-3929
chr20	38577195	38585195	38581270	8000	38581195	-4000	4000	75
chr20	4245287	4253287	4248430	8000	4249287	-4000	4000	-857
chr20	23031312	23039312	23035882	8000	23035312	-4000	4000	570
chr20	23031312	23039312	23036559	8000	23035312	-4000	4000	1247
chr20	45217373	45225373	45222256	8000	45221373	-4000	4000	883
chr20	57521652	57529652	57523887	8000	57525652	-4000	4000	-1765
chr20	45787932	45795932	45788975	8000	45791932	-4000	4000	-2957
chr20	31472757	31480757	31476638	8000	31476757	-4000	4000	-119
chr20	62704836	62712836	62709615	8000	62708836	-4000	4000	779
chr20	31472757	31480757	31476781	8000	31476757	-4000	4000	24
chr20	57521652	57529652	57523979	8000	57525652	-4000	4000	-1673
chr20	23487101	23495101	23493000	8000	23491101	-4000	4000	1899
chr20	185711	193711	189585	8000	189711	-4000	4000	-126
chr20	23984779	23992779	23985775	8000	23988779	-4000	4000	-3004
chr20	25078141	25086141	25079482	8000	25082141	-4000	4000	-2659
chr20	45883622	45891622	45887139	8000	45887622	-4000	4000	-483
chr20	912334	920334	915988	8000	916334	-4000	4000	-346
chr20	153454	161454	158816	8000	157454	-4000	4000	1362
chr20	63268694	63276694	63276559	8000	63272694	-4000	4000	3865
chr20	31815308	31823308	31821680	8000	31819308	-4000	4000	2372
chr20	22581455	22589455	22582278	8000	22585455	-4000	4000	-3177
chr20	23031312	23039312	23036565	8000	23035312	-4000	4000	1253
chr20	45217373	45225373	45222429	8000	45221373	-4000	4000	1056
chr20	253724	261724	259145	8000	257724	-4000	4000	1421
chr20	62704836	62712836	62709649	8000	62708836	-4000	4000	813
chr20	45203033	45211033	45208250	8000	45207033	-4000	4000	1217
chr20	45829745	45837745	45834847	8000	45833745	-4000	4000	1102
chr20	31386590	31394590	31389150	8000	31390590	-4000	4000	-1440
chr20	7936458	7944458	7940355	8000	7940458	-4000	4000	-103
chr20	223258	231258	229545	8000	227258	-4000	4000	2287
chr20	45217373	45225373	45222605	8000	45221373	-4000	4000	1232
chr20	63543891	63551891	63544266	8000	63547891	-4000	4000	-3625
chr20	43723002	43731002	43726271	8000	43727002	-4000	4000	-731
chr20	43723002	43731002	43726272	8000	43727002	-4000	4000	-730
chr20	912334	920334	916117	8000	916334	-4000	4000	-217
chr20	21701659	21709659	21706664	8000	21705659	-4000	4000	1005
chr20	45511622	45519622	45512752	8000	45515622	-4000	4000	-2870
chr20	56001519	56009519	56003883	8000	56005519	-4000	4000	-1636
chr20	63231883	63239883	63236286	8000	63235883	-4000	4000	403
chr20	45217373	45225373	45222255	8000	45221373	-4000	4000	882
chr20	23487101	23495101	23491896	8000	23491101	-4000	4000	795
chr20	22581455	22589455	22584221	8000	22585455	-4000	4000	-1234
chr20	45511622	45519622	45512674	8000	45515622	-4000	4000	-2948
chr20	63231883	63239883	63236303	8000	63235883	-4000	4000	420
chr20	23031312	23039312	23036504	8000	23035312	-4000	4000	1192
chr20	56001519	56009519	56003951	8000	56005519	-4000	4000	-1568
chr20	31815308	31823308	31820461	8000	31819308	-4000	4000	1153
chr20	31815308	31823308	31820304	8000	31819308	-4000	4000	996
chr20	31386590	31394590	31389075	8000	31390590	-4000	4000	-1515
chr20	45217373	45225373	45222507	8000	45221373	-4000	4000	1134
chr20	56244732	56252732	56249092	8000	56248732	-4000	4000	360
chr20	185711	193711	188002	8000	189711	-4000	4000	-1709
chr20	64103565	64111565	64106702	8000	64107565	-4000	4000	-863
chr20	45304529	45312529	45305520	8000	45308529	-4000	4000	-3009
chr20	31386590	31394590	31390497	8000	31390590	-4000	4000	-93
chr20	35288425	35296425	35288800	8000	35292425	-4000	4000	-3625
chr20	44333043	44341043	44337287	8000	44337043	-4000	4000	244
chr20	2532573	2540573	2537271	8000	2536573	-4000	4000	698
chr20	45111172	45119172	45115022	8000	45115172	-4000	4000	-150
chr20	31253664	31261664	31259577	8000	31257664	-4000	4000	1913
chr20	44333043	44341043	44337378	8000	44337043	-4000	4000	335
chr20	23031312	23039312	23036455	8000	23035312	-4000	4000	1143
chr20	35525652	35533652	35528470	8000	35529652	-4000	4000	-1182
chr20	45203033	45211033	45207509	8000	45207033	-4000	4000	476
chr20	31815308	31823308	31819607	8000	31819308	-4000	4000	299
chr20	56521925	56529925	56526015	8000	56525925	-4000	4000	90
chr20	22581455	22589455	22582687	8000	22585455	-4000	4000	-2768
chr20	62216278	62224278	62219801	8000	62220278	-4000	4000	-477
chr20	45304529	45312529	45312227	8000	45308529	-4000	4000	3698
chr20	31472757	31480757	31476489	8000	31476757	-4000	4000	-268
chr20	31472757	31480757	31476415	8000	31476757	-4000	4000	-342
chr20	45575326	45583326	45579287	8000	45579326	-4000	4000	-39
chr20	1616009	1624009	1619890	8000	1620009	-4000	4000	-119
chr20	23031312	23039312	23035606	8000	23035312	-4000	4000	294
chr20	31472757	31480757	31476383	8000	31476757	-4000	4000	-374
chr20	45203033	45211033	45208485	8000	45207033	-4000	4000	1452
chr20	45883622	45891622	45883686	8000	45887622	-4000	4000	-3936
chr20	23031312	23039312	23036203	8000	23035312	-4000	4000	891
chr20	223258	231258	229846	8000	227258	-4000	4000	2588
chr20	2812302	2820302	2815431	8000	2816302	-4000	4000	-871
chr20	2812302	2820302	2815804	8000	2816302	-4000	4000	-498
chr20	6050060	6058060	6050981	8000	6054060	-4000	4000	-3079
chr20	23984779	23992779	23986097	8000	23988779	-4000	4000	-2682
chr20	43723002	43731002	43726434	8000	43727002	-4000	4000	-568
chr20	45120465	45128465	45124168	8000	45124465	-4000	4000	-297
chr20	45543662	45551662	45545628	8000	45547662	-4000	4000	-2034
chr20	45787932	45795932	45795365	8000	45791932	-4000	4000	3433
chr20	56244732	56252732	56248970	8000	56248732	-4000	4000	238
chr20	57521652	57529652	57524125	8000	57525652	-4000	4000	-1527
chr20	45698038	45706038	45702150	8000	45702038	-4000	4000	112
chr20	5312954	5320954	5314028	8000	5316954	-4000	4000	-2926
chr20	56244732	56252732	56249272	8000	56248732	-4000	4000	540
chr20	223258	231258	229804	8000	227258	-4000	4000	2546
chr20	16744358	16752358	16748494	8000	16748358	-4000	4000	136
chr20	23448876	23456876	23450561	8000	23452876	-4000	4000	-2315
chr20	31386590	31394590	31389013	8000	31390590	-4000	4000	-1577
chr20	31815308	31823308	31821592	8000	31819308	-4000	4000	2284
chr20	33051424	33059424	33055512	8000	33055424	-4000	4000	88
chr20	38720486	38728486	38728081	8000	38724486	-4000	4000	3595
chr20	45120465	45128465	45124432	8000	45124465	-4000	4000	-33
chr20	45217373	45225373	45222031	8000	45221373	-4000	4000	658
chr20	45217373	45225373	45222307	8000	45221373	-4000	4000	934
chr20	33051424	33059424	33056685	8000	33055424	-4000	4000	1261
chr20	45575326	45583326	45579259	8000	45579326	-4000	4000	-67
chr20	44333043	44341043	44337345	8000	44337043	-4000	4000	302
chr20	56244732	56252732	56249160	8000	56248732	-4000	4000	428
chr20	21701659	21709659	21706434	8000	21705659	-4000	4000	775
chr20	63231883	63239883	63239573	8000	63235883	-4000	4000	3690
chr20	23031312	23039312	23035829	8000	23035312	-4000	4000	517
chr20	23031312	23039312	23035830	8000	23035312	-4000	4000	518
chr20	38720486	38728486	38724874	8000	38724486	-4000	4000	388
chr20	31472757	31480757	31476400	8000	31476757	-4000	4000	-357
chr20	18809783	18817783	18813920	8000	18813783	-4000	4000	137
chr20	45787932	45795932	45795374	8000	45791932	-4000	4000	3442
chr20	35525652	35533652	35528701	8000	35529652	-4000	4000	-951
chr20	56244732	56252732	56249535	8000	56248732	-4000	4000	803
chr20	38720486	38728486	38727676	8000	38724486	-4000	4000	3190
chr20	23984779	23992779	23985743	8000	23988779	-4000	4000	-3036
chr20	63231883	63239883	63237962	8000	63235883	-4000	4000	2079
chr20	45304529	45312529	45309603	8000	45308529	-4000	4000	1074
chr20	45543662	45551662	45545550	8000	45547662	-4000	4000	-2112
chr20	56244732	56252732	56248731	8000	56248732	-4000	4000	-1
chr20	7936458	7944458	7940331	8000	7940458	-4000	4000	-127
chr20	38577195	38585195	38578829	8000	38581195	-4000	4000	-2366
chr20	45203033	45211033	45208366	8000	45207033	-4000	4000	1333
chr20	18809783	18817783	18814237	8000	18813783	-4000	4000	454
chr20	45217373	45225373	45222503	8000	45221373	-4000	4000	1130
chr20	57521652	57529652	57524228	8000	57525652	-4000	4000	-1424
chr20	45217373	45225373	45222257	8000	45221373	-4000	4000	884
chr20	22581455	22589455	22581719	8000	22585455	-4000	4000	-3736
chr20	45217373	45225373	45223250	8000	45221373	-4000	4000	1877
chr20	64103565	64111565	64106554	8000	64107565	-4000	4000	-1011
chr20	22581455	22589455	22584375	8000	22585455	-4000	4000	-1080
chr20	31386590	31394590	31390590	8000	31390590	-4000	4000	0
chr21	33066141	33074141	33071821	8000	33070141	-4000	4000	1680
chr21	30426230	30434230	30430388	8000	30430230	-4000	4000	158
chr21	44569729	44577729	44574142	8000	44573729	-4000	4000	413
chr21	44608079	44616079	44612891	8000	44612079	-4000	4000	812
chr21	42346997	42354997	42349915	8000	42350997	-4000	4000	-1082
chr21	44596597	44604597	44600975	8000	44600597	-4000	4000	378
chr21	44281838	44289838	44287518	8000	44285838	-4000	4000	1680
chr21	30609930	30617930	30613824	8000	30613930	-4000	4000	-106
chr21	44623093	44631093	44627430	8000	44627093	-4000	4000	337
chr21	44623093	44631093	44628025	8000	44627093	-4000	4000	932
chr21	30877580	30885580	30881105	8000	30881580	-4000	4000	-475
chr21	30421968	30429968	30425490	8000	30425968	-4000	4000	-478
chr21	44596597	44604597	44600992	8000	44600597	-4000	4000	395
chr21	30285514	30293514	30289344	8000	30289514	-4000	4000	-170
chr21	44653932	44661932	44658197	8000	44657932	-4000	4000	265
chr21	44569729	44577729	44574615	8000	44573729	-4000	4000	886
chr21	44633356	44641356	44638353	8000	44637356	-4000	4000	997
chr21	44608079	44616079	44612340	8000	44612079	-4000	4000	261
chr21	44623093	44631093	44627267	8000	44627093	-4000	4000	174
chr21	30638864	30646864	30642896	8000	30642864	-4000	4000	32
chr21	30162805	30170805	30165980	8000	30166805	-4000	4000	-825
chr21	46151579	46159579	46155562	8000	46155579	-4000	4000	-17
chr21	33066141	33074141	33072127	8000	33070141	-4000	4000	1986
chr21	31034476	31042476	31038185	8000	31038476	-4000	4000	-291
chr21	30476367	30484367	30480208	8000	30480367	-4000	4000	-159
chr21	44642414	44650414	44646677	8000	44646414	-4000	4000	263
chr21	30368271	30376271	30371515	8000	30372271	-4000	4000	-756
chr21	30588440	30596440	30592692	8000	30592440	-4000	4000	252
chr21	30426230	30434230	30430418	8000	30430230	-4000	4000	188
chr21	44608079	44616079	44612111	8000	44612079	-4000	4000	32
chr21	42346997	42354997	42350991	8000	42350997	-4000	4000	-6
chr21	42346997	42354997	42347619	8000	42350997	-4000	4000	-3378
chr21	44608079	44616079	44612943	8000	44612079	-4000	4000	864
chr21	30609930	30617930	30616609	8000	30613930	-4000	4000	2679
chr21	30483436	30491436	30487315	8000	30487436	-4000	4000	-121
chr21	44596597	44604597	44600974	8000	44600597	-4000	4000	377
chr21	30493165	30501165	30497014	8000	30497165	-4000	4000	-151
chr21	30638864	30646864	30642924	8000	30642864	-4000	4000	60
chr21	44596597	44604597	44600960	8000	44600597	-4000	4000	363
chr21	44596597	44604597	44601370	8000	44600597	-4000	4000	773
chr21	30421968	30429968	30425423	8000	30425968	-4000	4000	-545
chr21	30631206	30639206	30635278	8000	30635206	-4000	4000	72
chr21	30436275	30444275	30440581	8000	30440275	-4000	4000	306
chr21	30162805	30170805	30166042	8000	30166805	-4000	4000	-763
chr21	30333694	30341694	30337154	8000	30337694	-4000	4000	-540
chr21	44569729	44577729	44573979	8000	44573729	-4000	4000	250
chr21	30162805	30170805	30166519	8000	30166805	-4000	4000	-286
chr21	30537864	30545864	30541664	8000	30541864	-4000	4000	-200
chr21	30162805	30170805	30166025	8000	30166805	-4000	4000	-780
chr21	30368271	30376271	30371906	8000	30372271	-4000	4000	-365
chr21	30616627	30624627	30620842	8000	30620627	-4000	4000	215
chr21	44653932	44661932	44657973	8000	44657932	-4000	4000	41
chr21	30751428	30759428	30755158	8000	30755428	-4000	4000	-270
chr21	30809274	30817274	30813037	8000	30813274	-4000	4000	-237
chr21	44623093	44631093	44627243	8000	44627093	-4000	4000	150
chr21	30333694	30341694	30337362	8000	30337694	-4000	4000	-332
chr21	44569729	44577729	44573900	8000	44573729	-4000	4000	171
chr21	30285514	30293514	30289397	8000	30289514	-4000	4000	-117
chr21	44642414	44650414	44646753	8000	44646414	-4000	4000	339
chr21	30162805	30170805	30166436	8000	30166805	-4000	4000	-369
chr21	44569729	44577729	44573890	8000	44573729	-4000	4000	161
chr21	44642414	44650414	44646828	8000	44646414	-4000	4000	414
chr21	30493165	30501165	30496902	8000	30497165	-4000	4000	-263
chr21	30278950	30286950	30281996	8000	30282950	-4000	4000	-954
chr21	30809274	30817274	30812925	8000	30813274	-4000	4000	-349
chr21	44653932	44661932	44658308	8000	44657932	-4000	4000	376
chr21	30436275	30444275	30440535	8000	30440275	-4000	4000	260
chr21	44623093	44631093	44627539	8000	44627093	-4000	4000	446
chr21	44653932	44661932	44658061	8000	44657932	-4000	4000	129
chr21	44642414	44650414	44647256	8000	44646414	-4000	4000	842
chr21	44608079	44616079	44612076	8000	44612079	-4000	4000	-3
chr21	30278950	30286950	30282244	8000	30282950	-4000	4000	-706
chr21	30278950	30286950	30282841	8000	30282950	-4000	4000	-109
chr21	44633356	44641356	44637592	8000	44637356	-4000	4000	236
chr21	30426230	30434230	30430620	8000	30430230	-4000	4000	390
chr21	30751428	30759428	30755185	8000	30755428	-4000	4000	-243
chr21	30609930	30617930	30613874	8000	30613930	-4000	4000	-56
chr21	30344606	30352606	30348539	8000	30348606	-4000	4000	-67
chr21	30588440	30596440	30592559	8000	30592440	-4000	4000	119
chr21	44693172	44701172	44697676	8000	44697172	-4000	4000	504
chr21	44569729	44577729	44573858	8000	44573729	-4000	4000	129
chr21	44596597	44604597	44600675	8000	44600597	-4000	4000	78
chr21	30316315	30324315	30319964	8000	30320315	-4000	4000	-351
chr21	44623093	44631093	44627668	8000	44627093	-4000	4000	575
chr21	30537864	30545864	30541779	8000	30541864	-4000	4000	-85
chr21	30537864	30545864	30541773	8000	30541864	-4000	4000	-91
chr21	30631206	30639206	30635310	8000	30635206	-4000	4000	104
chr21	30588440	30596440	30592908	8000	30592440	-4000	4000	468
chr21	44642414	44650414	44647252	8000	44646414	-4000	4000	838
chr21	30421968	30429968	30425751	8000	30425968	-4000	4000	-217
chr21	30609930	30617930	30613720	8000	30613930	-4000	4000	-210
chr21	44642414	44650414	44646833	8000	44646414	-4000	4000	419
chr21	30476367	30484367	30480066	8000	30480367	-4000	4000	-301
chr21	30631206	30639206	30635326	8000	30635206	-4000	4000	120
chr21	30278950	30286950	30282883	8000	30282950	-4000	4000	-67
chr21	30483436	30491436	30487349	8000	30487436	-4000	4000	-87
chr21	30743259	30751259	30747039	8000	30747259	-4000	4000	-220
chr22	46259343	46267343	46259828	8000	46263343	-4000	4000	-3515
chr22	46259343	46267343	46262017	8000	46263343	-4000	4000	-1326
chr22	22240780	22248780	22244957	8000	22244780	-4000	4000	177
chr22	29434583	29442583	29437749	8000	29438583	-4000	4000	-834
chr22	16588810	16596810	16591644	8000	16592810	-4000	4000	-1166
chr22	29434583	29442583	29438904	8000	29438583	-4000	4000	321
chr22	32251347	32259347	32255232	8000	32255347	-4000	4000	-115
chr22	17004222	17012222	17008063	8000	17008222	-4000	4000	-159
chr22	15686026	15694026	15690115	8000	15690026	-4000	4000	89
chr22	23758990	23766990	23766230	8000	23762990	-4000	4000	3240
chr22	15524192	15532192	15529076	8000	15528192	-4000	4000	884
chr22	29057831	29065831	29059045	8000	29061831	-4000	4000	-2786
chr22	46259343	46267343	46262569	8000	46263343	-4000	4000	-774
chr22	50482784	50490784	50483310	8000	50486784	-4000	4000	-3474
chr22	21041960	21049960	21048167	8000	21045960	-4000	4000	2207
chr22	22240780	22248780	22245046	8000	22244780	-4000	4000	266
chr22	21005808	21013808	21009173	8000	21009808	-4000	4000	-635
chr22	21005808	21013808	21009529	8000	21009808	-4000	4000	-279
chr22	29434583	29442583	29437815	8000	29438583	-4000	4000	-768
chr22	46259343	46267343	46259806	8000	46263343	-4000	4000	-3537
chr22	29434583	29442583	29441635	8000	29438583	-4000	4000	3052
chr22	15686026	15694026	15690627	8000	15690026	-4000	4000	601
chr22	18607919	18615919	18608921	8000	18611919	-4000	4000	-2998
chr22	30468017	30476017	30468517	8000	30472017	-4000	4000	-3500
chr22	43888013	43896013	43891295	8000	43892013	-4000	4000	-718
chr22	46259343	46267343	46260434	8000	46263343	-4000	4000	-2909
chr22	35713872	35721872	35720588	8000	35717872	-4000	4000	2716
chr22	16588810	16596810	16590990	8000	16592810	-4000	4000	-1820
chr22	15524192	15532192	15529031	8000	15528192	-4000	4000	839
chr22	29434583	29442583	29437656	8000	29438583	-4000	4000	-927
chr22	29434583	29442583	29437940	8000	29438583	-4000	4000	-643
chr22	38566204	38574204	38568302	8000	38570204	-4000	4000	-1902
chr22	16821411	16829411	16827485	8000	16825411	-4000	4000	2074
chr22	25195858	25203858	25202758	8000	25199858	-4000	4000	2900
chr22	29434583	29442583	29439429	8000	29438583	-4000	4000	846
chr22	29434583	29442583	29441228	8000	29438583	-4000	4000	2645
chr22	23628321	23636321	23632124	8000	23632321	-4000	4000	-197
chr22	32201073	32209073	32202452	8000	32205073	-4000	4000	-2621
chr22	32251347	32259347	32251793	8000	32255347	-4000	4000	-3554
chr22	18607919	18615919	18608217	8000	18611919	-4000	4000	-3702
chr22	29434583	29442583	29441851	8000	29438583	-4000	4000	3268
chr22	29057831	29065831	29061861	8000	29061831	-4000	4000	30
chr22	29434583	29442583	29437569	8000	29438583	-4000	4000	-1014
chr22	32350885	32358885	32358250	8000	32354885	-4000	4000	3365
chr22	21628716	21636716	21636597	8000	21632716	-4000	4000	3881
chr22	24001453	24009453	24005165	8000	24005453	-4000	4000	-288
chr22	50734196	50742196	50740208	8000	50738196	-4000	4000	2012
chr22	50734196	50742196	50739464	8000	50738196	-4000	4000	1268
chr22	21005808	21013808	21009091	8000	21009808	-4000	4000	-717
chr22	21005808	21013808	21009421	8000	21009808	-4000	4000	-387
chr22	21628716	21636716	21635084	8000	21632716	-4000	4000	2368
chr22	29434583	29442583	29438694	8000	29438583	-4000	4000	111
chr22	30468017	30476017	30470209	8000	30472017	-4000	4000	-1808
chr22	35062136	35070136	35067235	8000	35066136	-4000	4000	1099
chr22	26617963	26625963	26625538	8000	26621963	-4000	4000	3575
chr22	16588810	16596810	16590928	8000	16592810	-4000	4000	-1882
chr22	16821411	16829411	16828047	8000	16825411	-4000	4000	2636
chr22	30468017	30476017	30468807	8000	30472017	-4000	4000	-3210
chr22	46259343	46267343	46259347	8000	46263343	-4000	4000	-3996
chr22	46259343	46267343	46259613	8000	46263343	-4000	4000	-3730
chr22	46259343	46267343	46260559	8000	46263343	-4000	4000	-2784
chr22	15686026	15694026	15690500	8000	15690026	-4000	4000	474
chr22	18607919	18615919	18608013	8000	18611919	-4000	4000	-3906
chr22	29434583	29442583	29441470	8000	29438583	-4000	4000	2887
chr22	18607919	18615919	18608209	8000	18611919	-4000	4000	-3710
chr22	15524192	15532192	15528924	8000	15528192	-4000	4000	732
chr22	30468017	30476017	30471957	8000	30472017	-4000	4000	-60
chr22	15686026	15694026	15690339	8000	15690026	-4000	4000	313
chr22	50482784	50490784	50483272	8000	50486784	-4000	4000	-3512
chr22	15686026	15694026	15690557	8000	15690026	-4000	4000	531
chr22	46259343	46267343	46262639	8000	46263343	-4000	4000	-704
chr22	19146292	19154292	19148992	8000	19150292	-4000	4000	-1300
chr22	29434583	29442583	29438528	8000	29438583	-4000	4000	-55
chr22	32350885	32358885	32358325	8000	32354885	-4000	4000	3440
chr22	15524192	15532192	15528966	8000	15528192	-4000	4000	774
chr22	46259343	46267343	46261466	8000	46263343	-4000	4000	-1877
chr22	21041960	21049960	21049031	8000	21045960	-4000	4000	3071
chr22	29434583	29442583	29439025	8000	29438583	-4000	4000	442
chr22	16588810	16596810	16591070	8000	16592810	-4000	4000	-1740
chrX	112450500	112458500	112455506	8000	112454500	-4000	4000	1006
chrX	24310069	24318069	24312238	8000	24314069	-4000	4000	-1831
chrX	26134343	26142343	26139556	8000	26138343	-4000	4000	1213
chrX	30239715	30247715	30243004	8000	30243715	-4000	4000	-711
chrX	49691984	49699984	49694768	8000	49695984	-4000	4000	-1216
chrX	112450500	112458500	112455631	8000	112454500	-4000	4000	1131
chrX	55071030	55079030	55076100	8000	55075030	-4000	4000	1070
chrX	120111913	120119913	120115619	8000	120115913	-4000	4000	-294
chrX	154830662	154838662	154837639	8000	154834662	-4000	4000	2977
chrX	34938796	34946796	34943145	8000	34942796	-4000	4000	349
chrX	126162289	126170289	126164666	8000	126166289	-4000	4000	-1623
chrX	34128314	34136314	34130016	8000	34132314	-4000	4000	-2298
chrX	34938796	34946796	34944264	8000	34942796	-4000	4000	1468
chrX	70045938	70053938	70049896	8000	70049938	-4000	4000	-42
chrX	83504290	83512290	83509454	8000	83508290	-4000	4000	1164
chrX	116166744	116174744	116172993	8000	116170744	-4000	4000	2249
chrX	149877141	149885141	149884454	8000	149881141	-4000	4000	3313
chrX	104250933	104258933	104254781	8000	104254933	-4000	4000	-152
chrX	155993696	156001696	155997645	8000	155997696	-4000	4000	-51
chrX	120154613	120162613	120159056	8000	120158613	-4000	4000	443
chrX	104250933	104258933	104254443	8000	104254933	-4000	4000	-490
chrX	137029995	137037995	137030765	8000	137033995	-4000	4000	-3230
chrX	34128314	34136314	34131996	8000	34132314	-4000	4000	-318
chrX	107770899	107778899	107775322	8000	107774899	-4000	4000	423
chrX	126548814	126556814	126551549	8000	126552814	-4000	4000	-1265
chrX	137562127	137570127	137567649	8000	137566127	-4000	4000	1522
chrX	137029995	137037995	137030394	8000	137033995	-4000	4000	-3601
chrX	137029995	137037995	137031622	8000	137033995	-4000	4000	-2373
chrX	27459341	27467341	27462114	8000	27463341	-4000	4000	-1227
chrX	26188440	26196440	26195026	8000	26192440	-4000	4000	2586
chrX	115285715	115293715	115289768	8000	115289715	-4000	4000	53
chrX	120358085	120366085	120362221	8000	120362085	-4000	4000	136
chrX	120871866	120879866	120875352	8000	120875866	-4000	4000	-514
chrX	110516312	110524312	110521151	8000	110520312	-4000	4000	839
chrX	6531118	6539118	6534150	8000	6535118	-4000	4000	-968
chrX	149877141	149885141	149884673	8000	149881141	-4000	4000	3532
chrX	30305390	30313390	30308429	8000	30309390	-4000	4000	-961
chrX	48352707	48360707	48354630	8000	48356707	-4000	4000	-2077
chrX	83504290	83512290	83508868	8000	83508290	-4000	4000	578
chrX	104009708	104017708	104013429	8000	104013708	-4000	4000	-279
chrX	86144451	86152451	86148885	8000	86148451	-4000	4000	434
chrX	27459341	27467341	27462939	8000	27463341	-4000	4000	-402
chrX	55619400	55627400	55624159	8000	55623400	-4000	4000	759
chrX	151172584	151180584	151180164	8000	151176584	-4000	4000	3580
chrX	50466825	50474825	50470257	8000	50470825	-4000	4000	-568
chrX	137029995	137037995	137031171	8000	137033995	-4000	4000	-2824
chrX	13316053	13324053	13319576	8000	13320053	-4000	4000	-477
chrX	126548814	126556814	126552237	8000	126552814	-4000	4000	-577
chrX	55216346	55224346	55224027	8000	55220346	-4000	4000	3681
chrX	1611059	1619059	1615226	8000	1615059	-4000	4000	167
chrX	31068041	31076041	31071644	8000	31072041	-4000	4000	-397
chrX	70419031	70427031	70426883	8000	70423031	-4000	4000	3852
chrX	102933272	102941272	102937717	8000	102937272	-4000	4000	445
chrX	126548814	126556814	126551487	8000	126552814	-4000	4000	-1327
chrX	140501069	140509069	140504644	8000	140505069	-4000	4000	-425
chrX	89917908	89925908	89922123	8000	89921908	-4000	4000	215
chrX	104035956	104043956	104040127	8000	104039956	-4000	4000	171
chrX	104009708	104017708	104013618	8000	104013708	-4000	4000	-90
chrX	115185410	115193410	115190509	8000	115189410	-4000	4000	1099
chrX	126815729	126823729	126821076	8000	126819729	-4000	4000	1347
chrX	137562127	137570127	137566640	8000	137566127	-4000	4000	513
chrX	137562127	137570127	137566876	8000	137566127	-4000	4000	749
chrX	118819824	118827824	118825479	8000	118823824	-4000	4000	1655
chrX	115185410	115193410	115191465	8000	115189410	-4000	4000	2055
chrX	120871866	120879866	120875304	8000	120875866	-4000	4000	-562
chrX	126162289	126170289	126164585	8000	126166289	-4000	4000	-1704
chrX	34128314	34136314	34131267	8000	34132314	-4000	4000	-1047
chrX	152134578	152142578	152135459	8000	152138578	-4000	4000	-3119
chrX	11289413	11297413	11290422	8000	11293413	-4000	4000	-2991
chrX	18216886	18224886	18220901	8000	18220886	-4000	4000	15
chrX	34128314	34136314	34130819	8000	34132314	-4000	4000	-1495
chrX	70278093	70286093	70283574	8000	70282093	-4000	4000	1481
chrX	83504290	83512290	83508656	8000	83508290	-4000	4000	366
chrX	83504290	83512290	83509170	8000	83508290	-4000	4000	880
chrX	115185410	115193410	115190239	8000	115189410	-4000	4000	829
chrX	120111913	120119913	120115690	8000	120115913	-4000	4000	-223
chrX	152990116	152998116	152990659	8000	152994116	-4000	4000	-3457
chrX	105216694	105224694	105219979	8000	105220694	-4000	4000	-715
chrX	128048403	128056403	128051540	8000	128052403	-4000	4000	-863
chrX	26188440	26196440	26194448	8000	26192440	-4000	4000	2008
chrX	8797383	8805383	8798983	8000	8801383	-4000	4000	-2400
chrX	115185410	115193410	115192064	8000	115189410	-4000	4000	2654
chrX	70230655	70238655	70234691	8000	70234655	-4000	4000	36
chrX	131540074	131548074	131544411	8000	131544074	-4000	4000	337
chrX	70230655	70238655	70237073	8000	70234655	-4000	4000	2418
chrX	30239715	30247715	30242709	8000	30243715	-4000	4000	-1006
chrX	154649579	154657579	154653324	8000	154653579	-4000	4000	-255
chrX	52807287	52815287	52813148	8000	52811287	-4000	4000	1861
chrX	34938796	34946796	34944461	8000	34942796	-4000	4000	1665
chrX	30239715	30247715	30242759	8000	30243715	-4000	4000	-956
chrX	120871866	120879866	120873871	8000	120875866	-4000	4000	-1995
chrX	136483947	136491947	136488169	8000	136487947	-4000	4000	222
chrX	26188440	26196440	26194798	8000	26192440	-4000	4000	2358
chrX	147977337	147985337	147981618	8000	147981337	-4000	4000	281
chrX	34128314	34136314	34131780	8000	34132314	-4000	4000	-534
chrX	44840021	44848021	44844467	8000	44844021	-4000	4000	446
chrX	34128314	34136314	34131740	8000	34132314	-4000	4000	-574
chrX	50906735	50914735	50910804	8000	50910735	-4000	4000	69
chrX	26134343	26142343	26139463	8000	26138343	-4000	4000	1120
chrX	34938796	34946796	34943398	8000	34942796	-4000	4000	602
chrX	26188440	26196440	26193818	8000	26192440	-4000	4000	1378
chrX	141899894	141907894	141905714	8000	141903894	-4000	4000	1820
chrX	27977449	27985449	27980399	8000	27981449	-4000	4000	-1050
chrX	102933272	102941272	102938058	8000	102937272	-4000	4000	786
chrX	110516312	110524312	110521641	8000	110520312	-4000	4000	1329
chrX	115185410	115193410	115192034	8000	115189410	-4000	4000	2624
chrX	151690607	151698607	151698560	8000	151694607	-4000	4000	3953
chrX	27977449	27985449	27980907	8000	27981449	-4000	4000	-542
chrX	119068960	119076960	119073993	8000	119072960	-4000	4000	1033
chrX	149591314	149599314	149597961	8000	149595314	-4000	4000	2647
chrX	110516312	110524312	110521570	8000	110520312	-4000	4000	1258
chrX	126162289	126170289	126164788	8000	126166289	-4000	4000	-1501
chrX	141694739	141702739	141697643	8000	141698739	-4000	4000	-1096
chrX	21654330	21662330	21657474	8000	21658330	-4000	4000	-856
chrX	55619400	55627400	55624502	8000	55623400	-4000	4000	1102
chrX	70058457	70066457	70063244	8000	70062457	-4000	4000	787
chrX	128048403	128056403	128051913	8000	128052403	-4000	4000	-490
chrX	104108131	104116131	104115328	8000	104112131	-4000	4000	3197
chrX	133214354	133222354	133217050	8000	133218354	-4000	4000	-1304
chrX	133214354	133222354	133217051	8000	133218354	-4000	4000	-1303
chrX	118819824	118827824	118825274	8000	118823824	-4000	4000	1450
chrX	70278093	70286093	70284630	8000	70282093	-4000	4000	2537
chrX	24356639	24364639	24363449	8000	24360639	-4000	4000	2810
chrX	105216694	105224694	105219449	8000	105220694	-4000	4000	-1245
chrX	34938796	34946796	34943685	8000	34942796	-4000	4000	889
chrX	26134343	26142343	26139736	8000	26138343	-4000	4000	1393
chrX	51402948	51410948	51406955	8000	51406948	-4000	4000	7
chrX	51402948	51410948	51408199	8000	51406948	-4000	4000	1251
chrX	151172584	151180584	151180580	8000	151176584	-4000	4000	3996
chrX	55260916	55268916	55263268	8000	55264916	-4000	4000	-1648
chrX	70256204	70264204	70259416	8000	70260204	-4000	4000	-788
chrX	31068041	31076041	31071781	8000	31072041	-4000	4000	-260
chrX	151172584	151180584	151180160	8000	151176584	-4000	4000	3576
chrX	75781254	75789254	75784267	8000	75785254	-4000	4000	-987
chrX	47366578	47374578	47370733	8000	47370578	-4000	4000	155
chrX	51402948	51410948	51408340	8000	51406948	-4000	4000	1392
chrX	13316053	13324053	13319871	8000	13320053	-4000	4000	-182
chrX	34938796	34946796	34943558	8000	34942796	-4000	4000	762
chrX	26156601	26164601	26161275	8000	26160601	-4000	4000	674
chrX	34938796	34946796	34943297	8000	34942796	-4000	4000	501
chrX	126548814	126556814	126550970	8000	126552814	-4000	4000	-1844
chrX	104250933	104258933	104254236	8000	104254933	-4000	4000	-697
chrX	55619400	55627400	55624286	8000	55623400	-4000	4000	886
chrX	104108131	104116131	104114830	8000	104112131	-4000	4000	2699
chrX	126815729	126823729	126821286	8000	126819729	-4000	4000	1557
chrX	93670013	93678013	93671718	8000	93674013	-4000	4000	-2295
chrX	102933272	102941272	102938080	8000	102937272	-4000	4000	808
chrX	149877141	149885141	149884761	8000	149881141	-4000	4000	3620
chrX	128048403	128056403	128051887	8000	128052403	-4000	4000	-516
chrX	37004366	37012366	37008734	8000	37008366	-4000	4000	368
chrX	115185410	115193410	115190183	8000	115189410	-4000	4000	773
chrX	83504290	83512290	83509238	8000	83508290	-4000	4000	948
chrX	141899894	141907894	141907694	8000	141903894	-4000	4000	3800
chrX	35794342	35802342	35802161	8000	35798342	-4000	4000	3819
chrX	52793427	52801427	52796503	8000	52797427	-4000	4000	-924
chrX	86144451	86152451	86149048	8000	86148451	-4000	4000	597
chrX	6531118	6539118	6533946	8000	6535118	-4000	4000	-1172
chrX	118819824	118827824	118826073	8000	118823824	-4000	4000	2249
chrX	154291853	154299853	154295862	8000	154295853	-4000	4000	9
chrX	26156601	26164601	26161516	8000	26160601	-4000	4000	915
chrX	26188440	26196440	26194486	8000	26192440	-4000	4000	2046
chrX	70927125	70935125	70927804	8000	70931125	-4000	4000	-3321
chrX	102933272	102941272	102937507	8000	102937272	-4000	4000	235
chrX	120871866	120879866	120875391	8000	120875866	-4000	4000	-475
chrX	131540074	131548074	131544371	8000	131544074	-4000	4000	297
chrX	149877141	149885141	149884681	8000	149881141	-4000	4000	3540
chrX	37004366	37012366	37009869	8000	37008366	-4000	4000	1503
chrX	26156601	26164601	26161732	8000	26160601	-4000	4000	1131
chrX	21654330	21662330	21657454	8000	21658330	-4000	4000	-876
chrX	126548814	126556814	126551990	8000	126552814	-4000	4000	-824
chrX	52650900	52658900	52652327	8000	52654900	-4000	4000	-2573
chrX	115185410	115193410	115192103	8000	115189410	-4000	4000	2693
chrX	27977449	27985449	27981152	8000	27981449	-4000	4000	-297
chrX	152990116	152998116	152990814	8000	152994116	-4000	4000	-3302
chrX	70256204	70264204	70258701	8000	70260204	-4000	4000	-1503
chrX	93670013	93678013	93672935	8000	93674013	-4000	4000	-1078
chrX	137562127	137570127	137569052	8000	137566127	-4000	4000	2925
chrX	64391452	64399452	64395419	8000	64395452	-4000	4000	-33
chrX	149770068	149778068	149774785	8000	149774068	-4000	4000	717
chrX	137562127	137570127	137566940	8000	137566127	-4000	4000	813
chrX	105216694	105224694	105220072	8000	105220694	-4000	4000	-622
chrX	30211563	30219563	30218974	8000	30215563	-4000	4000	3411
chrX	115185410	115193410	115189513	8000	115189410	-4000	4000	103
chrX	74300180	74308180	74304261	8000	74304180	-4000	4000	81
chrX	37004366	37012366	37009534	8000	37008366	-4000	4000	1168
chrX	118819824	118827824	118826566	8000	118823824	-4000	4000	2742
chrX	149684228	149692228	149688837	8000	149688228	-4000	4000	609
chrX	137562127	137570127	137570098	8000	137566127	-4000	4000	3971
chrX	34128314	34136314	34131378	8000	34132314	-4000	4000	-936
chrX	149770068	149778068	149775040	8000	149774068	-4000	4000	972
chrX	115185410	115193410	115190549	8000	115189410	-4000	4000	1139
chrX	8460830	8468830	8466351	8000	8464830	-4000	4000	1521
chrX	55085018	55093018	55091393	8000	55089018	-4000	4000	2375
chrX	141899894	141907894	141907075	8000	141903894	-4000	4000	3181
chrX	27977449	27985449	27979573	8000	27981449	-4000	4000	-1876
chrX	141899894	141907894	141905516	8000	141903894	-4000	4000	1622
chrX	126162289	126170289	126164887	8000	126166289	-4000	4000	-1402
chrX	27977449	27985449	27979587	8000	27981449	-4000	4000	-1862
chrX	87513409	87521409	87517965	8000	87517409	-4000	4000	556
chrX	55216346	55224346	55221802	8000	55220346	-4000	4000	1456
chrX	70230655	70238655	70238313	8000	70234655	-4000	4000	3658
chrX	78655328	78663328	78658073	8000	78659328	-4000	4000	-1255
chrX	48352707	48360707	48355181	8000	48356707	-4000	4000	-1526
chrX	107770899	107778899	107775146	8000	107774899	-4000	4000	247
chrX	154830662	154838662	154837543	8000	154834662	-4000	4000	2881
chrX	51402948	51410948	51408546	8000	51406948	-4000	4000	1598
chrX	37004366	37012366	37010197	8000	37008366	-4000	4000	1831
chrX	13316053	13324053	13319780	8000	13320053	-4000	4000	-273
chrX	73075512	73083512	73077850	8000	73079512	-4000	4000	-1662
chrX	112450500	112458500	112457124	8000	112454500	-4000	4000	2624
chrX	78655328	78663328	78657141	8000	78659328	-4000	4000	-2187
chrX	34128314	34136314	34130648	8000	34132314	-4000	4000	-1666
chrX	126815729	126823729	126821328	8000	126819729	-4000	4000	1599
chrX	8460830	8468830	8465353	8000	8464830	-4000	4000	523
chrX	3002546	3010546	3010046	8000	3006546	-4000	4000	3500
chrX	13316053	13324053	13318893	8000	13320053	-4000	4000	-1160
chrX	37004366	37012366	37009509	8000	37008366	-4000	4000	1143
chrX	112450500	112458500	112455364	8000	112454500	-4000	4000	864
chrX	34128314	34136314	34132111	8000	34132314	-4000	4000	-203
chrX	137562127	137570127	137570003	8000	137566127	-4000	4000	3876
chrX	13316053	13324053	13319991	8000	13320053	-4000	4000	-62
chrX	37004366	37012366	37009149	8000	37008366	-4000	4000	783
chrX	78655328	78663328	78658386	8000	78659328	-4000	4000	-942
chrX	135167398	135175398	135171103	8000	135171398	-4000	4000	-295
chrX	37004366	37012366	37010562	8000	37008366	-4000	4000	2196
chrX	44840021	44848021	44844223	8000	44844021	-4000	4000	202
chrX	52365021	52373021	52370080	8000	52369021	-4000	4000	1059
chrX	89917908	89925908	89922797	8000	89921908	-4000	4000	889
chrX	128048403	128056403	128051447	8000	128052403	-4000	4000	-956
chrX	140501069	140509069	140504607	8000	140505069	-4000	4000	-462
chrX	30305390	30313390	30308746	8000	30309390	-4000	4000	-644
chrX	27459341	27467341	27460819	8000	27463341	-4000	4000	-2522
chrX	70230655	70238655	70238273	8000	70234655	-4000	4000	3618
chrX	110516312	110524312	110521974	8000	110520312	-4000	4000	1662
chrX	22995960	23003960	23000541	8000	22999960	-4000	4000	581
chrX	120154613	120162613	120159120	8000	120158613	-4000	4000	507
chrX	49318037	49326037	49323226	8000	49322037	-4000	4000	1189
chrX	55085018	55093018	55090512	8000	55089018	-4000	4000	1494
chrX	106034727	106042727	106037281	8000	106038727	-4000	4000	-1446
chrX	22995960	23003960	23001656	8000	22999960	-4000	4000	1696
chrX	21654330	21662330	21656297	8000	21658330	-4000	4000	-2033
chrX	6531118	6539118	6534104	8000	6535118	-4000	4000	-1014
chrX	7838262	7846262	7843597	8000	7842262	-4000	4000	1335
chrX	8167267	8175267	8170250	8000	8171267	-4000	4000	-1017
chrX	21654330	21662330	21656238	8000	21658330	-4000	4000	-2092
chrX	35915734	35923734	35919788	8000	35919734	-4000	4000	54
chrX	49337192	49345192	49342913	8000	49341192	-4000	4000	1721
chrX	51402948	51410948	51407094	8000	51406948	-4000	4000	146
chrX	70058457	70066457	70063145	8000	70062457	-4000	4000	688
chrX	104108131	104116131	104113923	8000	104112131	-4000	4000	1792
chrX	126548814	126556814	126551974	8000	126552814	-4000	4000	-840
chrX	131540074	131548074	131544729	8000	131544074	-4000	4000	655
chrX	155993696	156001696	156001480	8000	155997696	-4000	4000	3784
chrX	50906735	50914735	50911112	8000	50910735	-4000	4000	377
chrX	37004366	37012366	37011456	8000	37008366	-4000	4000	3090
chrX	104250933	104258933	104254226	8000	104254933	-4000	4000	-707
chrX	120073690	120081690	120077019	8000	120077690	-4000	4000	-671
chrX	48192795	48200795	48194203	8000	48196795	-4000	4000	-2592
chrX	27977449	27985449	27980964	8000	27981449	-4000	4000	-485
chrX	34128314	34136314	34131062	8000	34132314	-4000	4000	-1252
chrX	115185410	115193410	115190495	8000	115189410	-4000	4000	1085
chrX	41720181	41728181	41727606	8000	41724181	-4000	4000	3425
chrX	149877141	149885141	149884994	8000	149881141	-4000	4000	3853
chrX	15380413	15388413	15384040	8000	15384413	-4000	4000	-373
chrX	115185410	115193410	115188328	8000	115189410	-4000	4000	-1082
chrX	71297750	71305750	71297888	8000	71301750	-4000	4000	-3862
chrX	34128314	34136314	34131459	8000	34132314	-4000	4000	-855
chrX	34938796	34946796	34943803	8000	34942796	-4000	4000	1007
chrX	52864083	52872083	52867265	8000	52868083	-4000	4000	-818
chrX	74300180	74308180	74304375	8000	74304180	-4000	4000	195
chrX	74300180	74308180	74304630	8000	74304180	-4000	4000	450
chrX	93670013	93678013	93671718	8000	93674013	-4000	4000	-2295
chrX	112450500	112458500	112455352	8000	112454500	-4000	4000	852
chrX	119754588	119762588	119759796	8000	119758588	-4000	4000	1208
chrX	152134578	152142578	152135560	8000	152138578	-4000	4000	-3018
chrX	24356639	24364639	24363868	8000	24360639	-4000	4000	3229
chrX	26188440	26196440	26195160	8000	26192440	-4000	4000	2720
chrX	30239715	30247715	30242595	8000	30243715	-4000	4000	-1120
chrX	37004366	37012366	37008449	8000	37008366	-4000	4000	83
chrX	102933272	102941272	102937997	8000	102937272	-4000	4000	725
chrX	136483947	136491947	136488464	8000	136487947	-4000	4000	517
chrX	152990116	152998116	152991687	8000	152994116	-4000	4000	-2429
chrX	55619400	55627400	55623553	8000	55623400	-4000	4000	153
chrX	143717423	143725423	143720604	8000	143721423	-4000	4000	-819
chrX	155993696	156001696	155997784	8000	155997696	-4000	4000	88
chrX	103272750	103280750	103274048	8000	103276750	-4000	4000	-2702
chrX	115185410	115193410	115191125	8000	115189410	-4000	4000	1715
chrX	126548814	126556814	126551721	8000	126552814	-4000	4000	-1093
chrX	104108131	104116131	104114991	8000	104112131	-4000	4000	2860
chrX	149591314	149599314	149598126	8000	149595314	-4000	4000	2812
chrX	30239715	30247715	30242610	8000	30243715	-4000	4000	-1105
chrX	83504290	83512290	83508498	8000	83508290	-4000	4000	208
chrX	55216346	55224346	55221792	8000	55220346	-4000	4000	1446
chrX	55619400	55627400	55624652	8000	55623400	-4000	4000	1252
chrX	70058457	70066457	70063165	8000	70062457	-4000	4000	708
chrX	34128314	34136314	34130758	8000	34132314	-4000	4000	-1556
chrX	15311640	15319640	15314497	8000	15315640	-4000	4000	-1143
chrX	74300180	74308180	74304596	8000	74304180	-4000	4000	416
chrX	78655328	78663328	78657472	8000	78659328	-4000	4000	-1856
chrX	27977449	27985449	27978762	8000	27981449	-4000	4000	-2687
chrX	48352707	48360707	48354718	8000	48356707	-4000	4000	-1989
chrX	35915734	35923734	35919828	8000	35919734	-4000	4000	94
chrX	71297750	71305750	71303473	8000	71301750	-4000	4000	1723
chrX	51402948	51410948	51408334	8000	51406948	-4000	4000	1386
chrX	107978370	107986370	107981500	8000	107982370	-4000	4000	-870
chrX	149770068	149778068	149774603	8000	149774068	-4000	4000	535
chrX	51402948	51410948	51407242	8000	51406948	-4000	4000	294
chrX	126162289	126170289	126164673	8000	126166289	-4000	4000	-1616
chrX	137029995	137037995	137031447	8000	137033995	-4000	4000	-2548
chrX	118819824	118827824	118826331	8000	118823824	-4000	4000	2507
chrX	75781254	75789254	75784285	8000	75785254	-4000	4000	-969
chrX	133214354	133222354	133217229	8000	133218354	-4000	4000	-1125
chrX	70278093	70286093	70281707	8000	70282093	-4000	4000	-386
chrX	115185410	115193410	115191741	8000	115189410	-4000	4000	2331
chrX	149877141	149885141	149885064	8000	149881141	-4000	4000	3923
chrX	24310069	24318069	24311343	8000	24314069	-4000	4000	-2726
chrX	37004366	37012366	37011276	8000	37008366	-4000	4000	2910
chrX	137029995	137037995	137030693	8000	137033995	-4000	4000	-3302
chrX	107978370	107986370	107981008	8000	107982370	-4000	4000	-1362
chrX	101074879	101082879	101078947	8000	101078879	-4000	4000	68
chrX	34128314	34136314	34130724	8000	34132314	-4000	4000	-1590
chrX	8797383	8805383	8798392	8000	8801383	-4000	4000	-2991
chrX	115185410	115193410	115190971	8000	115189410	-4000	4000	1561
chrX	26188440	26196440	26193816	8000	26192440	-4000	4000	1376
chrX	52365021	52373021	52370638	8000	52369021	-4000	4000	1617
chrX	52807287	52815287	52813211	8000	52811287	-4000	4000	1924
chrX	103706909	103714909	103713636	8000	103710909	-4000	4000	2727
chrX	41443343	41451343	41447725	8000	41447343	-4000	4000	382
chrX	154291853	154299853	154295788	8000	154295853	-4000	4000	-65
chrX	78655328	78663328	78657677	8000	78659328	-4000	4000	-1651
chrX	24310069	24318069	24312331	8000	24314069	-4000	4000	-1738
chrX	35794342	35802342	35802257	8000	35798342	-4000	4000	3915
chrX	103706909	103714909	103713705	8000	103710909	-4000	4000	2796
chrX	126162289	126170289	126164915	8000	126166289	-4000	4000	-1374
chrX	55085018	55093018	55091337	8000	55089018	-4000	4000	2319
chrX	137562127	137570127	137566571	8000	137566127	-4000	4000	444
chrX	27977449	27985449	27980248	8000	27981449	-4000	4000	-1201
chrX	130167962	130175962	130171999	8000	130171962	-4000	4000	37
chrX	128048403	128056403	128052111	8000	128052403	-4000	4000	-292
chrX	126162289	126170289	126165427	8000	126166289	-4000	4000	-862
chrX	128048403	128056403	128051348	8000	128052403	-4000	4000	-1055
chrX	70927125	70935125	70929851	8000	70931125	-4000	4000	-1274
chrX	104108131	104116131	104114692	8000	104112131	-4000	4000	2561
chrX	22995960	23003960	23001249	8000	22999960	-4000	4000	1289
chrX	34128314	34136314	34130979	8000	34132314	-4000	4000	-1335
chrX	34938796	34946796	34943297	8000	34942796	-4000	4000	501
chrX	48251392	48259392	48257773	8000	48255392	-4000	4000	2381
chrX	48251392	48259392	48257774	8000	48255392	-4000	4000	2382
chrX	30211563	30219563	30218598	8000	30215563	-4000	4000	3035
chrX	83504290	83512290	83508341	8000	83508290	-4000	4000	51
chrX	149591314	149599314	149598096	8000	149595314	-4000	4000	2782
chrX	70419031	70427031	70419760	8000	70423031	-4000	4000	-3271
chrX	103089143	103097143	103093069	8000	103093143	-4000	4000	-74
chrX	137029995	137037995	137030221	8000	137033995	-4000	4000	-3774
chrX	152990116	152998116	152990513	8000	152994116	-4000	4000	-3603
chrX	13040682	13048682	13043138	8000	13044682	-4000	4000	-1544
chrX	24310069	24318069	24312883	8000	24314069	-4000	4000	-1186
chrX	37004366	37012366	37010794	8000	37008366	-4000	4000	2428
chrX	52793427	52801427	52797332	8000	52797427	-4000	4000	-95
chrX	52807287	52815287	52815145	8000	52811287	-4000	4000	3858
chrX	55260916	55268916	55263272	8000	55264916	-4000	4000	-1644
chrX	75781254	75789254	75783624	8000	75785254	-4000	4000	-1630
chrX	93670013	93678013	93672782	8000	93674013	-4000	4000	-1231
chrX	120871866	120879866	120875034	8000	120875866	-4000	4000	-832
chrX	133214354	133222354	133217866	8000	133218354	-4000	4000	-488
chrX	141899894	141907894	141906855	8000	141903894	-4000	4000	2961
chrX	141899894	141907894	141907064	8000	141903894	-4000	4000	3170
chrX	154880972	154888972	154885193	8000	154884972	-4000	4000	221
chrX	34938796	34946796	34943844	8000	34942796	-4000	4000	1048
chrX	152134578	152142578	152134594	8000	152138578	-4000	4000	-3984
chrX	152990116	152998116	152991331	8000	152994116	-4000	4000	-2785
chrX	18668108	18676108	18672069	8000	18672108	-4000	4000	-39
chrX	30305390	30313390	30308620	8000	30309390	-4000	4000	-770
chrX	22995960	23003960	23000611	8000	22999960	-4000	4000	651
chrX	136483947	136491947	136488493	8000	136487947	-4000	4000	546
chrX	73443053	73451053	73447325	8000	73447053	-4000	4000	272
chrX	15380413	15388413	15384873	8000	15384413	-4000	4000	460
chrX	126548814	126556814	126551759	8000	126552814	-4000	4000	-1055
chrX	48822513	48830513	48829986	8000	48826513	-4000	4000	3473
chrX	93670013	93678013	93673471	8000	93674013	-4000	4000	-542
chrX	141899894	141907894	141907681	8000	141903894	-4000	4000	3787
chrX	132124020	132132020	132127940	8000	132128020	-4000	4000	-80
chrX	22995960	23003960	23000208	8000	22999960	-4000	4000	248
chrX	22995960	23003960	23001701	8000	22999960	-4000	4000	1741
chrX	26134343	26142343	26138993	8000	26138343	-4000	4000	650
chrX	26188440	26196440	26194523	8000	26192440	-4000	4000	2083
chrX	26188440	26196440	26194606	8000	26192440	-4000	4000	2166
chrX	27977449	27985449	27981022	8000	27981449	-4000	4000	-427
chrX	30239715	30247715	30242302	8000	30243715	-4000	4000	-1413
chrX	30239715	30247715	30242946	8000	30243715	-4000	4000	-769
chrX	31068041	31076041	31071278	8000	31072041	-4000	4000	-763
chrX	34938796	34946796	34943351	8000	34942796	-4000	4000	555
chrX	51402948	51410948	51408162	8000	51406948	-4000	4000	1214
chrX	70256204	70264204	70259201	8000	70260204	-4000	4000	-1003
chrX	70278093	70286093	70282822	8000	70282093	-4000	4000	729
chrX	83504290	83512290	83509278	8000	83508290	-4000	4000	988
chrX	101289057	101297057	101292889	8000	101293057	-4000	4000	-168
chrX	103272750	103280750	103274580	8000	103276750	-4000	4000	-2170
chrX	103706909	103714909	103713798	8000	103710909	-4000	4000	2889
chrX	104250933	104258933	104254891	8000	104254933	-4000	4000	-42
chrX	105216694	105224694	105219122	8000	105220694	-4000	4000	-1572
chrX	106034727	106042727	106036621	8000	106038727	-4000	4000	-2106
chrX	107770899	107778899	107775275	8000	107774899	-4000	4000	376
chrX	115285715	115293715	115289767	8000	115289715	-4000	4000	52
chrX	116166744	116174744	116172372	8000	116170744	-4000	4000	1628
chrX	130381674	130389674	130384498	8000	130385674	-4000	4000	-1176
chrX	143717423	143725423	143720601	8000	143721423	-4000	4000	-822
chrX	15380413	15388413	15384980	8000	15384413	-4000	4000	567
chrX	70419031	70427031	70420264	8000	70423031	-4000	4000	-2767
chrX	75781254	75789254	75783794	8000	75785254	-4000	4000	-1460
chrX	87513409	87521409	87518198	8000	87517409	-4000	4000	789
chrX	89917908	89925908	89922817	8000	89921908	-4000	4000	909
chrX	120073690	120081690	120077038	8000	120077690	-4000	4000	-652
chrX	133214354	133222354	133217593	8000	133218354	-4000	4000	-761
chrX	37004366	37012366	37009335	8000	37008366	-4000	4000	969
chrX	30239715	30247715	30242801	8000	30243715	-4000	4000	-914
chrX	70419031	70427031	70425790	8000	70423031	-4000	4000	2759
chrX	27977449	27985449	27980827	8000	27981449	-4000	4000	-622
chrX	100870359	100878359	100874169	8000	100874359	-4000	4000	-190
chrX	118819824	118827824	118825588	8000	118823824	-4000	4000	1764
chrX	115285715	115293715	115289768	8000	115289715	-4000	4000	53
chrX	37004366	37012366	37009928	8000	37008366	-4000	4000	1562
chrX	137562127	137570127	137566608	8000	137566127	-4000	4000	481
chrX	34938796	34946796	34942859	8000	34942796	-4000	4000	63
chrX	22995960	23003960	23001637	8000	22999960	-4000	4000	1677
chrX	37004366	37012366	37010302	8000	37008366	-4000	4000	1936
chrX	70173483	70181483	70177642	8000	70177483	-4000	4000	159
chrX	78655328	78663328	78657771	8000	78659328	-4000	4000	-1557
chrX	126548814	126556814	126551673	8000	126552814	-4000	4000	-1141
chrX	24356639	24364639	24363569	8000	24360639	-4000	4000	2930
chrX	70419031	70427031	70419697	8000	70423031	-4000	4000	-3334
chrX	115185410	115193410	115191842	8000	115189410	-4000	4000	2432
chrX	27977449	27985449	27980821	8000	27981449	-4000	4000	-628
chrX	154649579	154657579	154653318	8000	154653579	-4000	4000	-261
chrX	70927125	70935125	70929992	8000	70931125	-4000	4000	-1133
chrX	52793427	52801427	52796356	8000	52797427	-4000	4000	-1071
chrX	8460830	8468830	8466386	8000	8464830	-4000	4000	1556
chrX	13040682	13048682	13043210	8000	13044682	-4000	4000	-1472
chrX	26134343	26142343	26139498	8000	26138343	-4000	4000	1155
chrX	30239715	30247715	30242179	8000	30243715	-4000	4000	-1536
chrX	44840021	44848021	44844364	8000	44844021	-4000	4000	343
chrX	71297750	71305750	71300162	8000	71301750	-4000	4000	-1588
chrX	71297750	71305750	71305277	8000	71301750	-4000	4000	3527
chrX	75781254	75789254	75783315	8000	75785254	-4000	4000	-1939
chrX	104035956	104043956	104040248	8000	104039956	-4000	4000	292
chrX	116166744	116174744	116172958	8000	116170744	-4000	4000	2214
chrX	140501069	140509069	140504467	8000	140505069	-4000	4000	-602
chrX	115185410	115193410	115192068	8000	115189410	-4000	4000	2658
chrX	37004366	37012366	37008565	8000	37008366	-4000	4000	199
chrX	24356639	24364639	24364432	8000	24360639	-4000	4000	3793
chrX	34128314	34136314	34131780	8000	34132314	-4000	4000	-534
chrX	152134578	152142578	152134779	8000	152138578	-4000	4000	-3799
chrX	55071030	55079030	55077413	8000	55075030	-4000	4000	2383
chrX	104035956	104043956	104040041	8000	104039956	-4000	4000	85
chrX	27459341	27467341	27461484	8000	27463341	-4000	4000	-1857
chrX	55085018	55093018	55091412	8000	55089018	-4000	4000	2394
chrX	116166744	116174744	116173216	8000	116170744	-4000	4000	2472
chrX	116166744	116174744	116173731	8000	116170744	-4000	4000	2987
chrX	83504290	83512290	83508887	8000	83508290	-4000	4000	597
chrX	128048403	128056403	128052095	8000	128052403	-4000	4000	-308
chrX	26188440	26196440	26195268	8000	26192440	-4000	4000	2828
chrX	120154613	120162613	120159175	8000	120158613	-4000	4000	562
chrX	22995960	23003960	23000078	8000	22999960	-4000	4000	118
chrX	18216886	18224886	18220796	8000	18220886	-4000	4000	-90
chrX	49691984	49699984	49694775	8000	49695984	-4000	4000	-1209
chrX	24310069	24318069	24312505	8000	24314069	-4000	4000	-1564
chrX	70927125	70935125	70928499	8000	70931125	-4000	4000	-2626
chrX	30239715	30247715	30242603	8000	30243715	-4000	4000	-1112
chrX	34128314	34136314	34130578	8000	34132314	-4000	4000	-1736
chrX	34128314	34136314	34132083	8000	34132314	-4000	4000	-231
chrX	115185410	115193410	115191336	8000	115189410	-4000	4000	1926
chrX	137029995	137037995	137031098	8000	137033995	-4000	4000	-2897
chrX	70927125	70935125	70929724	8000	70931125	-4000	4000	-1401
chrX	118819824	118827824	118826449	8000	118823824	-4000	4000	2625
chrX	37004366	37012366	37008571	8000	37008366	-4000	4000	205
chrX	71297750	71305750	71301782	8000	71301750	-4000	4000	32
chrX	71297750	71305750	71304587	8000	71301750	-4000	4000	2837
chrX	27977449	27985449	27979488	8000	27981449	-4000	4000	-1961
chrX	26156601	26164601	26161271	8000	26160601	-4000	4000	670
chrX	119146579	119154579	119150501	8000	119150579	-4000	4000	-78
chrX	110516312	110524312	110521682	8000	110520312	-4000	4000	1370
chrX	141834316	141842316	141838318	8000	141838316	-4000	4000	2
chrX	141899894	141907894	141906479	8000	141903894	-4000	4000	2585
chrX	34938796	34946796	34943722	8000	34942796	-4000	4000	926
chrX	34938796	34946796	34943560	8000	34942796	-4000	4000	764
chrX	51402948	51410948	51407555	8000	51406948	-4000	4000	607
chrX	78655328	78663328	78656818	8000	78659328	-4000	4000	-2510
chrX	15380413	15388413	15384061	8000	15384413	-4000	4000	-352
chrX	93670013	93678013	93672870	8000	93674013	-4000	4000	-1143
chrX	100925433	100933433	100928280	8000	100929433	-4000	4000	-1153
chrX	27459341	27467341	27461287	8000	27463341	-4000	4000	-2054
chrX	52807287	52815287	52815149	8000	52811287	-4000	4000	3862
chrX	103706909	103714909	103707345	8000	103710909	-4000	4000	-3564
chrX	126548814	126556814	126552131	8000	126552814	-4000	4000	-683
chrX	22995960	23003960	23000537	8000	22999960	-4000	4000	577
chrX	26134343	26142343	26139970	8000	26138343	-4000	4000	1627
chrX	24310069	24318069	24312357	8000	24314069	-4000	4000	-1712
chrX	70058457	70066457	70063744	8000	70062457	-4000	4000	1287
chrX	149591314	149599314	149594516	8000	149595314	-4000	4000	-798
chrX	30211563	30219563	30219055	8000	30215563	-4000	4000	3492
chrX	70256204	70264204	70259201	8000	70260204	-4000	4000	-1003
chrX	34938796	34946796	34942924	8000	34942796	-4000	4000	128
chrX	75781254	75789254	75783253	8000	75785254	-4000	4000	-2001
chrX	75781254	75789254	75784566	8000	75785254	-4000	4000	-688
chrX	115285715	115293715	115289808	8000	115289715	-4000	4000	93
chrX	141899894	141907894	141907607	8000	141903894	-4000	4000	3713
chrX	75781254	75789254	75784313	8000	75785254	-4000	4000	-941
chrX	74300180	74308180	74304252	8000	74304180	-4000	4000	72
chrX	119146579	119154579	119150317	8000	119150579	-4000	4000	-262
chrX	24310069	24318069	24311469	8000	24314069	-4000	4000	-2600
chrX	70419031	70427031	70419747	8000	70423031	-4000	4000	-3284
chrX	104108131	104116131	104115556	8000	104112131	-4000	4000	3425
chrX	71297750	71305750	71304584	8000	71301750	-4000	4000	2834
chrX	120154613	120162613	120159185	8000	120158613	-4000	4000	572
chrX	49691984	49699984	49694767	8000	49695984	-4000	4000	-1217
chrX	74300180	74308180	74304224	8000	74304180	-4000	4000	44
chrX	120871866	120879866	120875399	8000	120875866	-4000	4000	-467
chrX	52650900	52658900	52652273	8000	52654900	-4000	4000	-2627
chrX	49691984	49699984	49694761	8000	49695984	-4000	4000	-1223
chrX	126815729	126823729	126821407	8000	126819729	-4000	4000	1678
chrX	133214354	133222354	133217070	8000	133218354	-4000	4000	-1284
chrX	23904006	23912006	23910319	8000	23908006	-4000	4000	2313
chrX	110516312	110524312	110521105	8000	110520312	-4000	4000	793
chrX	34938796	34946796	34944527	8000	34942796	-4000	4000	1731
chrX	26134343	26142343	26139426	8000	26138343	-4000	4000	1083
chrX	24668677	24676677	24672646	8000	24672677	-4000	4000	-31
chrX	120073690	120081690	120077089	8000	120077690	-4000	4000	-601
chrX	137029995	137037995	137031071	8000	137033995	-4000	4000	-2924
chrX	149770068	149778068	149774783	8000	149774068	-4000	4000	715
chrX	52650900	52658900	52652311	8000	52654900	-4000	4000	-2589
chrX	34938796	34946796	34943138	8000	34942796	-4000	4000	342
chrX	120073690	120081690	120077058	8000	120077690	-4000	4000	-632
chrX	129734949	129742949	129739093	8000	129738949	-4000	4000	144
chrX	86144451	86152451	86148917	8000	86148451	-4000	4000	466
chrX	104009708	104017708	104013198	8000	104013708	-4000	4000	-510
chrX	14525298	14533298	14530109	8000	14529298	-4000	4000	811
chrX	37004366	37012366	37010244	8000	37008366	-4000	4000	1878
chrX	37004366	37012366	37010622	8000	37008366	-4000	4000	2256
chrX	136483947	136491947	136488085	8000	136487947	-4000	4000	138
chrY	18021787	18029787	18026214	8000	18025787	-4000	4000	427
