Chr	Start	End	Name	Score	Strand	Length
chr17	42325758	42345509	SLC4A1	0	-	19751
chr16	24267656	24373733	CACNG3	0	+	106077
chr19	40195121	40200084	LGALS14	0	+	4963
chr17	10204182	10276447	MYH13	0	-	72265
chr17	11501787	11873065	DNAH9	0	+	371278
chr6	50681239	50740746	TFAP2D	0	+	59507
chr12	329787	372039	SLC6A13	0	-	42252
chr17	49230951	49249105	NME1-NME2	0	+	18154
chrY	21865751	21906825	KDM5D	0	-	41074
chr2	110550335	110615282	RGPD5	0	+	64947
chr5	50679282	50690564	ISL1	0	+	11282
chr1	86934051	86965942	CLCA1	0	+	31891
chr7	99425636	99463716	CYP3A43	0	+	38080
chr1	57394880	57440056	C8B	0	-	45176
chr5	161274069	161326987	GABRA1	0	+	52918
chr9	113431059	113568838	MUSK	0	+	137779
chr8	20002366	20040717	SLC18A1	0	-	38351
chr5	24487209	24645087	CDH10	0	-	157878
chr1	215796233	216596790	USH2A	0	-	800557
chr1	42619081	42621491	GUCA2B	0	+	2410
chr20	55904859	55919050	SPO11	0	+	14191
chr19	4153628	4173051	CREB3L3	0	+	19423
chr5	137419679	137428054	WNT8A	0	+	8375
chr22	19134506	19137805	GSC2	0	-	3299
chr3	87308554	87325734	POU1F1	0	-	17180
chr2	79412357	80875986	CTNNA2	0	+	1463629
chrY	15016019	15032390	DDX3Y	0	+	16371
chrY	2803322	2850547	ZFY	0	+	47225
chr2	48757064	49003656	STON1-GTF2A1L	0	+	246592
chr5	135548433	135701233	TRPC7	0	-	152800
chr8	24298443	24384483	ADAM7	0	+	86040
chr10	50817141	50875988	CHAT	0	+	58847
chr11	2425745	2465744	TRPM5	0	-	39999
chr11	60260251	60274903	MS4A12	0	+	14652
chr2	238475217	238475818	PRLH	0	+	601
chr2	234959323	234985778	SPP2	0	+	26455
chrX	111011239	111326004	TRPC5	0	-	314765
chr10	48001603	48055018	KNOWN	0	-	53415
chr2	169772008	169887834	ABCB11	0	-	115826
chr1	157800701	157868046	CD5L	0	-	67345
chr6	155716502	155776973	NOX3	0	-	60471
chr20	62031561	62104030	KCNQ2	0	-	72469
chr11	69585790	69590109	FGF4	0	-	4319
chr17	64831235	64890868	CACNG5	0	+	59633
chr10	102495153	102589701	PAX2	0	+	94548
chr19	3933067	3942414	NMRK2	0	+	9347
chr7	100240720	100254071	ACTL6B	0	-	13351
chrX	110537007	110655657	DCX	0	-	118650
chr16	5289803	7763342	RBFOX1	0	+	2473539
chr8	16849690	16859854	FGF20	0	-	10164
chr4	74347462	74369718	AFM	0	+	22256
chr19	10123925	10132955	RDH8	0	+	9030
chr1	196912868	196928752	CFHR2	0	+	15884
chr18	63417488	63557573	CDH7	0	+	140085
chr1	201008640	201081579	CACNA1S	0	-	72939
chr7	122753585	122840026	SLC13A1	0	-	86441
chr6	70576448	70922171	COL19A1	0	+	345723
chr20	138095	139804	DEFB127	0	+	1709
chr4	187187343	187210835	F11	0	+	23492
chr12	113899838	113910085	LHX5	0	-	10247
chr12	113008184	113336686	RPH3A	0	+	328502
chr3	164696686	164796284	SI	0	-	99598
chr7	107663993	107770806	LAMB4	0	-	106813
chr11	22359927	22401049	SLC17A6	0	+	41122
chr3	16628299	16711813	DAZL	0	-	83514
chrY	6778727	6970011	TBL1Y	0	+	191284
chr19	15193022	15203781	OR1I1	0	+	10759
chr11	114389656	114430603	NXPE1	0	-	40947
chr6	39282474	39290744	KCNK16	0	-	8270
chr6	41303346	41318627	NCR2	0	+	15281
chr6	33762450	33771780	MLN	0	-	9330
chrX	30233680	30238206	MAGEB2	0	+	4526
chrY	4868267	5610265	PCDH11Y	0	+	741998
chr22	30843946	30868004	SEC14L3	0	-	24058
chr22	26565428	26779563	SEZ6L	0	+	214135
chr22	22987085	22990368	GGTLC2	0	+	3283
chr14	70510932	70655787	SLC8A3	0	-	144855
chr14	96176284	96180533	TCL1A	0	-	4249
chr14	24540046	24547309	CPNE6	0	+	7263
chr20	42965683	42979878	R3HDML	0	+	14195
chr20	42984339	43061485	HNF4A	0	+	77146
chr20	60790016	60795334	HRH3	0	-	5318
chr20	3063202	3065370	AVP	0	-	2168
chr20	61924538	61966203	COL20A1	0	+	41665
chr20	61974575	62009753	CHRNA4	0	-	35178
chr20	5279864	5297600	PROKR2	0	-	17736
chr20	1959403	1974931	PDYN	0	-	15528
chr20	23545369	23549121	CST9L	0	-	3752
chr20	37353129	37358015	SLC32A1	0	+	4886
chr20	44141101	44144262	SPINT3	0	-	3161
chrX	108616135	108725315	GUCY2F	0	-	109180
chrX	119495940	119517104	ATP1B4	0	+	21164
chrX	49593863	49598867	PAGE4	0	+	5004
chrX	14547420	14749934	GLRA2	0	+	202514
chrX	138612898	138645618	F9	0	+	32720
chrX	114524281	114542128	LUZP4	0	+	17847
chrX	42636617	42637414	PPP1R2C	0	-	797
chrX	153409717	153424507	OPN1LW	0	+	14790
chrX	150345056	150349937	GPR50	0	+	4881
chrX	135570106	135575939	BRS3	0	+	5833
chr13	77522646	77532773	ACOD1	0	+	10127
chr16	21208771	21225831	ZP2	0	-	17060
chr16	4390252	4470495	CORO7-PAM16	0	-	80243
chr8	55421982	55784280	RP1	0	+	362298
chr8	143915663	143997922	GML	0	+	82259
chr19	40093164	40098114	LGALS13	0	+	4950
chr19	40221895	40228669	CLC	0	-	6774
chr19	51883163	51891228	LIM2	0	-	8065
chr19	10397631	10399198	ICAM4	0	+	1567
chr19	48323036	48346587	CRX	0	+	23551
chr19	48373724	48389572	SULT2A1	0	-	15848
chr19	5455428	5456867	ZNRF4	0	+	1439
chr19	48532640	48547336	CABP5	0	-	14696
chr19	54412532	54447204	CACNG7	0	+	34672
chr19	36040933	36054560	ATP4A	0	-	13627
chr19	36024357	36036221	GAPDHS	0	+	11864
chr7	25264189	25268105	NPVF	0	-	3916
chr7	123469037	123517535	HYAL4	0	+	48498
chr7	123565291	123611468	SPAM1	0	+	46177
chr7	127250346	127258196	PAX4	0	-	7850
chr7	31726829	31748069	PPP1R17	0	+	21240
chr7	100838288	100844319	MOGAT3	0	-	6031
chr7	144094333	144107320	NOBOX	0	-	12987
chr7	151653464	151717014	GALNTL5	0	+	63550
chr9	139088096	139096974	LHX3	0	-	8878
chr10	98064166	98098321	DNTT	0	+	34155
chr10	103989943	104001269	PITX3	0	-	11326
chr10	95517597	95566029	LGI1	0	+	48432
chr17	39576799	39580837	KRT37	0	-	4038
chr17	31340105	32501983	ASIC2	0	-	1161878
chr17	42018172	42019844	PPY	0	-	1672
chr17	10395624	10421859	MYH1	0	-	26235
chr4	46920917	46995598	GABRA4	0	-	74681
chr4	69681712	69697741	UGT2B10	0	+	16029
chr4	10488019	10686392	CLNK	0	-	198373
chr11	125773243	125813597	DDX25	0	+	40354
chr11	57105826	57139869	P2RX3	0	+	34043
chr11	116660083	116663136	APOA5	0	-	3053
chr11	116691416	116694020	APOA4	0	-	2604
chr11	116700422	116703788	APOC3	0	+	3366
chr11	107461817	107537505	ELMOD1	0	+	75688
chr12	109252708	109294819	DAO	0	+	42111
chr12	33527173	33592754	SYT10	0	-	65581
chr12	81101413	81103253	MYF6	0	+	1840
chr12	81110691	81113450	MYF5	0	+	2759
chr12	4537321	4554981	FGF6	0	-	17660
chr12	111348623	111359247	MYL2	0	-	10624
chr12	111471969	111788358	CUX2	0	+	316389
chr12	68595129	68619590	IL26	0	-	24461
chr12	7801996	7818504	APOBEC1	0	-	16508
chr12	7940390	7951742	NANOG	0	+	11352
chr12	8754751	8765838	AICDA	0	-	11087
chr12	106976782	107156581	RFX4	0	+	179799
chr6	52051173	52055436	IL17A	0	+	4263
chr6	52101479	52110487	IL17F	0	-	9008
chr6	62389866	62996130	KHDRBS2	0	-	606264
chr6	22569795	22571895	HDGFL1	0	+	2100
chr6	25912982	25930919	SLC17A2	0	-	17937
chr6	167525295	167552629	CCR6	0	+	27334
chr6	46761126	46807515	MEP1A	0	+	46389
chr5	26880706	27121257	CDH9	0	-	240551
chr5	153854532	153857787	HAND1	0	-	3255
chr5	158741788	158757871	IL12B	0	-	16083
chr5	39284242	39371426	C9	0	-	87184
chr3	186378005	186396023	HRG	0	+	18018
chr3	50229043	50235129	GNAT1	0	+	6086
chrY	14649585	14972764	USP9Y	0	+	323179
chr3	108677095	108836981	MORC1	0	-	159886
chr2	162999392	163008914	GCG	0	-	9522
chr2	233897382	233899767	NEU2	0	+	2385
chr2	108602979	108630450	SLC5A7	0	+	27471
chr1	175284330	175712752	TNR	0	-	428422
chr1	12851546	12856777	PRAMEF1	0	+	5231
chr1	12833881	12838049	PRAMEF12	0	+	4168
chr1	238041164	238054222	ZP4	0	-	13058
chr1	170904667	171033906	MROH9	0	+	129239
chr2	208986331	208989248	CRYGD	0	-	2917
chr18	29136972	29178796	TTR	0	+	41824
chr5	159990127	160279221	ATP10B	0	-	289094
chr6	88757559	88776556	SPACA1	0	+	18997
chr6	146920103	147136598	ADGB	0	+	216495
chr20	35879489	35890222	GHRH	0	-	10733
chr1	102268116	102462482	OLFM3	0	-	194366
chr10	114043158	114064796	TECTB	0	+	21638
chr10	120349509	120355160	PRLHR	0	-	5651
chr10	101801950	101841626	CPN1	0	-	39676
chr17	46605888	46608373	HOXB1	0	-	2485
chr9	5231419	5235304	INSL4	0	+	3885
chr9	21349834	21351377	KNOWN	0	-	1543
chr9	21409116	21410184	IFNA8	0	+	1068
chr1	177893091	177953438	SEC16B	0	-	60347
chr6	167568735	167571468	GPR31	0	-	2733
chr10	29577990	29607257	LYZL1	0	+	29267
chr8	27317273	27337400	CHRNA2	0	-	20127
chr1	12916941	12921764	PRAMEF2	0	+	4823
chr12	10958650	10959885	TAS2R8	0	-	1235
chr12	10954131	10955226	TAS2R7	0	-	1095
chr12	10961693	10962767	TAS2R9	0	-	1074
chr1	182378327	182529734	RGSL1	0	+	151407
chr3	109044991	109056393	DPPA4	0	-	11402
chr1	203052257	203055140	MYOG	0	-	2883
chr6	161123270	161175129	PLG	0	+	51859
chr7	8473239	8792591	NXPH1	0	+	319352
chr9	32629452	32635667	TAF1L	0	-	6215
chr7	137687070	137803051	AKR1D1	0	+	115981
chrX	127184941	127186382	ACTRT1	0	-	1441
chr13	52436105	52440368	CCDC70	0	+	4263
chr12	55413758	55423801	NEUROD4	0	+	10043
chrX	105276426	105282718	SERPINA7	0	-	6292
chrX	148663309	148669116	KNOWN	0	-	5807
chrX	13336766	13338172	ATXN3L	0	-	1406
chr2	228735770	228789060	DAW1	0	+	53290
chr20	54823788	54824871	MC3R	0	+	1083
chr20	56071022	56100708	CTCFL	0	-	29686
chr20	43850014	43853099	SEMG2	0	+	3085
chr20	48697661	48770174	PEDS1-UBE2V1	0	-	72513
chr20	56791182	56803709	ANKRD60	0	-	12527
chr20	43835674	43838409	SEMG1	0	+	2735
chrX	151301782	151307050	MAGEA10	0	-	5268
chr16	88704980	88706876	IL17C	0	+	1896
chr19	44220228	44224173	IRGC	0	+	3945
chr19	43256838	43359843	PSG8	0	-	103005
chr19	43084395	43099207	CEACAM8	0	-	14812
chr6	25833294	25882514	SLC17A3	0	-	49220
chr6	26017260	26018015	H1-1	0	-	755
chr6	38683087	38998568	DNAH8	0	+	315481
chr6	47749718	47800516	OPN5	0	+	50798
chr12	130822432	130857182	PIWIL1	0	+	34750
chr13	103696348	103718767	SLC10A2	0	-	22419
chr13	95361876	95364799	SOX21	0	-	2923
chr17	10424465	10453017	MYH2	0	-	28552
chr9	135457993	135465639	BARHL1	0	+	7646
chr19	55281245	55295774	KIR2DL1	0	+	14529
chr20	61637279	61638387	BHLHE23	0	-	1108
chr17	61780205	61829457	ENSG00000125695	0	-	49252
chr20	23471738	23476647	CST8	0	+	4909
chr20	21376003	21378164	NKX2-4	0	-	2161
chr20	17206752	17465223	PCSK2	0	+	258471
chr20	3639895	3644046	GFRA4	0	-	4151
chr20	16729003	16750707	OTOR	0	+	21704
chr20	17674317	17716516	BANF2	0	+	42199
chr20	207899	210527	DEFB129	0	+	2628
chr14	65381203	65528521	CHURC1-FNTB	0	+	147318
chr20	34111014	34117481	C20orf173	0	-	6467
chr20	33873534	33880228	FAM83C	0	-	6694
chr19	35861970	35863864	GPR42	0	+	1894
chr19	35838805	35844766	FFAR1	0	+	5961
chr4	70861683	70868287	STATH	0	+	6604
chr19	54382444	54410906	PRKCG	0	+	28462
chrX	85403455	86087607	DACH2	0	+	684152
chrX	48114827	48126879	SSX1	0	+	12052
chr16	90122974	90158480	PRDM7	0	-	35506
chrX	153880246	153881853	CTAG2	0	-	1607
chr12	68642022	68647384	IL22	0	-	5362
chr7	142605267	142630843	TRPV5	0	-	25576
chr19	14951278	14959734	OR7A10	0	-	8456
chr19	15052301	15053260	OR7C2	0	+	959
chr17	3336164	3337135	OR1E2	0	-	971
chr22	29834572	29838444	RFPL1	0	+	3872
chr22	38219389	38221492	GALR3	0	+	2103
chr7	122634758	122635754	TAS2R16	0	-	996
chr11	17741118	17743683	MYOD1	0	+	2565
chr11	19203577	19232118	CSRP3	0	-	28541
chr17	6297013	6338519	AIPL1	0	-	41506
chr11	3666358	3685646	ART1	0	+	19288
chrY	2709643	2800041	RPS4Y1	0	+	90398
chrY	16168107	16168838	VCY1B	0	+	731
chrY	16097652	16098353	VCY	0	-	701
chrY	19990140	19992100	CDY2B	0	-	1960
chr12	4829566	4961093	GALNT8	0	+	131527
chr16	3138891	3149296	ZSCAN10	0	-	10405
chr19	19322767	19363042	NCAN	0	+	40275
chr6	160312020	160338479	MAS1	0	+	26459
chrX	50653735	50659641	BMP15	0	+	5906
chr19	54494891	54515920	CACNG6	0	+	21029
chr22	16448824	16449805	KNOWN	0	-	981
chr2	234216462	234255701	SAG	0	+	39239
chr9	97080480	97090926	NUTM2F	0	-	10446
chr20	31805116	31815612	BPIFA3	0	+	10496
chr20	29956404	29961726	DEFB118	0	+	5322
chr19	43905648	43922749	TEX101	0	+	17101
chr5	176806236	176825849	SLC34A1	0	+	19613
chrX	72666889	72675007	CDX4	0	+	8118
chr17	41052814	41066455	G6PC1	0	+	13641
chrX	119292519	119299536	RHOXF2	0	+	7017
chr11	30252561	30256808	FSHB	0	+	4247
chr19	57630506	57643294	USP29	0	+	12788
chr1	26737308	26756219	LIN28A	0	+	18911
chr14	60386431	60530277	LRRC9	0	+	143846
chr16	30205196	30208882	SLX1A	0	+	3686
chrX	31089350	31090158	FTHL17	0	-	808
chr4	71494461	71512541	ENAM	0	+	18080
chr9	43064966	43133544	KNOWN	0	-	68578
chr20	18794427	18795022	SCP2D1	0	+	595
chr20	23015949	23019874	SSTR4	0	+	3925
chr1	159682079	159684379	CRP	0	-	2300
chr1	159557616	159558655	APCS	0	+	1039
chr18	40847857	40857500	SYT4	0	-	9643
chr18	42792960	43263653	SLC14A2	0	+	470693
chr5	151771107	151812929	NMUR2	0	-	41822
chr13	19997016	20135765	TPTE2	0	-	138749
chr13	25338307	25454059	RNF17	0	+	115752
chr17	10293639	10325267	MYH8	0	-	31628
chr13	32313663	32377526	RXFP2	0	+	63863
chr13	39540062	39564996	STOML3	0	-	24934
chr14	70989075	71001732	ADAM20	0	-	12657
chr15	31293264	31453476	TRPM1	0	-	160212
chr1	120336640	120354203	REG4	0	-	17563
chr1	115572447	115576923	TSHB	0	+	4476
chr1	111833473	111863188	CHIA	0	+	29715
chr1	120436156	120439138	ADAM30	0	-	2982
chr1	196944140	196978808	CFHR5	0	+	34668
chr18	56934267	56941318	RAX	0	-	7051
chr18	22040601	22059925	HRH4	0	+	19324
chr12	21284128	21392730	SLCO1B1	0	+	108602
chr11	47352957	47374253	MYBPC3	0	-	21296
chrX	132157196	132231137	USP26	0	-	73941
chrX	139585150	139587234	SOX3	0	-	2084
chr11	92702817	92718232	MTNR1B	0	+	15415
chr11	59596746	59612972	CBLIF	0	-	16226
chr7	97613999	97620481	OCM2	0	-	6482
chr4	70820974	70831446	CSN2	0	-	10472
chr4	70146193	70160768	UGT2B28	0	+	14575
chr6	78170641	78173208	HTR1B	0	-	2567
chr6	90604188	90631479	GJA10	0	+	27291
chr12	53817639	53825456	AMHR2	0	+	7817
chr12	55024595	55028679	LACRT	0	-	4084
chr12	52753790	52761265	KRT85	0	-	7475
chr6	132909731	132910880	TAAR5	0	-	1149
chr2	233390703	233401377	CHRND	0	+	10674
chr7	14184674	15014402	DGKB	0	-	829728
chr7	4945620	4998844	MMD2	0	-	53224
chr17	61972269	61974021	CSH1	0	-	1752
chr8	11344403	11422108	BLK	0	+	77705
chr8	11534468	11617511	GATA4	0	+	83043
chr2	113763036	113765621	IL36A	0	+	2585
chr2	113779666	113810444	IL36B	0	-	30778
chr2	113825547	113833420	IL1F10	0	+	7873
chr2	131349738	131357148	CFC1	0	-	7410
chr10	26505594	26593487	GAD2	0	+	87893
chr9	107379529	107380485	OR13C9	0	-	956
chr9	104116464	104147682	BAAT	0	-	31218
chr9	100689073	100707138	HEMGN	0	-	18065
chr9	125486269	125487204	OR1L4	0	+	935
chr9	21165636	21166659	IFNA21	0	-	1023
chr6	43263432	43273276	SLC22A7	0	+	9844
chr4	147627769	147867034	TTC29	0	-	239265
chr11	111338251	111385092	BTG4	0	-	46841
chr15	54270398	54920905	UNC13C	0	+	650507
chr15	45544432	45570044	SLC28A2	0	+	25612
chr15	51500254	51630798	CYP19A1	0	-	130544
chr1	92414900	92479983	BRDT	0	+	65083
chr2	37394963	37423741	SULT6B1	0	-	28778
chr10	96698415	96749848	CYP2C9	0	+	51433
chr10	74694520	74714564	PLA2G12B	0	-	20044
chr10	74653342	74692794	OIT3	0	+	39452
chr10	69847654	69971774	MYPN	0	+	124120
chr3	108626639	108672726	GUCA1C	0	-	46087
chr15	73612200	73661299	HCN4	0	-	49099
chr4	115748919	116035032	NDST4	0	-	286113
chr4	123531263	123542221	IL21	0	-	10958
chr4	100432169	100463460	C4orf17	0	+	31291
chr22	50457004	50496727	TTLL8	0	-	39723
chr12	15125976	15134799	PDE6H	0	+	8823
chr12	48866342	48867405	ANP32D	0	+	1063
chr13	28494137	28500450	PDX1	0	+	6313
chr12	51722226	51740463	CELA1	0	-	18237
chr12	119419346	119600856	SRRM4	0	+	181510
chr13	103338097	103347394	METTL21C	0	-	9297
chr15	75575176	75588148	GOLGA6D	0	+	12972
chr15	74495046	74628813	CCDC33	0	+	133767
chr15	75041186	75048948	CYP1A2	0	+	7762
chr15	75105057	75118098	LMAN1L	0	+	13041
chr16	68009566	68014452	DPEP3	0	-	4886
chr17	33474836	33516364	UNC45B	0	+	41528
chr17	56225745	56236946	OR4D1	0	+	11201
chr17	51900288	51902554	KIF2B	0	+	2266
chr17	31297394	31324895	SPACA3	0	+	27501
chr18	70203915	70305756	CBLN2	0	-	101841
chr19	57645464	57656570	ZIM3	0	-	11106
chr19	16589878	16739015	ENSG00000141979	0	-	149137
chr19	54466191	54493469	CACNG8	0	+	27278
chr17	4675179	4686508	TM4SF5	0	+	11329
chr19	51273721	51274989	GPR32	0	+	1268
chr19	51358171	51364020	KLK3	0	+	5849
chr1	17531623	17572502	PADI1	0	+	40879
chr1	34632484	34684732	C1orf94	0	+	52248
chr1	22328150	22339035	CELA3A	0	+	10885
chr1	53925072	53933161	DMRTB1	0	+	8089
chr1	111059839	111061797	KCNA10	0	-	1958
chr1	109255530	109285371	FNDC7	0	+	29841
chr1	197007871	197036390	F13B	0	-	28519
chr1	210074268	210344734	SYT14	0	+	270466
chr1	210850165	211307507	KCNH1	0	-	457342
chr1	152321211	152332482	FLG2	0	-	11271
chr1	152381719	152386739	CRNN	0	-	5020
chr1	154293566	154297801	AQP10	0	+	4235
chr1	155259084	155271229	PKLR	0	-	12145
chr2	20866904	20879003	GDF7	0	+	12099
chr2	79252812	79255631	REG3G	0	+	2819
chr2	96142756	96150502	TRIM43B	0	-	7746
chr2	192813769	193059659	TMEFF2	0	-	245890
chr2	226264426	226594603	NYAP2	0	+	330177
chr3	186330849	186339107	AHSG	0	+	8258
chr4	71200698	71202833	CABS1	0	+	2135
chr4	72607413	72669758	GC	0	-	62345
chr4	120238405	120243293	FABP2	0	-	4888
chr5	35951108	36001130	UGT3A1	0	-	50022
chr5	96427571	96478457	LIX1	0	-	50886
chr5	135257968	135290672	LECT2	0	-	32704
chr5	135227935	135231530	IL9	0	-	3595
chr5	147691982	147695485	SPINK7	0	+	3503
chr5	151202074	151304412	GLRA1	0	-	102338
chr5	175223313	175311024	CPLX2	0	+	87711
chr6	25754927	25781427	SLC17A4	0	+	26500
chr6	25727005	25727573	H2BC1	0	+	568
chr6	89887223	89940997	GABRR1	0	-	53774
chr6	123317380	123394070	CLVS2	0	+	76690
chr6	132938161	132945414	TAAR2	0	-	7253
chr6	132891461	132892498	TAAR6	0	+	1037
chr6	132873811	132874895	TAAR8	0	+	1084
chr6	132964451	132980321	TAAR1	0	-	15870
chr7	19184405	19185044	FERD3L	0	-	639
chr7	123207064	123279535	ASB15	0	+	72471
chr7	150872785	150884919	ASB10	0	-	12134
chrX	49955420	49965658	AKAP4	0	-	10238
chrX	88002226	88009786	CPXCR1	0	+	7560
chrX	129513423	129519648	GPR119	0	-	6225
chr8	42552509	42592550	CHRNB3	0	+	40041
chr8	50822349	51709252	SNTG1	0	+	886903
chr8	53023398	53373519	ST18	0	-	350121
chr8	67088611	67090699	CRH	0	-	2088
chr8	82352561	82359674	PMP2	0	-	7113
chr8	70963886	70983928	PRDM14	0	-	20042
chr8	108911544	109095870	RSPO2	0	-	184326
chr8	139142266	139509504	FAM135B	0	-	367238
chr9	14719722	14722731	CER1	0	-	3009
chr9	21304325	21305312	IFNA5	0	-	987
chr9	21216372	21217310	IFNA16	0	-	938
chr9	40700291	40706537	KNOWN	0	+	6246
chr9	107288534	107289490	OR13C4	0	-	956
chr9	111616868	111618266	ACTL7B	0	-	1398
chr9	125551212	125552174	OR5C1	0	+	962
chr9	138555155	138558807	LCN9	0	+	3652
chr10	17794200	17842867	TMEM236	0	+	48667
chr10	52559169	52645435	A1CF	0	-	86266
chr11	26688567	26744974	SLC5A12	0	-	56407
chr11	55761157	55762101	OR5F1	0	-	944
chr11	62756626	62783313	SLC22A8	0	-	26687
chr11	59807882	59815517	OOSP2	0	+	7635
chr11	59824060	59838588	MS4A3	0	+	14528
chr20	45169585	45179293	OCSTAMP	0	-	9708
chr20	44350986	44354469	SPINT4	0	+	3483
chr11	63137257	63177766	SLC22A9	0	+	40509
chr11	55029631	55038590	TRIM48	0	+	8959
chr11	56113515	56114474	OR8K1	0	+	959
chr10	55562531	57387702	PCDH15	0	-	1825171
chr11	85566144	85631064	CCDC83	0	+	64920
chr4	164392247	164394906	TKTL2	0	-	2659
chr2	3705790	3750261	ALLC	0	+	44471
chr2	17997727	17999065	MSGN1	0	+	1338
chr4	128651555	128695447	SLC25A31	0	+	43892
chr3	113846427	113918254	DRD3	0	-	71827
chr4	147560045	147563626	POU4F2	0	+	3581
chr14	58030638	58448912	SLC35F4	0	-	418274
chr4	46245565	46477247	GABRA2	0	-	231682
chr14	59971257	60043530	CCDC175	0	-	72273
chr12	129556270	130388570	TMEM132D	0	-	832300
chr4	155702365	155749965	RBM46	0	+	47600
chr6	100366395	100442123	MCHR2	0	-	75728
chr2	131278770	131286177	CFC1B	0	+	7407
chr4	93225117	94731308	GRID2	0	+	1506191
chr18	40323192	40695656	RIT2	0	-	372464
chr11	13513601	13517728	PTH	0	-	4127
chr4	88529681	88538025	DSPP	0	+	8344
chr6	146348782	146758737	GRM1	0	+	409955
chr12	25562241	25801513	LMNTD1	0	-	239272
chr1	247901917	247902861	OR14K1	0	+	944
chr6	47653600	47689757	ADGRF4	0	+	36157
chr13	113030669	113089003	SPACA7	0	+	58334
chr15	28623767	28637167	GOLGA8F	0	+	13400
chrX	89176907	89177882	TGIF2LX	0	+	975
chr4	68686594	68749720	TMPRSS11D	0	-	63126
chr1	76384558	76398089	ASB17	0	-	13531
chr7	113516832	113715975	PPP1R3A	0	-	199143
chr10	125425871	125456915	GPR26	0	+	31044
chrX	51927972	51935364	MAGED4	0	+	7392
chr18	23713816	23773319	PSMA8	0	+	59503
chrY	15815779	15817904	TMSB4Y	0	+	2125
chr21	19641433	19858197	TMPRSS15	0	-	216764
chr3	13857755	13921568	WNT7A	0	-	63813
chr7	55861233	55930448	SEPTIN14	0	-	69215
chr7	5965181	6010320	RSPH10B	0	-	45139
chr2	124782864	125678796	CNTNAP5	0	+	895932
chr8	103563817	103573246	ODF1	0	+	9429
chr14	20399076	20404916	OR4K1	0	+	5840
chr4	8560452	8621488	GPR78	0	+	61036
chrX	52112164	52118823	XAGE2	0	+	6659
chr16	21675289	21773256	OTOA	0	+	97967
chr9	105757593	105780770	CYLC2	0	+	23177
chr3	140396906	140419992	TRIM42	0	+	23086
chr4	70345883	70391732	UGT2B4	0	-	45849
chr4	76781017	76823724	PPEF2	0	-	42707
chr4	80146848	80247215	NAA11	0	-	100367
chr21	31537883	31539123	CLDN17	0	-	1240
chr11	57144242	57148623	PRG3	0	-	4381
chrX	135383122	135499049	ADGRG4	0	+	115927
chr3	9540045	9595506	LHFPL4	0	-	55461
chr3	187386700	187388182	SST	0	-	1482
chr1	182869000	182922660	SHCBP1L	0	-	53660
chr3	42727029	42734036	KLHL40	0	+	7007
chr1	57320441	57383896	C8A	0	+	63455
chr7	154862034	154879102	HTR5A	0	+	17068
chr16	70207225	70221264	CLEC18C	0	+	14039
chr1	13641973	13648988	KNOWN	0	+	7015
chr21	38979675	39493439	KCNJ6	0	-	513764
chr11	7041710	7092757	NLRP14	0	+	51047
chr5	143191726	143200281	HMHB1	0	+	8555
chr1	160914815	160924599	ITLN2	0	-	9784
chr1	20465816	20476874	PLA2G2F	0	+	11058
chr1	20617368	20686011	VWA5B1	0	+	68643
chr20	44179792	44207965	WFDC8	0	-	28173
chr17	46799081	46799880	PRAC1	0	-	799
chr17	47035916	47045958	GIP	0	-	10042
chr15	35043233	35047199	GJD2	0	-	3966
chr15	74362198	74374891	GOLGA6A	0	-	12693
chr15	42359207	42386760	PLA2G4D	0	-	27553
chr1	17634690	17690499	PADI4	0	+	55809
chr16	55880066	55989943	CES5A	0	-	109877
chr1	152658599	152659873	LCE2B	0	+	1274
chr17	3323862	3324827	KNOWN	0	+	965
chr21	44589118	44592915	CRYAA	0	+	3797
chr21	45705721	45718531	AIRE	0	+	12810
chr9	138413284	138418386	LCN1	0	+	5102
chr7	99354583	99381871	CYP3A4	0	-	27288
chr17	40336078	40337470	HCRT	0	-	1392
chr19	50655805	50666538	IZUMO2	0	-	10733
chr19	9225504	9226439	OR7G1	0	-	935
chr12	52771596	52779436	KRT84	0	-	7840
chr12	52787715	52800119	KRT82	0	-	12404
chr17	8633253	8648537	CCDC42	0	-	15284
chr16	610394	615529	PRR35	0	+	5135
chr16	1122747	1131454	SSTR5	0	+	8707
chr1	47603107	47615399	CYP4A22	0	+	12292
chr1	15764938	15775737	CTRC	0	+	10799
chr1	47011313	47017319	KNCN	0	-	6006
chr1	16068994	16074477	TMEM82	0	+	5483
chr1	248308450	248309388	OR2M5	0	+	938
chr1	165513237	165533194	LRRC52	0	+	19957
chr1	212797816	212800117	GARIN4	0	+	2301
chr1	241815580	241966079	WDR64	0	+	150499
chr1	207131310	207143970	FCAMR	0	-	12660
chr2	187692202	187713935	ZSWIM2	0	-	21733
chr2	167744990	168116263	XIRP2	0	+	371273
chr4	96761244	96762615	PDHA2	0	+	1371
chr4	98105244	99064627	STPG2	0	-	959383
chr1	152850798	152857523	SMCP	0	+	6725
chr2	69088041	69098529	BMP10	0	-	10488
chr2	208992861	208994552	CRYGC	0	-	1691
chr2	233243434	233247599	ALPP	0	+	4165
chr4	46037786	46126071	GABRG1	0	-	88285
chr2	233271554	233275424	ALPG	0	+	3870
chr4	46995740	47428464	GABRB1	0	+	432724
chr2	233320835	233325463	ALPI	0	+	4628
chr2	219845809	219849906	FEV	0	-	4097
chr2	219919146	219925643	IHH	0	-	6497
chr3	108462271	108476257	RETNLB	0	-	13986
chr1	157543537	157567875	FCRL4	0	-	24338
chr3	109012635	109035364	DPPA2	0	-	22729
chr1	157764193	157789910	FCRL1	0	-	25717
chr1	158580494	158656505	SPTA1	0	-	76011
chr3	170714136	170744532	SLC2A2	0	-	30396
chr2	88422501	88427581	FABP1	0	-	5080
chr3	63213991	63602600	SYNPR	0	+	388609
chr2	27371872	27379842	TCF23	0	+	7970
chr3	44916100	44956482	TGM4	0	+	40382
chr3	121312226	121349142	FBXO40	0	+	36916
chr3	129247482	129254187	RHO	0	+	6705
chr4	4190453	4228656	OTOP1	0	-	38203
chr4	123300121	123350957	ADAD1	0	+	50836
chr4	177134824	177198722	ASB5	0	-	63898
chr5	33944728	33984798	SLC45A2	0	-	40070
chr5	23443695	23528202	PRDM9	0	+	84507
chr5	147830595	148056798	HTR4	0	-	226203
chr5	72469020	72470970	TMEM174	0	+	1950
chr5	1225496	1246304	SLC6A18	0	+	20808
chr5	131396348	131398897	IL3	0	+	2549
chr6	25726291	25726790	H2AC1	0	-	499
chr7	35242042	35293711	TBX20	0	-	51669
chr7	31377079	31380340	NEUROD6	0	-	3261
chr7	155592674	155605157	SHH	0	-	12483
chr17	33519539	33521412	SLC35G3	0	-	1873
chr8	113235157	114449168	CSMD3	0	-	1214011
chr8	6912826	6914261	DEFA5	0	-	1435
chr8	6793342	6795828	DEFA4	0	-	2486
chr8	6782219	6783598	DEFA6	0	-	1379
chr7	1272508	1276962	UNCX	0	+	4454
chr8	7300206	7321196	SPAG11B	0	-	20990
chr7	150845096	150871832	GBX1	0	-	26736
chr9	71627420	71629029	PRKACG	0	-	1609
chr7	141536100	141541287	PRSS37	0	-	5187
chr9	114448451	114557288	SHOC1	0	-	108837
chrX	15299819	15333762	ASB11	0	-	33943
chr9	125377017	125377961	OR1Q1	0	+	944
chrY	16634453	16957534	NLGN4Y	0	+	323081
chrX	136106088	136116154	GPR101	0	-	10066
chr10	54525140	54532544	MBL2	0	-	7404
chr14	47120213	47120984	RPL10L	0	-	771
chr13	25735817	25746426	AMER2	0	-	10609
chrX	48045656	48056231	SSX5	0	-	10575
chrX	48205862	48216142	SSX3	0	-	10280
chr14	57266623	57283411	OTX2	0	-	16788
chr10	50572111	50604135	DRGX	0	-	32024
chr14	20343301	20352091	OR4K2	0	+	8790
chr12	80493317	80774660	OTOGL	0	+	281343
chr11	20621140	20680831	SLC6A5	0	+	59691
chrX	148863584	148869397	KNOWN	0	+	5813
chrX	150732147	150845211	PASD1	0	+	113064
chr15	38214140	38259925	TMCO5A	0	+	45785
chr14	23842018	23845612	IL25	0	+	3594
chr12	109301517	109458873	SVOP	0	-	157356
chr11	133710526	133715433	SPATA19	0	-	4907
chr16	49407715	49433342	C16orf78	0	+	25627
chr21	10906201	11029719	KNOWN	0	-	123518
chrX	153485225	153498755	OPN1MW2	0	+	13530
chr12	101869114	101880775	SPIC	0	+	11661
chr10	72530994	72545157	TBATA	0	-	14163
chr17	55821856	55822660	CCDC182	0	-	804
chr21	14982098	15018144	POTED	0	+	36046
chr11	6866914	6867867	OR10A5	0	+	953
chr11	6912805	6913731	OR2D2	0	-	926
chr12	8662071	8674962	CLEC4D	0	+	12891
chr16	84043272	84076400	SLC38A8	0	-	33128
chr18	56942388	56985881	CPLX4	0	-	43493
chr18	74961804	74989856	GALR1	0	+	28052
chr18	61209602	61236562	SERPINB12	0	+	26960
chr22	36956904	37099797	CACNG2	0	-	142893
chr11	59224434	59225378	OR4D6	0	+	944
chr11	60094728	60164069	MS4A6E	0	+	69341
chr11	60197045	60222687	MS4A5	0	+	25642
chr20	2361547	2413399	TGM6	0	+	51852
chr11	60467058	60483280	MS4A8	0	+	16222
chr15	45248885	45271427	TERB2	0	+	22542
chr20	31571579	31592239	SUN5	0	-	20660
chr20	31619454	31631853	BPIFB6	0	+	12399
chr17	48838390	48844918	ANKRD40CL	0	-	6528
chr15	74165905	74181555	TBC1D21	0	+	15650
chr15	75550675	75565796	GOLGA6C	0	+	15121
chr11	4726014	5013661	MMP26	0	+	287647
chr19	55327923	55342233	KIR3DL1	0	+	14310
chr19	3879862	3928080	ATCAY	0	+	48218
chr19	51364824	51383823	KLK2	0	+	18999
chr11	67286383	67291988	CABP2	0	-	5605
chr19	10416103	10426685	ENSG00000167807	0	-	10582
chr11	55902197	55907677	OR8J3	0	-	5480
chr11	55702932	55703876	OR5I1	0	-	944
chr8	59402737	59412722	CYP7A1	0	-	9985
chr17	38854243	38860004	KRT24	0	-	5761
chr11	64704989	64739580	MAJIN	0	-	34591
chr6	27878963	27880174	OR2B2	0	-	1211
chr16	3405889	3407306	OR2C1	0	+	1417
chr10	23481241	23483174	PTF1A	0	+	1933
chr3	39508689	39570970	MOBP	0	+	62281
chr8	49966870	49988652	PPDPFL	0	+	21782
chr14	36003370	36006260	INSM2	0	+	2890
chr16	84252263	84273618	KCNG4	0	-	21355
chr18	9885763	9889272	TXNDC2	0	+	3509
chr11	61957688	61961011	SCGB1D1	0	+	3323
chr2	211154874	211179898	MYL1	0	-	25024
chr2	209025464	209028313	CRYGA	0	-	2849
chr4	175750819	175899331	ADAM29	0	+	148512
chr8	39442008	39587584	ADAM18	0	+	145576
chr2	98703579	98929762	VWA3B	0	+	226183
chrY	6114264	6117060	KNOWN	0	+	2796
chr6	87647246	87726397	HTR1E	0	+	79151
chr4	162305049	163085156	FSTL5	0	-	780107
chr5	180415846	180433727	BTNL3	0	+	17881
chr11	89530823	89541743	TRIM49	0	-	10920
chr2	228226754	228246711	TM4SF20	0	-	19957
chr11	88237744	88799150	GRM5	0	-	561406
chrX	6451659	6453159	VCX3A	0	-	1500
chr16	27798849	28075035	GSG1L	0	-	276186
chr5	131991955	131996802	IL13	0	+	4847
chr14	22036651	22048210	OR10G3	0	-	11559
chrX	30322323	30327507	NR0B1	0	-	5184
chrX	28605563	29974835	IL1RAPL1	0	+	1369272
chr14	21616529	21627219	OR5AU1	0	-	10690
chr16	20370497	20416059	PDILT	0	-	45562
chr19	48497889	48528411	ELSPBP1	0	+	30522
chr14	21359544	21360507	RNASE3	0	+	963
chr7	6793734	6838996	RSPH10B2	0	+	45262
chr14	20482302	20487466	OR4K14	0	-	5164
chr14	20443750	20444724	OR4K15	0	+	974
chr1	152486958	152488484	CRCT1	0	+	1526
chrX	134290465	134305322	CT55	0	-	14857
chr22	22599192	22599927	VPREB1	0	+	735
chr2	69201705	69208112	GKN1	0	+	6407
chr16	56685798	56687116	MT1B	0	+	1318
chr3	128779622	128781249	GP9	0	+	1627
chr1	2938031	2939467	ACTRT2	0	+	1436
chr5	9627459	9712490	TAS2R1	0	-	85031
chrY	24636544	24660784	PRY	0	+	24240
chrY	24314689	24329129	RBMY1F	0	-	14440
chrY	24217903	24242154	PRY2	0	-	24251
chr4	104507188	104641142	TACR3	0	-	133954
chr13	28366620	28368905	GSX1	0	+	2285
chr15	53047250	53083275	ONECUT1	0	-	36025
chr7	100663353	100702140	MUC17	0	+	38787
chrX	11840542	12742642	FRMPD4	0	+	902100
chrY	20893326	20935621	HSFY2	0	-	42295
chr5	173472709	173670504	NSG2	0	+	197795
chr2	176964523	176967217	HOXD12	0	+	2694
chr4	145030456	145061904	GYPA	0	-	31448
chr9	67792938	67794111	KNOWN	0	-	1173
chr11	18955046	18960961	MRGPRX1	0	-	5915
chr7	54610018	54638773	VSTM2A	0	+	28755
chr12	53200333	53207900	KRT4	0	-	7567
chr12	52959566	52967627	KRT74	0	-	8061
chr12	52979373	52995322	KRT72	0	-	15949
chr12	55520190	55526534	OR9K2	0	+	6344
chr11	7958718	7963255	OR10A3	0	-	4537
chr11	7110229	7112379	RBMXL2	0	+	2150
chr9	6328375	6331891	TPD52L3	0	+	3516
chr11	6897856	6898850	OR10A4	0	+	994
chr11	6884288	6895948	OR10A2	0	+	11660
chr7	123295920	123304344	LMOD2	0	+	8424
chr2	49189296	49381666	FSHR	0	-	192370
chr19	43406238	43423715	PSG6	0	-	17477
chr19	9236688	9237626	OR7G3	0	-	938
chr19	9211083	9218151	OR7G2	0	-	7068
chrX	107224094	107225600	TEX13B	0	-	1506
chr19	9197737	9206345	OR1M1	0	+	8608
chr19	8943053	8954016	MBD3L1	0	+	10963
chr6	49753373	49754998	PGK2	0	-	1625
chr11	124409531	124415229	OR8B12	0	-	5698
chr11	123810324	123811280	OR4D5	0	+	956
chr11	125616174	125619762	PATE1	0	+	3588
chrX	148855726	148858525	HSFX1	0	+	2799
chr9	114089509	114092504	OR2K2	0	-	2995
chr1	248394719	248407981	OR2M4	0	+	13262
chr17	39315901	39317000	KRTAP4-4	0	-	1099
chrX	52891554	52897114	XAGE3	0	-	5560
chrX	52840311	52847325	XAGE5	0	+	7014
chr17	39032141	39041494	KRT20	0	-	9353
chr9	125504582	125513062	OR1L6	0	+	8480
chrX	47990008	47992002	SPACA5B	0	+	1994
chr9	125437409	125438383	OR1L3	0	+	974
chr19	56511092	56573176	NLRP5	0	+	62084
chr5	40998119	41071444	MROH2B	0	-	73325
chr9	125315391	125317452	OR1N2	0	+	2061
chr9	125288637	125289575	OR1N1	0	-	938
chr4	159236463	159574524	RXFP1	0	+	338061
chr17	37759789	37766030	NEUROD2	0	-	6241
chr5	76924537	76934538	OTP	0	-	10001
chr4	155504280	155511897	FGA	0	-	7617
chr11	74792798	74807921	OR2AT4	0	-	15123
chr17	72270373	72311023	DNAI2	0	+	40650
chr6	42883727	42893576	PTCRA	0	+	9849
chr8	7752199	7754238	DEFB4A	0	+	2039
chr10	135043721	135045062	UTF1	0	+	1341
chr5	140430959	140438931	PCDHB1	0	+	7972
chr1	44584493	44600812	KLF17	0	+	16319
chr19	15848795	15853153	OR10H3	0	+	4358
chr19	15838834	15839862	OR10H2	0	+	1028
chr11	5150006	5159586	OR52A5	0	-	9580
chr15	60296433	60353929	FOXB1	0	+	57496
chr2	79384129	79386879	REG3A	0	-	2750
chr2	79312149	79315145	REG1B	0	-	2996
chr2	88824167	88829103	TEX37	0	+	4936
chr17	3110833	3122190	OR1A1	0	+	11357
chr17	3100813	3101742	OR1A2	0	+	929
chr11	55860784	55861716	OR8I2	0	+	932
chr1	152769197	152770657	LCE1D	0	+	1460
chr6	22287473	22303055	PRL	0	-	15582
chr11	55369836	55375121	OR4C11	0	-	5285
chr11	56143100	56144029	OR8U1	0	+	929
chr11	48266656	48267567	OR4X2	0	+	911
chr4	94749904	94752115	ATOH1	0	+	2211
chrY	27768264	27771049	CDY1	0	+	2785
chr11	59203942	59218853	OR5A1	0	+	14911
chr11	59184442	59193886	OR5A2	0	-	9444
chrY	26191376	26194166	CDY1B	0	-	2790
chr11	58206467	58209709	OR5B12	0	-	3242
chr11	58188711	58195594	OR5B2	0	-	6883
chr11	119056166	119060932	PDZD3	0	+	4766
chr1	67263423	67266959	INSL5	0	-	3536
chr11	56508699	56516173	OR9G4	0	-	7474
chr11	56431162	56432094	OR5AR1	0	+	932
chr11	56408965	56409915	OR5AP2	0	-	950
chrY	20708577	20750849	HSFY1	0	+	42272
chr11	56127691	56128764	KNOWN	0	+	1073
chr11	56019676	56020698	KNOWN	0	+	1022
chr19	15898471	15911167	OR10H5	0	+	12696
chr10	50339199	50342066	FAM170B	0	-	2867
chr8	57025501	57026541	MOS	0	-	1040
chr11	60552806	60568778	MS4A10	0	+	15972
chr14	67656110	67695267	GARIN2	0	+	39157
chr11	59278841	59288176	OR4D9	0	+	9335
chr3	130064359	130203690	COL6A5	0	+	139331
chr11	58169937	58174347	OR5B3	0	-	4410
chr11	58034264	58035732	OR10W1	0	-	1468
chr12	53038342	53045995	KRT2	0	-	7653
chr11	68747490	68748455	MRGPRD	0	-	965
chr3	38307303	38320248	SLC22A13	0	+	12945
chr22	17264302	17306301	XKR3	0	-	41999
chr3	75713479	75716371	FRG2C	0	+	2892
chr3	35680437	35835988	ARPP21	0	+	155551
chr12	111284573	111345339	CCDC63	0	+	60766
chr10	96953957	96988686	ACSM6	0	+	34729
chr5	145892707	145895753	GPR151	0	-	3046
chr1	158431364	158440647	OR10K1	0	+	9283
chr2	131486643	131487909	GPR148	0	+	1266
chr19	56403065	56443702	NLRP13	0	-	40637
chr4	70454135	70518967	UGT2A1	0	-	64832
chr6	117113248	117150246	GPRC6A	0	-	36998
chr6	116816152	116866847	TRAPPC3L	0	-	50695
chr1	6304239	6305638	HES3	0	+	1399
chr9	125423845	125424927	OR1L1	0	+	1082
chr2	231855039	231889770	SPATA3	0	+	34731
chr3	44283378	44373590	TOPAZ1	0	+	90212
chr17	61600695	61626338	KCNH6	0	+	25643
chr17	38948448	38956211	KRT28	0	-	7763
chr19	3769087	3772226	RAX2	0	-	3139
chrX	79591003	79700810	TENT5D	0	+	109807
chr4	37246365	37451085	NWD2	0	+	204720
chr10	51187938	51192032	KNOWN	0	+	4094
chr3	113953478	113956425	ZNF80	0	-	2947
chr2	176942200	176948690	EVX2	0	-	6490
chr5	180166123	180167058	OR2Y1	0	-	935
chr5	1201710	1225226	SLC6A19	0	+	23516
chr8	110098814	110133794	TRHR	0	+	34980
chr8	107771711	107782472	ABRA	0	-	10761
chr15	23684185	23692390	GOLGA6L2	0	-	8205
chr2	215275778	215443700	VWC2L	0	+	167922
chr4	172733405	173962710	GALNTL6	0	+	1229305
chr19	51328545	51340469	KLK15	0	-	11924
chr19	9320952	9330265	OR7D4	0	-	9313
chr1	104230037	104239076	AMY1B	0	-	9039
chr11	56466571	56471360	OR9G1	0	+	4789
chr3	154052732	154147979	GPR149	0	-	95247
chr11	55944094	55945032	OR5J2	0	+	938
chr11	55733231	55737421	OR10AG1	0	-	4190
chr11	55415803	55420330	OR4S2	0	+	4527
chr16	87915152	87970186	CA5A	0	-	55034
chr16	29789577	29794294	ZG16	0	+	4717
chr10	127265091	127371732	TEX36	0	-	106641
chr18	28956740	28994875	DSG4	0	+	38135
chr3	186915274	186919250	RTP1	0	+	3976
chr1	248566349	248571321	OR2T1	0	+	4972
chr5	177419236	177423243	PROP1	0	-	4007
chr22	35462129	35483380	ISX	0	+	21251
chr12	56030676	56031617	OR10P1	0	+	941
chr11	6220454	6221416	OR52W1	0	+	962
chr10	118305443	118327367	PNLIP	0	+	21924
chr11	48238362	48239291	OR4B1	0	+	929
chr13	31506793	31549637	TEX26	0	+	42844
chr14	94453571	94475209	CCDC197	0	+	21638
chr5	176057619	176073645	EIF4E1B	0	+	16026
chr13	103381717	103411422	CCDC168	0	-	29705
chr3	111753583	111800116	TMPRSS7	0	+	46533
chr17	56497528	56565769	HSF5	0	-	68241
chr14	29235993	29239483	FOXG1	0	+	3490
chr22	40139049	40289868	ENTHD1	0	-	150819
chr14	20707445	20712508	OR11H4	0	+	5063
chr11	59271049	59271984	OR4D11	0	+	935
chr14	20691869	20692861	OR11H6	0	+	992
chr14	20578898	20590358	OR4K17	0	+	11460
chr19	16055109	16061160	OR10H4	0	+	6051
chr14	20528204	20529142	OR4L1	0	+	938
chr14	20497558	20504197	OR4K13	0	-	6639
chr8	116086	117024	OR4F21	0	-	938
chr14	20388766	20389737	OR4K5	0	+	971
chr14	20336356	20337302	OR4K3	0	-	946
chr14	20187174	20298412	OR4N2	0	+	111238
chr11	118842422	118851997	FOXR1	0	+	9575
chr11	59126368	59139187	OR5AN1	0	+	12819
chr7	143206349	143216562	OR10AC1	0	-	10213
chr11	48387037	48388017	OR4C5	0	-	980
chr11	48346472	48347507	OR4C3	0	+	1035
chr11	48327775	48328704	OR4S1	0	+	929
chr11	48285413	48286330	OR4X1	0	+	917
chr8	87878643	88627447	CNBD1	0	+	748804
chr2	135722055	135805038	MAP3K19	0	-	82983
chr22	30476453	30573064	HORMAD2	0	+	96611
chrY	3447108	3448082	TGIF2LY	0	+	974
chr19	107104	117102	OR4F17	0	+	9998
chr11	5220965	5221912	OR51V1	0	-	947
chrX	26210557	26213763	MAGEB6	0	+	3206
chr10	132890654	133109984	TCERG1L	0	-	219330
chrX	26156460	26158853	MAGEB18	0	+	2393
chr8	7693958	7698764	DEFB104A	0	+	4806
chr11	5079880	5080857	OR52E2	0	-	977
chr8	7738914	7740185	DEFB103A	0	+	1271
chr11	5016081	5026766	OR51L1	0	+	10685
chr4	165937610	165962901	TRIM60	0	+	25291
chr8	7327830	7332604	DEFB104B	0	-	4774
chr9	21140631	21141831	IFNW1	0	-	1200
chrX	8992273	9263722	FAM9B	0	-	271449
chr18	580380	582114	CETN1	0	+	1734
chr1	248799657	248808579	OR2T35	0	-	8922
chr1	248512077	248513015	OR14C36	0	+	938
chr8	61969717	62414204	CLVS1	0	+	444487
chr1	248486932	248487870	OR2M7	0	-	938
chr1	248453441	248466726	OR2T12	0	-	13285
chr1	248433219	248441278	OR2T33	0	-	8059
chr8	7286410	7287870	DEFB103B	0	-	1460
chr8	7272377	7274385	DEFB4B	0	-	2008
chr1	248088191	248098641	OR2AJ1	0	+	10450
chr1	111062459	111174096	KCNA2	0	-	111637
chrX	18181051	18239006	BEND2	0	-	57955
chr10	50507215	50535537	C10orf71	0	+	28322
chr1	64669306	64733051	UBE2U	0	+	63745
chr6	137813336	137815531	OLIG3	0	-	2195
chr1	247768888	247769817	OR2G3	0	+	929
chr1	247751662	247752615	OR2G2	0	+	953
chrX	8137985	8139308	VCX2	0	-	1323
chr18	55019788	55038962	ST8SIA3	0	+	19174
chr1	247612420	247621407	OR2B11	0	-	8987
chr1	116378998	116386538	NHLH2	0	-	7540
chr19	35715703	35719642	FAM187B	0	-	3939
chr2	232457575	232458987	TEX44	0	+	1412
chr6	49927962	49931877	DEFB114	0	-	3915
chrX	27826107	27841131	MAGEB10	0	+	15024
chr15	102462245	102463316	OR4F4	0	-	1071
chr9	90744220	90753390	SPATA31C2	0	-	9170
chr9	90497792	90503818	SPATA31E1	0	+	6026
chr15	30844253	30857887	GOLGA8Q	0	+	13634
chr2	131513113	131525707	AMER3	0	+	12594
chr5	147582357	147594700	SPINK6	0	+	12343
chr10	82297658	82406316	SH2D4B	0	+	108658
chr8	7705398	7726389	SPAG11A	0	+	20991
chr11	6942233	6943225	OR2D3	0	+	992
chr5	63253701	63258334	HTR1A	0	-	4633
chr10	5406929	5416655	UCN3	0	+	9726
chr4	71457973	71473005	AMBN	0	+	15032
chr2	240984494	240986444	OR6B3	0	-	1950
chr20	67891	77735	DEFB125	0	+	9844
chr10	50887697	50918307	C10orf53	0	+	30610
chr18	52254988	52266724	DYNAP	0	+	11736
chr3	194115550	194119995	GP5	0	-	4445
chr11	76927603	77012732	GDPD4	0	-	85129
chr3	129262018	129270310	H1-8	0	+	8292
chr19	48304489	48322308	TPRX1	0	-	17819
chr9	107456799	107457743	OR13D1	0	+	944
chr12	103631369	103889756	C12orf42	0	-	258387
chr10	23491625	23633774	C10orf67	0	-	142149
chr1	12907230	12908573	HNRNPCL1	0	-	1343
chr19	51749603	51772584	SIGLECL1	0	+	22981
chr3	128181280	128185811	DNAJB8	0	-	4531
chr7	142723287	142724219	OR9A2	0	-	932
chr12	100750852	100815833	SLC17A8	0	+	64981
chr14	63779549	63785649	GPHB5	0	-	6100
chr12	55966252	55969396	OR2AP1	0	+	3144
chr12	55943386	55949616	OR6C4	0	+	6230
chr12	55837853	55847131	OR6C2	0	+	9278
chr19	56459198	56499995	NLRP8	0	+	40797
chr13	43355686	43365685	FAM216B	0	+	9999
chr11	18194384	18195827	MRGPRX4	0	+	1443
chr19	56296763	56348166	NLRP11	0	-	51403
chr12	55614809	55615759	OR10A7	0	+	950
chr15	30375158	30388893	GOLGA8J	0	+	13735
chr17	3300398	3301704	OR1E1	0	-	1306
chr19	55866276	55874628	GARIN5B	0	-	8352
chr8	23559253	23564269	NKX2-6	0	-	5016
chr20	44277202	44298909	WFDC11	0	-	21707
chr13	37677396	37679801	CSNK1A1L	0	-	2405
chr20	44236578	44259923	WFDC9	0	-	23345
chr11	46740746	46761056	F2	0	+	20310
chr16	20039561	20085212	GPR139	0	-	45651
chr17	39431950	39432459	KRTAP9-7	0	+	509
chr20	30028435	30038060	DEFB123	0	+	9625
chr11	57995354	57996390	OR10Q1	0	-	1036
chr20	29964967	29978393	DEFB119	0	-	13426
chr3	126245842	126277808	C3orf22	0	-	31966
chr1	158388000	158396027	OR10K2	0	-	8027
chrX	115301997	115306227	AGTR2	0	+	4230
chr6	50009812	50017642	DEFB112	0	-	7830
chr11	6040566	6055568	OR56A1	0	-	15002
chr11	5901859	5908309	OR52E4	0	+	6450
chr11	5830154	5842713	OR52N2	0	+	12559
chr11	5807701	5812495	OR52N1	0	-	4794
chr11	5797395	5804585	OR52N5	0	-	7190
chr11	5782383	5790310	OR56B2P	0	+	7927
chr7	136553399	136705002	CHRM2	0	+	151603
chr11	124095437	124096371	OR8G2P	0	+	934
chr4	5899100	6202282	C4orf50	0	-	303182
chr11	56756389	56757318	OR5AK2	0	+	929
chr11	56738525	56739454	OR5AK3P	0	+	929
chr11	56257911	56258846	OR5M8	0	-	935
chr2	219867568	219906249	CFAP65	0	-	38681
chrX	134971363	134995221	SAGE1	0	+	23858
chr11	123813574	123814545	OR6T1	0	-	971
chr11	123772874	123779936	OR8D4	0	+	7062
chr11	56055938	56059730	OR8H1	0	-	3792
chr11	56041630	56044295	OR5T1	0	+	2665
chr11	55998758	56001731	OR5T2	0	-	2973
chr19	8831998	8842522	OR2Z1	0	+	10524
chr11	55926870	55927793	OR8K5	0	-	923
chr11	55889849	55890787	OR8H3	0	+	938
chr11	55871163	55875134	OR8H2	0	+	3971
chr11	55795130	55805667	OR5AS1	0	+	10537
chr19	8807750	8809145	ACTL9	0	-	1395
chr14	21108855	21109850	OR6S1	0	-	995
chr11	55429677	55433671	OR4C6	0	+	3994
chr11	55402589	55407785	OR4P4	0	+	5196
chr11	55321783	55322895	OR4C15	0	+	1112
chr11	55135450	55136394	OR4A15	0	+	944
chr11	55110677	55111663	OR4A16	0	+	986
chr11	4470525	4471591	OR52K2	0	+	1066
chr20	37209838	37217106	ADIG	0	+	7268
chr12	86349445	87232681	MGAT4C	0	-	883236
chr11	49049053	49060003	TRIM49B	0	+	10950
chr11	5168054	5175987	OR52A1	0	-	7933
chr2	240968841	240969906	KNOWN	0	-	1065
chr17	77704705	77716018	ENPP7	0	+	11313
chr11	3239174	3240043	MRGPRG	0	-	869
chr2	237102102	237173052	ASB18	0	-	70950
chr2	209007297	209010882	CRYGB	0	-	3585
chr11	30031277	30038577	KCNA4	0	-	7300
chr11	7979084	7986994	NLRP10	0	-	7910
chr17	28643351	28661077	TMIGD1	0	-	17726
chr19	7056218	7069676	MBD3L3	0	-	13458
chr1	13386646	13390765	KNOWN	0	-	4119
chr10	90424198	90438571	LIPF	0	+	14373
chr11	7846365	7852387	OR5P3	0	-	6022
chr13	106118216	106143383	DAOA	0	+	25167
chr7	88389014	88967842	ZNF804B	0	+	578828
chrY	20137667	20139626	CDY2A	0	+	1959
chr3	161214596	161221730	OTOL1	0	+	7134
chr11	64058774	64067503	KCNK4	0	+	8729
chr6	28021006	28021943	OR2B8P	0	-	937
chr21	32252963	32253899	KRTAP11-1	0	-	936
chr5	180574586	180586285	OR2V2	0	+	11699
chr5	33936491	33939023	RXFP3	0	+	2532
chr11	123906720	123912032	OR10G7	0	-	5312
chr10	118083960	118139541	CCDC172	0	+	55581
chr2	220192129	220197899	RESP18	0	-	5770
chr1	248720213	248726073	OR2T29	0	-	5860
chr21	31743708	31744589	KRTAP13-2	0	-	881
chr15	102352405	102360400	OR4F15	0	+	7995
chr17	7258442	7260538	TMEM95	0	+	2096
chr1	152056617	152061540	TCHHL1	0	-	4923
chr13	112721463	112726020	SOX1	0	+	4557
chr17	3029904	3030845	OR1G1	0	-	941
chr17	72919045	72930007	OTOP2	0	+	10962
chrX	83116134	83141707	CYLC1	0	+	25573
chr2	111271379	111368417	RGPD6	0	-	97038
chr4	144498455	144621828	FREM3	0	-	123373
chr10	105232561	105238997	CALHM3	0	-	6436
chr3	97703946	97754159	GABRR3	0	-	50213
chr18	14507338	14543599	POTEC	0	-	36261
chr10	67672215	69523395	CTNNA3	0	-	1851180
chr11	5877979	5878920	OR52E8	0	-	941
chr12	119772517	119978845	CCDC60	0	+	206328
chr11	7817521	7818489	OR5P2	0	-	968
chrX	8758836	8769424	FAM9A	0	-	10588
chrX	151883075	151887096	MAGEA2B	0	+	4021
chr1	248737102	248738058	OR2T34	0	-	956
chr11	6007122	6008215	OR52L1	0	-	1093
chr17	8650842	8661877	SPDYE4	0	-	11035
chr15	73735505	73852354	REC114	0	+	116849
chr11	6020675	6028176	OR56A4	0	-	7501
chrX	52511761	52516905	KNOWN	0	+	5144
chr13	28551854	28562830	URAD	0	-	10976
chr10	124457225	124459362	C10orf120	0	-	2137
chr2	69172364	69180025	GKN2	0	-	7661
chr15	28764757	28778160	GOLGA8G	0	-	13403
chr16	32684849	32687486	TP53TG3	0	-	2637
chr21	32185015	32185592	KRTAP8-1	0	-	577
chr5	16067248	16180871	MARCHF11	0	-	113623
chr3	68053390	68594772	TAFA1	0	+	541382
chr19	43715943	43773682	PSG9	0	-	57739
chr2	71004442	71017775	FIGLA	0	-	13333
chrY	25119966	25151612	BPY2	0	+	31646
chr5	143550437	143865249	KCTD16	0	+	314812
chr4	44175920	44450826	KCTD8	0	-	274906
chrY	26753707	26785354	BPY2B	0	+	31647
chrY	15346458	15592553	UTY	0	-	246095
chr16	22173813	22203529	SDR42E2	0	+	29716
chr1	248753788	248761001	OR2T10	0	-	7213
chr21	32007525	32007938	KRTAP20-2	0	+	413
chrX	153845865	153847533	CTAG1B	0	-	1668
chr4	189060595	189068897	TRIML1	0	+	8302
chr15	102343712	102347090	OR4F6	0	+	3378
chr1	152943124	152945050	SPRR4	0	+	1926
chr1	159504868	159505797	OR10J5	0	-	929
chr17	2991778	3007716	OR1D2	0	-	15938
chrX	69397333	69425554	DGAT2L6	0	+	28221
chr1	153388996	153395698	S100A7A	0	+	6702
chr3	51895631	51897440	IQCF2	0	+	1809
chr21	31852025	31852686	KRTAP19-1	0	-	661
chrX	72222778	72225945	PABPC1L2B	0	+	3167
chr14	20606979	20613630	OR4N5	0	+	6651
chr22	32809832	32860471	BPIFC	0	-	50639
chr16	1138226	1146244	C1QTNF8	0	-	8018
chr17	9674751	9694909	DHRS7C	0	-	20158
chr17	8243158	8249366	ODF4	0	+	6208
chr9	70426623	70429731	KNOWN	0	-	3108
chr8	85095022	85834079	RALYL	0	+	739057
chr21	31985750	31986249	KRTAP6-1	0	-	499
chrX	23018077	23021706	DDX53	0	+	3629
chr5	174867039	174871185	DRD1	0	-	4146
chrY	2654896	2655723	SRY	0	-	827
chrX	71996714	72068637	DMRTC1B	0	+	71923
chr11	6812967	6820920	OR6A2	0	-	7953
chr2	241631283	241637900	AQP12A	0	+	6617
chr12	55862984	55863922	OR6C70	0	-	938
chr15	34260698	34359659	CHRM5	0	+	98961
chr11	63035494	63079255	SLC22A10	0	+	43761
chr7	76160630	76172614	SPDYE16	0	-	11984
chr8	13942354	15095940	SGCZ	0	-	1153586
chr5	173400782	173433143	C5orf47	0	+	32361
chr12	53161939	53171129	KRT76	0	-	9190
chr2	241615835	241622323	AQP12B	0	-	6488
chr7	57187321	57207571	KNOWN	0	-	20250
chr19	685546	695498	PRSS57	0	-	9952
chr18	13882043	13915706	MC2R	0	-	33663
chr22	37387161	37403892	TEX33	0	-	16731
chr17	43922247	43924433	SPPL2C	0	+	2186
chr2	88055479	88125315	RGPD2	0	-	69836
chr3	38738293	38857777	SCN10A	0	-	119484
chr13	96742361	97491816	HS6ST3	0	+	749455
chr5	180550122	180558169	OR2V1	0	-	8047
chr19	14989015	14996944	OR7A17	0	-	7929
chrX	34147869	34150431	FAM47A	0	-	2562
chr5	171209436	171223130	SMIM23	0	+	13694
chr11	109292916	109299893	C11orf87	0	+	6977
chr4	184242917	184243579	CLDN24	0	-	662
chr9	43624507	43630730	KNOWN	0	-	6223
chr12	55820038	55820976	OR6C76	0	+	938
chr15	24920922	24928540	NPAP1	0	+	7618
chr1	162794248	162838551	CCDC190	0	-	44303
chr4	69092371	69111412	TMPRSS11B	0	-	19041
chr1	228003376	228034171	PRSS38	0	+	30795
chrY	27177048	27208695	BPY2C	0	-	31647
chr7	143140546	143141502	TAS2R60	0	+	956
chr11	51515282	51516211	OR4C46	0	+	929
chr10	105212997	105218657	CALHM1	0	-	5660
chr11	1651005	1652160	KRTAP5-5	0	+	1155
chrX	585079	620146	SHOX	0	+	35067
chrY	535079	570146	SHOX	0	+	35067
chr1	152595310	152595579	LCE3A	0	-	269
chr1	152538130	152539256	LCE3E	0	-	1126
chr20	168494	170352	DEFB128	0	-	1858
chr13	114303119	114312513	ATP4B	0	-	9394
chr3	183814852	183824783	HTR3E	0	+	9931
chr12	53001354	53012343	KRT73	0	-	10989
chr3	183749332	183757157	HTR3D	0	+	7825
chr1	65419	71585	OR4F5	0	+	6166
chr3	121286796	121309469	ARGFX	0	+	22673
chr11	55563032	55563976	OR5D14	0	+	944
chr19	15988833	16008887	CYP4F2	0	-	20054
chr11	55587106	55588047	OR5D18	0	+	941
chr12	11338599	11339543	TAS2R42	0	-	944
chr2	27359716	27362278	PRR30	0	-	2562
chr4	9446140	9452392	DEFB131A	0	+	6252
chr20	31641709	31661653	BPIFB3	0	+	19944
chr20	31667449	31699557	BPIFB4	0	+	32108
chr1	152483279	152484653	LCE5A	0	+	1374
chr1	152758690	152760902	LCE1E	0	+	2212
chrX	72297115	72299351	PABPC1L2A	0	-	2236
chr1	158368312	158369256	OR10T2	0	-	944
chr5	150655919	150683327	SLC36A3	0	-	27408
chr5	150694533	150727151	SLC36A2	0	-	32618
chr5	129083787	129102425	MINAR2	0	+	18638
chr17	38922490	38928453	KRT26	0	-	5963
chr1	158530396	158540370	OR6P1	0	-	9974
chr12	53183469	53189901	KRT3	0	-	6432
chr2	1792885	2335436	MYT1L	0	-	542551
chr11	57791353	57949088	OR9Q1	0	+	157735
chr11	57956542	57961525	OR9Q2	0	+	4983
chr8	7678526	7681402	DEFB105A	0	-	2876
chr8	7669242	7673238	DEFB107A	0	-	3996
chr8	7682661	7686575	DEFB106A	0	+	3914
chr8	7345201	7347115	DEFB105B	0	+	1914
chr15	83424114	83474822	FSD2	0	-	50708
chr7	76651623	76661678	SPDYE17	0	-	10055
chr9	84558415	84565008	SPATA31D3	0	+	6593
chr10	118957000	118969810	KCNK18	0	+	12810
chr9	21206180	21207142	IFNA10	0	-	962
chr1	152799949	152800573	LCE1A	0	+	624
chr9	107266544	107267503	OR13F1	0	+	959
chr11	55491252	55497097	OR5D3P	0	+	5845
chr11	69624736	69634184	FGF3	0	-	9448
chr21	31973406	31973701	KRTAP22-1	0	+	295
chr21	31913854	31914183	KRTAP19-6	0	-	329
chr21	31970909	31971221	KRTAP6-2	0	-	312
chr9	107331449	107332411	OR13C8	0	+	962
chr21	31859362	31859755	KRTAP19-2	0	-	393
chr21	31869142	31869483	KRTAP19-4	0	-	341
chr21	31812593	31813187	KRTAP15-1	0	+	594
chr21	31802538	31803344	KRTAP13-4	0	+	806
chr21	31873975	31874459	KRTAP19-5	0	-	484
chr21	31720717	31720924	KRTAP23-1	0	-	207
chr9	111624546	111626036	ACTL7A	0	+	1490
chr21	32127333	32127746	KRTAP21-1	0	-	413
chr10	118349897	118368687	PNLIPRP1	0	+	18790
chr21	32119112	32119577	KRTAP21-2	0	-	465
chr3	169629360	169656963	SAMD7	0	+	27603
chr1	47394849	47407156	CYP4A11	0	-	12307
chr4	68775113	68829858	TMPRSS11A	0	-	54745
chr1	248128535	248129688	OR2AK2	0	+	1153
chr8	7340026	7343922	DEFB106B	0	-	3896
chr10	98757795	98945716	SLIT1	0	-	187921
chr19	30016901	30055458	VSTM2B	0	+	38557
chr1	16713612	16763919	SPATA21	0	-	50307
chr12	48722763	48724062	H1-7	0	+	1299
chr1	152680636	152681910	LCE4A	0	+	1274
chr1	152670821	152671918	LCE2A	0	+	1097
chr1	152647755	152649045	LCE2C	0	+	1290
chrY	26909216	26959639	DAZ3	0	-	50423
chr1	152635856	152637135	LCE2D	0	+	1279
chr1	152586287	152586574	LCE3B	0	+	287
chrX	51804923	51812315	MAGED4B	0	-	7392
chr7	34697830	34917944	NPSR1	0	+	220114
chr17	39394251	39395256	KRTAP9-8	0	+	1005
chr18	49866567	51062273	DCC	0	+	1195706
chr7	103969051	104549008	LHFPL3	0	+	579957
chr14	19988416	20020272	POTEG	0	-	31856
chr1	12952727	12958101	PRAMEF10	0	-	5374
chr19	56039978	56048500	SBK2	0	-	8522
chr10	94820555	94829297	CYP26C1	0	+	8742
chr9	70917783	70920000	FOXD4L3	0	+	2217
chr12	7864029	7870155	DPPA3	0	+	6126
chr11	55681126	55682058	OR5W2	0	-	932
chr9	136379708	136393734	MYMK	0	-	14026
chr2	87135076	87241099	RGPD1	0	+	106023
chr5	157098541	157107166	C5orf52	0	+	8625
chr19	19365565	19373613	HAPLN4	0	-	8048
chr1	248813232	248814185	KNOWN	0	-	953
chr1	104287945	104301348	AMY1C	0	+	13403
chrX	52673111	52683950	SSX7	0	-	10839
chr9	34889063	34895761	FAM205C	0	-	6698
chr15	72690643	72700708	TMEM202	0	+	10065
chr4	185939644	185942107	HELT	0	+	2463
chrX	111326244	111700742	RTL4	0	+	374498
chr2	74011310	74044275	C2orf78	0	+	32965
chr12	108168481	108170421	ASCL4	0	+	1940
chr12	55756759	55763063	OR6C75	0	+	6304
chr1	156549515	156557511	TTC24	0	+	7996
chr6	55192267	55267291	GFRAL	0	+	75024
chr19	55940107	55954667	SHISA7	0	-	14560
chr22	21400235	21418457	LRRC74B	0	+	18222
chr12	29565407	29650619	OVCH1	0	-	85212
chrX	73524015	73524869	ZCCHC13	0	+	854
chr1	20487746	20513011	PLA2G2C	0	-	25265
chr17	76142466	76162378	C17orf99	0	+	19912
chr19	9289655	9299494	OR7D2	0	+	9839
chr2	242811752	242815975	RTP5	0	+	4223
chr16	67918788	67922758	NRN1L	0	+	3970
chr15	42273592	42343388	PLA2G4E	0	-	69796
chrY	25275502	25345157	DAZ1	0	-	69655
chr11	6786857	6793207	OR2AG2	0	-	6350
chr11	17568806	17668697	OTOG	0	+	99891
chr19	36236579	36245420	ENSG00000188223	0	+	8841
chr22	20692438	20716938	KNOWN	0	+	24500
chr12	55687772	55690353	OR6C6	0	-	2581
chr19	48471303	48495427	BSPH1	0	-	24124
chr1	158744012	158750994	OR6N2	0	-	6982
chr9	21384254	21385397	IFNA2	0	-	1143
chr12	10051272	10084969	CLEC2A	0	-	33697
chrX	26234286	26236387	MAGEB5	0	+	2101
chr19	46416472	46418036	NANOS2	0	-	1564
chr1	248671374	248690638	OR2G6	0	+	19264
chr10	97667360	97793502	CC2D2B	0	+	126142
chr14	21024252	21029090	RNASE9	0	-	4838
chr2	209030067	209054754	C2orf80	0	-	24687
chr21	31653627	31655268	KRTAP24-1	0	-	1641
chr10	76797230	76833400	DUSP29	0	-	36170
chr1	203463281	203478077	OPTC	0	+	14796
chr1	26517052	26529459	CATSPER4	0	+	12407
chr1	20246502	20250110	PLA2G2E	0	-	3608
chr1	40711619	40717356	TMCO2	0	+	5737
chr3	63638351	63664696	SNTN	0	+	26345
chr1	24197005	24239852	CNR2	0	-	42847
chr15	81623429	81666554	TMC3	0	-	43125
chr8	43147626	43218661	POTEA	0	+	71035
chr11	122848278	122852542	BSX	0	-	4264
chrX	41306596	41334963	NYX	0	+	28367
chr1	12776113	12788727	AADACL3	0	+	12614
chr12	16341419	16430619	SLC15A5	0	-	89200
chr19	55315065	55325972	KIR2DL4	0	+	10907
chrX	35816459	35821889	MAGEB16	0	+	5430
chr1	156268415	156269098	VHLL	0	-	683
chrX	44703267	44704134	DUSP21	0	+	867
chr19	49547105	49548568	CGB5	0	+	1463
chrX	49354099	49361427	GAGE2A	0	+	7328
chr19	54544079	54567207	VSTM1	0	-	23128
chr10	47177204	47181681	KNOWN	0	-	4477
chrX	34960913	34963032	FAM47B	0	+	2119
chr14	44973352	44976486	FSCB	0	-	3134
chr12	53083410	53097308	KRT77	0	-	13898
chrX	27608461	27768059	DCAF8L2	0	+	159598
chrX	142596564	142605303	SPANXN3	0	-	8739
chr11	89603606	89611655	TRIM64B	0	-	8049
chrX	55649833	55652625	FOXR2	0	+	2792
chr6	36283538	36304665	BNIP5	0	-	21127
chrX	142113714	142122488	SPANXN4	0	+	8774
chr19	53780715	53788200	FAM90A27P	0	+	7485
chr2	29179477	29275096	TOGARAM2	0	+	95619
chr9	84543343	84549913	SPATA31D4	0	+	6570
chr17	18537560	18547740	TBC1D28	0	-	10180
chrX	69282307	69284029	OTUD6A	0	+	1722
chr3	98072698	98073663	OR5K4	0	+	965
chr11	123676116	123677057	OR6M1	0	-	941
chr11	124436556	124452838	OR8A1	0	+	16282
chr19	53761545	53765090	VN1R2	0	+	3545
chr17	39323483	39324473	KRTAP4-3	0	-	990
chr1	158669468	158670442	OR6K2	0	-	974
chr1	159407635	159412868	OR10J1	0	+	5233
chr2	108856424	108881807	SULT1C3	0	+	25383
chr1	248608813	248619026	OR2T2	0	+	10213
chr11	123847368	123848488	OR10S1	0	-	1120
chr1	159283510	159284449	OR10J3	0	-	939
chr3	6811688	7783220	GRM7	0	+	971532
chr11	124172727	124184995	OR8D1	0	-	12268
chr4	100333418	100356667	ADH7	0	-	23249
chr3	131252399	132004254	CPNE4	0	-	751855
chr14	20468072	20472919	OR4Q2	0	+	4847
chrX	140785568	140786896	SPANXD	0	-	1328
chr4	80327515	80329382	GK2	0	-	1867
chr1	248636652	248637608	OR2T3	0	+	956
chr14	66878422	66965395	CCDC196	0	+	86973
chr5	176827110	176827662	PFN3	0	-	552
chr3	97806017	97806946	OR5AC2	0	+	929
chr19	7018980	7021443	MBD3L2B	0	-	2463
chr11	62925909	63011071	SLC22A25	0	-	85162
chr1	152784447	152785584	LCE1B	0	+	1137
chr1	247977962	247987421	OR14A16	0	-	9459
chr11	4503876	4514727	OR52K1	0	+	10851
chr1	153042702	153044087	SPRR2B	0	-	1385
chr19	12572373	12662288	ENSG00000196826	0	-	89915
chr14	20659055	20669234	OR11G2	0	+	10179
chr2	108443348	108509000	RGPD4	0	+	65652
chr5	125967397	125971976	TEX43	0	+	4579
chr1	248524883	248525929	KNOWN	0	+	1046
chr9	136442203	136474511	FAM163B	0	-	32308
chr16	28763108	28784128	NPIPB9	0	+	21020
chr4	36283238	36349133	DTHD1	0	+	65895
chr17	39632962	39637403	KRT35	0	-	4441
chr11	124307341	124315592	OR8B8	0	-	8251
chr10	134901428	134945179	ADGRA1	0	+	43751
chr19	56701055	56709184	ZSCAN5B	0	-	8129
chr9	125273081	125274022	OR1J2	0	+	941
chr1	9063032	9086482	SLC2A7	0	-	23450
chr1	42628361	42630416	GUCA2A	0	-	2055
chr11	124054052	124059487	OR10D3	0	+	5435
chr1	158717604	158741985	OR6N1	0	-	24381
chr19	41497187	41524303	CYP2B6	0	+	27116
chr15	22736246	22746002	KNOWN	0	+	9756
chr8	82437216	82502374	FABP12	0	-	65158
chr11	4658707	4664290	OR51D1	0	+	5583
chr10	98102978	98119122	OPALIN	0	-	16144
chr1	247834114	247843041	OR13G1	0	-	8927
chr1	248176962	248187578	OR2L5	0	+	10616
chr19	56687377	56697144	GALP	0	+	9767
chr1	158514340	158524195	OR6Y1	0	-	9855
chr1	248004230	248005198	OR11L1	0	-	968
chr14	23851191	23877482	MYH6	0	-	26291
chr18	61254223	61271873	SERPINB13	0	+	17650
chr12	91299399	91348953	CCER1	0	-	49554
chr11	62847412	62911693	SLC22A24	0	-	64281
chr17	36337711	36358166	KNOWN	0	-	20455
chr21	31691442	31692633	KRTAP26-1	0	-	1191
chr12	55640982	55642086	KNOWN	0	+	1104
chr11	62063753	62066547	SCGB1D4	0	-	2794
chr11	58125597	58126542	OR5B17	0	-	945
chr11	4566421	4567374	OR52M1	0	+	953
chr4	81256884	81884904	CFAP299	0	+	628020
chr11	124111835	124124260	OR8G1	0	+	12425
chr11	57970676	57971614	OR1S2	0	-	938
chr11	64358113	64369825	SLC22A12	0	+	11712
chr10	115348473	115423829	NRAP	0	-	75356
chr11	62703857	62752439	SLC22A6	0	-	48582
chr10	48247669	48252143	KNOWN	0	+	4474
chr1	152184552	152196669	HRNR	0	-	12117
chr9	21440438	21441315	IFNA1	0	+	877
chr1	2460184	2461702	HES5	0	-	1518
chr3	98001349	98002914	OR5H2	0	+	1565
chr3	151451704	151479127	AADACL2	0	+	27423
chr15	82722223	82731338	KNOWN	0	+	9115
chrX	140671796	140672860	SPANXA1	0	-	1064
chr10	48189612	48237508	KNOWN	0	+	47896
chr22	16256441	16287937	KNOWN	0	-	31496
chr16	30234218	30266589	NPIPB13	0	-	32371
chr17	39411636	39412616	KRTAP9-9	0	+	980
chr17	39295685	39296796	KRTAP4-6	0	-	1111
chr4	68918916	68995587	TMPRSS11F	0	-	76671
chr1	248539047	248555112	OR2T6	0	+	16065
chr1	248210138	248226709	OR2L3	0	+	16571
chr8	7353433	7366833	DEFB107B	0	+	13400
chr1	149553003	149553787	KNOWN	0	+	784
chrX	37026439	37029737	FAM47C	0	+	3298
chr12	7881979	7904201	CLEC4C	0	-	22222
chr1	181286826	181782397	CACNA1E	0	+	495571
chr17	39305176	39306077	KRTAP4-5	0	-	901
chr11	58274280	58275578	OR5B21	0	-	1298
chr20	2796948	2800930	TMEM239	0	+	3982
chr21	31768349	31769140	KRTAP13-1	0	+	791
chr3	190146444	190167690	TMEM207	0	-	21246
chr22	17071641	17073700	CCT8L2	0	-	2059
chr1	247780445	247785674	OR14L1P	0	+	5229
chr3	187416047	187420345	RTP2	0	-	4298
chr11	76745442	76753020	B3GNT6	0	+	7578
chr1	211649864	211665504	RD3	0	-	15640
chrX	140335596	140336650	SPANXC	0	-	1054
chr19	30719197	31204445	ZNF536	0	+	485248
chr1	248338123	248344369	OR2M2	0	+	6246
chr6	160952514	161085307	LPA	0	-	132793
chr11	123864870	123865868	OR10G6	0	-	998
chr12	48953665	48956739	OR5BS1P	0	+	3074
chrY	22737662	22755040	EIF1AY	0	+	17378
chr6	28471073	28495992	GPX6	0	-	24919
chrX	30248774	30255612	MAGEB3	0	+	6838
chr12	70002344	70004687	LRRC10	0	-	2343
chr7	86273225	86494195	GRM3	0	+	220970
chr1	152691998	152692946	C1orf68	0	+	948
chrX	63444074	63450487	ASB12	0	-	6413
chrX	125683366	125686797	DCAF12L1	0	-	3431
chr1	158442010	158450726	OR10R2	0	+	8716
chr1	248651890	248654414	OR2T5	0	+	2524
chr1	248193372	248205607	OR2L2	0	+	12235
chr6	130152389	130182692	TMEM244	0	-	30303
chr1	158686117	158690510	OR6K3	0	-	4393
chr1	153190060	153191786	PRR9	0	+	1726
chr1	153175906	153177596	LELP1	0	+	1690
chr1	152730501	152734532	KPRP	0	+	4031
chr10	124670126	124672627	FAM24A	0	+	2501
chr1	149812259	149812780	H3C14	0	-	521
chr10	118187359	118237469	PNLIPRP3	0	+	50110
chr1	149824170	149824687	H3C15	0	+	517
chr1	120049821	120057677	HSD3B1	0	+	7856
chrX	154051623	154062937	SMIM9	0	-	11314
chrX	152341458	152343394	KNOWN	0	-	1936
chr6	74078278	74104856	OOEP	0	-	26578
chr6	74072381	74073894	KHDC3L	0	+	1513
chr6	74062786	74063999	DPPA5	0	-	1213
chrX	144329023	144337728	SPANXN1	0	+	8705
chrX	140677835	140678889	SPANXA2	0	+	1054
chrX	139037887	139047680	CXorf66	0	-	9793
chr1	67557848	67697536	C1orf141	0	-	139688
chr6	49976851	49989707	DEFB110	0	-	12856
chrX	119206229	119211655	RHOXF2B	0	-	5426
chr9	139632619	139642905	ENSG00000204003	0	-	10286
chr1	51567893	51613758	C1orf185	0	+	45865
chr9	138515494	138531386	GLT6D1	0	-	15892
chr10	90519739	90539383	LIPN	0	+	19644
chr10	90346510	90366733	LIPJ	0	+	20223
chr10	85980327	85985300	LRIT2	0	-	4973
chr9	113065756	113100164	TXNDC8	0	-	34408
chrX	69454505	69460509	AWAT1	0	+	6004
chr9	107298030	107299137	OR13C3	0	-	1107
chr17	76227391	76237068	TMEM235	0	+	9677
chrX	55284848	55291349	PAGE3	0	-	6501
chr6	32361116	32374958	BTNL2	0	-	13842
chr6	32256303	32339684	TSBP1	0	-	83381
chr11	123753627	123756377	TMEM225	0	-	2750
chr17	72352555	72358007	BTBD17	0	-	5452
chrX	52825184	52826467	SPANXN5	0	-	1283
chrX	52541053	52546197	KNOWN	0	-	5144
chrX	52528159	52533303	KNOWN	0	-	5144
chrX	52255219	52260363	KNOWN	0	-	5144
chrX	52235228	52243954	KNOWN	0	+	8726
chr17	61986957	61988701	CSHL1	0	-	1744
chr11	89764274	89775193	TRIM49C	0	+	10919
chr11	89699205	89707240	TRIM64	0	+	8035
chr1	13736907	13747803	PRAMEF20	0	+	10896
chr1	13716092	13719089	PRAMEF17	0	+	2997
chr1	13694889	13698405	PRAMEF19	0	-	3516
chr1	13668269	13673511	PRAMEF14	0	-	5242
chr1	13516066	13526943	KNOWN	0	+	10877
chr1	13495254	13498260	KNOWN	0	+	3006
chr1	13474689	13477522	KNOWN	0	-	2833
chr1	13421176	13428191	KNOWN	0	+	7015
chr1	13359819	13369057	KNOWN	0	+	9238
chr1	13328196	13331692	KNOWN	0	-	3496
chr1	13035543	13038381	KNOWN	0	+	2838
chr1	12976430	12980571	PRAMEF7	0	+	4141
chr1	12884468	12891264	KNOWN	0	-	6796
chr1	12704104	12727087	AADACL4	0	+	22983
chr19	56713642	56720830	ZSCAN5C	0	+	7188
chr20	29992648	30000641	DEFB121	0	-	7993
chr11	71292901	71314399	KRTAP5-11	0	-	21498
chr19	54135253	54140268	DPRX	0	+	5015
chr9	79634571	79635869	FOXB2	0	+	1298
chr6	30119720	30128988	TRIM10	0	-	9268
chr6	30103901	30116512	TRIM40	0	+	12611
chr2	101086944	101099742	NMS	0	+	12798
chr9	74666292	74687637	C9orf57	0	-	21345
chr6	29424932	29432105	OR2H1	0	+	7173
chr6	29269478	29280794	OR14J1	0	+	11316
chr6	29138684	29143588	OR2J2	0	+	4904
chr6	29075835	29082547	OR2J3	0	+	6712
chr6	29067267	29070478	OR2J1	0	+	3211
chr6	29053985	29055090	OR2B3	0	-	1105
chr6	29011990	29012952	OR2W1	0	-	962
chr9	70175707	70178815	FOXD4L5	0	-	3108
chr9	69377902	69380597	KNOWN	0	-	2695
chr9	69199480	69202204	KNOWN	0	-	2724
chr9	42717234	42720342	KNOWN	0	+	3108
chr9	39884975	39891210	KNOWN	0	+	6235
chr9	39355666	39361959	SPATA31A1	0	+	6293
chr17	39388701	39389706	KRTAP9-3	0	+	1005
chr17	39253233	39254394	KRTAP4-8	0	-	1161
chr17	39185603	39186447	KRTAP1-4	0	-	844
chr17	38904273	38911583	KRT25	0	-	7310
chr19	43670408	43690688	PSG5	0	-	20280
chr17	37092685	37123656	FBXO47	0	-	30971
chr11	60282865	60310194	MS4A13	0	+	27329
chr7	142457319	142460923	PRSS1	0	+	3604
chr16	88929741	88933068	PABPN1L	0	-	3327
chr11	55606228	55607214	OR5D16	0	+	986
chr11	55594695	55595630	OR5L2	0	+	935
chr4	190945522	190948412	FRG2	0	-	2890
chr9	34723050	34729485	FAM205A	0	-	6435
chr11	44069531	44081527	ACCSL	0	+	11996
chr8	86568695	86575726	KNOWN	0	-	7031
chr8	82370488	82373814	FABP9	0	-	3326
chr7	102222970	102283316	ENSG00000205236	0	-	60346
chr7	100612846	100662220	MUC12	0	+	49374
chr15	82635130	82641706	KNOWN	0	-	6576
chr4	141363416	141419531	MGAT4D	0	-	56115
chr7	100169851	100171523	SAP25	0	-	1672
chr12	55886162	55887100	OR6C68	0	+	938
chr12	55794313	55795251	OR6C65	0	+	938
chr12	55723827	55726471	OR6C3	0	+	2644
chr12	55708127	55716148	OR6C1	0	+	8021
chr11	5862158	5863182	OR52E6	0	-	1024
chr9	24542950	24545944	IZUMO3	0	-	2994
chr11	5067756	5068691	OR52J3	0	+	935
chr4	75480629	75490486	KNOWN	0	+	9857
chr4	70894172	70902255	HTN3	0	+	8083
chr4	65140975	65275186	TECRL	0	-	134211
chr19	7037760	7040190	MBD3L4	0	-	2430
chrX	49197607	49204923	KNOWN	0	+	7316
chrX	49363623	49373141	GAGE1	0	+	9518
chr12	8608558	8630926	CLEC6A	0	+	22368
chr7	16566450	16621193	LRRC72	0	+	54743
chr11	1618407	1619524	KRTAP5-2	0	-	1117
chr8	11850683	11858261	DEFB134	0	-	7578
chr8	11839765	11842099	DEFB135	0	+	2334
chr8	11831446	11832108	DEFB136	0	-	662
chrY	26979990	27053187	DAZ4	0	+	73197
chr19	1753505	1780987	ONECUT3	0	+	27482
chr16	2580036	2581418	CEMP1	0	-	1382
chr21	34398243	34401504	OLIG2	0	+	3261
chrY	25365594	25437503	DAZ2	0	+	71909
chr18	73121431	73139658	SMIM21	0	-	18227
chr18	71983074	72026424	C18orf63	0	+	43350
chr8	6835171	6837614	DEFA1	0	-	2443
chr18	61314813	61393666	SERPINB11	0	+	78853
chr21	32410478	32410795	KRTAP19-8	0	-	317
chr21	32015183	32015455	KRTAP20-3	0	+	272
chr21	31992946	31993169	KRTAP20-4	0	+	223
chr21	31962424	31962716	KRTAP22-2	0	-	292
chr21	31709331	31710012	KRTAP27-1	0	-	681
chr15	32734115	32747835	GOLGA8O	0	-	13720
chr3	149478887	149686172	ANKUB1	0	-	207285
chr3	138666059	138672832	FOXL2NB	0	+	6773
chr18	7231087	7232042	LRRC30	0	+	955
chr6	29407083	29408754	OR10C1	0	+	1671
chr3	112534556	112565711	CD200R1L	0	-	31155
chr3	98109510	98110475	OR5K3	0	+	965
chr8	56014588	56454613	XKR4	0	+	440025
chr17	39463952	39465561	KRTAP16-1	0	-	1609
chr17	39421630	39422112	KRTAP9-6	0	+	482
chr18	19993562	19997878	CTAGE1	0	-	4316
chr17	39273433	39274625	KRTAP4-11	0	-	1192
chr17	39261641	39262740	KRTAP4-9	0	+	1099
chr17	39202793	39203568	KRTAP2-1	0	-	775
chr7	143925337	143936698	OR2A42	0	-	11361
chr17	39155445	39156158	KRTAP3-2	0	-	713
chr21	31964759	31965394	KRTAP6-3	0	+	635
chr19	49550895	49552368	CGB8	0	-	1473
chr7	143651937	143694405	OR2F1	0	+	42468
chr17	61949372	61951126	CSH2	0	-	1754
chr14	96152763	96158965	TCL1B	0	+	6202
chr5	179220981	179223648	LTC4S	0	+	2667
chr17	39279343	39280434	KRTAP4-12	0	-	1091
chr17	39221368	39222131	KRTAP2-4	0	-	763
chr3	97783316	97784240	OR5AC1	0	+	924
chr15	75118968	75124143	CPLX3	0	+	5175
chr16	29471234	29476287	SULT1A4	0	+	5053
chr19	51981793	51994555	CEACAM18	0	+	12762
chr19	45202421	45213990	CEACAM16	0	+	11569
chr19	40267235	40276931	LEUTX	0	+	9696
chr9	21201468	21202204	IFNA7	0	-	736
chr3	196233750	196242217	SMCO1	0	-	8467
chr7	141408153	141431071	WEE2	0	+	22918
chr10	129347573	129351804	NPS	0	+	4231
chr3	126911974	126917028	C3orf56	0	+	5054
chr5	171621176	171630458	EFCAB9	0	+	9282
chr11	89443467	89451040	TRIM77	0	+	7573
chr2	73429702	73439641	NOTO	0	+	9939
chr17	39210750	39211482	KRTAP2-2	0	-	732
chr6	49936390	49937338	DEFB113	0	-	948
chr3	51907737	51909617	IQCF5	0	-	1880
chr3	51812577	51813257	IQCF6	0	-	680
chr11	60496777	60511685	MS4A18	0	+	14908
chr8	124864227	125132302	FER1L6	0	+	268075
chr17	20483037	20484224	CDRT15L2	0	+	1187
chr2	3751165	3895598	DCDC2C	0	+	144433
chr11	49075266	49080664	TRIM64C	0	-	5398
chr9	84603687	84610168	SPATA31D1	0	+	6481
chr14	31952081	31957245	GPR33	0	-	5164
chr17	9703925	9725396	GSG1L2	0	-	21471
chr10	47746962	47770871	NOVEL	0	+	23909
chrX	70983199	70987054	CXorf49B	0	+	3855
chrX	70934221	70938135	CXorf49	0	-	3914
chrX	57703500	57706693	NLRP2B	0	-	3193
chr15	72947038	72961940	GOLGA6B	0	+	14902
chr4	42894730	43032675	GRXCR1	0	+	137945
chr8	36641842	36793643	KCNU1	0	+	151801
chrX	49335003	49342357	GAGE12G	0	+	7354
chr8	11946847	11973025	ZNF705D	0	+	26178
chr8	7876951	7882174	FAM90A24P	0	-	5223
chr8	7783859	7809935	ZNF705B	0	+	26076
chr8	7213039	7243080	ZNF705G	0	-	30041
chr8	7144914	7147924	FAM90A5P	0	+	3010
chr18	44732540	44778031	SKOR2	0	-	45491
chr20	29891015	29896388	DEFB116	0	-	5373
chr20	29845467	29847435	DEFB115	0	+	1968
chr22	17442826	17489112	GAB4	0	-	46286
chr15	82930438	82939159	NOVEL	0	-	8721
chr1	23279536	23299359	LACTBL1	0	-	19823
chr1	11821844	11849642	C1orf167	0	+	27798
chr7	48964143	48967050	CDC14C	0	+	2907
chr2	21346840	21367240	TDRD15	0	+	20400
chr1	22303515	22325135	CELA3B	0	+	21620
chr11	64067830	64072242	CATSPERZ	0	+	4412
chr11	48997050	49005437	TRIM51G	0	-	8387
chr7	143697413	143705886	OR6B1	0	+	8473
chr19	43225790	43244633	PSG3	0	-	18843
chr7	143746041	143755938	OR2A5	0	+	9897
chr11	51411378	51412448	OR4A5	0	-	1070
chr17	39182278	39183460	KRTAP1-5	0	-	1182
chr7	143174966	143175889	TAS2R41	0	+	923
chr7	143783371	143796046	OR2A12	0	+	12675
chr19	53431728	53466076	ZNF816-ZNF321P	0	-	34348
chr19	43428284	43441359	PSG7	0	-	13075
chr17	39190136	39191126	KRTAP1-3	0	-	990
chr17	3180236	3289611	OR3A2	0	-	109375
chr1	247918148	247923858	OR1C1	0	-	5710
chr7	53103326	53104618	POM121L12	0	+	1292
chr7	143632326	143633279	OR2F2	0	+	953
chr11	123624288	123625226	OR6X1	0	-	938
chr7	143766904	143772963	OR2A25	0	+	6059
chr7	143820269	143828281	OR2A14	0	+	8012
chr11	50003009	50004071	OR4C12	0	-	1062
chr7	144009512	144019830	OR2A1	0	+	10318
chr14	22122051	22135856	OR4E2	0	+	13805
chr1	109834987	109849633	MYBPHL	0	-	14646
chr7	143806676	143807632	OR2A2	0	+	956
chr11	4388493	4389616	OR52B4	0	-	1123
chr14	23511421	23513269	PSMB11	0	+	1848
chr14	19553365	19589682	POTEM	0	+	36317
chr2	131369013	131415610	POTEJ	0	+	46597
chr11	89644279	89654935	KNOWN	0	-	10656
chr8	11993944	11996358	USP17L2	0	-	2414
chr4	9236111	9237772	USP17L15	0	+	1661
chrX	51453608	51455227	CENPVL1	0	+	1619
chr10	22497404	22506944	EBLN1	0	-	9540
chr11	5253908	5264887	HBD	0	-	10979
chrX	24326327	24332186	SUPT20HL2	0	-	5859
chr7	63667581	63680668	ZNF735	0	+	13087
chr19	56270463	56274787	RFPL4A	0	+	4324
chrX	24378756	24385956	SUPT20HL1	0	+	7200
chr8	7137292	7140302	FAM90A13P	0	+	3010
chrX	120072555	120075877	CT47A10	0	-	3322
chrX	134252881	134254454	ETDB	0	-	1573
chrX	51359872	51361764	CENPVL3	0	-	1892
chrX	145895624	145896262	CXorf51A	0	-	638
chrX	49178516	49185863	GAGE12J	0	+	7347
chrX	49344552	49351904	GAGE12H	0	+	7352
chr19	45445495	45452822	APOC4-APOC2	0	+	7327
chrX	27478324	27481458	PPP4R3C	0	-	3134
chrX	152583138	152587225	PNMA6F	0	-	4087
chr8	7833915	7835507	USP17L3	0	-	1592
chrX	109764124	109766249	TDGF1P3	0	+	2125
chr7	142749438	142750379	OR6V1	0	+	941
chr10	135437399	135440299	FRG2B	0	-	2900
chr11	51435459	51436403	OR4A8	0	-	944
chrX	120092019	120095341	CT47A6	0	-	3322
chr11	4602973	4614570	OR52I2	0	+	11597
chr2	241845747	241932728	CROCC2	0	+	86981
chr8	11989926	11991608	USP17L7	0	-	1682
chr8	142524738	142528837	ENSG00000226490	0	+	4099
chrX	120077415	120080737	CT47A9	0	-	3322
chrX	120064104	120066155	CT47A12	0	-	2051
chr13	51656255	51774388	C13orf42	0	-	118133
chrX	134962849	134971244	KNOWN	0	-	8395
chrX	120067694	120071012	CT47A11	0	-	3318
chrY	24549557	24564028	RBMY1J	0	+	14471
chr12	133794898	133812463	ANHX	0	-	17565
chr4	9341129	9342721	USP17L5	0	+	1592
chr13	57734766	57737787	PRR20D	0	+	3021
chr1	248599660	248607617	OR2T7	0	+	7957
chrX	140084759	140085871	SPANXB1	0	+	1112
chrX	49306336	49313697	GAGE12D	0	+	7361
chr4	9221878	9223470	USP17L12	0	+	1592
chr15	28798714	28808925	GOLGA6L25P	0	+	10211
chr7	102305815	102312110	POLR2J2	0	-	6295
chr18	54814318	54817641	BOD1L2	0	+	3323
chr9	21239001	21240004	IFNA14	0	-	1003
chr12	66517697	66563765	ENSG00000228144	0	-	46068
chr1	248360567	248376227	OR2M3	0	+	15660
chr2	90537839	90538397	PUTATIVE	0	-	558
chr1	247933471	247942826	OR9H1P	0	+	9355
chrX	120087136	120090454	CT47A7	0	-	3318
chr19	53769929	53770976	VN1R4	0	-	1047
chr10	81586495	81610634	NUTM2E	0	+	24139
chr11	113650518	113651207	CLDN25	0	+	689
chr6	31021227	31027667	HCG22	0	+	6440
chrX	134928331	134953994	KNOWN	0	-	25663
chr4	9364855	9366447	USP17L30	0	+	1592
chrY	9236030	9238832	TSPY3	0	+	2802
chr11	60989819	60999166	PGA4	0	+	9347
chr19	56280484	56284786	RFPL4AL1	0	+	4302
chrY	9195406	9198208	TSPY8	0	+	2802
chr1	13216356	13219581	PUTATIVE	0	-	3225
chr4	9336384	9337976	USP17L26	0	+	1592
chr13	57715052	57731216	PRR20C	0	+	16164
chr11	60970779	60980570	PGA3	0	+	9791
chr4	9172135	9178456	FAM90A26	0	+	6321
chr7	18066393	18067469	PRPS1L1	0	-	1076
chr15	21040701	21071643	POTEB2	0	-	30942
chr8	7114426	7117436	FAM90A15P	0	+	3010
chr6	46714670	46727243	ANKRD66	0	+	12573
chr5	180794269	180795263	OR4F3	0	+	994
chr7	124116425	124117009	SSU72P8	0	+	584
chr3	97982096	97984200	OR5H6	0	+	2104
chrX	120082276	120085598	CT47A8	0	-	3322
chr4	9331637	9333229	USP17L25	0	+	1592
chr8	7189909	7191501	USP17L1	0	+	1592
chr8	145437880	145440835	KNOWN	0	+	2955
chrX	120101740	120105062	CT47A4	0	-	3322
chrX	139173837	139175070	ENSG00000230707	0	+	1233
chr4	9350619	9352211	USP17L28	0	+	1592
chr21	32090843	32091095	KRTAP21-3	0	-	252
chr3	97849565	97857392	OR5H1	0	+	7827
chr17	41857803	41864988	CFAP97D1	0	+	7185
chr4	9212383	9213975	USP17L10	0	+	1592
chr4	9355364	9356956	USP17L29	0	+	1592
chr12	85408090	85430055	TSPAN19	0	-	21965
chr18	5142910	5197502	AKAIN1	0	-	54592
chrX	49235708	49242997	KNOWN	0	+	7289
chr12	10977559	11324207	PRH1	0	-	346648
chr19	43370616	43383974	PSG1	0	-	13358
chrX	26178718	26180527	MAGEB6B	0	+	1809
chr2	207516345	207586294	DYTN	0	-	69949
chr16	8587607	8622304	TMEM114	0	-	34697
chr21	31661463	31661832	KRTAP25-1	0	-	369
chr4	9326891	9328483	USP17L24	0	+	1592
chr11	4614980	4616243	OR52I1	0	+	1263
chr3	98182045	98191768	OR5K1	0	+	9723
chr4	9226622	9228214	USP17L13	0	+	1592
chrX	134883488	134891885	KNOWN	0	+	8397
chr1	12998302	13007406	PRAMEF6	0	-	9104
chrX	134847185	134857354	KNOWN	0	+	10169
chr3	98025596	98031687	OR5H8	0	+	6091
chr9	43135095	43135514	NOVEL	0	+	419
chr8	12168471	12175825	DEFB130A	0	-	7354
chr16	18451943	18473188	NOVEL	0	-	21245
chr8	11921898	11929256	DEFB130B	0	-	7358
chr8	7869304	7874533	FAM90A11P	0	-	5229
chr8	7122048	7125058	FAM90A3P	0	+	3010
chr4	9217131	9218723	USP17L11	0	+	1592
chr8	7152536	7155546	FAM90A20P	0	+	3010
chr3	97885540	97888618	OR5H15	0	+	3078
chr9	67924791	67925210	NOVEL	0	-	419
chr17	10725787	10741404	PIRT	0	-	15617
chr9	41500679	41506925	KNOWN	0	+	6246
chr11	89657232	89666231	TRIM49D2	0	+	8999
chrY	9175073	9177893	TSPY4	0	+	2820
chr9	21367371	21368056	IFNA13	0	-	685
chr5	86512423	86534822	KNOWN	0	-	22399
chr16	27078248	27080487	C16orf82	0	+	2239
chr9	41321107	41327364	KNOWN	0	-	6257
chr7	123670975	123673121	TMEM229A	0	-	2146
chr13	57741331	57744352	PRR20E	0	+	3021
chrY	23673258	23711212	RBMY1A1	0	+	37954
chr15	65369084	65372286	KBTBD13	0	+	3202
chr11	123897505	123901341	OR10G8	0	+	3836
chr9	65503363	65509610	KNOWN	0	-	6247
chr9	21227242	21228221	IFNA17	0	-	979
chr9	131901692	132022854	ENSG00000235007	0	+	121162
chr2	207507211	207514089	FAM237A	0	+	6878
chr1	367640	368634	KNOWN	0	+	994
chr4	1396720	1400230	NKX1-1	0	-	3510
chrX	145891289	145891929	CXorf51B	0	+	640
chr15	79575064	79590581	ANKRD34C	0	+	15517
chr11	119209652	119217415	MFRP	0	-	7763
chr4	9345874	9347466	USP17L27	0	+	1592
chr1	152815332	152816459	LCE6A	0	+	1127
chr11	125658022	125661495	PATE3	0	+	3473
chr9	47295855	47314322	NOVEL	0	-	18467
chr3	97866323	97875458	OR5H14	0	+	9135
chr8	7194637	7196229	USP17L4	0	+	1592
chrX	120106600	120109922	CT47A3	0	-	3322
chrX	49226182	49233481	KNOWN	0	+	7299
chr17	33871004	33887838	SLFN14	0	-	16834
chrX	49315881	49332821	GAGE12F	0	+	16940
chrX	120116330	120119614	CT47A1	0	-	3284
chr18	11609595	11610611	SLC35G4	0	+	1016
chr7	142880512	142881528	TAS2R39	0	+	1016
chrY	9365489	9368291	TSPY10	0	+	2802
chrX	120006461	120009720	CT47B1	0	-	3259
chr9	138496191	138511739	ENSG00000236543	0	+	15548
chr9	21186617	21187586	IFNA4	0	-	969
chrX	49294472	49294588	GAGE12B	0	+	116
chr3	49215067	49229291	C3orf84	0	-	14224
chr11	123893720	123894655	OR10G9	0	+	935
chr8	7829183	7830775	USP17L8	0	-	1592
chr6	132859416	132860475	TAAR9	0	+	1059
chr9	46385691	46387031	KNOWN	0	-	1340
chr19	7030589	7033022	MBD3L5	0	+	2433
chr11	125703211	125709967	PATE4	0	+	6756
chr13	64320874	64325213	ENSG00000237378	0	+	4339
chr11	48510345	48511274	OR4A47	0	+	929
chr2	233385098	233390426	PRSS56	0	+	5328
chr19	46236697	46267799	MEIOSIN	0	+	31102
chr19	9358020	9363301	OR7E24	0	+	5281
chr2	127656440	127659673	TEX51	0	+	3233
chrX	49188094	49195366	KNOWN	0	+	7272
chr7	141586948	141587892	OR9A1P	0	+	944
chrX	49296780	49304141	GAGE12C	0	+	7361
chr1	104198382	104207176	AMY1A	0	+	8794
chr1	16999498	17000007	KNOWN	0	+	509
chr15	28592997	28603230	GOLGA6L24P	0	-	10233
chrX	120096880	120100202	CT47A5	0	-	3322
chrY	9324876	9327690	TSPY9	0	+	2814
chrX	40482680	40483388	MPC1L	0	+	708
chr1	247875115	247887066	ENSG00000239395	0	-	11951
chr3	127002626	127006889	PRR20G	0	-	4263
chr1	13052394	13052998	PUTATIVE	0	-	604
chr8	6873391	6875819	DEFA3	0	-	2428
chr17	39382900	39383904	KRTAP9-2	0	+	1004
chr1	178482244	178517737	TEX35	0	+	35493
chr3	155008016	155011472	STRIT1	0	-	3456
chr8	6854288	6856720	DEFA1B	0	-	2432
chrX	49207160	49214420	KNOWN	0	+	7260
chr1	152747616	152749500	LCE1F	0	+	1884
chr19	55361898	55378662	KIR3DL2	0	+	16764
chr21	31797698	31798244	KRTAP13-3	0	-	546
chr17	39346139	39346891	KRTAP9-1	0	+	752
chr17	39240402	39241396	KRTAP4-7	0	+	994
chr3	108837099	108870248	C3orf85	0	+	33149
chr17	39257754	39258461	KRTAP4-16	0	-	707
chrX	49216659	49223943	KNOWN	0	+	7284
chrX	52725946	52736228	SSX2	0	-	10282
chr17	39405939	39406905	KRTAP9-4	0	+	966
chr11	1642188	1643368	KRTAP5-4	0	-	1180
chr19	55235947	55248099	KIR3DL3	0	+	12152
chr3	70243630	70361789	MDFIC2	0	-	118159
chrX	134866214	134874614	KNOWN	0	+	8400
chr19	43568361	43587197	PSG2	0	-	18836
chrX	120111460	120114782	CT47A2	0	-	3322
chr2	234526279	234681946	UGT1A8	0	+	155667
chrY	24049765	24064189	RBMY1E	0	-	14424
chr18	61575192	61603345	SERPINB10	0	+	28153
chr1	12939033	12946025	PRAMEF4	0	-	6992
chr19	43511808	43530626	PSG11	0	-	18818
chr19	10216899	10225456	PPAN-P2RY11	0	+	8557
chr1	104160049	104168402	AMY2A	0	+	8353
chr9	36002906	36003864	OR13C7	0	-	958
chr6	29321526	29399744	OR5V1	0	-	78218
chr19	55249978	55264504	KIR2DL3	0	+	14526
chr1	237167403	237167741	MT1HL1	0	-	338
chr21	31863780	31864331	KRTAP19-3	0	-	551
chr1	152572710	152573562	LCE3C	0	+	852
chr9	114393666	114432509	DNAJC25-GNG10	0	+	38843
chr21	31933194	31933633	KRTAP19-7	0	-	439
chrY	24026223	24040673	RBMY1D	0	-	14450
chr17	39333698	39334473	KRTAP4-2	0	-	775
chr20	1206688	1277065	RAD21L1	0	+	70377
chr21	31988744	31989018	KRTAP20-1	0	+	274
chr20	278211	280965	ZCCHC3	0	+	2754
chr19	54573149	54584634	TARM1	0	-	11485
chr11	66384097	66413940	RBM14-RBM4	0	+	29843
chr2	160628362	160761221	LY75-CD302	0	-	132859
chr3	159945241	160167617	ENSG00000248710	0	-	222376
chr4	100557686	100578985	C4orf54	0	-	21299
chr7	330136	334388	FOXL3	0	+	4252
chr17	7452416	7464918	TNFSF12-TNFSF13	0	+	12502
chr4	9255104	9256696	USP17L19	0	+	1592
chr4	9269345	9270937	USP17L22	0	+	1592
chr4	9245605	9247197	USP17L17	0	+	1592
chr20	44162835	44176301	EPPIN-WFDC6	0	-	13466
chr5	17610605	17611692	TAF11L12	0	+	1087
chr21	34956993	35303911	ENSG00000249209	0	-	346918
chr15	65134082	65223118	ENSG00000249240	0	+	89036
chr4	17516788	17528727	CLRN2	0	+	11939
chr5	17444119	17486938	LINC02218	0	+	42819
chr1	159401994	159402928	OR10J4	0	+	934
chr4	9264598	9266190	USP17L21	0	+	1592
chr6	114376760	114664187	HS3ST5	0	-	287427
chr19	40146553	40151287	LGALS16	0	+	4734
chr2	86732791	86948245	RNF103-CHMP3	0	-	215454
chr15	32681800	32695493	GOLGA8K	0	-	13693
chr10	99344131	99433667	ENSG00000249967	0	+	89536
chr4	107278549	107289935	GIMD1	0	-	11386
chrX	37208583	38546928	ENSG00000250349	0	+	1338345
chr4	144917257	144940533	GYPB	0	-	23276
chr4	165975018	165981706	TRIM75	0	+	6688
chrX	118212598	118284542	KIAA1210	0	-	71944
chr6	31674681	31685695	LY6G6F-LY6G6D	0	+	11014
chr13	36742931	36871979	CCDC169-SOHLH2	0	-	129048
chr2	18736811	18770830	NT5C1B-RDH14	0	-	34019
chr4	9259850	9261442	USP17L20	0	+	1592
chr5	17634569	17635162	TAF11L14	0	+	593
chr19	36290890	36304201	PRODH2	0	-	13311
chr4	56685956	56703655	EXOC1L	0	+	17699
chr4	9250356	9251948	USP17L18	0	+	1592
chr4	9274090	9274640	USP17L23	0	+	550
chr3	118866222	118906654	ENSG00000251012	0	+	40432
chr5	114914339	114961858	TMED7-TICAM2	0	-	47519
chr1	155036224	155059283	ENSG00000251246	0	+	23059
chr6	112668532	112672496	RFPL4B	0	+	3964
chr9	103204553	103339918	MSANTD3-TMEFF1	0	+	135365
chr22	24204375	24237410	ENSG00000251357	0	+	33035
chr1	10490159	10512210	CENPS-CORT	0	+	22051
chr17	15474805	15554967	ENSG00000251537	0	-	80162
chr2	170335990	170382432	ENSG00000251569	0	+	46442
chr16	1535887	1538982	PTX4	0	-	3095
chr1	192286122	192336415	RGS21	0	+	50293
chr17	59667782	59668580	NACA2	0	-	798
chr3	191178952	191179245	PYDC2	0	+	293
chr8	7884599	7889340	FAM90A12P	0	-	4741
chr11	59240788	59246834	OR4D10	0	+	6046
chr1	32930658	33066393	ENSG00000254553	0	+	135735
chr15	23888696	23893014	MAGEL2	0	-	4318
chr10	124214169	124216868	ARMS2	0	+	2699
chr11	2181009	2182451	INS	0	-	1442
chr14	101346090	101370059	RTL1	0	-	23969
chr11	55976461	55982698	OR8J2	0	-	6237
chr14	24658363	24682679	ENSG00000254692	0	-	24316
chr11	123883704	123889439	OR10G4	0	+	5735
chr11	56344212	56345263	KNOWN	0	-	1051
chr16	14836390	14859319	NPIPA2	0	+	22929
chr6	31497996	31514385	ATP6V1G2-DDX39B	0	-	16389
chr7	30791753	30931696	INMT-MINDY4	0	+	139943
chr11	89819118	89820299	UBTFL1	0	+	1181
chr11	56376712	56382350	OR5M1	0	-	5638
chr4	89442149	89444927	PIGY	0	-	2778
chr11	58346645	58392112	ZFP91-CNTF	0	+	45467
chr17	15602866	15649254	ZNF286A-TBC1D26	0	+	46388
chr15	35375611	35377496	NANOGP8	0	-	1885
chr11	56309816	56310733	OR5M11	0	-	917
chr11	117690878	117747382	FXYD6-FXYD2	0	-	56504
chr8	7397149	7399972	PRR23D1	0	+	2823
chr11	117874349	117959014	SMIM35	0	-	84665
chr1	19175767	19247615	NOVEL	0	-	71848
chr11	124126272	124136120	OR8G5	0	+	9848
chr11	6190585	6191556	OR52B2	0	-	971
chr6	127759551	127840146	ENSG00000255330	0	-	80595
chr11	22868468	22882020	CCDC179	0	-	13552
chr8	7636113	7638935	PRR23D2	0	-	2822
chr11	59745493	59798550	OOSP4B	0	+	53057
chr8	11618896	11620309	KNOWN	0	+	1413
chr11	124082414	124086535	OR8G3P	0	+	4121
chr11	62417166	62432650	ENSG00000255432	0	-	15484
chr11	105008441	105402424	CARD18	0	-	393983
chr16	28648975	28670065	NPIPB8	0	+	21090
chr14	22101992	22103096	OR10G2	0	-	1104
chr6	36665603	36700961	RAB44	0	+	35358
chr12	10564911	10588600	ENSG00000255641	0	-	23689
chr11	114271404	114314654	ENSG00000255663	0	+	43250
chr17	56244343	56248772	OR4D2	0	+	4429
chr19	41856758	41930906	ENSG00000255730	0	+	74148
chr14	23099834	23113561	OR6J1	0	-	13727
chr5	134779916	134788041	TIFAB	0	-	8125
chr1	226074396	226111978	ENSG00000255835	0	-	37582
chr11	94782586	94784502	KDM4F	0	+	1916
chr9	37588410	38068684	ENSG00000255872	0	-	480274
chr1	147954635	147955419	KNOWN	0	-	784
chr1	159804264	159842843	ENSG00000256029	0	-	38579
chr3	52097076	52097567	KNOWN	0	-	491
chr6	131148546	131158275	SMLR1	0	+	9729
chr5	150158319	150176296	SMIM3	0	+	17977
chr1	148201752	148202536	KNOWN	0	-	784
chr1	54598359	54665746	ENSG00000256407	0	-	67387
chr18	76739818	76762677	SALL3	0	+	22859
chr10	45797746	45811056	OR13A1	0	-	13310
chr7	42948872	42971813	ENSG00000256646	0	-	22941
chr12	10163226	10171395	CLEC12B	0	+	8169
chr11	61008647	61018916	PGA5	0	+	10269
chr21	14741931	14745386	NOVEL	0	-	3455
chr17	6555082	6596521	C17orf100	0	+	41439
chr12	133707570	133778955	ENSG00000256825	0	+	71385
chr12	122692326	122750970	ENSG00000256861	0	-	58644
chr12	20968608	21243179	SLCO1B3-SLCO1B7	0	+	274571
chr11	94245627	94265289	C11orf97	0	+	19662
chrX	152243996	152245978	KNOWN	0	-	1982
chr14	19377594	19378574	OR11H12	0	+	980
chr7	27203154	27219632	ENSG00000257184	0	-	16478
chr14	36942412	36990354	SFTA3	0	-	47942
chr12	49121218	49159573	TEX49	0	+	38355
chr12	72067984	72092748	ENSG00000258064	0	+	24764
chr7	141951963	141957878	PRSS58	0	-	5915
chr4	191005267	191007077	KNOWN	0	+	1810
chr8	133036485	133097902	ENSG00000258417	0	-	61417
chr14	20181063	20182491	OR11H2	0	-	1428
chr1	160186590	160254920	ENSG00000258465	0	-	68330
chr11	111657010	111750149	ENSG00000258529	0	-	93139
chr22	24666866	24838324	SPECC1L-ADORA2A	0	+	171458
chr14	94830650	94833035	SERPINA2	0	-	2385
chr14	74318674	74398981	ENSG00000258653	0	+	80307
chr19	19627036	19646885	ENSG00000258674	0	+	19849
chr14	96671181	96730266	ENSG00000258691	0	+	59085
chr8	10582909	10697357	PINX1	0	-	114448
chr9	34646628	34661883	ENSG00000258728	0	+	15255
chr11	49973943	49974971	OR4C13	0	+	1028
chr19	57665389	57678853	DUXA	0	-	13464
chr2	238875656	239008053	UBE2F-SCLY	0	+	132397
chrY	9304564	9307358	TSPY1	0	+	2794
chr19	48362492	48364978	TPRX2	0	+	2486
chr6	7881755	8064597	BLOC1S5-TXNDC5	0	-	182842
chr14	21051051	21077954	ENSG00000259060	0	-	26903
chr11	77728017	77790911	NDUFC2-KCTD14	0	-	62894
chr14	23415479	23451467	ENSG00000259132	0	-	35988
chr15	83011379	83018198	NOVEL	0	-	6819
chr15	64473379	64673639	ENSG00000259316	0	-	200260
chr15	23405069	23414193	NOVEL	0	-	9124
chr11	121986048	121986923	BLID	0	-	875
chr16	2563966	2577956	ENSG00000259784	0	+	13990
chr15	45879549	45968512	ENSG00000260170	0	+	88963
chr3	150600784	150659530	ENSG00000260234	0	-	58746
chr16	70333097	70406485	ENSG00000260537	0	+	73388
chr16	71463883	71475957	TLE7	0	-	12074
chrX	110754873	110765627	SERTM2	0	+	10754
chr20	1520790	1600655	ENSG00000260861	0	-	79865
chr20	30555954	30591190	XKR7	0	+	35236
chr15	30427254	30440951	GOLGA8T	0	+	13697
chr6	30978251	31003179	MUC22	0	+	24928
chr16	30537244	30546173	ENSG00000261459	0	-	8929
chr16	33262082	33264719	TP53TG3B	0	+	2637
chr15	29086978	29093821	GOLGA6L7	0	-	6843
chr8	144162047	144164903	LY6L	0	+	2856
chr9	140063306	140066436	ENSG00000261793	0	-	3130
chr3	128806418	128879879	ISY1-RAB43	0	-	73461
chr16	28467692	28503419	ENSG00000261832	0	-	35727
chr17	53525794	53588805	SMIM36	0	-	63011
chr17	3057183	3058176	OR1P1	0	-	993
chr17	7293053	7307416	TMEM256-PLSCR3	0	-	14363
chr6	138699042	138704623	SMIM28	0	+	5581
chr17	2965963	2966901	OR1D5	0	-	938
chr17	45000499	45127298	ENSG00000262633	0	+	126799
chr17	79670401	79687569	ENSG00000262660	0	+	17168
chr17	43697710	43913192	LINC02210-CRHR1	0	+	215482
chr2	74438731	74590504	ENSG00000264324	0	-	151773
chr17	10346607	10372876	MYH4	0	-	26269
chr8	144329280	144358573	ENSG00000264668	0	+	29293
chr17	61562184	61599209	ENSG00000264813	0	+	37025
chr17	56066399	56084607	ENSG00000266086	0	-	18208
chr17	26125832	26220391	ENSG00000266202	0	-	94559
chr17	16593575	16707767	ENSG00000266302	0	+	114192
chr19	2717767	2740046	ENSG00000267001	0	-	22279
chr19	44529506	44591471	ENSG00000267022	0	+	61965
chr19	1578338	1605444	ENSG00000267059	0	-	27106
chr19	36230153	36236333	ENSG00000267120	0	-	6180
chr18	33023835	33077904	ENSG00000267140	0	-	54069
chr19	44833848	44905774	ENSG00000267173	0	-	71926
chr19	12035890	12090105	ENSG00000267179	0	+	54215
chr19	49526210	49540152	ENSG00000267335	0	-	13942
chr19	11577055	11616513	ENSG00000267477	0	-	39458
chr17	33338368	33448512	ENSG00000267618	0	-	110144
chr18	48494389	48584514	ENSG00000267699	0	+	90125
chr19	5866182	5903798	ENSG00000267740	0	-	37616
chr19	42212576	42260645	ENSG00000267881	0	+	48069
chr14	70036516	70041588	CCDC177	0	-	5072
chr19	39308111	39330818	ENSG00000268083	0	-	22707
chr19	57999086	58028927	ENSG00000268107	0	+	29841
chr19	18263968	18288927	ENSG00000268173	0	+	24959
chr2	121221911	121223697	KNOWN	0	-	1786
chr5	115368021	115395815	ARL14EPL	0	+	27794
chr15	21004687	21005367	NOVEL	0	+	680
chr19	44058844	44097188	ENSG00000268361	0	-	38344
chr19	7694682	7712363	ENSG00000268400	0	+	17681
chr19	8740083	8791414	NFILZ	0	+	51331
chr19	52114213	52133654	SIGLEC5	0	-	19441
chr12	147052	147377	NOVEL	0	+	325
chr19	42738735	42759284	ENSG00000268643	0	-	20549
chr1	16865561	16866070	KNOWN	0	+	509
chr9	44325916	44326077	KNOWN	0	-	161
chr15	32774822	32780287	NOVEL	0	+	5465
chr19	41307202	41404187	ENSG00000268797	0	+	96985
chr5	17491076	17492185	H3Y2	0	-	1109
chr6	31973945	31974881	NOVEL	0	-	936
chr1	17060447	17060956	KNOWN	0	-	509
chr19	58193413	58264943	ENSG00000269026	0	+	71530
chr19	17547420	17571613	ENSG00000269035	0	-	24193
chr22	21358030	21360736	NOVEL	0	-	2706
chr19	50412758	50461648	ENSG00000269179	0	-	48890
chr19	21587961	21674068	ENSG00000269237	0	+	86107
chr5	17654977	17655958	H3Y1	0	-	981
chr19	49966009	49989488	ENSG00000269469	0	+	23479
chr19	39406044	39440495	ENSG00000269547	0	-	34451
chr7	65112081	65113280	NOVEL	0	-	1199
chr1	48569306	48569878	KNOWN	0	+	572
chr19	51499274	51512837	ENSG00000269741	0	-	13563
chr10	22605317	22618471	COMMD3-BMI1	0	+	13154
chr6	78359991	78636762	MEI4	0	+	276771
chr17	60349848	60360276	NOVEL	0	-	10428
chr13	103451460	103528344	BIVM-ERCC5	0	+	76884
chr10	104614029	104661656	BORCS7-ASMT	0	+	47627
chr7	143268894	143271480	CTAGE15	0	+	2586
chr7	143452182	143454789	CTAGE6	0	-	2607
chr1	55107459	55207981	MROH7-TTC4	0	+	100522
chr6	86214494	86388451	ENSG00000271793	0	-	173957
chr1	90098699	90398809	ENSG00000271949	0	+	300110
chr6	10748027	10930656	ENSG00000272162	0	+	182629
chr4	187347700	187476482	ENSG00000272297	0	-	128782
chr19	36208875	36229781	KMT2B	0	+	20906
chr3	10291056	10327480	ENSG00000272410	0	+	36424
chr4	77172874	77232282	FAM47E-STBD1	0	+	59408
chr7	99156318	99205433	ENSG00000272647	0	+	49115
chr20	34220262	34262466	ENSG00000272897	0	-	42204
chr11	56180172	56181156	OR5AL1	0	+	984
chr11	64781654	64808042	ARL2-SNX15	0	+	26388
chr12	54379629	54428672	ENSG00000273049	0	+	49043
chr12	13590876	14134936	GRIN2B	0	-	544060
chr11	5090802	5091727	OR52E1	0	+	925
chr1	155141885	155159748	ENSG00000273088	0	-	17863
chr13	24553839	24895169	ENSG00000273167	0	+	341330
chr5	130761584	131132676	ENSG00000273217	0	-	371092
chr4	567669	570084	TMEM271	0	-	2415
chr5	133532596	133706735	ENSG00000273345	0	-	174139
chr2	68358370	68488362	ENSG00000273398	0	-	129992
