Chr	Start	End	Mutation	Size	Middle	Start_C	End_C	Mutations_C
chr1	74564117	74572117	74571494	8000	74568117	-4000	4000	3377
chr1	38834198	38842198	38839519	8000	38838198	-4000	4000	1321
chr1	110019742	110027742	110021976	8000	110023742	-4000	4000	-1766
chr1	190093658	190101658	190098597	8000	190097658	-4000	4000	939
chr1	186439566	186447566	186443900	8000	186443566	-4000	4000	334
chr1	248345713	248353713	248349077	8000	248349713	-4000	4000	-636
chr1	161710352	161718352	161711946	8000	161714352	-4000	4000	-2406
chr1	19278573	19286573	19286262	8000	19282573	-4000	4000	3689
chr1	152149595	152157595	152155595	8000	152153595	-4000	4000	2000
chr1	171634799	171642799	171636268	8000	171638799	-4000	4000	-2531
chr1	205653851	205661851	205659182	8000	205657851	-4000	4000	1331
chr1	28765775	28773775	28769299	8000	28769775	-4000	4000	-476
chr1	149809225	149817225	149812291	8000	149813225	-4000	4000	-934
chr1	151360304	151368304	151364923	8000	151364304	-4000	4000	619
chr1	151695091	151703091	151698830	8000	151699091	-4000	4000	-261
chr1	152405243	152413243	152409902	8000	152409243	-4000	4000	659
chr1	152758052	152766052	152760603	8000	152762052	-4000	4000	-1449
chr1	153977617	153985617	153981976	8000	153981617	-4000	4000	359
chr1	193086866	193094866	193091685	8000	193090866	-4000	4000	819
chr1	39674648	39682648	39682462	8000	39678648	-4000	4000	3814
chr1	47212290	47220290	47216498	8000	47216290	-4000	4000	208
chr1	247602515	247610515	247606502	8000	247606515	-4000	4000	-13
chr1	17280233	17288233	17282990	8000	17284233	-4000	4000	-1243
chr1	18481974	18489974	18483028	8000	18485974	-4000	4000	-2946
chr1	30865466	30873466	30873183	8000	30869466	-4000	4000	3717
chr1	42151820	42159820	42153516	8000	42155820	-4000	4000	-2304
chr1	53463488	53471488	53464813	8000	53467488	-4000	4000	-2675
chr1	84921583	84929583	84926590	8000	84925583	-4000	4000	1007
chr1	100144448	100152448	100148040	8000	100148448	-4000	4000	-408
chr1	149809225	149817225	149813390	8000	149813225	-4000	4000	165
chr1	152716470	152724470	152719689	8000	152720470	-4000	4000	-781
chr1	159947492	159955492	159951799	8000	159951492	-4000	4000	307
chr1	200547497	200555497	200554579	8000	200551497	-4000	4000	3082
chr1	204613170	204621170	204618558	8000	204617170	-4000	4000	1388
chr1	205653851	205661851	205659544	8000	205657851	-4000	4000	1693
chr1	243120428	243128428	243126495	8000	243124428	-4000	4000	2067
chr1	247095962	247103962	247101772	8000	247099962	-4000	4000	1810
chr1	248097103	248105103	248099471	8000	248101103	-4000	4000	-1632
chr1	248677249	248685249	248681643	8000	248681249	-4000	4000	394
chr1	100516277	100524277	100519684	8000	100520277	-4000	4000	-593
chr1	247707813	247715813	247712381	8000	247711813	-4000	4000	568
chr1	154940076	154948076	154947515	8000	154944076	-4000	4000	3439
chr1	37856697	37864697	37857466	8000	37860697	-4000	4000	-3231
chr1	152405243	152413243	152410366	8000	152409243	-4000	4000	1123
chr1	159708289	159716289	159714052	8000	159712289	-4000	4000	1763
chr1	160354952	160362952	160358302	8000	160358952	-4000	4000	-650
chr1	19278573	19286573	19285103	8000	19282573	-4000	4000	2530
chr1	23960347	23968347	23961797	8000	23964347	-4000	4000	-2550
chr1	27375176	27383176	27380117	8000	27379176	-4000	4000	941
chr1	36084275	36092275	36085835	8000	36088275	-4000	4000	-2440
chr1	37530449	37538449	37537571	8000	37534449	-4000	4000	3122
chr1	37562816	37570816	37569079	8000	37566816	-4000	4000	2263
chr1	37992770	38000770	37997456	8000	37996770	-4000	4000	686
chr1	47374839	47382839	47376884	8000	47378839	-4000	4000	-1955
chr1	85261776	85269776	85267647	8000	85265776	-4000	4000	1871
chr1	109234182	109242182	109236488	8000	109238182	-4000	4000	-1694
chr1	148478548	148486548	148483103	8000	148482548	-4000	4000	555
chr1	150261078	150269078	150262162	8000	150265078	-4000	4000	-2916
chr1	151978915	151986915	151986213	8000	151982915	-4000	4000	3298
chr1	152758052	152766052	152760854	8000	152762052	-4000	4000	-1198
chr1	152881047	152889047	152884592	8000	152885047	-4000	4000	-455
chr1	153977617	153985617	153983538	8000	153981617	-4000	4000	1921
chr1	154940076	154948076	154945116	8000	154944076	-4000	4000	1040
chr1	154940076	154948076	154946562	8000	154944076	-4000	4000	2486
chr1	155909045	155917045	155914223	8000	155913045	-4000	4000	1178
chr1	156304968	156312968	156309125	8000	156308968	-4000	4000	157
chr1	156664763	156672763	156670029	8000	156668763	-4000	4000	1266
chr1	159199313	159207313	159200912	8000	159203313	-4000	4000	-2401
chr1	160197886	160205886	160198713	8000	160201886	-4000	4000	-3173
chr1	161161723	161169723	161168025	8000	161165723	-4000	4000	2302
chr1	202315781	202323781	202318238	8000	202319781	-4000	4000	-1543
chr1	204186341	204194341	204192813	8000	204190341	-4000	4000	2472
chr1	205528793	205536793	205530687	8000	205532793	-4000	4000	-2106
chr1	206730281	206738281	206732725	8000	206734281	-4000	4000	-1556
chr1	232805929	232813929	232807134	8000	232809929	-4000	4000	-2795
chr1	236545005	236553005	236550966	8000	236549005	-4000	4000	1961
chr1	248451725	248459725	248452797	8000	248455725	-4000	4000	-2928
chr1	67697475	67705475	67705172	8000	67701475	-4000	4000	3697
chr1	152102317	152110317	152110100	8000	152106317	-4000	4000	3783
chr1	70848353	70856353	70852748	8000	70852353	-4000	4000	395
chr1	109705551	109713551	109712259	8000	109709551	-4000	4000	2708
chr1	157509377	157517377	157515850	8000	157513377	-4000	4000	2473
chr1	171208686	171216686	171208861	8000	171212686	-4000	4000	-3825
chr1	10416511	10424511	10417396	8000	10420511	-4000	4000	-3115
chr1	215233090	215241090	215235722	8000	215237090	-4000	4000	-1368
chr1	247666812	247674812	247672269	8000	247670812	-4000	4000	1457
chr1	25496209	25504209	25498302	8000	25500209	-4000	4000	-1907
chr1	155610951	155618951	155611578	8000	155614951	-4000	4000	-3373
chr1	158556606	158564606	158562805	8000	158560606	-4000	4000	2199
chr1	159199313	159207313	159200880	8000	159203313	-4000	4000	-2433
chr1	25827913	25835913	25835648	8000	25831913	-4000	4000	3735
chr1	202887116	202895116	202893286	8000	202891116	-4000	4000	2170
chr1	2561382	2569382	2561714	8000	2565382	-4000	4000	-3668
chr1	23187895	23195895	23193503	8000	23191895	-4000	4000	1608
chr1	31625866	31633866	31633288	8000	31629866	-4000	4000	3422
chr1	43969369	43977369	43972155	8000	43973369	-4000	4000	-1214
chr1	89002679	89010679	89007644	8000	89006679	-4000	4000	965
chr1	149880459	149888459	149886521	8000	149884459	-4000	4000	2062
chr1	159051155	159059155	159051854	8000	159055155	-4000	4000	-3301
chr1	163072802	163080802	163074549	8000	163076802	-4000	4000	-2253
chr1	186307652	186315652	186314678	8000	186311652	-4000	4000	3026
chr1	198519222	198527222	198523313	8000	198523222	-4000	4000	91
chr1	201892456	201900456	201900178	8000	201896456	-4000	4000	3722
chr1	209778320	209786320	209780540	8000	209782320	-4000	4000	-1780
chr1	228057271	228065271	228059032	8000	228061271	-4000	4000	-2239
chr1	227914656	227922656	227921469	8000	227918656	-4000	4000	2813
chr1	39765523	39773523	39770325	8000	39769523	-4000	4000	802
chr1	46925177	46933177	46930203	8000	46929177	-4000	4000	1026
chr1	70249052	70257052	70250363	8000	70253052	-4000	4000	-2689
chr1	119419035	119427035	119419512	8000	119423035	-4000	4000	-3523
chr1	156664763	156672763	156672085	8000	156668763	-4000	4000	3322
chr1	152800832	152808832	152805425	8000	152804832	-4000	4000	593
chr1	152800832	152808832	152805427	8000	152804832	-4000	4000	595
chr1	12792628	12800628	12793374	8000	12796628	-4000	4000	-3254
chr1	26317698	26325698	26317976	8000	26321698	-4000	4000	-3722
chr1	203163405	203171405	203170314	8000	203167405	-4000	4000	2909
chr1	212895363	212903363	212895387	8000	212899363	-4000	4000	-3976
chr1	248319630	248327630	248323712	8000	248323630	-4000	4000	82
chr1	248915946	248923946	248917607	8000	248919946	-4000	4000	-2339
chr1	12875212	12883212	12879325	8000	12879212	-4000	4000	113
chr1	20660014	20668014	20664589	8000	20664014	-4000	4000	575
chr1	24150168	24158168	24157668	8000	24154168	-4000	4000	3500
chr1	91521764	91529764	91524064	8000	91525764	-4000	4000	-1700
chr1	151766107	151774107	151767237	8000	151770107	-4000	4000	-2870
chr1	159199313	159207313	159205953	8000	159203313	-4000	4000	2640
chr1	248470307	248478307	248473878	8000	248474307	-4000	4000	-429
chr1	12916482	12924482	12920255	8000	12920482	-4000	4000	-227
chr1	52404282	52412282	52405803	8000	52408282	-4000	4000	-2479
chr1	158770222	158778222	158777061	8000	158774222	-4000	4000	2839
chr1	15486832	15494832	15492806	8000	15490832	-4000	4000	1974
chr1	24669281	24677281	24672566	8000	24673281	-4000	4000	-715
chr1	151031713	151039713	151038939	8000	151035713	-4000	4000	3226
chr1	31625866	31633866	31633220	8000	31629866	-4000	4000	3354
chr1	145973811	145981811	145977093	8000	145977811	-4000	4000	-718
chr1	160354952	160362952	160358291	8000	160358952	-4000	4000	-661
chr1	152561654	152569654	152566134	8000	152565654	-4000	4000	480
chr1	163072802	163080802	163074576	8000	163076802	-4000	4000	-2226
chr1	170549834	170557834	170552261	8000	170553834	-4000	4000	-1573
chr1	222747004	222755004	222747043	8000	222751004	-4000	4000	-3961
chr1	248097103	248105103	248099867	8000	248101103	-4000	4000	-1236
chr1	212826141	212834141	212830151	8000	212830141	-4000	4000	10
chr1	115281904	115289904	115286700	8000	115285904	-4000	4000	796
chr1	220880503	220888503	220884414	8000	220884503	-4000	4000	-89
chr1	74762678	74770678	74763957	8000	74766678	-4000	4000	-2721
chr1	146013468	146021468	146018021	8000	146017468	-4000	4000	553
chr1	152758052	152766052	152760708	8000	152762052	-4000	4000	-1344
chr1	159304224	159312224	159305985	8000	159308224	-4000	4000	-2239
chr1	244053476	244061476	244054959	8000	244057476	-4000	4000	-2517
chr1	26317698	26325698	26318024	8000	26321698	-4000	4000	-3674
chr1	12843377	12851377	12847829	8000	12847377	-4000	4000	452
chr1	25358249	25366249	25362451	8000	25362249	-4000	4000	202
chr1	203336628	203344628	203342435	8000	203340628	-4000	4000	1807
chr1	110943190	110951190	110948223	8000	110947190	-4000	4000	1033
chr1	241991490	241999490	241998820	8000	241995490	-4000	4000	3330
chr1	248265917	248273917	248273043	8000	248269917	-4000	4000	3126
chr1	42653190	42661190	42659319	8000	42657190	-4000	4000	2129
chr1	159778543	159786543	159782260	8000	159782543	-4000	4000	-283
chr1	12663076	12671076	12666184	8000	12667076	-4000	4000	-892
chr1	19070510	19078510	19074698	8000	19074510	-4000	4000	188
chr1	24840321	24848321	24841015	8000	24844321	-4000	4000	-3306
chr1	27759116	27767116	27761435	8000	27763116	-4000	4000	-1681
chr1	31430680	31438680	31432968	8000	31434680	-4000	4000	-1712
chr1	92469043	92477043	92474838	8000	92473043	-4000	4000	1795
chr1	155082807	155090807	155086473	8000	155086807	-4000	4000	-334
chr1	155610951	155618951	155614464	8000	155614951	-4000	4000	-487
chr1	169507951	169515951	169514344	8000	169511951	-4000	4000	2393
chr1	205138505	205146505	205144297	8000	205142505	-4000	4000	1792
chr1	221697424	221705424	221702645	8000	221701424	-4000	4000	1221
chr1	68094473	68102473	68098743	8000	68098473	-4000	4000	270
chr1	145988435	145996435	145996228	8000	145992435	-4000	4000	3793
chr1	146060711	146068711	146068143	8000	146064711	-4000	4000	3432
chr1	162369203	162377203	162373910	8000	162373203	-4000	4000	707
chr1	204418628	204426628	204424871	8000	204422628	-4000	4000	2243
chr1	209778320	209786320	209781442	8000	209782320	-4000	4000	-878
chr1	212616777	212624777	212619388	8000	212620777	-4000	4000	-1389
chr1	62447804	62455804	62448560	8000	62451804	-4000	4000	-3244
chr1	74564117	74572117	74571220	8000	74568117	-4000	4000	3103
chr1	31648263	31656263	31654846	8000	31652263	-4000	4000	2583
chr1	202887116	202895116	202892351	8000	202891116	-4000	4000	1235
chr1	200400940	200408940	200407700	8000	200404940	-4000	4000	2760
chr1	246764137	246772137	246767240	8000	246768137	-4000	4000	-897
chr1	248569801	248577801	248574629	8000	248573801	-4000	4000	828
chr1	38020820	38028820	38023736	8000	38024820	-4000	4000	-1084
chr1	154940076	154948076	154946363	8000	154944076	-4000	4000	2287
chr1	158353553	158361553	158355431	8000	158357553	-4000	4000	-2122
chr1	158353553	158361553	158355432	8000	158357553	-4000	4000	-2121
chr1	201892456	201900456	201899628	8000	201896456	-4000	4000	3172
chr1	231014958	231022958	231019839	8000	231018958	-4000	4000	881
chr1	90707539	90715539	90714549	8000	90711539	-4000	4000	3010
chr1	154975251	154983251	154975757	8000	154979251	-4000	4000	-3494
chr1	175008027	175016027	175008650	8000	175012027	-4000	4000	-3377
chr1	24605328	24613328	24605801	8000	24609328	-4000	4000	-3527
chr1	13365067	13373067	13370662	8000	13369067	-4000	4000	1595
chr1	225395292	225403292	225402963	8000	225399292	-4000	4000	3671
chr1	247445108	247453108	247448817	8000	247449108	-4000	4000	-291
chr1	24115771	24123771	24121696	8000	24119771	-4000	4000	1925
chr1	24669281	24677281	24672566	8000	24673281	-4000	4000	-715
chr1	66370579	66378579	66373238	8000	66374579	-4000	4000	-1341
chr1	212616777	212624777	212618219	8000	212620777	-4000	4000	-2558
chr1	36411827	36419827	36418210	8000	36415827	-4000	4000	2383
chr1	160086563	160094563	160092989	8000	160090563	-4000	4000	2426
chr1	180968712	180976712	180976499	8000	180972712	-4000	4000	3787
chr1	198753476	198761476	198756417	8000	198757476	-4000	4000	-1059
chr1	209672390	209680390	209676006	8000	209676390	-4000	4000	-384
chr1	243120428	243128428	243126512	8000	243124428	-4000	4000	2084
chr1	45489866	45497866	45494984	8000	45493866	-4000	4000	1118
chr1	92059538	92067538	92063127	8000	92063538	-4000	4000	-411
chr1	232979435	232987435	232986142	8000	232983435	-4000	4000	2707
chr1	248142086	248150086	248145832	8000	248146086	-4000	4000	-254
chr1	152999856	153007856	153003097	8000	153003856	-4000	4000	-759
chr1	168071843	168079843	168075520	8000	168075843	-4000	4000	-323
chr1	247735559	247743559	247738656	8000	247739559	-4000	4000	-903
chr1	247962386	247970386	247965464	8000	247966386	-4000	4000	-922
chr1	248319630	248327630	248324373	8000	248323630	-4000	4000	743
chr1	27608064	27616064	27613252	8000	27612064	-4000	4000	1188
chr1	109705551	109713551	109713368	8000	109709551	-4000	4000	3817
chr1	156304968	156312968	156310644	8000	156308968	-4000	4000	1676
chr1	158540550	158548550	158547533	8000	158544550	-4000	4000	2983
chr1	26357634	26365634	26361851	8000	26361634	-4000	4000	217
chr1	161979192	161987192	161984921	8000	161983192	-4000	4000	1729
chr1	63321128	63329128	63323864	8000	63325128	-4000	4000	-1264
chr1	115281904	115289904	115286799	8000	115285904	-4000	4000	895
chr1	152758052	152766052	152760387	8000	152762052	-4000	4000	-1665
chr1	161522894	161530894	161525612	8000	161526894	-4000	4000	-1282
chr1	223216819	223224819	223222116	8000	223220819	-4000	4000	1297
chr1	158606704	158614704	158613842	8000	158610704	-4000	4000	3138
chr1	204613170	204621170	204619103	8000	204617170	-4000	4000	1933
chr1	47212290	47220290	47216583	8000	47216290	-4000	4000	293
chr1	52368829	52376829	52375516	8000	52372829	-4000	4000	2687
chr1	115832377	115840377	115836514	8000	115836377	-4000	4000	137
chr1	158182427	158190427	158183143	8000	158186427	-4000	4000	-3284
chr1	192363285	192371285	192366180	8000	192367285	-4000	4000	-1105
chr1	78885764	78893764	78891037	8000	78889764	-4000	4000	1273
chr1	94514666	94522666	94518364	8000	94518666	-4000	4000	-302
chr1	156655532	156663532	156657036	8000	156659532	-4000	4000	-2496
chr1	159439078	159447078	159440152	8000	159443078	-4000	4000	-2926
chr1	248645838	248653838	248650071	8000	248649838	-4000	4000	233
chr1	47374839	47382839	47377039	8000	47378839	-4000	4000	-1800
chr1	149933812	149941812	149936201	8000	149937812	-4000	4000	-1611
chr1	153066226	153074226	153070589	8000	153070226	-4000	4000	363
chr1	153066226	153074226	153070590	8000	153070226	-4000	4000	364
chr1	169507951	169515951	169515575	8000	169511951	-4000	4000	3624
chr1	203174931	203182931	203182841	8000	203178931	-4000	4000	3910
chr1	248059407	248067407	248061582	8000	248063407	-4000	4000	-1825
chr1	1397909	1405909	1405761	8000	1401909	-4000	4000	3852
chr1	13111488	13119488	13115751	8000	13115488	-4000	4000	263
chr1	182883982	182891982	182884712	8000	182887982	-4000	4000	-3270
chr1	206460436	206468436	206461093	8000	206464436	-4000	4000	-3343
chr1	212622775	212630775	212624988	8000	212626775	-4000	4000	-1787
chr1	152999856	153007856	153003583	8000	153003856	-4000	4000	-273
chr1	152080141	152088141	152085532	8000	152084141	-4000	4000	1391
chr1	1369730	1377730	1373903	8000	1373730	-4000	4000	173
chr1	13337892	13345892	13344486	8000	13341892	-4000	4000	2594
chr1	150503602	150511602	150504338	8000	150507602	-4000	4000	-3264
chr1	244705033	244713033	244705725	8000	244709033	-4000	4000	-3308
chr1	89929250	89937250	89935080	8000	89933250	-4000	4000	1830
chr1	151978915	151986915	151986127	8000	151982915	-4000	4000	3212
chr1	152208076	152216076	152213577	8000	152212076	-4000	4000	1501
chr1	211567568	211575568	211575385	8000	211571568	-4000	4000	3817
chr1	158606704	158614704	158614305	8000	158610704	-4000	4000	3601
chr1	12140207	12148207	12142464	8000	12144207	-4000	4000	-1743
chr1	43974295	43982295	43975847	8000	43978295	-4000	4000	-2448
chr1	66775047	66783047	66777512	8000	66779047	-4000	4000	-1535
chr1	171113819	171121819	171117487	8000	171117819	-4000	4000	-332
chr1	179072567	179080567	179075461	8000	179076567	-4000	4000	-1106
chr1	206460436	206468436	206462493	8000	206464436	-4000	4000	-1943
chr1	241798777	241806777	241801324	8000	241802777	-4000	4000	-1453
chr1	248404020	248412020	248407102	8000	248408020	-4000	4000	-918
chr1	53083179	53091179	53090761	8000	53087179	-4000	4000	3582
chr1	152080141	152088141	152087375	8000	152084141	-4000	4000	3234
chr1	152981500	152989500	152985248	8000	152985500	-4000	4000	-252
chr1	179094023	179102023	179095231	8000	179098023	-4000	4000	-2792
chr1	240485573	240493573	240493115	8000	240489573	-4000	4000	3542
chr1	197034741	197042741	197040712	8000	197038741	-4000	4000	1971
chr1	207014522	207022522	207022100	8000	207018522	-4000	4000	3578
chr1	248097103	248105103	248100153	8000	248101103	-4000	4000	-950
chr1	248319630	248327630	248324409	8000	248323630	-4000	4000	779
chr1	53210197	53218197	53210208	8000	53214197	-4000	4000	-3989
chr1	153977617	153985617	153982261	8000	153981617	-4000	4000	644
chr1	94514666	94522666	94517417	8000	94518666	-4000	4000	-1249
chr1	247602515	247610515	247606019	8000	247606515	-4000	4000	-496
chr1	248265917	248273917	248273106	8000	248269917	-4000	4000	3189
chr1	26121555	26129555	26122398	8000	26125555	-4000	4000	-3157
chr1	26796659	26804659	26797659	8000	26800659	-4000	4000	-3000
chr1	152344735	152352735	152351945	8000	152348735	-4000	4000	3210
chr1	206730281	206738281	206732574	8000	206734281	-4000	4000	-1707
chr1	53907086	53915086	53910020	8000	53911086	-4000	4000	-1066
chr1	212622775	212630775	212625525	8000	212626775	-4000	4000	-1250
chr1	53083179	53091179	53090824	8000	53087179	-4000	4000	3645
chr1	169128531	169136531	169132280	8000	169132531	-4000	4000	-251
chr1	15743982	15751982	15747598	8000	15747982	-4000	4000	-384
chr1	47114318	47122318	47115591	8000	47118318	-4000	4000	-2727
chr1	155745659	155753659	155752033	8000	155749659	-4000	4000	2374
chr1	203163405	203171405	203165798	8000	203167405	-4000	4000	-1607
chr1	205298063	205306063	205304207	8000	205302063	-4000	4000	2144
chr1	223775893	223783893	223780813	8000	223779893	-4000	4000	920
chr1	248470307	248478307	248473842	8000	248474307	-4000	4000	-465
chr1	248569801	248577801	248574266	8000	248573801	-4000	4000	465
chr1	26317698	26325698	26318082	8000	26321698	-4000	4000	-3616
chr1	156664763	156672763	156670656	8000	156668763	-4000	4000	1893
chr1	182050570	182058570	182056359	8000	182054570	-4000	4000	1789
chr1	12888896	12896896	12894844	8000	12892896	-4000	4000	1948
chr1	13337892	13345892	13342880	8000	13341892	-4000	4000	988
chr1	13821079	13829079	13823320	8000	13825079	-4000	4000	-1759
chr1	15743982	15751982	15747598	8000	15747982	-4000	4000	-384
chr1	25827913	25835913	25835319	8000	25831913	-4000	4000	3406
chr1	27608064	27616064	27615746	8000	27612064	-4000	4000	3682
chr1	29322813	29330813	29323374	8000	29326813	-4000	4000	-3439
chr1	46184683	46192683	46184872	8000	46188683	-4000	4000	-3811
chr1	46409848	46417848	46413575	8000	46413848	-4000	4000	-273
chr1	114563557	114571557	114570051	8000	114567557	-4000	4000	2494
chr1	115281904	115289904	115286703	8000	115285904	-4000	4000	799
chr1	119027216	119035216	119033220	8000	119031216	-4000	4000	2004
chr1	119615377	119623377	119623187	8000	119619377	-4000	4000	3810
chr1	153386032	153394032	153390035	8000	153390032	-4000	4000	3
chr1	154151304	154159304	154152851	8000	154155304	-4000	4000	-2453
chr1	158574919	158582919	158579068	8000	158578919	-4000	4000	149
chr1	160087340	160095340	160094983	8000	160091340	-4000	4000	3643
chr1	186667791	186675791	186675277	8000	186671791	-4000	4000	3486
chr1	196828189	196836189	196830520	8000	196832189	-4000	4000	-1669
chr1	204613170	204621170	204618428	8000	204617170	-4000	4000	1258
chr1	206102936	206110936	206110514	8000	206106936	-4000	4000	3578
chr1	206730281	206738281	206731139	8000	206734281	-4000	4000	-3142
chr1	223105404	223113404	223110642	8000	223109404	-4000	4000	1238
chr1	223105404	223113404	223112948	8000	223109404	-4000	4000	3544
chr1	227777826	227785826	227780716	8000	227781826	-4000	4000	-1110
chr1	228102679	228110679	228108075	8000	228106679	-4000	4000	1396
chr1	11915591	11923591	11922784	8000	11919591	-4000	4000	3193
chr1	113973869	113981869	113981135	8000	113977869	-4000	4000	3266
chr1	113973869	113981869	113981136	8000	113977869	-4000	4000	3267
chr1	156304968	156312968	156309302	8000	156308968	-4000	4000	334
chr1	167048836	167056836	167055080	8000	167052836	-4000	4000	2244
chr1	6575755	6583755	6577030	8000	6579755	-4000	4000	-2725
chr1	118879046	118887046	118884095	8000	118883046	-4000	4000	1049
chr1	65411871	65419871	65412950	8000	65415871	-4000	4000	-2921
chr1	158606704	158614704	158614306	8000	158610704	-4000	4000	3602
chr1	159439078	159447078	159439989	8000	159443078	-4000	4000	-3089
chr1	13277035	13285035	13283994	8000	13281035	-4000	4000	2959
chr1	17823063	17831063	17826488	8000	17827063	-4000	4000	-575
chr1	156005048	156013048	156011786	8000	156009048	-4000	4000	2738
chr1	161225666	161233666	161230656	8000	161229666	-4000	4000	990
chr1	204418628	204426628	204424945	8000	204422628	-4000	4000	2317
chr1	206953965	206961965	206961171	8000	206957965	-4000	4000	3206
chr1	248846006	248854006	248848161	8000	248850006	-4000	4000	-1845
chr1	152344735	152352735	152350940	8000	152348735	-4000	4000	2205
chr1	153035732	153043732	153040045	8000	153039732	-4000	4000	313
chr1	247836928	247844928	247841030	8000	247840928	-4000	4000	102
chr1	247836928	247844928	247841354	8000	247840928	-4000	4000	426
chr1	247836928	247844928	247841527	8000	247840928	-4000	4000	599
chr1	961719	969719	962441	8000	965719	-4000	4000	-3278
chr1	6243353	6251353	6250503	8000	6247353	-4000	4000	3150
chr1	20660014	20668014	20666279	8000	20664014	-4000	4000	2265
chr1	24895511	24903511	24902491	8000	24899511	-4000	4000	2980
chr1	94891246	94899246	94897896	8000	94895246	-4000	4000	2650
chr1	99305590	99313590	99306273	8000	99309590	-4000	4000	-3317
chr1	110943190	110951190	110949848	8000	110947190	-4000	4000	2658
chr1	145988435	145996435	145993675	8000	145992435	-4000	4000	1240
chr1	147752199	147760199	147759133	8000	147756199	-4000	4000	2934
chr1	149809225	149817225	149813683	8000	149813225	-4000	4000	458
chr1	152824097	152832097	152827647	8000	152828097	-4000	4000	-450
chr1	152981500	152989500	152985239	8000	152985500	-4000	4000	-261
chr1	153614787	153622787	153615902	8000	153618787	-4000	4000	-2885
chr1	154271875	154279875	154275644	8000	154275875	-4000	4000	-231
chr1	154347304	154355304	154348467	8000	154351304	-4000	4000	-2837
chr1	156655532	156663532	156656946	8000	156659532	-4000	4000	-2586
chr1	158574919	158582919	158579172	8000	158578919	-4000	4000	253
chr1	158695678	158703678	158700212	8000	158699678	-4000	4000	534
chr1	158712327	158720327	158717691	8000	158716327	-4000	4000	1364
chr1	161225666	161233666	161228752	8000	161229666	-4000	4000	-914
chr1	161225666	161233666	161229946	8000	161229666	-4000	4000	280
chr1	161522894	161530894	161526496	8000	161526894	-4000	4000	-398
chr1	168578069	168586069	168581087	8000	168582069	-4000	4000	-982
chr1	170735421	170743421	170736231	8000	170739421	-4000	4000	-3190
chr1	173179731	173187731	173186596	8000	173183731	-4000	4000	2865
chr1	182050570	182058570	182057268	8000	182054570	-4000	4000	2698
chr1	200173420	200181420	200174050	8000	200177420	-4000	4000	-3370
chr1	209609939	209617939	209612048	8000	209613939	-4000	4000	-1891
chr1	223001995	223009995	223003839	8000	223005995	-4000	4000	-2156
chr1	224189441	224197441	224192348	8000	224193441	-4000	4000	-1093
chr1	225395292	225403292	225403273	8000	225399292	-4000	4000	3981
chr1	228102679	228110679	228107841	8000	228106679	-4000	4000	1162
chr1	228403935	228411935	228411015	8000	228407935	-4000	4000	3080
chr1	247095962	247103962	247100837	8000	247099962	-4000	4000	875
chr1	248097103	248105103	248099979	8000	248101103	-4000	4000	-1124
chr1	248404020	248412020	248406130	8000	248408020	-4000	4000	-1890
chr1	149880459	149888459	149886301	8000	149884459	-4000	4000	1842
chr1	225882696	225890696	225887048	8000	225886696	-4000	4000	352
chr1	240471187	240479187	240472287	8000	240475187	-4000	4000	-2900
chr1	50199772	50207772	50201473	8000	50203772	-4000	4000	-2299
chr1	117032552	117040552	117034077	8000	117036552	-4000	4000	-2475
chr1	43964022	43972022	43970623	8000	43968022	-4000	4000	2601
chr1	75914873	75922873	75919032	8000	75918873	-4000	4000	159
chr1	152575381	152583381	152579700	8000	152579381	-4000	4000	319
chr1	160993957	161001957	160998739	8000	160997957	-4000	4000	782
chr1	236545005	236553005	236552000	8000	236549005	-4000	4000	2995
chr1	93135079	93143079	93136880	8000	93139079	-4000	4000	-2199
chr1	150509789	150517789	150511484	8000	150513789	-4000	4000	-2305
chr1	153977617	153985617	153982627	8000	153981617	-4000	4000	1010
chr1	156664763	156672763	156670507	8000	156668763	-4000	4000	1744
chr1	158182427	158190427	158183075	8000	158186427	-4000	4000	-3352
chr1	169128531	169136531	169132800	8000	169132531	-4000	4000	269
chr1	204613170	204621170	204618299	8000	204617170	-4000	4000	1129
chr1	209609939	209617939	209617472	8000	209613939	-4000	4000	3533
chr1	248645838	248653838	248650094	8000	248649838	-4000	4000	256
chr1	205528793	205536793	205529580	8000	205532793	-4000	4000	-3213
chr1	145988435	145996435	145995223	8000	145992435	-4000	4000	2788
chr1	248142086	248150086	248146012	8000	248146086	-4000	4000	-74
chr1	18481974	18489974	18483716	8000	18485974	-4000	4000	-2258
chr1	211370946	211378946	211372643	8000	211374946	-4000	4000	-2303
chr1	247666812	247674812	247672193	8000	247670812	-4000	4000	1381
chr1	248387811	248395811	248387999	8000	248391811	-4000	4000	-3812
chr1	156208796	156216796	156213022	8000	156212796	-4000	4000	226
chr1	229426365	229434365	229431456	8000	229430365	-4000	4000	1091
chr1	150642230	150650230	150648285	8000	150646230	-4000	4000	2055
chr1	161066998	161074998	161073272	8000	161070998	-4000	4000	2274
chr1	186307652	186315652	186311062	8000	186311652	-4000	4000	-590
chr1	206865223	206873223	206866009	8000	206869223	-4000	4000	-3214
chr1	150509789	150517789	150511754	8000	150513789	-4000	4000	-2035
chr1	152695442	152703442	152699106	8000	152699442	-4000	4000	-336
chr1	244053476	244061476	244055214	8000	244057476	-4000	4000	-2262
chr1	109488804	109496804	109490117	8000	109492804	-4000	4000	-2687
chr1	248358627	248366627	248361800	8000	248362627	-4000	4000	-827
chr1	155316666	155324666	155320486	8000	155320666	-4000	4000	-180
chr1	13318598	13326598	13321973	8000	13322598	-4000	4000	-625
chr1	204418628	204426628	204425733	8000	204422628	-4000	4000	3105
chr1	223105404	223113404	223110454	8000	223109404	-4000	4000	1050
chr1	1698379	1706379	1703915	8000	1702379	-4000	4000	1536
chr1	152102317	152110317	152108435	8000	152106317	-4000	4000	2118
chr1	40236921	40244921	40237324	8000	40240921	-4000	4000	-3597
chr1	52404282	52412282	52405774	8000	52408282	-4000	4000	-2508
chr1	202315781	202323781	202318065	8000	202319781	-4000	4000	-1716
chr1	223391465	223399465	223395420	8000	223395465	-4000	4000	-45
chr1	109488804	109496804	109490003	8000	109492804	-4000	4000	-2801
chr1	39965968	39973968	39969636	8000	39969968	-4000	4000	-332
chr1	46553407	46561407	46557508	8000	46557407	-4000	4000	101
chr1	152344735	152352735	152352673	8000	152348735	-4000	4000	3938
chr1	152660659	152668659	152664639	8000	152664659	-4000	4000	-20
chr1	155881199	155889199	155881446	8000	155885199	-4000	4000	-3753
chr1	161522894	161530894	161526482	8000	161526894	-4000	4000	-412
chr1	211472522	211480522	211479315	8000	211476522	-4000	4000	2793
chr1	5858811	5866811	5863328	8000	5862811	-4000	4000	517
chr1	40492343	40500343	40495118	8000	40496343	-4000	4000	-1225
chr1	74564117	74572117	74571927	8000	74568117	-4000	4000	3810
chr1	115044011	115052011	115050434	8000	115048011	-4000	4000	2423
chr1	248619557	248627557	248626733	8000	248623557	-4000	4000	3176
chr1	43359203	43367203	43359271	8000	43363203	-4000	4000	-3932
chr1	147752199	147760199	147758436	8000	147756199	-4000	4000	2237
chr1	151031713	151039713	151033913	8000	151035713	-4000	4000	-1800
chr1	152683397	152691397	152686948	8000	152687397	-4000	4000	-449
chr1	156664763	156672763	156670237	8000	156668763	-4000	4000	1474
chr1	226227149	226235149	226232722	8000	226231149	-4000	4000	1573
chr1	12916482	12924482	12919908	8000	12920482	-4000	4000	-574
chr1	13218705	13226705	13225258	8000	13222705	-4000	4000	2553
chr1	147905269	147913269	147909029	8000	147909269	-4000	4000	-240
chr1	16193854	16201854	16199173	8000	16197854	-4000	4000	1319
chr1	149809225	149817225	149813650	8000	149813225	-4000	4000	425
chr1	150509789	150517789	150511702	8000	150513789	-4000	4000	-2087
chr1	158353553	158361553	158355863	8000	158357553	-4000	4000	-1690
chr1	159439078	159447078	159439980	8000	159443078	-4000	4000	-3098
chr1	247602515	247610515	247606140	8000	247606515	-4000	4000	-375
chr1	179550735	179558735	179554528	8000	179554735	-4000	4000	-207
chr1	24052035	24060035	24057606	8000	24056035	-4000	4000	1571
chr1	39834110	39842110	39841876	8000	39838110	-4000	4000	3766
chr1	146992202	147000202	146994722	8000	146996202	-4000	4000	-1480
chr1	155316666	155324666	155320489	8000	155320666	-4000	4000	-177
chr1	235127634	235135634	235127886	8000	235131634	-4000	4000	-3748
chr1	205593556	205601556	205600617	8000	205597556	-4000	4000	3061
chr1	103660554	103668554	103660638	8000	103664554	-4000	4000	-3916
chr1	26185884	26193884	26188249	8000	26189884	-4000	4000	-1635
chr1	26185884	26193884	26191385	8000	26189884	-4000	4000	1501
chr1	150805713	150813713	150812110	8000	150809713	-4000	4000	2397
chr1	151843101	151851101	151847802	8000	151847101	-4000	4000	701
chr1	182895865	182903865	182900208	8000	182899865	-4000	4000	343
chr1	201892456	201900456	201899243	8000	201896456	-4000	4000	2787
chr1	206098449	206106449	206102012	8000	206102449	-4000	4000	-437
chr1	206585448	206593448	206591710	8000	206589448	-4000	4000	2262
chr1	207140972	207148972	207143880	8000	207144972	-4000	4000	-1092
chr1	215618891	215626891	215625606	8000	215622891	-4000	4000	2715
chr1	220880503	220888503	220881240	8000	220884503	-4000	4000	-3263
chr1	244836638	244844638	244843207	8000	244840638	-4000	4000	2569
chr1	88832255	88840255	88833098	8000	88836255	-4000	4000	-3157
chr1	109092934	109100934	109094442	8000	109096934	-4000	4000	-2492
chr1	113973869	113981869	113981269	8000	113977869	-4000	4000	3400
chr1	161537759	161545759	161542867	8000	161541759	-4000	4000	1108
chr1	186307652	186315652	186314626	8000	186311652	-4000	4000	2974
chr1	220880503	220888503	220882338	8000	220884503	-4000	4000	-2165
chr1	12888896	12896896	12894849	8000	12892896	-4000	4000	1953
chr1	15730769	15738769	15738725	8000	15734769	-4000	4000	3956
chr1	109705551	109713551	109713374	8000	109709551	-4000	4000	3823
chr1	119744002	119752002	119744167	8000	119748002	-4000	4000	-3835
chr1	156664763	156672763	156669906	8000	156668763	-4000	4000	1143
chr1	156664763	156672763	156670947	8000	156668763	-4000	4000	2184
chr1	158323951	158331951	158329857	8000	158327951	-4000	4000	1906
chr1	160354952	160362952	160355928	8000	160358952	-4000	4000	-3024
chr1	182050570	182058570	182057605	8000	182054570	-4000	4000	3035
chr1	186667791	186675791	186674764	8000	186671791	-4000	4000	2973
chr1	190093658	190101658	190098961	8000	190097658	-4000	4000	1303
chr1	202327657	202335657	202331954	8000	202331657	-4000	4000	297
chr1	204150819	204158819	204156305	8000	204154819	-4000	4000	1486
chr1	222747004	222755004	222747049	8000	222751004	-4000	4000	-3955
chr1	248097103	248105103	248099508	8000	248101103	-4000	4000	-1595
chr1	248915946	248923946	248916608	8000	248919946	-4000	4000	-3338
chr1	150509789	150517789	150512795	8000	150513789	-4000	4000	-994
chr1	155610951	155618951	155614671	8000	155614951	-4000	4000	-280
chr1	159923039	159931039	159930181	8000	159927039	-4000	4000	3142
chr1	33119492	33127492	33120098	8000	33123492	-4000	4000	-3394
chr1	91676343	91684343	91683718	8000	91680343	-4000	4000	3375
chr1	150509789	150517789	150513298	8000	150513789	-4000	4000	-491
chr1	39891426	39899426	39897559	8000	39895426	-4000	4000	2133
chr1	45614904	45622904	45615028	8000	45618904	-4000	4000	-3876
chr1	115281904	115289904	115286394	8000	115285904	-4000	4000	490
chr1	155610951	155618951	155614177	8000	155614951	-4000	4000	-774
chr1	155610951	155618951	155614178	8000	155614951	-4000	4000	-773
chr1	211312385	211320385	211313446	8000	211316385	-4000	4000	-2939
chr1	62208328	62216328	62210152	8000	62212328	-4000	4000	-2176
chr1	158254269	158262269	158254462	8000	158258269	-4000	4000	-3807
chr1	173179731	173187731	173186566	8000	173183731	-4000	4000	2835
chr1	158353553	158361553	158356829	8000	158357553	-4000	4000	-724
chr1	233381148	233389148	233382655	8000	233385148	-4000	4000	-2493
chr1	63321128	63329128	63323738	8000	63325128	-4000	4000	-1390
chr1	205138505	205146505	205143975	8000	205142505	-4000	4000	1470
chr1	206730281	206738281	206732713	8000	206734281	-4000	4000	-1568
chr1	110668465	110676465	110673068	8000	110672465	-4000	4000	603
chr1	23692835	23700835	23696341	8000	23696835	-4000	4000	-494
chr1	26198968	26206968	26202499	8000	26202968	-4000	4000	-469
chr1	44811585	44819585	44813422	8000	44815585	-4000	4000	-2163
chr1	155316666	155324666	155320499	8000	155320666	-4000	4000	-167
chr1	237000103	237008103	237004351	8000	237004103	-4000	4000	248
chr1	6181020	6189020	6186771	8000	6185020	-4000	4000	1751
chr1	157741733	157749733	157746699	8000	157745733	-4000	4000	966
chr1	66793740	66801740	66801146	8000	66797740	-4000	4000	3406
chr1	153977617	153985617	153982066	8000	153981617	-4000	4000	449
chr1	158556606	158564606	158562903	8000	158560606	-4000	4000	2297
chr1	171634799	171642799	171636279	8000	171638799	-4000	4000	-2520
chr1	223001995	223009995	223004048	8000	223005995	-4000	4000	-1947
chr1	230798003	230806003	230801607	8000	230802003	-4000	4000	-396
chr1	115281904	115289904	115286558	8000	115285904	-4000	4000	654
chr1	92241813	92249813	92242275	8000	92245813	-4000	4000	-3538
chr1	46257196	46265196	46261307	8000	46261196	-4000	4000	111
chr1	66370579	66378579	66372474	8000	66374579	-4000	4000	-2105
chr1	75783575	75791575	75789268	8000	75787575	-4000	4000	1693
chr1	154544147	154552147	154544407	8000	154548147	-4000	4000	-3740
chr1	158394522	158402522	158398919	8000	158398522	-4000	4000	397
chr1	179550735	179558735	179551383	8000	179554735	-4000	4000	-3352
chr1	202315781	202323781	202318697	8000	202319781	-4000	4000	-1084
chr1	231351023	231359023	231352985	8000	231355023	-4000	4000	-2038
chr1	246536561	246544561	246540915	8000	246540561	-4000	4000	354
chr1	248569801	248577801	248574673	8000	248573801	-4000	4000	872
chr1	212622775	212630775	212626288	8000	212626775	-4000	4000	-487
chr1	119889533	119897533	119895973	8000	119893533	-4000	4000	2440
chr1	247810660	247818660	247815564	8000	247814660	-4000	4000	904
chr1	248677249	248685249	248681390	8000	248681249	-4000	4000	141
chr1	88832255	88840255	88833374	8000	88836255	-4000	4000	-2881
chr1	111349013	111357013	111351395	8000	111353013	-4000	4000	-1618
chr1	156381219	156389219	156384862	8000	156385219	-4000	4000	-357
chr1	13337892	13345892	13344568	8000	13341892	-4000	4000	2676
chr1	52605051	52613051	52606792	8000	52609051	-4000	4000	-2259
chr1	160368846	160376846	160370945	8000	160372846	-4000	4000	-1901
chr1	63321128	63329128	63323535	8000	63325128	-4000	4000	-1593
chr1	152758052	152766052	152760163	8000	152762052	-4000	4000	-1889
chr1	158695678	158703678	158699703	8000	158699678	-4000	4000	25
chr1	237000103	237008103	237004406	8000	237004103	-4000	4000	303
chr1	247666812	247674812	247672753	8000	247670812	-4000	4000	1941
chr1	240471187	240479187	240472126	8000	240475187	-4000	4000	-3061
chr1	152705434	152713434	152709178	8000	152709434	-4000	4000	-256
chr1	151796264	151804264	151801865	8000	151800264	-4000	4000	1601
chr1	246664595	246672595	246666303	8000	246668595	-4000	4000	-2292
chr1	62450298	62458298	62451135	8000	62454298	-4000	4000	-3163
chr1	149809225	149817225	149812264	8000	149813225	-4000	4000	-961
chr1	198519222	198527222	198523353	8000	198523222	-4000	4000	131
chr1	92828737	92836737	92832999	8000	92832737	-4000	4000	262
chr1	107567161	107575161	107572670	8000	107571161	-4000	4000	1509
chr1	107567161	107575161	107572797	8000	107571161	-4000	4000	1636
chr1	211312385	211320385	211313865	8000	211316385	-4000	4000	-2520
chr1	3018903	3026903	3022597	8000	3022903	-4000	4000	-306
chr1	13337892	13345892	13342658	8000	13341892	-4000	4000	766
chr1	17280233	17288233	17280722	8000	17284233	-4000	4000	-3511
chr1	35418058	35426058	35419922	8000	35422058	-4000	4000	-2136
chr1	40616680	40624680	40622870	8000	40620680	-4000	4000	2190
chr1	46039661	46047661	46046016	8000	46043661	-4000	4000	2355
chr1	70848353	70856353	70852738	8000	70852353	-4000	4000	385
chr1	94525173	94533173	94530126	8000	94529173	-4000	4000	953
chr1	111316566	111324566	111318028	8000	111320566	-4000	4000	-2538
chr1	244705033	244713033	244708402	8000	244709033	-4000	4000	-631
chr1	247919152	247927152	247921061	8000	247923152	-4000	4000	-2091
chr1	158254269	158262269	158256988	8000	158258269	-4000	4000	-1281
chr1	46184683	46192683	46184823	8000	46188683	-4000	4000	-3860
chr1	150503602	150511602	150507053	8000	150507602	-4000	4000	-549
chr1	150503602	150511602	150508167	8000	150507602	-4000	4000	565
chr1	47246139	47254139	47250960	8000	47250139	-4000	4000	821
chr1	248038305	248046305	248039059	8000	248042305	-4000	4000	-3246
chr1	111474512	111482512	111478293	8000	111478512	-4000	4000	-219
chr1	182050570	182058570	182056484	8000	182054570	-4000	4000	1914
chr1	13417328	13425328	13420940	8000	13421328	-4000	4000	-388
chr1	43350466	43358466	43352224	8000	43354466	-4000	4000	-2242
chr1	152208076	152216076	152216050	8000	152212076	-4000	4000	3974
chr1	159708289	159716289	159714065	8000	159712289	-4000	4000	1776
chr1	209778320	209786320	209779442	8000	209782320	-4000	4000	-2878
chr1	13365067	13373067	13369361	8000	13369067	-4000	4000	294
chr1	184786724	184794724	184792636	8000	184790724	-4000	4000	1912
chr1	220880503	220888503	220881243	8000	220884503	-4000	4000	-3260
chr1	248470307	248478307	248474279	8000	248474307	-4000	4000	-28
chr1	64689058	64697058	64691802	8000	64693058	-4000	4000	-1256
chr1	203163811	203171811	203171488	8000	203167811	-4000	4000	3677
chr1	59872322	59880322	59875536	8000	59876322	-4000	4000	-786
chr1	64177498	64185498	64178465	8000	64181498	-4000	4000	-3033
chr1	67394724	67402724	67395919	8000	67398724	-4000	4000	-2805
chr1	13277035	13285035	13281830	8000	13281035	-4000	4000	795
chr1	22635678	22643678	22638971	8000	22639678	-4000	4000	-707
chr1	159199313	159207313	159205863	8000	159203313	-4000	4000	2550
chr1	113973869	113981869	113981346	8000	113977869	-4000	4000	3477
chr1	86576754	86584754	86579449	8000	86580754	-4000	4000	-1305
chr1	240471187	240479187	240472408	8000	240475187	-4000	4000	-2779
chr1	158770222	158778222	158777254	8000	158774222	-4000	4000	3032
chr1	1626605	1634605	1629667	8000	1630605	-4000	4000	-938
chr1	11670480	11678480	11676104	8000	11674480	-4000	4000	1624
chr1	16981958	16989958	16986484	8000	16985958	-4000	4000	526
chr1	152298165	152306165	152304016	8000	152302165	-4000	4000	1851
chr1	248806446	248814446	248812289	8000	248810446	-4000	4000	1843
chr1	39891426	39899426	39897896	8000	39895426	-4000	4000	2470
chr1	149933812	149941812	149936787	8000	149937812	-4000	4000	-1025
chr1	150304979	150312979	150308145	8000	150308979	-4000	4000	-834
chr1	158476936	158484936	158480940	8000	158480936	-4000	4000	4
chr1	173484815	173492815	173485456	8000	173488815	-4000	4000	-3359
chr1	74762678	74770678	74763922	8000	74766678	-4000	4000	-2756
chr1	159708289	159716289	159713428	8000	159712289	-4000	4000	1139
chr1	24669281	24677281	24670242	8000	24673281	-4000	4000	-3039
chr1	159947492	159955492	159953619	8000	159951492	-4000	4000	2127
chr1	247666812	247674812	247672269	8000	247670812	-4000	4000	1457
chr1	113910086	113918086	113913547	8000	113914086	-4000	4000	-539
chr1	151245536	151253536	151246952	8000	151249536	-4000	4000	-2584
chr1	16193854	16201854	16198679	8000	16197854	-4000	4000	825
chr1	19971431	19979431	19978782	8000	19975431	-4000	4000	3351
chr1	22644110	22652110	22647765	8000	22648110	-4000	4000	-345
chr1	53907086	53915086	53910125	8000	53911086	-4000	4000	-961
chr1	111410319	111418319	111414752	8000	111414319	-4000	4000	433
chr1	154958298	154966298	154963887	8000	154962298	-4000	4000	1589
chr1	155745659	155753659	155751809	8000	155749659	-4000	4000	2150
chr1	158323951	158331951	158330843	8000	158327951	-4000	4000	2892
chr1	159058484	159066484	159062708	8000	159062484	-4000	4000	224
chr1	192363285	192371285	192365990	8000	192367285	-4000	4000	-1295
chr1	203020848	203028848	203023181	8000	203024848	-4000	4000	-1667
chr1	211567568	211575568	211575526	8000	211571568	-4000	4000	3958
chr1	23960347	23968347	23967569	8000	23964347	-4000	4000	3222
chr1	157790403	157798403	157797790	8000	157794403	-4000	4000	3387
chr1	158182427	158190427	158183060	8000	158186427	-4000	4000	-3367
chr1	39891426	39899426	39897811	8000	39895426	-4000	4000	2385
chr1	27882685	27890685	27882942	8000	27886685	-4000	4000	-3743
chr1	89002679	89010679	89007507	8000	89006679	-4000	4000	828
chr1	152344735	152352735	152351071	8000	152348735	-4000	4000	2336
chr1	248345713	248353713	248349667	8000	248349713	-4000	4000	-46
chr1	62450298	62458298	62450504	8000	62454298	-4000	4000	-3794
chr1	154940076	154948076	154945566	8000	154944076	-4000	4000	1490
chr1	163072802	163080802	163074554	8000	163076802	-4000	4000	-2248
chr1	117032552	117040552	117033951	8000	117036552	-4000	4000	-2601
chr1	167018214	167026214	167021712	8000	167022214	-4000	4000	-502
chr1	241991490	241999490	241996309	8000	241995490	-4000	4000	819
chr1	158323951	158331951	158328255	8000	158327951	-4000	4000	304
chr1	247810660	247818660	247815144	8000	247814660	-4000	4000	484
chr1	12663076	12671076	12666560	8000	12667076	-4000	4000	-516
chr1	84562194	84570194	84563415	8000	84566194	-4000	4000	-2779
chr1	110943190	110951190	110947757	8000	110947190	-4000	4000	567
chr1	32201453	32209453	32207922	8000	32205453	-4000	4000	2469
chr1	240485573	240493573	240493085	8000	240489573	-4000	4000	3512
chr1	26121555	26129555	26121976	8000	26125555	-4000	4000	-3579
chr1	37562816	37570816	37566504	8000	37566816	-4000	4000	-312
chr1	247945796	247953796	247949648	8000	247949796	-4000	4000	-148
chr1	159531078	159539078	159535654	8000	159535078	-4000	4000	576
chr1	231351023	231359023	231352632	8000	231355023	-4000	4000	-2391
chr1	109305568	109313568	109313452	8000	109309568	-4000	4000	3884
chr1	155046930	155054930	155053443	8000	155050930	-4000	4000	2513
chr1	23960347	23968347	23961791	8000	23964347	-4000	4000	-2556
chr1	40419326	40427326	40422316	8000	40423326	-4000	4000	-1010
chr1	108966214	108974214	108970228	8000	108970214	-4000	4000	14
chr1	119511054	119519054	119514202	8000	119515054	-4000	4000	-852
chr1	152758052	152766052	152760599	8000	152762052	-4000	4000	-1453
chr1	153201120	153209120	153204755	8000	153205120	-4000	4000	-365
chr1	186186949	186194949	186189753	8000	186190949	-4000	4000	-1196
chr1	247707813	247715813	247712483	8000	247711813	-4000	4000	670
chr1	43619666	43627666	43622088	8000	43623666	-4000	4000	-1578
chr1	176853302	176861302	176857612	8000	176857302	-4000	4000	310
chr1	248319630	248327630	248323865	8000	248323630	-4000	4000	235
chr1	84411018	84419018	84414590	8000	84415018	-4000	4000	-428
chr1	110397249	110405249	110401388	8000	110401249	-4000	4000	139
chr1	209672390	209680390	209675837	8000	209676390	-4000	4000	-553
chr1	68041886	68049886	68046959	8000	68045886	-4000	4000	1073
chr1	151534692	151542692	151537853	8000	151538692	-4000	4000	-839
chr1	1438882	1446882	1439221	8000	1442882	-4000	4000	-3661
chr1	39834110	39842110	39841767	8000	39838110	-4000	4000	3657
chr1	158606704	158614704	158612952	8000	158610704	-4000	4000	2248
chr1	173854808	173862808	173857667	8000	173858808	-4000	4000	-1141
chr1	54752898	54760898	54758790	8000	54756898	-4000	4000	1892
chr1	113890194	113898194	113895412	8000	113894194	-4000	4000	1218
chr1	146992202	147000202	146994416	8000	146996202	-4000	4000	-1786
chr1	19676966	19684966	19683058	8000	19680966	-4000	4000	2092
chr1	70147945	70155945	70148605	8000	70151945	-4000	4000	-3340
chr1	152839983	152847983	152843592	8000	152843983	-4000	4000	-391
chr1	158540550	158548550	158547698	8000	158544550	-4000	4000	3148
chr1	40236921	40244921	40237718	8000	40240921	-4000	4000	-3203
chr1	147171351	147179351	147179097	8000	147175351	-4000	4000	3746
chr1	234381080	234389080	234383742	8000	234385080	-4000	4000	-1338
chr1	43987500	43995500	43992566	8000	43991500	-4000	4000	1066
chr1	212616777	212624777	212619507	8000	212620777	-4000	4000	-1270
chr1	961719	969719	963353	8000	965719	-4000	4000	-2366
chr1	12792628	12800628	12793336	8000	12796628	-4000	4000	-3292
chr1	26472642	26480642	26475946	8000	26476642	-4000	4000	-696
chr1	43619666	43627666	43622098	8000	43623666	-4000	4000	-1568
chr1	46184683	46192683	46192408	8000	46188683	-4000	4000	3725
chr1	53964168	53972168	53966293	8000	53968168	-4000	4000	-1875
chr1	54838252	54846252	54841664	8000	54842252	-4000	4000	-588
chr1	67088165	67096165	67093311	8000	67092165	-4000	4000	1146
chr1	149899318	149907318	149905811	8000	149903318	-4000	4000	2493
chr1	149899318	149907318	149905813	8000	149903318	-4000	4000	2495
chr1	152508177	152516177	152515995	8000	152512177	-4000	4000	3818
chr1	161161723	161169723	161165604	8000	161165723	-4000	4000	-119
chr1	186307652	186315652	186312363	8000	186311652	-4000	4000	711
chr1	209778320	209786320	209781381	8000	209782320	-4000	4000	-939
chr1	246835098	246843098	246840858	8000	246839098	-4000	4000	1760
chr1	247945796	247953796	247949366	8000	247949796	-4000	4000	-430
chr1	248319630	248327630	248324545	8000	248323630	-4000	4000	915
chr1	248645838	248653838	248650791	8000	248649838	-4000	4000	953
chr1	19676966	19684966	19683171	8000	19680966	-4000	4000	2205
chr1	206730281	206738281	206732807	8000	206734281	-4000	4000	-1474
chr1	247962386	247970386	247966248	8000	247966386	-4000	4000	-138
chr1	32241397	32249397	32247263	8000	32245397	-4000	4000	1866
chr1	3732201	3740201	3733527	8000	3736201	-4000	4000	-2674
chr1	13417328	13425328	13421038	8000	13421328	-4000	4000	-290
chr1	74022015	74030015	74026810	8000	74026015	-4000	4000	795
chr1	152149595	152157595	152155145	8000	152153595	-4000	4000	1550
chr1	158540550	158548550	158547956	8000	158544550	-4000	4000	3406
chr1	200547497	200555497	200554579	8000	200551497	-4000	4000	3082
chr1	204123743	204131743	204126754	8000	204127743	-4000	4000	-989
chr1	1917951	1925951	1923091	8000	1921951	-4000	4000	1140
chr1	12875212	12883212	12883123	8000	12879212	-4000	4000	3911
chr1	152102317	152110317	152110171	8000	152106317	-4000	4000	3854
chr1	203163811	203171811	203171485	8000	203167811	-4000	4000	3674
chr1	35709877	35717877	35716118	8000	35713877	-4000	4000	2241
chr1	205298063	205306063	205305312	8000	205302063	-4000	4000	3249
chr1	75914873	75922873	75922293	8000	75918873	-4000	4000	3420
chr1	158712327	158720327	158717999	8000	158716327	-4000	4000	1672
chr1	171113819	171121819	171117098	8000	171117819	-4000	4000	-721
chr1	77691987	77699987	77697716	8000	77695987	-4000	4000	1729
chr1	222553902	222561902	222561404	8000	222557902	-4000	4000	3502
chr1	182050570	182058570	182056617	8000	182054570	-4000	4000	2047
chr1	12875212	12883212	12879664	8000	12879212	-4000	4000	452
chr1	203174931	203182931	203181253	8000	203178931	-4000	4000	2322
chr1	248619557	248627557	248626514	8000	248623557	-4000	4000	2957
chr1	11915591	11923591	11922937	8000	11919591	-4000	4000	3346
chr1	64689058	64697058	64691361	8000	64693058	-4000	4000	-1697
chr1	182050570	182058570	182056652	8000	182054570	-4000	4000	2082
chr1	201035512	201043512	201039949	8000	201039512	-4000	4000	437
chr1	247585313	247593313	247589082	8000	247589313	-4000	4000	-231
chr1	113681923	113689923	113683283	8000	113685923	-4000	4000	-2640
chr1	89047882	89055882	89053391	8000	89051882	-4000	4000	1509
chr1	152800832	152808832	152805437	8000	152804832	-4000	4000	605
chr1	152575381	152583381	152579947	8000	152579381	-4000	4000	566
chr1	248142086	248150086	248145448	8000	248146086	-4000	4000	-638
chr1	248470307	248478307	248473712	8000	248474307	-4000	4000	-595
chr1	3808086	3816086	3815450	8000	3812086	-4000	4000	3364
chr1	12888896	12896896	12892947	8000	12892896	-4000	4000	51
chr1	149809225	149817225	149812364	8000	149813225	-4000	4000	-861
chr1	152999856	153007856	153003423	8000	153003856	-4000	4000	-433
chr1	154544147	154552147	154547931	8000	154548147	-4000	4000	-216
chr1	158323951	158331951	158330016	8000	158327951	-4000	4000	2065
chr1	168536768	168544768	168543955	8000	168540768	-4000	4000	3187
chr1	20647511	20655511	20650560	8000	20651511	-4000	4000	-951
chr1	70848353	70856353	70852859	8000	70852353	-4000	4000	506
chr1	182826384	182834384	182829082	8000	182830384	-4000	4000	-1302
chr1	13045476	13053476	13050264	8000	13049476	-4000	4000	788
chr1	47046751	47054751	47050179	8000	47050751	-4000	4000	-572
chr1	81989932	81997932	81990833	8000	81993932	-4000	4000	-3099
chr1	110943190	110951190	110950021	8000	110947190	-4000	4000	2831
chr1	153293116	153301116	153299197	8000	153297116	-4000	4000	2081
chr1	207077024	207085024	207079260	8000	207081024	-4000	4000	-1764
chr1	32241397	32249397	32247588	8000	32245397	-4000	4000	2191
chr1	162391268	162399268	162397197	8000	162395268	-4000	4000	1929
chr1	247919152	247927152	247921336	8000	247923152	-4000	4000	-1816
chr1	248059407	248067407	248060820	8000	248063407	-4000	4000	-2587
chr1	158414210	158422210	158420498	8000	158418210	-4000	4000	2288
chr1	204613170	204621170	204618076	8000	204617170	-4000	4000	906
chr1	248569801	248577801	248574378	8000	248573801	-4000	4000	577
chr1	152597086	152605086	152600671	8000	152601086	-4000	4000	-415
chr1	231351023	231359023	231351355	8000	231355023	-4000	4000	-3668
chr1	20614903	20622903	20618627	8000	20618903	-4000	4000	-276
chr1	63321128	63329128	63323146	8000	63325128	-4000	4000	-1982
chr1	92180725	92188725	92181072	8000	92184725	-4000	4000	-3653
chr1	148527385	148535385	148534693	8000	148531385	-4000	4000	3308
chr1	152102317	152110317	152107726	8000	152106317	-4000	4000	1409
chr1	152809108	152817108	152812928	8000	152813108	-4000	4000	-180
chr1	159923039	159931039	159930332	8000	159927039	-4000	4000	3293
chr1	223001995	223009995	223003288	8000	223005995	-4000	4000	-2707
chr1	41474775	41482775	41479316	8000	41478775	-4000	4000	541
chr1	158574919	158582919	158579093	8000	158578919	-4000	4000	174
chr1	159531078	159539078	159535348	8000	159535078	-4000	4000	270
chr1	198519222	198527222	198523360	8000	198523222	-4000	4000	138
chr1	209610870	209618870	209618561	8000	209614870	-4000	4000	3691
chr1	215233090	215241090	215234938	8000	215237090	-4000	4000	-2152
chr1	247602515	247610515	247606087	8000	247606515	-4000	4000	-428
chr1	27391814	27399814	27394609	8000	27395814	-4000	4000	-1205
chr1	201888587	201896587	201890476	8000	201892587	-4000	4000	-2111
chr1	81989932	81997932	81990858	8000	81993932	-4000	4000	-3074
chr1	116765229	116773229	116768469	8000	116769229	-4000	4000	-760
chr1	225397502	225405502	225404680	8000	225401502	-4000	4000	3178
chr1	92180725	92188725	92181738	8000	92184725	-4000	4000	-2987
chr1	214333131	214341131	214336799	8000	214337131	-4000	4000	-332
chr1	159051155	159059155	159052053	8000	159055155	-4000	4000	-3102
chr1	228420845	228428845	228424867	8000	228424845	-4000	4000	22
chr1	167048836	167056836	167055044	8000	167052836	-4000	4000	2208
chr1	152405243	152413243	152409836	8000	152409243	-4000	4000	593
chr1	158323951	158331951	158329622	8000	158327951	-4000	4000	1671
chr1	175144075	175152075	175147148	8000	175148075	-4000	4000	-927
chr1	216499246	216507246	216507122	8000	216503246	-4000	4000	3876
chr1	247707813	247715813	247712308	8000	247711813	-4000	4000	495
chr1	248038305	248046305	248039021	8000	248042305	-4000	4000	-3284
chr1	177278422	177286422	177281742	8000	177282422	-4000	4000	-680
chr1	186307652	186315652	186314061	8000	186311652	-4000	4000	2409
chr1	198753476	198761476	198756302	8000	198757476	-4000	4000	-1174
chr1	206492889	206500889	206496172	8000	206496889	-4000	4000	-717
chr1	231351023	231359023	231353162	8000	231355023	-4000	4000	-1861
chr1	117949590	117957590	117952586	8000	117953590	-4000	4000	-1004
chr1	148478548	148486548	148483241	8000	148482548	-4000	4000	693
chr1	152999856	153007856	153003016	8000	153003856	-4000	4000	-840
chr1	248645838	248653838	248650359	8000	248649838	-4000	4000	521
chr1	75783575	75791575	75791545	8000	75787575	-4000	4000	3970
chr1	153201120	153209120	153204712	8000	153205120	-4000	4000	-408
chr1	212988037	212996037	212995058	8000	212992037	-4000	4000	3021
chr1	1917951	1925951	1923780	8000	1921951	-4000	4000	1829
chr1	15730769	15738769	15736717	8000	15734769	-4000	4000	1948
chr1	149880459	149888459	149886455	8000	149884459	-4000	4000	1996
chr1	154940076	154948076	154947996	8000	154944076	-4000	4000	3920
chr1	156521405	156529405	156526524	8000	156525405	-4000	4000	1119
chr1	161225666	161233666	161233246	8000	161229666	-4000	4000	3580
chr1	182050570	182058570	182056622	8000	182054570	-4000	4000	2052
chr1	223391465	223399465	223394880	8000	223395465	-4000	4000	-585
chr1	231219763	231227763	231226605	8000	231223763	-4000	4000	2842
chr1	26121555	26129555	26122071	8000	26125555	-4000	4000	-3484
chr1	28331965	28339965	28334671	8000	28335965	-4000	4000	-1294
chr1	47414052	47422052	47416684	8000	47418052	-4000	4000	-1368
chr1	81989932	81997932	81990801	8000	81993932	-4000	4000	-3131
chr1	149919317	149927317	149926722	8000	149923317	-4000	4000	3405
chr1	150261078	150269078	150261330	8000	150265078	-4000	4000	-3748
chr1	152208076	152216076	152214190	8000	152212076	-4000	4000	2114
chr1	175144075	175152075	175146987	8000	175148075	-4000	4000	-1088
chr1	196914713	196922713	196918262	8000	196918713	-4000	4000	-451
chr1	247945796	247953796	247949043	8000	247949796	-4000	4000	-753
chr1	29322813	29330813	29325210	8000	29326813	-4000	4000	-1603
chr1	41474775	41482775	41479335	8000	41478775	-4000	4000	560
chr1	74564117	74572117	74571232	8000	74568117	-4000	4000	3115
chr1	154544147	154552147	154544506	8000	154548147	-4000	4000	-3641
chr1	156459727	156467727	156467645	8000	156463727	-4000	4000	3918
chr1	159708289	159716289	159713937	8000	159712289	-4000	4000	1648
chr1	223105404	223113404	223112093	8000	223109404	-4000	4000	2689
chr1	160368846	160376846	160371317	8000	160372846	-4000	4000	-1529
chr1	168310426	168318426	168314218	8000	168314426	-4000	4000	-208
chr1	200870178	200878178	200873987	8000	200874178	-4000	4000	-191
chr1	22599595	22607595	22602631	8000	22603595	-4000	4000	-964
chr1	154975251	154983251	154978037	8000	154979251	-4000	4000	-1214
chr1	225786468	225794468	225789472	8000	225790468	-4000	4000	-996
chr1	119907553	119915553	119915317	8000	119911553	-4000	4000	3764
chr1	42151820	42159820	42155548	8000	42155820	-4000	4000	-272
chr1	145734868	145742868	145738355	8000	145738868	-4000	4000	-513
chr1	12875212	12883212	12879790	8000	12879212	-4000	4000	578
chr1	38039829	38047829	38045687	8000	38043829	-4000	4000	1858
chr1	40236921	40244921	40240314	8000	40240921	-4000	4000	-607
chr1	43619666	43627666	43621989	8000	43623666	-4000	4000	-1677
chr1	46815413	46823413	46818141	8000	46819413	-4000	4000	-1272
chr1	65411871	65419871	65412925	8000	65415871	-4000	4000	-2946
chr1	110453358	110461358	110456300	8000	110457358	-4000	4000	-1058
chr1	152149595	152157595	152156543	8000	152153595	-4000	4000	2948
chr1	161042946	161050946	161048438	8000	161046946	-4000	4000	1492
chr1	163072802	163080802	163073500	8000	163076802	-4000	4000	-3302
chr1	171281978	171289978	171281987	8000	171285978	-4000	4000	-3991
chr1	173604336	173612336	173609972	8000	173608336	-4000	4000	1636
chr1	248645838	248653838	248650197	8000	248649838	-4000	4000	359
chr1	158323951	158331951	158328045	8000	158327951	-4000	4000	94
chr1	158556606	158564606	158562817	8000	158560606	-4000	4000	2211
chr1	152298165	152306165	152304640	8000	152302165	-4000	4000	2475
chr1	13259314	13267314	13263002	8000	13263314	-4000	4000	-312
chr1	15114043	15122043	15114649	8000	15118043	-4000	4000	-3394
chr1	111474512	111482512	111477704	8000	111478512	-4000	4000	-808
chr1	158606704	158614704	158607189	8000	158610704	-4000	4000	-3515
chr1	192656311	192664311	192659335	8000	192660311	-4000	4000	-976
chr1	223105404	223113404	223110896	8000	223109404	-4000	4000	1492
chr1	226140679	226148679	226146629	8000	226144679	-4000	4000	1950
chr1	12857909	12865909	12861292	8000	12861909	-4000	4000	-617
chr1	13318598	13326598	13319826	8000	13322598	-4000	4000	-2772
chr1	160354952	160362952	160358178	8000	160358952	-4000	4000	-774
chr1	163072802	163080802	163073610	8000	163076802	-4000	4000	-3192
chr1	190093658	190101658	190099023	8000	190097658	-4000	4000	1365
chr1	23784232	23792232	23787468	8000	23788232	-4000	4000	-764
chr1	27882685	27890685	27885446	8000	27886685	-4000	4000	-1239
chr1	34977533	34985533	34983931	8000	34981533	-4000	4000	2398
chr1	120886530	120894530	120889872	8000	120890530	-4000	4000	-658
chr1	248470307	248478307	248474151	8000	248474307	-4000	4000	-156
chr1	248632356	248640356	248638511	8000	248636356	-4000	4000	2155
chr1	248645838	248653838	248650153	8000	248649838	-4000	4000	315
chr1	149924651	149932651	149930684	8000	149928651	-4000	4000	2033
chr1	206953965	206961965	206960943	8000	206957965	-4000	4000	2978
chr1	12857909	12865909	12860210	8000	12861909	-4000	4000	-1699
chr1	152758052	152766052	152760619	8000	152762052	-4000	4000	-1433
chr1	11915591	11923591	11922782	8000	11919591	-4000	4000	3191
chr1	12663076	12671076	12666689	8000	12667076	-4000	4000	-387
chr1	15114043	15122043	15114413	8000	15118043	-4000	4000	-3630
chr1	20715731	20723731	20723672	8000	20719731	-4000	4000	3941
chr1	25238249	25246249	25242466	8000	25242249	-4000	4000	217
chr1	40459718	40467718	40463512	8000	40463718	-4000	4000	-206
chr1	43974295	43982295	43978033	8000	43978295	-4000	4000	-262
chr1	99690541	99698541	99694029	8000	99694541	-4000	4000	-512
chr1	100079563	100087563	100085427	8000	100083563	-4000	4000	1864
chr1	111766662	111774662	111766822	8000	111770662	-4000	4000	-3840
chr1	155881199	155889199	155881449	8000	155885199	-4000	4000	-3750
chr1	158973059	158981059	158973708	8000	158977059	-4000	4000	-3351
chr1	161360733	161368733	161365556	8000	161364733	-4000	4000	823
chr1	165559957	165567957	165563507	8000	165563957	-4000	4000	-450
chr1	29322813	29330813	29325804	8000	29326813	-4000	4000	-1009
chr1	152758052	152766052	152761309	8000	152762052	-4000	4000	-743
chr1	29116046	29124046	29119552	8000	29120046	-4000	4000	-494
chr1	61677046	61685046	61681100	8000	61681046	-4000	4000	54
chr1	61677046	61685046	61681101	8000	61681046	-4000	4000	55
chr1	155881199	155889199	155881286	8000	155885199	-4000	4000	-3913
chr1	149880459	149888459	149886630	8000	149884459	-4000	4000	2171
chr1	175144075	175152075	175144532	8000	175148075	-4000	4000	-3543
chr1	158254269	158262269	158255328	8000	158258269	-4000	4000	-2941
chr1	182050570	182058570	182056494	8000	182054570	-4000	4000	1924
chr1	71059291	71067291	71063950	8000	71063291	-4000	4000	659
chr1	152716470	152724470	152719800	8000	152720470	-4000	4000	-670
chr1	158476936	158484936	158480525	8000	158480936	-4000	4000	-411
chr1	179916077	179924077	179918418	8000	179920077	-4000	4000	-1659
chr1	203740081	203748081	203743199	8000	203744081	-4000	4000	-882
chr1	207014522	207022522	207022512	8000	207018522	-4000	4000	3990
chr1	248265917	248273917	248273202	8000	248269917	-4000	4000	3285
chr1	54221433	54229433	54226754	8000	54225433	-4000	4000	1321
chr1	153108121	153116121	153112592	8000	153112121	-4000	4000	471
chr1	248569801	248577801	248574114	8000	248573801	-4000	4000	313
chr1	248097103	248105103	248100082	8000	248101103	-4000	4000	-1021
chr1	228420845	228428845	228424886	8000	228424845	-4000	4000	41
chr1	151796264	151804264	151801558	8000	151800264	-4000	4000	1294
chr1	247735559	247743559	247739555	8000	247739559	-4000	4000	-4
chr1	186984981	186992981	186988739	8000	186988981	-4000	4000	-242
chr1	248345713	248353713	248349485	8000	248349713	-4000	4000	-228
chr1	1698379	1706379	1703884	8000	1702379	-4000	4000	1505
chr1	92828737	92836737	92833489	8000	92832737	-4000	4000	752
chr1	248059407	248067407	248060967	8000	248063407	-4000	4000	-2440
chr1	32932445	32940445	32937265	8000	32936445	-4000	4000	820
chr1	158712327	158720327	158717701	8000	158716327	-4000	4000	1374
chr1	224189441	224197441	224189580	8000	224193441	-4000	4000	-3861
chr1	32241397	32249397	32247274	8000	32245397	-4000	4000	1877
chr1	85152889	85160889	85158804	8000	85156889	-4000	4000	1915
chr1	158606704	158614704	158613860	8000	158610704	-4000	4000	3156
chr1	158695678	158703678	158700037	8000	158699678	-4000	4000	359
chr1	165197867	165205867	165203820	8000	165201867	-4000	4000	1953
chr1	161161723	161169723	161167414	8000	161165723	-4000	4000	1691
chr1	44647724	44655724	44655080	8000	44651724	-4000	4000	3356
chr1	229426365	229434365	229432040	8000	229430365	-4000	4000	1675
chr1	159199313	159207313	159204935	8000	159203313	-4000	4000	1622
chr1	166852359	166860359	166856766	8000	166856359	-4000	4000	407
chr1	215618891	215626891	215625806	8000	215622891	-4000	4000	2915
chr1	223001995	223009995	223002895	8000	223005995	-4000	4000	-3100
chr1	247585313	247593313	247588797	8000	247589313	-4000	4000	-516
chr1	153433058	153441058	153438312	8000	153437058	-4000	4000	1254
chr1	17062761	17070761	17069164	8000	17066761	-4000	4000	2403
chr1	168071843	168079843	168075433	8000	168075843	-4000	4000	-410
chr1	46039661	46047661	46046002	8000	46043661	-4000	4000	2341
chr1	152907886	152915886	152910375	8000	152911886	-4000	4000	-1511
chr1	156655532	156663532	156658236	8000	156659532	-4000	4000	-1296
chr1	158845506	158853506	158849266	8000	158849506	-4000	4000	-240
chr1	220695153	220703153	220696833	8000	220699153	-4000	4000	-2320
chr1	12820605	12828605	12827599	8000	12824605	-4000	4000	2994
chr1	17062761	17070761	17070159	8000	17066761	-4000	4000	3398
chr1	53210197	53218197	53214429	8000	53214197	-4000	4000	232
chr1	145734868	145742868	145738155	8000	145738868	-4000	4000	-713
chr1	158414210	158422210	158419989	8000	158418210	-4000	4000	1779
chr1	92828737	92836737	92834879	8000	92832737	-4000	4000	2142
chr1	37607350	37615350	37612893	8000	37611350	-4000	4000	1543
chr1	55062359	55070359	55069019	8000	55066359	-4000	4000	2660
chr1	201892456	201900456	201900138	8000	201896456	-4000	4000	3682
chr1	223391465	223399465	223394597	8000	223395465	-4000	4000	-868
chr1	228178257	228186257	228181631	8000	228182257	-4000	4000	-626
chr1	247602515	247610515	247605662	8000	247606515	-4000	4000	-853
chr1	248569801	248577801	248574470	8000	248573801	-4000	4000	669
chr1	248586487	248594487	248592945	8000	248590487	-4000	4000	2458
chr1	11102535	11110535	11109320	8000	11106535	-4000	4000	2785
chr1	113890194	113898194	113895485	8000	113894194	-4000	4000	1291
chr1	38881807	38889807	38886440	8000	38885807	-4000	4000	633
chr1	54003298	54011298	54010329	8000	54007298	-4000	4000	3031
chr1	153369711	153377711	153373793	8000	153373711	-4000	4000	82
chr1	159439078	159447078	159440469	8000	159443078	-4000	4000	-2609
chr1	205528793	205536793	205531354	8000	205532793	-4000	4000	-1439
chr1	229426365	229434365	229433047	8000	229430365	-4000	4000	2682
chr1	159708289	159716289	159713744	8000	159712289	-4000	4000	1455
chr1	196743504	196751504	196745883	8000	196747504	-4000	4000	-1621
chr1	53964168	53972168	53967807	8000	53968168	-4000	4000	-361
chr1	115696021	115704021	115702992	8000	115700021	-4000	4000	2971
chr1	151843101	151851101	151848185	8000	151847101	-4000	4000	1084
chr1	160604106	160612106	160610730	8000	160608106	-4000	4000	2624
chr1	205824025	205832025	205828709	8000	205828025	-4000	4000	684
chr1	109395042	109403042	109401902	8000	109399042	-4000	4000	2860
chr1	159830474	159838474	159835278	8000	159834474	-4000	4000	804
chr1	203740081	203748081	203743292	8000	203744081	-4000	4000	-789
chr1	152800832	152808832	152805443	8000	152804832	-4000	4000	611
chr1	211472522	211480522	211479080	8000	211476522	-4000	4000	2558
chr1	182050570	182058570	182057495	8000	182054570	-4000	4000	2925
chr1	70254999	70262999	70262636	8000	70258999	-4000	4000	3637
chr1	152102317	152110317	152107448	8000	152106317	-4000	4000	1131
chr1	220053482	220061482	220058679	8000	220057482	-4000	4000	1197
chr1	17242007	17250007	17249218	8000	17246007	-4000	4000	3211
chr1	159439078	159447078	159440213	8000	159443078	-4000	4000	-2865
chr1	92242402	92250402	92244365	8000	92246402	-4000	4000	-2037
chr1	13388629	13396629	13389926	8000	13392629	-4000	4000	-2703
chr1	230686776	230694776	230687059	8000	230690776	-4000	4000	-3717
chr1	92828737	92836737	92832894	8000	92832737	-4000	4000	157
chr1	172662876	172670876	172665640	8000	172666876	-4000	4000	-1236
chr1	78536701	78544701	78536799	8000	78540701	-4000	4000	-3902
chr1	153419222	153427222	153419328	8000	153423222	-4000	4000	-3894
chr1	64829229	64837229	64834651	8000	64833229	-4000	4000	1422
chr1	154940076	154948076	154945908	8000	154944076	-4000	4000	1832
chr1	155243205	155251205	155250860	8000	155247205	-4000	4000	3655
chr1	161035251	161043251	161040648	8000	161039251	-4000	4000	1397
chr1	173899800	173907800	173903816	8000	173903800	-4000	4000	16
chr1	179916077	179924077	179918325	8000	179920077	-4000	4000	-1752
chr1	200965390	200973390	200972795	8000	200969390	-4000	4000	3405
chr1	206953965	206961965	206961205	8000	206957965	-4000	4000	3240
chr1	158323951	158331951	158329585	8000	158327951	-4000	4000	1634
chr1	201888587	201896587	201889504	8000	201892587	-4000	4000	-3083
chr1	248569801	248577801	248574714	8000	248573801	-4000	4000	913
chr1	12888896	12896896	12893360	8000	12892896	-4000	4000	464
chr1	12820605	12828605	12827750	8000	12824605	-4000	4000	3145
chr1	149880459	149888459	149886215	8000	149884459	-4000	4000	1756
chr1	149924651	149932651	149931422	8000	149928651	-4000	4000	2771
chr1	171281978	171289978	171285433	8000	171285978	-4000	4000	-545
chr1	10942471	10950471	10948274	8000	10946471	-4000	4000	1803
chr1	10942471	10950471	10948370	8000	10946471	-4000	4000	1899
chr1	92180725	92188725	92184144	8000	92184725	-4000	4000	-581
chr1	151534692	151542692	151536821	8000	151538692	-4000	4000	-1871
chr1	154958298	154966298	154963788	8000	154962298	-4000	4000	1490
chr1	177278422	177286422	177281180	8000	177282422	-4000	4000	-1242
chr1	190093658	190101658	190099034	8000	190097658	-4000	4000	1376
chr1	158695678	158703678	158700193	8000	158699678	-4000	4000	515
chr1	182050570	182058570	182057383	8000	182054570	-4000	4000	2813
chr1	236217865	236225865	236225137	8000	236221865	-4000	4000	3272
chr1	17823063	17831063	17826570	8000	17827063	-4000	4000	-493
chr1	156136081	156144081	156136858	8000	156140081	-4000	4000	-3223
chr1	149880459	149888459	149886087	8000	149884459	-4000	4000	1628
chr1	13111488	13119488	13116119	8000	13115488	-4000	4000	631
chr1	46039661	46047661	46046590	8000	46043661	-4000	4000	2929
chr1	112907847	112915847	112914144	8000	112911847	-4000	4000	2297
chr1	216499246	216507246	216506860	8000	216503246	-4000	4000	3614
chr1	154940076	154948076	154945737	8000	154944076	-4000	4000	1661
chr1	202315781	202323781	202318490	8000	202319781	-4000	4000	-1291
chr1	152208076	152216076	152215979	8000	152212076	-4000	4000	3903
chr1	156912429	156920429	156914832	8000	156916429	-4000	4000	-1597
chr1	200911742	200919742	200913731	8000	200915742	-4000	4000	-2011
chr1	156664763	156672763	156669566	8000	156668763	-4000	4000	803
chr1	248265917	248273917	248272875	8000	248269917	-4000	4000	2958
chr1	109275556	109283556	109281924	8000	109279556	-4000	4000	2368
chr1	158476936	158484936	158479940	8000	158480936	-4000	4000	-996
chr1	248677249	248685249	248682025	8000	248681249	-4000	4000	776
chr1	111458773	111466773	111459576	8000	111462773	-4000	4000	-3197
chr1	13417328	13425328	13420957	8000	13421328	-4000	4000	-371
chr1	13045476	13053476	13050061	8000	13049476	-4000	4000	585
chr1	84234498	84242498	84235329	8000	84238498	-4000	4000	-3169
chr1	150261078	150269078	150262594	8000	150265078	-4000	4000	-2484
chr1	155165409	155173409	155173381	8000	155169409	-4000	4000	3972
chr1	205079129	205087129	205084202	8000	205083129	-4000	4000	1073
chr1	223001995	223009995	223004205	8000	223005995	-4000	4000	-1790
chr1	247919152	247927152	247921268	8000	247923152	-4000	4000	-1884
chr1	20715731	20723731	20723689	8000	20719731	-4000	4000	3958
chr1	46670659	46678659	46678292	8000	46674659	-4000	4000	3633
chr1	224158047	224166047	224158458	8000	224162047	-4000	4000	-3589
chr1	40236921	40244921	40237926	8000	40240921	-4000	4000	-2995
chr1	149050027	149058027	149055868	8000	149054027	-4000	4000	1841
chr1	16193854	16201854	16198526	8000	16197854	-4000	4000	672
chr1	158323951	158331951	158328131	8000	158327951	-4000	4000	180
chr1	169390870	169398870	169395189	8000	169394870	-4000	4000	319
chr1	169850080	169858080	169852935	8000	169854080	-4000	4000	-1145
chr1	161035251	161043251	161039827	8000	161039251	-4000	4000	576
chr1	169584849	169592849	169586501	8000	169588849	-4000	4000	-2348
chr1	12916482	12924482	12917884	8000	12920482	-4000	4000	-2598
chr1	248345713	248353713	248349323	8000	248349713	-4000	4000	-390
chr1	89102132	89110132	89109795	8000	89106132	-4000	4000	3663
chr1	158290774	158298774	158291383	8000	158294774	-4000	4000	-3391
chr1	159199313	159207313	159206451	8000	159203313	-4000	4000	3138
chr1	167048836	167056836	167055010	8000	167052836	-4000	4000	2174
chr1	155610951	155618951	155611480	8000	155614951	-4000	4000	-3471
chr1	13337892	13345892	13342929	8000	13341892	-4000	4000	1037
chr1	27375176	27383176	27379884	8000	27379176	-4000	4000	708
chr1	64177498	64185498	64177665	8000	64181498	-4000	4000	-3833
chr1	154940076	154948076	154947639	8000	154944076	-4000	4000	3563
chr1	70147945	70155945	70155711	8000	70151945	-4000	4000	3766
chr1	91521764	91529764	91524186	8000	91525764	-4000	4000	-1578
chr1	223105404	223113404	223112750	8000	223109404	-4000	4000	3346
chr1	247735559	247743559	247738656	8000	247739559	-4000	4000	-903
chr1	156289185	156297185	156293519	8000	156293185	-4000	4000	334
chr1	248915946	248923946	248916707	8000	248919946	-4000	4000	-3239
chr1	12875212	12883212	12882424	8000	12879212	-4000	4000	3212
chr1	212722153	212730153	212727047	8000	212726153	-4000	4000	894
chr1	248404020	248412020	248406748	8000	248408020	-4000	4000	-1272
chr1	196828189	196836189	196830506	8000	196832189	-4000	4000	-1683
chr1	40236921	40244921	40240557	8000	40240921	-4000	4000	-364
chr1	23187895	23195895	23193167	8000	23191895	-4000	4000	1272
chr1	98886245	98894245	98893086	8000	98890245	-4000	4000	2841
chr1	182050570	182058570	182056979	8000	182054570	-4000	4000	2409
chr1	158414210	158422210	158420789	8000	158418210	-4000	4000	2579
chr1	8348397	8356397	8354669	8000	8352397	-4000	4000	2272
chr1	147905269	147913269	147908849	8000	147909269	-4000	4000	-420
chr1	101239713	101247713	101239928	8000	101243713	-4000	4000	-3785
chr1	152149595	152157595	152156838	8000	152153595	-4000	4000	3243
chr1	211312385	211320385	211313572	8000	211316385	-4000	4000	-2813
chr1	68424822	68432822	68431560	8000	68428822	-4000	4000	2738
chr1	155745659	155753659	155749552	8000	155749659	-4000	4000	-107
chr1	12792628	12800628	12795624	8000	12796628	-4000	4000	-1004
chr1	29116046	29124046	29119360	8000	29120046	-4000	4000	-686
chr1	100516277	100524277	100518783	8000	100520277	-4000	4000	-1494
chr1	149809225	149817225	149813574	8000	149813225	-4000	4000	349
chr1	149880459	149888459	149886428	8000	149884459	-4000	4000	1969
chr1	160674746	160682746	160678945	8000	160678746	-4000	4000	199
chr1	197149682	197157682	197154221	8000	197153682	-4000	4000	539
chr1	202720495	202728495	202727491	8000	202724495	-4000	4000	2996
chr1	225841536	225849536	225842384	8000	225845536	-4000	4000	-3152
chr1	53210197	53218197	53214663	8000	53214197	-4000	4000	466
chr1	3018903	3026903	3022696	8000	3022903	-4000	4000	-207
chr1	115832377	115840377	115840238	8000	115836377	-4000	4000	3861
chr1	160284594	160292594	160291858	8000	160288594	-4000	4000	3264
chr1	232805929	232813929	232808569	8000	232809929	-4000	4000	-1360
chr1	245745342	245753342	245749536	8000	245749342	-4000	4000	194
chr1	149880459	149888459	149886569	8000	149884459	-4000	4000	2110
chr1	152102317	152110317	152108305	8000	152106317	-4000	4000	1988
chr1	152102317	152110317	152109454	8000	152106317	-4000	4000	3137
chr1	152618834	152626834	152623023	8000	152622834	-4000	4000	189
chr1	153052120	153060120	153056273	8000	153056120	-4000	4000	153
chr1	167805386	167813386	167809685	8000	167809386	-4000	4000	299
chr1	190093658	190101658	190098593	8000	190097658	-4000	4000	935
chr1	247836928	247844928	247841124	8000	247840928	-4000	4000	196
chr1	225786468	225794468	225789399	8000	225790468	-4000	4000	-1069
chr1	31723117	31731117	31731103	8000	31727117	-4000	4000	3986
chr1	40236921	40244921	40238770	8000	40240921	-4000	4000	-2151
chr1	61677046	61685046	61681145	8000	61681046	-4000	4000	99
chr1	100144448	100152448	100147917	8000	100148448	-4000	4000	-531
chr1	109488804	109496804	109490285	8000	109492804	-4000	4000	-2519
chr1	113910086	113918086	113911845	8000	113914086	-4000	4000	-2241
chr1	114578848	114586848	114581552	8000	114582848	-4000	4000	-1296
chr1	149880459	149888459	149886378	8000	149884459	-4000	4000	1919
chr1	150694060	150702060	150698712	8000	150698060	-4000	4000	652
chr1	152298165	152306165	152305612	8000	152302165	-4000	4000	3447
chr1	155134857	155142857	155140252	8000	155138857	-4000	4000	1395
chr1	158323951	158331951	158331369	8000	158327951	-4000	4000	3418
chr1	158712327	158720327	158717630	8000	158716327	-4000	4000	1303
chr1	161042946	161050946	161047819	8000	161046946	-4000	4000	873
chr1	173496460	173504460	173503319	8000	173500460	-4000	4000	2859
chr1	180110875	180118875	180112872	8000	180114875	-4000	4000	-2003
chr1	182050570	182058570	182056629	8000	182054570	-4000	4000	2059
chr1	186186949	186194949	186189690	8000	186190949	-4000	4000	-1259
chr1	202327657	202335657	202333465	8000	202331657	-4000	4000	1808
chr1	207077024	207085024	207077646	8000	207081024	-4000	4000	-3378
chr1	216499246	216507246	216503680	8000	216503246	-4000	4000	434
chr1	227777826	227785826	227780577	8000	227781826	-4000	4000	-1249
chr1	234387313	234395313	234393675	8000	234391313	-4000	4000	2362
chr1	247945796	247953796	247949380	8000	247949796	-4000	4000	-416
chr1	248387811	248395811	248388232	8000	248391811	-4000	4000	-3579
chr1	68424822	68432822	68429736	8000	68428822	-4000	4000	914
chr1	116570399	116578399	116577458	8000	116574399	-4000	4000	3059
chr1	156732960	156740960	156736639	8000	156736960	-4000	4000	-321
chr1	159778543	159786543	159782228	8000	159782543	-4000	4000	-315
chr1	159778543	159786543	159782432	8000	159782543	-4000	4000	-111
chr1	202315781	202323781	202318714	8000	202319781	-4000	4000	-1067
chr1	247585313	247593313	247588944	8000	247589313	-4000	4000	-369
chr1	158353553	158361553	158355307	8000	158357553	-4000	4000	-2246
chr1	84639706	84647706	84647347	8000	84643706	-4000	4000	3641
chr1	149778689	149786689	149784253	8000	149782689	-4000	4000	1564
chr1	153052120	153060120	153056439	8000	153056120	-4000	4000	319
chr1	159812257	159820257	159815581	8000	159816257	-4000	4000	-676
chr1	203850999	203858999	203852206	8000	203854999	-4000	4000	-2793
chr1	228057271	228065271	228059111	8000	228061271	-4000	4000	-2160
chr1	248038305	248046305	248038427	8000	248042305	-4000	4000	-3878
chr1	26032464	26040464	26036211	8000	26036464	-4000	4000	-253
chr1	157826911	157834911	157833363	8000	157830911	-4000	4000	2452
chr1	207791513	207799513	207793632	8000	207795513	-4000	4000	-1881
chr1	215233090	215241090	215236609	8000	215237090	-4000	4000	-481
chr1	48291373	48299373	48298676	8000	48295373	-4000	4000	3303
chr1	180968712	180976712	180976520	8000	180972712	-4000	4000	3808
chr1	207140972	207148972	207143826	8000	207144972	-4000	4000	-1146
chr1	24669281	24677281	24672566	8000	24673281	-4000	4000	-715
chr1	68041886	68049886	68047001	8000	68045886	-4000	4000	1115
chr1	155285293	155293293	155287200	8000	155289293	-4000	4000	-2093
chr1	12792628	12800628	12795596	8000	12796628	-4000	4000	-1032
chr1	13337892	13345892	13344592	8000	13341892	-4000	4000	2700
chr1	48244644	48252644	48247540	8000	48248644	-4000	4000	-1104
chr1	90707539	90715539	90714663	8000	90711539	-4000	4000	3124
chr1	192576024	192584024	192576828	8000	192580024	-4000	4000	-3196
chr1	246536561	246544561	246540918	8000	246540561	-4000	4000	357
chr1	156877850	156885850	156879192	8000	156881850	-4000	4000	-2658
chr1	170164866	170172866	170167575	8000	170168866	-4000	4000	-1291
chr1	13337892	13345892	13342663	8000	13341892	-4000	4000	771
chr1	7765706	7773706	7766852	8000	7769706	-4000	4000	-2854
chr1	186186949	186194949	186190886	8000	186190949	-4000	4000	-63
chr1	95243225	95251225	95244606	8000	95247225	-4000	4000	-2619
chr1	12773906	12781906	12775671	8000	12777906	-4000	4000	-2235
chr1	12820605	12828605	12825151	8000	12824605	-4000	4000	546
chr1	23376909	23384909	23381324	8000	23380909	-4000	4000	415
chr1	158254269	158262269	158254527	8000	158258269	-4000	4000	-3742
chr1	202327657	202335657	202335651	8000	202331657	-4000	4000	3994
chr1	248915946	248923946	248918134	8000	248919946	-4000	4000	-1812
chr1	152080141	152088141	152085302	8000	152084141	-4000	4000	1161
chr1	74564117	74572117	74570359	8000	74568117	-4000	4000	2242
chr1	183924532	183932532	183928173	8000	183928532	-4000	4000	-359
chr1	145973811	145981811	145978435	8000	145977811	-4000	4000	624
chr1	154577695	154585695	154585329	8000	154581695	-4000	4000	3634
chr1	23187895	23195895	23192561	8000	23191895	-4000	4000	666
chr1	26198968	26206968	26201492	8000	26202968	-4000	4000	-1476
chr1	44811585	44819585	44813032	8000	44815585	-4000	4000	-2553
chr1	168310426	168318426	168314330	8000	168314426	-4000	4000	-96
chr1	205332061	205340061	205336529	8000	205336061	-4000	4000	468
chr1	235657041	235665041	235662844	8000	235661041	-4000	4000	1803
chr1	247666812	247674812	247672312	8000	247670812	-4000	4000	1500
chr1	12724760	12732760	12725250	8000	12728760	-4000	4000	-3510
chr1	119419035	119427035	119419512	8000	119423035	-4000	4000	-3523
chr1	152660659	152668659	152664564	8000	152664659	-4000	4000	-95
chr1	186667791	186675791	186675356	8000	186671791	-4000	4000	3565
chr1	248038305	248046305	248038386	8000	248042305	-4000	4000	-3919
chr1	248097103	248105103	248100118	8000	248101103	-4000	4000	-985
chr1	39765523	39773523	39769842	8000	39769523	-4000	4000	319
chr1	116765229	116773229	116768503	8000	116769229	-4000	4000	-726
chr1	145988435	145996435	145993423	8000	145992435	-4000	4000	988
chr1	207077024	207085024	207079346	8000	207081024	-4000	4000	-1678
chr1	12875212	12883212	12879710	8000	12879212	-4000	4000	498
chr1	12875212	12883212	12881985	8000	12879212	-4000	4000	2773
chr1	15486832	15494832	15491124	8000	15490832	-4000	4000	292
chr1	16456078	16464078	16458961	8000	16460078	-4000	4000	-1117
chr1	16981958	16989958	16988156	8000	16985958	-4000	4000	2198
chr1	17280233	17288233	17280743	8000	17284233	-4000	4000	-3490
chr1	23758059	23766059	23759549	8000	23762059	-4000	4000	-2510
chr1	24150168	24158168	24157785	8000	24154168	-4000	4000	3617
chr1	25827913	25835913	25835678	8000	25831913	-4000	4000	3765
chr1	26032464	26040464	26039150	8000	26036464	-4000	4000	2686
chr1	26198968	26206968	26201066	8000	26202968	-4000	4000	-1902
chr1	32194285	32202285	32202037	8000	32198285	-4000	4000	3752
chr1	33141399	33149399	33147494	8000	33145399	-4000	4000	2095
chr1	40236921	40244921	40236924	8000	40240921	-4000	4000	-3997
chr1	101239713	101247713	101240007	8000	101243713	-4000	4000	-3706
chr1	117107060	117115060	117112332	8000	117111060	-4000	4000	1272
chr1	120886530	120894530	120889826	8000	120890530	-4000	4000	-704
chr1	153557108	153565108	153563834	8000	153561108	-4000	4000	2726
chr1	161042946	161050946	161047895	8000	161046946	-4000	4000	949
chr1	162369203	162377203	162376700	8000	162373203	-4000	4000	3497
chr1	182895865	182903865	182900108	8000	182899865	-4000	4000	243
chr1	201888587	201896587	201890493	8000	201892587	-4000	4000	-2094
chr1	205079129	205087129	205083613	8000	205083129	-4000	4000	484
chr1	205785094	205793094	205791655	8000	205789094	-4000	4000	2561
chr1	205909048	205917048	205914954	8000	205913048	-4000	4000	1906
chr1	206838981	206846981	206841050	8000	206842981	-4000	4000	-1931
chr1	209609939	209617939	209615362	8000	209613939	-4000	4000	1423
chr1	212622775	212630775	212625940	8000	212626775	-4000	4000	-835
chr1	212622775	212630775	212626351	8000	212626775	-4000	4000	-424
chr1	223001995	223009995	223004476	8000	223005995	-4000	4000	-1519
chr1	223391465	223399465	223395470	8000	223395465	-4000	4000	5
chr1	224189441	224197441	224192367	8000	224193441	-4000	4000	-1074
chr1	247095962	247103962	247102003	8000	247099962	-4000	4000	2041
chr1	248358627	248366627	248362579	8000	248362627	-4000	4000	-48
chr1	248586487	248594487	248593359	8000	248590487	-4000	4000	2872
chr1	145988435	145996435	145994992	8000	145992435	-4000	4000	2557
chr1	40492343	40500343	40495611	8000	40496343	-4000	4000	-732
chr1	45012399	45020399	45013558	8000	45016399	-4000	4000	-2841
chr1	247810660	247818660	247815354	8000	247814660	-4000	4000	694
chr1	12792628	12800628	12794014	8000	12796628	-4000	4000	-2614
chr1	10416511	10424511	10417010	8000	10420511	-4000	4000	-3501
chr1	20802292	20810292	20807000	8000	20806292	-4000	4000	708
chr1	23355448	23363448	23361338	8000	23359448	-4000	4000	1890
chr1	25827913	25835913	25832379	8000	25831913	-4000	4000	466
chr1	26571030	26579030	26572059	8000	26575030	-4000	4000	-2971
chr1	27662064	27670064	27669329	8000	27666064	-4000	4000	3265
chr1	32241397	32249397	32241516	8000	32245397	-4000	4000	-3881
chr1	33119492	33127492	33120055	8000	33123492	-4000	4000	-3437
chr1	40616680	40624680	40621029	8000	40620680	-4000	4000	349
chr1	44815844	44823844	44823353	8000	44819844	-4000	4000	3509
chr1	46815413	46823413	46818733	8000	46819413	-4000	4000	-680
chr1	81989932	81997932	81990414	8000	81993932	-4000	4000	-3518
chr1	84234498	84242498	84236632	8000	84238498	-4000	4000	-1866
chr1	85314481	85322481	85318754	8000	85318481	-4000	4000	273
chr1	109926992	109934992	109929002	8000	109930992	-4000	4000	-1990
chr1	109926992	109934992	109929309	8000	109930992	-4000	4000	-1683
chr1	117949590	117957590	117950065	8000	117953590	-4000	4000	-3525
chr1	153066226	153074226	153070538	8000	153070226	-4000	4000	312
chr1	157670321	157678321	157676755	8000	157674321	-4000	4000	2434
chr1	159531078	159539078	159535322	8000	159535078	-4000	4000	244
chr1	184686237	184694237	184692999	8000	184690237	-4000	4000	2762
chr1	205653851	205661851	205658790	8000	205657851	-4000	4000	939
chr1	206460436	206468436	206462504	8000	206464436	-4000	4000	-1932
chr1	216499246	216507246	216507062	8000	216503246	-4000	4000	3816
chr1	248038305	248046305	248039306	8000	248042305	-4000	4000	-2999
chr1	153293116	153301116	153298005	8000	153297116	-4000	4000	889
chr1	153657788	153665788	153659499	8000	153661788	-4000	4000	-2289
chr1	244053476	244061476	244054759	8000	244057476	-4000	4000	-2717
chr1	32858268	32866268	32863059	8000	32862268	-4000	4000	791
chr1	152405243	152413243	152410681	8000	152409243	-4000	4000	1438
chr1	155881199	155889199	155884430	8000	155885199	-4000	4000	-769
chr1	156664763	156672763	156671631	8000	156668763	-4000	4000	2868
chr1	170735421	170743421	170737099	8000	170739421	-4000	4000	-2322
chr1	196221779	196229779	196227688	8000	196225779	-4000	4000	1909
chr1	204613170	204621170	204618558	8000	204617170	-4000	4000	1388
chr1	213270774	213278774	213273290	8000	213274774	-4000	4000	-1484
chr1	233381148	233389148	233383453	8000	233385148	-4000	4000	-1695
chr1	247962386	247970386	247965505	8000	247966386	-4000	4000	-881
chr1	248915946	248923946	248918092	8000	248919946	-4000	4000	-1854
chr1	2561382	2569382	2561704	8000	2565382	-4000	4000	-3678
chr1	111181104	111189104	111188362	8000	111185104	-4000	4000	3258
chr1	153066226	153074226	153070576	8000	153070226	-4000	4000	350
chr1	156664763	156672763	156672759	8000	156668763	-4000	4000	3996
chr1	192656311	192664311	192658203	8000	192660311	-4000	4000	-2108
chr1	18835599	18843599	18840005	8000	18839599	-4000	4000	406
chr1	94514666	94522666	94517115	8000	94518666	-4000	4000	-1551
chr1	151802071	151810071	151807633	8000	151806071	-4000	4000	1562
chr1	152758052	152766052	152760400	8000	152762052	-4000	4000	-1652
chr1	152809108	152817108	152813070	8000	152813108	-4000	4000	-38
chr1	153066226	153074226	153070595	8000	153070226	-4000	4000	369
chr1	154347304	154355304	154349138	8000	154351304	-4000	4000	-2166
chr1	5858811	5866811	5866378	8000	5862811	-4000	4000	3567
chr1	39619435	39627435	39626842	8000	39623435	-4000	4000	3407
chr1	152208076	152216076	152215813	8000	152212076	-4000	4000	3737
chr1	158254269	158262269	158254509	8000	158258269	-4000	4000	-3760
chr1	223391465	223399465	223395126	8000	223395465	-4000	4000	-339
chr1	226356210	226364210	226361440	8000	226360210	-4000	4000	1230
chr1	248677249	248685249	248682229	8000	248681249	-4000	4000	980
chr1	32241397	32249397	32247498	8000	32245397	-4000	4000	2101
chr1	110513217	110521217	110518687	8000	110517217	-4000	4000	1470
chr1	150261078	150269078	150263067	8000	150265078	-4000	4000	-2011
chr1	157826911	157834911	157833304	8000	157830911	-4000	4000	2393
chr1	247876138	247884138	247876199	8000	247880138	-4000	4000	-3939
chr1	247945796	247953796	247949110	8000	247949796	-4000	4000	-686
chr1	147752199	147760199	147758958	8000	147756199	-4000	4000	2759
chr1	12792628	12800628	12795903	8000	12796628	-4000	4000	-725
chr1	13304907	13312907	13305985	8000	13308907	-4000	4000	-2922
chr1	21818244	21826244	21823523	8000	21822244	-4000	4000	1279
chr1	23187895	23195895	23193411	8000	23191895	-4000	4000	1516
chr1	32201453	32209453	32207899	8000	32205453	-4000	4000	2446
chr1	32282165	32290165	32285605	8000	32286165	-4000	4000	-560
chr1	46925177	46933177	46932758	8000	46929177	-4000	4000	3581
chr1	51283258	51291258	51290572	8000	51287258	-4000	4000	3314
chr1	84234498	84242498	84235310	8000	84238498	-4000	4000	-3188
chr1	102872467	102880467	102878145	8000	102876467	-4000	4000	1678
chr1	108738749	108746749	108741799	8000	108742749	-4000	4000	-950
chr1	145666650	145674650	145671473	8000	145670650	-4000	4000	823
chr1	149924651	149932651	149928751	8000	149928651	-4000	4000	100
chr1	151398724	151406724	151405810	8000	151402724	-4000	4000	3086
chr1	151843101	151851101	151851074	8000	151847101	-4000	4000	3973
chr1	152080141	152088141	152088045	8000	152084141	-4000	4000	3904
chr1	152102317	152110317	152110144	8000	152106317	-4000	4000	3827
chr1	153433058	153441058	153438198	8000	153437058	-4000	4000	1140
chr1	155745659	155753659	155750685	8000	155749659	-4000	4000	1026
chr1	162382812	162390812	162383763	8000	162386812	-4000	4000	-3049
chr1	177278422	177286422	177280971	8000	177282422	-4000	4000	-1451
chr1	215233090	215241090	215235071	8000	215237090	-4000	4000	-2019
chr1	221697424	221705424	221702492	8000	221701424	-4000	4000	1068
chr1	225978702	225986702	225985483	8000	225982702	-4000	4000	2781
chr1	248915946	248923946	248918338	8000	248919946	-4000	4000	-1608
chr1	5858811	5866811	5865172	8000	5862811	-4000	4000	2361
chr1	21818244	21826244	21824031	8000	21822244	-4000	4000	1787
chr1	148527385	148535385	148533112	8000	148531385	-4000	4000	1727
chr1	150509789	150517789	150510155	8000	150513789	-4000	4000	-3634
chr1	152758052	152766052	152760711	8000	152762052	-4000	4000	-1341
chr1	158414210	158422210	158420228	8000	158418210	-4000	4000	2018
chr1	158845506	158853506	158845969	8000	158849506	-4000	4000	-3537
chr1	161619196	161627196	161626265	8000	161623196	-4000	4000	3069
chr1	179916077	179924077	179917865	8000	179920077	-4000	4000	-2212
chr1	190093658	190101658	190097914	8000	190097658	-4000	4000	256
chr1	223001995	223009995	223003974	8000	223005995	-4000	4000	-2021
chr1	223216819	223224819	223223552	8000	223220819	-4000	4000	2733
chr1	228420845	228428845	228425148	8000	228424845	-4000	4000	303
chr1	247945796	247953796	247949709	8000	247949796	-4000	4000	-87
chr1	247962386	247970386	247966137	8000	247966386	-4000	4000	-249
chr1	248451725	248459725	248453322	8000	248455725	-4000	4000	-2403
chr1	248632356	248640356	248638737	8000	248636356	-4000	4000	2381
chr1	1698379	1706379	1704690	8000	1702379	-4000	4000	2311
chr1	1698379	1706379	1705003	8000	1702379	-4000	4000	2624
chr1	2524745	2532745	2526579	8000	2528745	-4000	4000	-2166
chr1	13318598	13326598	13319784	8000	13322598	-4000	4000	-2814
chr1	13470973	13478973	13475745	8000	13474973	-4000	4000	772
chr1	16030050	16038050	16032255	8000	16034050	-4000	4000	-1795
chr1	23841077	23849077	23845700	8000	23845077	-4000	4000	623
chr1	23841077	23849077	23846103	8000	23845077	-4000	4000	1026
chr1	32858268	32866268	32863361	8000	32862268	-4000	4000	1093
chr1	35418058	35426058	35421172	8000	35422058	-4000	4000	-886
chr1	43619666	43627666	43620488	8000	43623666	-4000	4000	-3178
chr1	50413550	50421550	50419567	8000	50417550	-4000	4000	2017
chr1	51794427	51802427	51794824	8000	51798427	-4000	4000	-3603
chr1	53210197	53218197	53210955	8000	53214197	-4000	4000	-3242
chr1	64689058	64697058	64691619	8000	64693058	-4000	4000	-1439
chr1	71059291	71067291	71063870	8000	71063291	-4000	4000	579
chr1	86496259	86504259	86498642	8000	86500259	-4000	4000	-1617
chr1	90707539	90715539	90712578	8000	90711539	-4000	4000	1039
chr1	92828737	92836737	92833631	8000	92832737	-4000	4000	894
chr1	99305590	99313590	99309183	8000	99309590	-4000	4000	-407
chr1	110513217	110521217	110518220	8000	110517217	-4000	4000	1003
chr1	113890194	113898194	113895293	8000	113894194	-4000	4000	1099
chr1	113910086	113918086	113912069	8000	113914086	-4000	4000	-2017
chr1	149809225	149817225	149813390	8000	149813225	-4000	4000	165
chr1	152298165	152306165	152303551	8000	152302165	-4000	4000	1386
chr1	154267510	154275510	154274956	8000	154271510	-4000	4000	3446
chr1	154958298	154966298	154964237	8000	154962298	-4000	4000	1939
chr1	155610951	155618951	155614854	8000	155614951	-4000	4000	-97
chr1	155881199	155889199	155881289	8000	155885199	-4000	4000	-3910
chr1	156068013	156076013	156074954	8000	156072013	-4000	4000	2941
chr1	156459727	156467727	156464436	8000	156463727	-4000	4000	709
chr1	157569747	157577747	157575568	8000	157573747	-4000	4000	1821
chr1	158414210	158422210	158420064	8000	158418210	-4000	4000	1854
chr1	158712327	158720327	158717625	8000	158716327	-4000	4000	1298
chr1	159199313	159207313	159201291	8000	159203313	-4000	4000	-2022
chr1	160086563	160094563	160087581	8000	160090563	-4000	4000	-2982
chr1	160481030	160489030	160485909	8000	160485030	-4000	4000	879
chr1	161979192	161987192	161984998	8000	161983192	-4000	4000	1806
chr1	169128531	169136531	169132607	8000	169132531	-4000	4000	76
chr1	170164866	170172866	170166729	8000	170168866	-4000	4000	-2137
chr1	179916077	179924077	179918440	8000	179920077	-4000	4000	-1637
chr1	200173420	200181420	200175402	8000	200177420	-4000	4000	-2018
chr1	204418628	204426628	204422642	8000	204422628	-4000	4000	14
chr1	204418628	204426628	204422818	8000	204422628	-4000	4000	190
chr1	210242631	210250631	210242643	8000	210246631	-4000	4000	-3988
chr1	211936399	211944399	211942087	8000	211940399	-4000	4000	1688
chr1	221697424	221705424	221702373	8000	221701424	-4000	4000	949
chr1	247585313	247593313	247589196	8000	247589313	-4000	4000	-117
chr1	248404020	248412020	248406062	8000	248408020	-4000	4000	-1958
chr1	12205228	12213228	12206897	8000	12209228	-4000	4000	-2331
chr1	37992770	38000770	37997523	8000	37996770	-4000	4000	753
chr1	43964022	43972022	43971502	8000	43968022	-4000	4000	3480
chr1	47179582	47187582	47187358	8000	47183582	-4000	4000	3776
chr1	89929250	89937250	89935172	8000	89933250	-4000	4000	1922
chr1	110513217	110521217	110517770	8000	110517217	-4000	4000	553
chr1	111239440	111247440	111242297	8000	111243440	-4000	4000	-1143
chr1	145734868	145742868	145736090	8000	145738868	-4000	4000	-2778
chr1	149924651	149932651	149929170	8000	149928651	-4000	4000	519
chr1	152102317	152110317	152109639	8000	152106317	-4000	4000	3322
chr1	152575381	152583381	152579744	8000	152579381	-4000	4000	363
chr1	158476936	158484936	158480631	8000	158480936	-4000	4000	-305
chr1	159058484	159066484	159066181	8000	159062484	-4000	4000	3697
chr1	159304224	159312224	159306008	8000	159308224	-4000	4000	-2216
chr1	190093658	190101658	190098556	8000	190097658	-4000	4000	898
chr1	200173420	200181420	200174215	8000	200177420	-4000	4000	-3205
chr1	200856704	200864704	200857776	8000	200860704	-4000	4000	-2928
chr1	203163405	203171405	203169357	8000	203167405	-4000	4000	1952
chr1	228102679	228110679	228108002	8000	228106679	-4000	4000	1323
chr1	232805929	232813929	232807845	8000	232809929	-4000	4000	-2084
chr1	247892531	247900531	247896103	8000	247896531	-4000	4000	-428
chr1	26425728	26433728	26429396	8000	26429728	-4000	4000	-332
chr1	145887208	145895208	145892339	8000	145891208	-4000	4000	1131
chr1	152405243	152413243	152410228	8000	152409243	-4000	4000	985
chr1	166852359	166860359	166853430	8000	166856359	-4000	4000	-2929
chr1	244404494	244412494	244411381	8000	244408494	-4000	4000	2887
chr1	247919152	247927152	247921650	8000	247923152	-4000	4000	-1502
chr1	17014722	17022722	17018820	8000	17018722	-4000	4000	98
chr1	150642230	150650230	150648311	8000	150646230	-4000	4000	2081
chr1	230686776	230694776	230688428	8000	230690776	-4000	4000	-2348
chr1	190093658	190101658	190098358	8000	190097658	-4000	4000	700
chr1	247876138	247884138	247876368	8000	247880138	-4000	4000	-3770
chr1	90707539	90715539	90712132	8000	90711539	-4000	4000	593
chr1	248586487	248594487	248593384	8000	248590487	-4000	4000	2897
chr1	26357634	26365634	26362170	8000	26361634	-4000	4000	536
chr1	233381148	233389148	233382346	8000	233385148	-4000	4000	-2802
chr1	36084275	36092275	36085205	8000	36088275	-4000	4000	-3070
chr1	152705434	152713434	152709062	8000	152709434	-4000	4000	-372
chr1	152784426	152792426	152787347	8000	152788426	-4000	4000	-1079
chr1	160750821	160758821	160753295	8000	160754821	-4000	4000	-1526
chr1	165197867	165205867	165203991	8000	165201867	-4000	4000	2124
chr1	201892456	201900456	201899886	8000	201896456	-4000	4000	3430
chr1	216499246	216507246	216506909	8000	216503246	-4000	4000	3663
chr1	222518258	222526258	222522593	8000	222522258	-4000	4000	335
chr1	5858811	5866811	5864478	8000	5862811	-4000	4000	1667
chr1	177278422	177286422	177278595	8000	177282422	-4000	4000	-3827
chr1	22599595	22607595	22603346	8000	22603595	-4000	4000	-249
chr1	38039829	38047829	38044515	8000	38043829	-4000	4000	686
chr1	115030302	115038302	115034070	8000	115034302	-4000	4000	-232
chr1	172662876	172670876	172666630	8000	172666876	-4000	4000	-246
chr1	209672390	209680390	209675688	8000	209676390	-4000	4000	-702
chr1	119744002	119752002	119744171	8000	119748002	-4000	4000	-3831
chr1	21818244	21826244	21822179	8000	21822244	-4000	4000	-65
chr1	13218705	13226705	13224962	8000	13222705	-4000	4000	2257
chr1	43160175	43168175	43164244	8000	43164175	-4000	4000	69
chr1	63434553	63442553	63437111	8000	63438553	-4000	4000	-1442
chr1	158290774	158298774	158291357	8000	158294774	-4000	4000	-3417
chr1	179687272	179695272	179690755	8000	179691272	-4000	4000	-517
chr1	12773906	12781906	12775078	8000	12777906	-4000	4000	-2828
chr1	152575381	152583381	152579752	8000	152579381	-4000	4000	371
chr1	152080141	152088141	152086181	8000	152084141	-4000	4000	2040
chr1	48291373	48299373	48298802	8000	48295373	-4000	4000	3429
chr1	77558416	77566416	77565643	8000	77562416	-4000	4000	3227
chr1	111410319	111418319	111414574	8000	111414319	-4000	4000	255
chr1	232979435	232987435	232984407	8000	232983435	-4000	4000	972
chr1	247836928	247844928	247841830	8000	247840928	-4000	4000	902
chr1	13417328	13425328	13418663	8000	13421328	-4000	4000	-2665
chr1	86452553	86460553	86453565	8000	86456553	-4000	4000	-2988
chr1	241493511	241501511	241497683	8000	241497511	-4000	4000	172
chr1	223772018	223780018	223772219	8000	223776018	-4000	4000	-3799
chr1	3885125	3893125	3890056	8000	3889125	-4000	4000	931
chr1	196828189	196836189	196831866	8000	196832189	-4000	4000	-323
chr1	37856697	37864697	37857414	8000	37860697	-4000	4000	-3283
chr1	119907553	119915553	119915524	8000	119911553	-4000	4000	3971
chr1	158254269	158262269	158254589	8000	158258269	-4000	4000	-3680
chr1	158606704	158614704	158612935	8000	158610704	-4000	4000	2231
chr1	202887116	202895116	202893407	8000	202891116	-4000	4000	2291
chr1	1369730	1377730	1374747	8000	1373730	-4000	4000	1017
chr1	175152986	175160986	175160860	8000	175156986	-4000	4000	3874
chr1	200173420	200181420	200174394	8000	200177420	-4000	4000	-3026
chr1	13111488	13119488	13116458	8000	13115488	-4000	4000	970
chr1	236760631	236768631	236761089	8000	236764631	-4000	4000	-3542
chr1	247445108	247453108	247451385	8000	247449108	-4000	4000	2277
chr1	247585313	247593313	247588899	8000	247589313	-4000	4000	-414
chr1	248677249	248685249	248682087	8000	248681249	-4000	4000	838
chr1	158606704	158614704	158612858	8000	158610704	-4000	4000	2154
chr1	158973059	158981059	158973738	8000	158977059	-4000	4000	-3321
chr1	53210197	53218197	53210869	8000	53214197	-4000	4000	-3328
chr1	98886245	98894245	98892972	8000	98890245	-4000	4000	2727
chr1	152102317	152110317	152109916	8000	152106317	-4000	4000	3599
chr1	153530599	153538599	153534797	8000	153534599	-4000	4000	198
chr1	158695678	158703678	158700567	8000	158699678	-4000	4000	889
chr1	159051155	159059155	159051735	8000	159055155	-4000	4000	-3420
chr1	176841601	176849601	176842392	8000	176845601	-4000	4000	-3209
chr1	248345713	248353713	248349146	8000	248349713	-4000	4000	-567
chr1	28496364	28504364	28496542	8000	28500364	-4000	4000	-3822
chr1	12843377	12851377	12847529	8000	12847377	-4000	4000	152
chr1	171113819	171121819	171114127	8000	171117819	-4000	4000	-3692
chr1	185098603	185106603	185101373	8000	185102603	-4000	4000	-1230
chr1	248451725	248459725	248453055	8000	248455725	-4000	4000	-2670
chr1	109234182	109242182	109236423	8000	109238182	-4000	4000	-1759
chr1	117624389	117632389	117627811	8000	117628389	-4000	4000	-578
chr1	182050570	182058570	182057621	8000	182054570	-4000	4000	3051
chr1	200965390	200973390	200970164	8000	200969390	-4000	4000	774
chr1	155610951	155618951	155614881	8000	155614951	-4000	4000	-70
chr1	190093658	190101658	190098984	8000	190097658	-4000	4000	1326
chr1	40236921	40244921	40239382	8000	40240921	-4000	4000	-1539
chr1	158606704	158614704	158607344	8000	158610704	-4000	4000	-3360
chr1	13417328	13425328	13420984	8000	13421328	-4000	4000	-344
chr1	150790880	150798880	150796721	8000	150794880	-4000	4000	1841
chr1	205763986	205771986	205770781	8000	205767986	-4000	4000	2795
chr1	13417328	13425328	13418138	8000	13421328	-4000	4000	-3190
chr1	112519514	112527514	112525924	8000	112523514	-4000	4000	2410
chr1	158556606	158564606	158562917	8000	158560606	-4000	4000	2311
chr1	159531078	159539078	159535643	8000	159535078	-4000	4000	565
chr1	223391465	223399465	223394180	8000	223395465	-4000	4000	-1285
chr1	248487113	248495113	248488670	8000	248491113	-4000	4000	-2443
chr1	7841177	7849177	7847679	8000	7845177	-4000	4000	2502
chr1	151534692	151542692	151536849	8000	151538692	-4000	4000	-1843
chr1	223391465	223399465	223394199	8000	223395465	-4000	4000	-1266
chr1	53761478	53769478	53768026	8000	53765478	-4000	4000	2548
chr1	19299965	19307965	19304167	8000	19303965	-4000	4000	202
chr1	74564117	74572117	74571663	8000	74568117	-4000	4000	3546
chr1	90911298	90919298	90918056	8000	90915298	-4000	4000	2758
chr1	117107060	117115060	117112203	8000	117111060	-4000	4000	1143
chr1	89929250	89937250	89934649	8000	89933250	-4000	4000	1399
chr1	152758052	152766052	152759824	8000	152762052	-4000	4000	-2228
chr1	159947492	159955492	159953546	8000	159951492	-4000	4000	2054
chr1	184786724	184794724	184791134	8000	184790724	-4000	4000	410
chr1	51794427	51802427	51794518	8000	51798427	-4000	4000	-3909
chr1	145988435	145996435	145996330	8000	145992435	-4000	4000	3895
chr1	226985865	226993865	226990751	8000	226989865	-4000	4000	886
chr1	248586487	248594487	248593491	8000	248590487	-4000	4000	3004
chr1	7777432	7785432	7779845	8000	7781432	-4000	4000	-1587
chr1	13304907	13312907	13306874	8000	13308907	-4000	4000	-2033
chr1	13613957	13621957	13615912	8000	13617957	-4000	4000	-2045
chr1	20715731	20723731	20721836	8000	20719731	-4000	4000	2105
chr1	46925177	46933177	46930003	8000	46929177	-4000	4000	826
chr1	71059291	71067291	71066922	8000	71063291	-4000	4000	3631
chr1	152149595	152157595	152156637	8000	152153595	-4000	4000	3042
chr1	215618891	215626891	215625834	8000	215622891	-4000	4000	2943
chr1	223216819	223224819	223223399	8000	223220819	-4000	4000	2580
chr1	25827913	25835913	25835768	8000	25831913	-4000	4000	3855
chr1	201888587	201896587	201890480	8000	201892587	-4000	4000	-2107
chr1	206004535	206012535	206010219	8000	206008535	-4000	4000	1684
chr1	150509789	150517789	150513465	8000	150513789	-4000	4000	-324
chr1	12820605	12828605	12827630	8000	12824605	-4000	4000	3025
chr1	21592221	21600221	21597979	8000	21596221	-4000	4000	1758
chr1	160086563	160094563	160093933	8000	160090563	-4000	4000	3370
chr1	231014958	231022958	231019805	8000	231018958	-4000	4000	847
chr1	247602515	247610515	247605741	8000	247606515	-4000	4000	-774
chr1	39891426	39899426	39897627	8000	39895426	-4000	4000	2201
chr1	146013468	146021468	146019205	8000	146017468	-4000	4000	1737
chr1	147905269	147913269	147909112	8000	147909269	-4000	4000	-157
chr1	152758052	152766052	152761163	8000	152762052	-4000	4000	-889
chr1	211312385	211320385	211312907	8000	211316385	-4000	4000	-3478
chr1	145973811	145981811	145977779	8000	145977811	-4000	4000	-32
chr1	119889533	119897533	119895998	8000	119893533	-4000	4000	2465
chr1	156521405	156529405	156529011	8000	156525405	-4000	4000	3606
chr1	202143013	202151013	202150413	8000	202147013	-4000	4000	3400
chr1	204613170	204621170	204619028	8000	204617170	-4000	4000	1858
chr1	152824097	152832097	152827544	8000	152828097	-4000	4000	-553
chr1	232979435	232987435	232986131	8000	232983435	-4000	4000	2696
chr1	53222900	53230900	53226998	8000	53226900	-4000	4000	98
chr1	89929250	89937250	89933912	8000	89933250	-4000	4000	662
chr1	21574410	21582410	21577520	8000	21578410	-4000	4000	-890
chr1	10416511	10424511	10417004	8000	10420511	-4000	4000	-3507
chr1	74022015	74030015	74026956	8000	74026015	-4000	4000	941
chr1	156664763	156672763	156670493	8000	156668763	-4000	4000	1730
chr1	163072802	163080802	163074413	8000	163076802	-4000	4000	-2389
chr1	223391465	223399465	223394655	8000	223395465	-4000	4000	-810
chr1	152208076	152216076	152213203	8000	152212076	-4000	4000	1127
chr1	13417328	13425328	13421159	8000	13421328	-4000	4000	-169
chr1	40767603	40775603	40770665	8000	40771603	-4000	4000	-938
chr1	158556606	158564606	158563088	8000	158560606	-4000	4000	2482
chr1	10377603	10385603	10378247	8000	10381603	-4000	4000	-3356
chr1	16981958	16989958	16987198	8000	16985958	-4000	4000	1240
chr1	43359203	43367203	43362303	8000	43363203	-4000	4000	-900
chr1	43974295	43982295	43975151	8000	43978295	-4000	4000	-3144
chr1	153089135	153097135	153093420	8000	153093135	-4000	4000	285
chr1	156877850	156885850	156880037	8000	156881850	-4000	4000	-1813
chr1	161161723	161169723	161168104	8000	161165723	-4000	4000	2381
chr1	223534007	223542007	223541739	8000	223538007	-4000	4000	3732
chr1	37562816	37570816	37569174	8000	37566816	-4000	4000	2358
chr1	159830474	159838474	159835151	8000	159834474	-4000	4000	677
chr1	12875212	12883212	12879653	8000	12879212	-4000	4000	441
chr1	37530449	37538449	37537401	8000	37534449	-4000	4000	2952
chr1	158353553	158361553	158356774	8000	158357553	-4000	4000	-779
chr1	167018214	167026214	167022130	8000	167022214	-4000	4000	-84
chr1	248038305	248046305	248038488	8000	248042305	-4000	4000	-3817
chr1	248177067	248185067	248180373	8000	248181067	-4000	4000	-694
chr1	160284594	160292594	160291860	8000	160288594	-4000	4000	3266
chr1	5858811	5866811	5865131	8000	5862811	-4000	4000	2320
chr1	37797137	37805137	37799912	8000	37801137	-4000	4000	-1225
chr1	42742335	42750335	42750281	8000	42746335	-4000	4000	3946
chr1	47179582	47187582	47185044	8000	47183582	-4000	4000	1462
chr1	52890998	52898998	52896584	8000	52894998	-4000	4000	1586
chr1	168198109	168206109	168198921	8000	168202109	-4000	4000	-3188
chr1	168198109	168206109	168199926	8000	168202109	-4000	4000	-2183
chr1	228420845	228428845	228425051	8000	228424845	-4000	4000	206
chr1	248619557	248627557	248626830	8000	248623557	-4000	4000	3273
chr1	159304224	159312224	159307907	8000	159308224	-4000	4000	-317
chr1	19654456	19662456	19657034	8000	19658456	-4000	4000	-1422
chr1	12820605	12828605	12825106	8000	12824605	-4000	4000	501
chr1	27662064	27670064	27666361	8000	27666064	-4000	4000	297
chr1	45489866	45497866	45497365	8000	45493866	-4000	4000	3499
chr1	46032122	46040122	46034597	8000	46036122	-4000	4000	-1525
chr1	52605051	52613051	52608295	8000	52609051	-4000	4000	-756
chr1	65411871	65419871	65412951	8000	65415871	-4000	4000	-2920
chr1	119027216	119035216	119033117	8000	119031216	-4000	4000	1901
chr1	145988435	145996435	145995501	8000	145992435	-4000	4000	3066
chr1	151766107	151774107	151768078	8000	151770107	-4000	4000	-2029
chr1	152102317	152110317	152109814	8000	152106317	-4000	4000	3497
chr1	158606704	158614704	158611310	8000	158610704	-4000	4000	606
chr1	161066998	161074998	161074693	8000	161070998	-4000	4000	3695
chr1	161710352	161718352	161713323	8000	161714352	-4000	4000	-1029
chr1	167704696	167712696	167704732	8000	167708696	-4000	4000	-3964
chr1	248319630	248327630	248324222	8000	248323630	-4000	4000	592
chr1	12792628	12800628	12795871	8000	12796628	-4000	4000	-757
chr1	12857909	12865909	12861654	8000	12861909	-4000	4000	-255
chr1	152102317	152110317	152109697	8000	152106317	-4000	4000	3380
chr1	157741733	157749733	157746769	8000	157745733	-4000	4000	1036
chr1	179812198	179820198	179813116	8000	179816198	-4000	4000	-3082
chr1	180110875	180118875	180112660	8000	180114875	-4000	4000	-2215
chr1	208018242	208026242	208022639	8000	208022242	-4000	4000	397
chr1	47212290	47220290	47219981	8000	47216290	-4000	4000	3691
chr1	52680449	52688449	52687676	8000	52684449	-4000	4000	3227
chr1	168536768	168544768	168540895	8000	168540768	-4000	4000	127
chr1	171589511	171597511	171591801	8000	171593511	-4000	4000	-1710
chr1	247945796	247953796	247949714	8000	247949796	-4000	4000	-82
chr1	153145582	153153582	153150063	8000	153149582	-4000	4000	481
chr1	161066998	161074998	161072721	8000	161070998	-4000	4000	1723
chr1	232805929	232813929	232807894	8000	232809929	-4000	4000	-2035
chr1	155745659	155753659	155746916	8000	155749659	-4000	4000	-2743
chr1	155745659	155753659	155749429	8000	155749659	-4000	4000	-230
chr1	224189441	224197441	224189641	8000	224193441	-4000	4000	-3800
chr1	225395292	225403292	225403185	8000	225399292	-4000	4000	3893
chr1	232393965	232401965	232398978	8000	232397965	-4000	4000	1013
chr1	232805929	232813929	232806737	8000	232809929	-4000	4000	-3192
chr1	248097103	248105103	248099750	8000	248101103	-4000	4000	-1353
chr1	155230452	155238452	155237500	8000	155234452	-4000	4000	3048
chr1	119511054	119519054	119511513	8000	119515054	-4000	4000	-3541
chr1	196914713	196922713	196918337	8000	196918713	-4000	4000	-376
chr1	152597086	152605086	152600928	8000	152601086	-4000	4000	-158
chr1	165559957	165567957	165563905	8000	165563957	-4000	4000	-52
chr1	86576754	86584754	86580124	8000	86580754	-4000	4000	-630
chr1	150261078	150269078	150263148	8000	150265078	-4000	4000	-1930
chr1	156664763	156672763	156672280	8000	156668763	-4000	4000	3517
chr1	158476936	158484936	158479937	8000	158480936	-4000	4000	-999
chr1	182050570	182058570	182056788	8000	182054570	-4000	4000	2218
chr1	205528793	205536793	205529095	8000	205532793	-4000	4000	-3698
chr1	205528793	205536793	205530297	8000	205532793	-4000	4000	-2496
chr1	229426365	229434365	229431627	8000	229430365	-4000	4000	1262
chr1	229589121	229597121	229594818	8000	229593121	-4000	4000	1697
chr1	244637177	244645177	244639997	8000	244641177	-4000	4000	-1180
chr1	247962386	247970386	247965541	8000	247966386	-4000	4000	-845
chr1	248404020	248412020	248406492	8000	248408020	-4000	4000	-1528
chr1	74022015	74030015	74026793	8000	74026015	-4000	4000	778
chr1	158845506	158853506	158847733	8000	158849506	-4000	4000	-1773
chr1	12934472	12942472	12938852	8000	12938472	-4000	4000	380
chr1	220880503	220888503	220881232	8000	220884503	-4000	4000	-3271
chr1	155165409	155173409	155173311	8000	155169409	-4000	4000	3902
chr1	190093658	190101658	190098979	8000	190097658	-4000	4000	1321
chr1	232805929	232813929	232806491	8000	232809929	-4000	4000	-3438
chr1	91256766	91264766	91262292	8000	91260766	-4000	4000	1526
chr1	185292388	185300388	185299547	8000	185296388	-4000	4000	3159
chr1	161522894	161530894	161525458	8000	161526894	-4000	4000	-1436
chr1	12663076	12671076	12666609	8000	12667076	-4000	4000	-467
chr1	212682417	212690417	212686942	8000	212686417	-4000	4000	525
chr1	22657637	22665637	22660910	8000	22661637	-4000	4000	-727
chr1	145988435	145996435	145996069	8000	145992435	-4000	4000	3634
chr1	158606704	158614704	158606955	8000	158610704	-4000	4000	-3749
chr1	70249052	70257052	70250791	8000	70253052	-4000	4000	-2261
chr1	248345713	248353713	248349046	8000	248349713	-4000	4000	-667
chr1	43964022	43972022	43971025	8000	43968022	-4000	4000	3003
chr1	147171351	147179351	147179229	8000	147175351	-4000	4000	3878
chr1	209781617	209789617	209782738	8000	209785617	-4000	4000	-2879
chr1	240485573	240493573	240493396	8000	240489573	-4000	4000	3823
chr1	89002679	89010679	89007328	8000	89006679	-4000	4000	649
chr1	207637765	207645765	207639413	8000	207641765	-4000	4000	-2352
chr1	42699805	42707805	42700837	8000	42703805	-4000	4000	-2968
chr1	53210197	53218197	53210878	8000	53214197	-4000	4000	-3319
chr1	165658216	165666216	165665119	8000	165662216	-4000	4000	2903
chr1	43987500	43995500	43990956	8000	43991500	-4000	4000	-544
chr1	70254999	70262999	70261717	8000	70258999	-4000	4000	2718
chr1	107567161	107575161	107571875	8000	107571161	-4000	4000	714
chr1	225882696	225890696	225886505	8000	225886696	-4000	4000	-191
chr1	232805929	232813929	232805957	8000	232809929	-4000	4000	-3972
chr1	115044011	115052011	115050270	8000	115048011	-4000	4000	2259
chr1	151833819	151841819	151839171	8000	151837819	-4000	4000	1352
chr1	248387811	248395811	248387937	8000	248391811	-4000	4000	-3874
chr1	27759116	27767116	27759644	8000	27763116	-4000	4000	-3472
chr1	40247684	40255684	40248138	8000	40251684	-4000	4000	-3546
chr1	158353553	158361553	158355333	8000	158357553	-4000	4000	-2220
chr1	158353553	158361553	158355335	8000	158357553	-4000	4000	-2218
chr1	111316566	111324566	111320453	8000	111320566	-4000	4000	-113
chr1	223001995	223009995	223004557	8000	223005995	-4000	4000	-1438
chr1	225882696	225890696	225886401	8000	225886696	-4000	4000	-295
chr1	13318598	13326598	13322032	8000	13322598	-4000	4000	-566
chr1	32932445	32940445	32936716	8000	32936445	-4000	4000	271
chr1	13218705	13226705	13226029	8000	13222705	-4000	4000	3324
chr1	248177067	248185067	248180294	8000	248181067	-4000	4000	-773
chr1	31583686	31591686	31585868	8000	31587686	-4000	4000	-1818
chr1	158845506	158853506	158849416	8000	158849506	-4000	4000	-90
chr1	92180725	92188725	92182043	8000	92184725	-4000	4000	-2682
chr1	152149595	152157595	152155566	8000	152153595	-4000	4000	1971
chr1	151802071	151810071	151802350	8000	151806071	-4000	4000	-3721
chr1	152800832	152808832	152805125	8000	152804832	-4000	4000	293
chr1	247735559	247743559	247739449	8000	247739559	-4000	4000	-110
chr1	169507951	169515951	169515576	8000	169511951	-4000	4000	3625
chr1	81989932	81997932	81991095	8000	81993932	-4000	4000	-2837
chr1	179550735	179558735	179551655	8000	179554735	-4000	4000	-3080
chr1	197903367	197911367	197905888	8000	197907367	-4000	4000	-1479
chr1	44774779	44782779	44775576	8000	44778779	-4000	4000	-3203
chr1	152298165	152306165	152305524	8000	152302165	-4000	4000	3359
chr1	206730281	206738281	206732725	8000	206734281	-4000	4000	-1556
chr1	206730281	206738281	206732726	8000	206734281	-4000	4000	-1555
chr1	151534692	151542692	151536790	8000	151538692	-4000	4000	-1902
chr1	160086563	160094563	160093812	8000	160090563	-4000	4000	3249
chr1	170549834	170557834	170552113	8000	170553834	-4000	4000	-1721
chr1	240485573	240493573	240493080	8000	240489573	-4000	4000	3507
chr1	99305590	99313590	99307375	8000	99309590	-4000	4000	-2215
chr1	220880503	220888503	220884842	8000	220884503	-4000	4000	339
chr1	146013468	146021468	146019487	8000	146017468	-4000	4000	2019
chr1	161979192	161987192	161983725	8000	161983192	-4000	4000	533
chr1	248569801	248577801	248574033	8000	248573801	-4000	4000	232
chr1	153066226	153074226	153070744	8000	153070226	-4000	4000	518
chr1	162369203	162377203	162374105	8000	162373203	-4000	4000	902
chr1	248470307	248478307	248473958	8000	248474307	-4000	4000	-349
chr1	248470307	248478307	248473959	8000	248474307	-4000	4000	-348
chr1	156583719	156591719	156585203	8000	156587719	-4000	4000	-2516
chr1	182050570	182058570	182056638	8000	182054570	-4000	4000	2068
chr1	186439566	186447566	186444340	8000	186443566	-4000	4000	774
chr1	212988037	212996037	212994772	8000	212992037	-4000	4000	2735
chr1	1698379	1706379	1704495	8000	1702379	-4000	4000	2116
chr1	2561382	2569382	2563040	8000	2565382	-4000	4000	-2342
chr1	2561382	2569382	2563296	8000	2565382	-4000	4000	-2086
chr1	5858811	5866811	5864419	8000	5862811	-4000	4000	1608
chr1	6260269	6268269	6264593	8000	6264269	-4000	4000	324
chr1	10942471	10950471	10948331	8000	10946471	-4000	4000	1860
chr1	11533551	11541551	11536357	8000	11537551	-4000	4000	-1194
chr1	12792628	12800628	12795871	8000	12796628	-4000	4000	-757
chr1	12875212	12883212	12880042	8000	12879212	-4000	4000	830
chr1	13337892	13345892	13345264	8000	13341892	-4000	4000	3372
chr1	13365067	13373067	13369456	8000	13369067	-4000	4000	389
chr1	13388629	13396629	13389819	8000	13392629	-4000	4000	-2810
chr1	15486832	15494832	15491164	8000	15490832	-4000	4000	332
chr1	15486832	15494832	15493192	8000	15490832	-4000	4000	2360
chr1	16053769	16061769	16058704	8000	16057769	-4000	4000	935
chr1	19971431	19979431	19978835	8000	19975431	-4000	4000	3404
chr1	22599595	22607595	22600969	8000	22603595	-4000	4000	-2626
chr1	23841077	23849077	23845798	8000	23845077	-4000	4000	721
chr1	24052035	24060035	24057606	8000	24056035	-4000	4000	1571
chr1	24669281	24677281	24672304	8000	24673281	-4000	4000	-977
chr1	26198968	26206968	26201403	8000	26202968	-4000	4000	-1565
chr1	26472642	26480642	26473810	8000	26476642	-4000	4000	-2832
chr1	26571030	26579030	26572090	8000	26575030	-4000	4000	-2940
chr1	27882685	27890685	27882776	8000	27886685	-4000	4000	-3909
chr1	28496364	28504364	28496561	8000	28500364	-4000	4000	-3803
chr1	29116046	29124046	29120958	8000	29120046	-4000	4000	912
chr1	32596792	32604792	32600313	8000	32600792	-4000	4000	-479
chr1	35111859	35119859	35113616	8000	35115859	-4000	4000	-2243
chr1	40236921	40244921	40239824	8000	40240921	-4000	4000	-1097
chr1	40767603	40775603	40770827	8000	40771603	-4000	4000	-776
chr1	43619666	43627666	43620841	8000	43623666	-4000	4000	-2825
chr1	45012399	45020399	45019204	8000	45016399	-4000	4000	2805
chr1	45489866	45497866	45494984	8000	45493866	-4000	4000	1118
chr1	46039661	46047661	46043841	8000	46043661	-4000	4000	180
chr1	47145727	47153727	47146201	8000	47149727	-4000	4000	-3526
chr1	47246139	47254139	47251628	8000	47250139	-4000	4000	1489
chr1	52404282	52412282	52404721	8000	52408282	-4000	4000	-3561
chr1	53083179	53091179	53090884	8000	53087179	-4000	4000	3705
chr1	53502237	53510237	53506740	8000	53506237	-4000	4000	503
chr1	53761478	53769478	53767976	8000	53765478	-4000	4000	2498
chr1	59983269	59991269	59990537	8000	59987269	-4000	4000	3268
chr1	66370579	66378579	66372498	8000	66374579	-4000	4000	-2081
chr1	66984619	66992619	66984936	8000	66988619	-4000	4000	-3683
chr1	67394724	67402724	67395775	8000	67398724	-4000	4000	-2949
chr1	74564117	74572117	74571269	8000	74568117	-4000	4000	3152
chr1	78660078	78668078	78663762	8000	78664078	-4000	4000	-316
chr1	85245953	85253953	85252615	8000	85249953	-4000	4000	2662
chr1	86496259	86504259	86500082	8000	86500259	-4000	4000	-177
chr1	88931773	88939773	88936138	8000	88935773	-4000	4000	365
chr1	89002679	89010679	89007474	8000	89006679	-4000	4000	795
chr1	92180725	92188725	92182152	8000	92184725	-4000	4000	-2573
chr1	92828737	92836737	92836195	8000	92832737	-4000	4000	3458
chr1	108811898	108819898	108817145	8000	108815898	-4000	4000	1247
chr1	109305568	109313568	109306916	8000	109309568	-4000	4000	-2652
chr1	109705551	109713551	109713271	8000	109709551	-4000	4000	3720
chr1	110668465	110676465	110673244	8000	110672465	-4000	4000	779
chr1	112459456	112467456	112467428	8000	112463456	-4000	4000	3972
chr1	113681923	113689923	113682243	8000	113685923	-4000	4000	-3680
chr1	115030302	115038302	115034207	8000	115034302	-4000	4000	-95
chr1	145913714	145921714	145917016	8000	145917714	-4000	4000	-698
chr1	145988435	145996435	145996261	8000	145992435	-4000	4000	3826
chr1	145988435	145996435	145996358	8000	145992435	-4000	4000	3923
chr1	147905269	147913269	147908345	8000	147909269	-4000	4000	-924
chr1	148478548	148486548	148483114	8000	148482548	-4000	4000	566
chr1	149580607	149588607	149584140	8000	149584607	-4000	4000	-467
chr1	149880459	149888459	149886228	8000	149884459	-4000	4000	1769
chr1	149880459	149888459	149886593	8000	149884459	-4000	4000	2134
chr1	149933812	149941812	149936725	8000	149937812	-4000	4000	-1087
chr1	150992549	151000549	151000465	8000	150996549	-4000	4000	3916
chr1	151127685	151135685	151135165	8000	151131685	-4000	4000	3480
chr1	151534692	151542692	151536850	8000	151538692	-4000	4000	-1842
chr1	152080141	152088141	152086304	8000	152084141	-4000	4000	2163
chr1	152149595	152157595	152156543	8000	152153595	-4000	4000	2948
chr1	152208076	152216076	152214877	8000	152212076	-4000	4000	2801
chr1	152298165	152306165	152304561	8000	152302165	-4000	4000	2396
chr1	152344735	152352735	152350869	8000	152348735	-4000	4000	2134
chr1	152610098	152618098	152613992	8000	152614098	-4000	4000	-106
chr1	152672569	152680569	152676159	8000	152676569	-4000	4000	-410
chr1	152809108	152817108	152812518	8000	152813108	-4000	4000	-590
chr1	152881047	152889047	152884845	8000	152885047	-4000	4000	-202
chr1	153066226	153074226	153070538	8000	153070226	-4000	4000	312
chr1	153453744	153461744	153459014	8000	153457744	-4000	4000	1270
chr1	153977617	153985617	153982801	8000	153981617	-4000	4000	1184
chr1	154321325	154329325	154323264	8000	154325325	-4000	4000	-2061
chr1	154940076	154948076	154946660	8000	154944076	-4000	4000	2584
chr1	155014523	155022523	155014684	8000	155018523	-4000	4000	-3839
chr1	155082807	155090807	155086427	8000	155086807	-4000	4000	-380
chr1	155165409	155173409	155172388	8000	155169409	-4000	4000	2979
chr1	155316666	155324666	155320531	8000	155320666	-4000	4000	-135
chr1	155610951	155618951	155611441	8000	155614951	-4000	4000	-3510
chr1	155610951	155618951	155612209	8000	155614951	-4000	4000	-2742
chr1	157826911	157834911	157831848	8000	157830911	-4000	4000	937
chr1	157826911	157834911	157834431	8000	157830911	-4000	4000	3520
chr1	158254269	158262269	158256088	8000	158258269	-4000	4000	-2181
chr1	159531078	159539078	159535448	8000	159535078	-4000	4000	370
chr1	159708289	159716289	159714015	8000	159712289	-4000	4000	1726
chr1	159923039	159931039	159930300	8000	159927039	-4000	4000	3261
chr1	160354952	160362952	160355722	8000	160358952	-4000	4000	-3230
chr1	160354952	160362952	160358211	8000	160358952	-4000	4000	-741
chr1	160872540	160880540	160879391	8000	160876540	-4000	4000	2851
chr1	161042946	161050946	161043280	8000	161046946	-4000	4000	-3666
chr1	171113819	171121819	171114016	8000	171117819	-4000	4000	-3803
chr1	171113819	171121819	171117464	8000	171117819	-4000	4000	-355
chr1	171281978	171289978	171285471	8000	171285978	-4000	4000	-507
chr1	182883982	182891982	182884632	8000	182887982	-4000	4000	-3350
chr1	192808275	192816275	192811644	8000	192812275	-4000	4000	-631
chr1	196221779	196229779	196228336	8000	196225779	-4000	4000	2557
chr1	197903367	197911367	197907235	8000	197907367	-4000	4000	-132
chr1	200547497	200555497	200553423	8000	200551497	-4000	4000	1926
chr1	203867152	203875152	203870033	8000	203871152	-4000	4000	-1119
chr1	205079129	205087129	205083508	8000	205083129	-4000	4000	379
chr1	205909048	205917048	205915225	8000	205913048	-4000	4000	2177
chr1	207014522	207022522	207022483	8000	207018522	-4000	4000	3961
chr1	207791513	207799513	207793775	8000	207795513	-4000	4000	-1738
chr1	209778320	209786320	209779583	8000	209782320	-4000	4000	-2737
chr1	211472522	211480522	211479245	8000	211476522	-4000	4000	2723
chr1	215233090	215241090	215235038	8000	215237090	-4000	4000	-2052
chr1	216499246	216507246	216506903	8000	216503246	-4000	4000	3657
chr1	221697424	221705424	221702365	8000	221701424	-4000	4000	941
chr1	222518258	222526258	222522638	8000	222522258	-4000	4000	380
chr1	223001995	223009995	223005127	8000	223005995	-4000	4000	-868
chr1	223001995	223009995	223005656	8000	223005995	-4000	4000	-339
chr1	223105404	223113404	223110967	8000	223109404	-4000	4000	1563
chr1	234320511	234328511	234323210	8000	234324511	-4000	4000	-1301
chr1	240485573	240493573	240493440	8000	240489573	-4000	4000	3867
chr1	244637177	244645177	244640123	8000	244641177	-4000	4000	-1054
chr1	244836638	244844638	244841855	8000	244840638	-4000	4000	1217
chr1	246835098	246843098	246840860	8000	246839098	-4000	4000	1762
chr1	247602515	247610515	247605649	8000	247606515	-4000	4000	-866
chr1	247666812	247674812	247672208	8000	247670812	-4000	4000	1396
chr1	247810660	247818660	247814863	8000	247814660	-4000	4000	203
chr1	247836928	247844928	247841237	8000	247840928	-4000	4000	309
chr1	248142086	248150086	248145822	8000	248146086	-4000	4000	-264
chr1	248345713	248353713	248349323	8000	248349713	-4000	4000	-390
chr1	248586487	248594487	248593391	8000	248590487	-4000	4000	2904
chr1	248586487	248594487	248593715	8000	248590487	-4000	4000	3228
chr1	248677249	248685249	248681700	8000	248681249	-4000	4000	451
chr1	248846006	248854006	248847241	8000	248850006	-4000	4000	-2765
chr1	26121555	26129555	26122498	8000	26125555	-4000	4000	-3057
chr1	85314481	85322481	85318589	8000	85318481	-4000	4000	108
chr1	152298165	152306165	152303124	8000	152302165	-4000	4000	959
chr1	190093658	190101658	190098673	8000	190097658	-4000	4000	1015
chr1	78885764	78893764	78891012	8000	78889764	-4000	4000	1248
chr1	154321325	154329325	154323318	8000	154325325	-4000	4000	-2007
chr1	247810660	247818660	247815624	8000	247814660	-4000	4000	964
chr1	248038305	248046305	248038694	8000	248042305	-4000	4000	-3611
chr1	248038305	248046305	248039060	8000	248042305	-4000	4000	-3245
chr1	18744866	18752866	18745189	8000	18748866	-4000	4000	-3677
chr1	64689058	64697058	64691837	8000	64693058	-4000	4000	-1221
chr1	147905269	147913269	147908754	8000	147909269	-4000	4000	-515
chr1	155130899	155138899	155133764	8000	155134899	-4000	4000	-1135
chr1	160826160	160834160	160832703	8000	160830160	-4000	4000	2543
chr1	206585448	206593448	206589024	8000	206589448	-4000	4000	-424
chr1	237000103	237008103	237004280	8000	237004103	-4000	4000	177
chr1	153201120	153209120	153204988	8000	153205120	-4000	4000	-132
chr1	161225666	161233666	161228746	8000	161229666	-4000	4000	-920
chr1	169507951	169515951	169515533	8000	169511951	-4000	4000	3582
chr1	197474455	197482455	197477722	8000	197478455	-4000	4000	-733
chr1	228096726	228104726	228097876	8000	228100726	-4000	4000	-2850
chr1	40492343	40500343	40495494	8000	40496343	-4000	4000	-849
chr1	185287781	185295781	185290894	8000	185291781	-4000	4000	-887
chr1	248097103	248105103	248099600	8000	248101103	-4000	4000	-1503
chr1	156655532	156663532	156658674	8000	156659532	-4000	4000	-858
chr1	200856704	200864704	200857751	8000	200860704	-4000	4000	-2953
chr1	13111488	13119488	13115562	8000	13115488	-4000	4000	74
chr1	247945796	247953796	247948890	8000	247949796	-4000	4000	-906
chr1	16120337	16128337	16125218	8000	16124337	-4000	4000	881
chr1	17242007	17250007	17249112	8000	17246007	-4000	4000	3105
chr1	23355448	23363448	23362347	8000	23359448	-4000	4000	2899
chr1	31786422	31794422	31790712	8000	31790422	-4000	4000	290
chr1	78134444	78142444	78135657	8000	78138444	-4000	4000	-2787
chr1	23355448	23363448	23362500	8000	23359448	-4000	4000	3052
chr1	23355448	23363448	23363030	8000	23359448	-4000	4000	3582
chr1	46670659	46678659	46678618	8000	46674659	-4000	4000	3959
chr1	149880459	149888459	149886419	8000	149884459	-4000	4000	1960
chr1	151127685	151135685	151135248	8000	151131685	-4000	4000	3563
chr1	152102317	152110317	152108932	8000	152106317	-4000	4000	2615
chr1	153557108	153565108	153561380	8000	153561108	-4000	4000	272
chr1	155251979	155259979	155254725	8000	155255979	-4000	4000	-1254
chr1	158712327	158720327	158717352	8000	158716327	-4000	4000	1025
chr1	171060765	171068765	171064238	8000	171064765	-4000	4000	-527
chr1	9981501	9989501	9982611	8000	9985501	-4000	4000	-2890
chr1	111316566	111324566	111318635	8000	111320566	-4000	4000	-1931
chr1	149809225	149817225	149813418	8000	149813225	-4000	4000	193
chr1	152800832	152808832	152805411	8000	152804832	-4000	4000	579
chr1	158394522	158402522	158399137	8000	158398522	-4000	4000	615
chr1	158712327	158720327	158717370	8000	158716327	-4000	4000	1043
chr1	212622775	212630775	212625708	8000	212626775	-4000	4000	-1067
chr1	231351023	231359023	231353274	8000	231355023	-4000	4000	-1749
chr1	12934472	12942472	12938984	8000	12938472	-4000	4000	512
chr1	93550661	93558661	93554170	8000	93554661	-4000	4000	-491
chr1	113973869	113981869	113981370	8000	113977869	-4000	4000	3501
chr1	152298165	152306165	152304456	8000	152302165	-4000	4000	2291
chr1	153066226	153074226	153070698	8000	153070226	-4000	4000	472
chr1	201224952	201232952	201227085	8000	201228952	-4000	4000	-1867
chr1	103660554	103668554	103660600	8000	103664554	-4000	4000	-3954
chr1	153657788	153665788	153664062	8000	153661788	-4000	4000	2274
chr1	39483177	39491177	39484731	8000	39487177	-4000	4000	-2446
chr1	155046930	155054930	155052535	8000	155050930	-4000	4000	1605
chr1	197149682	197157682	197157499	8000	197153682	-4000	4000	3817
chr1	158353553	158361553	158356770	8000	158357553	-4000	4000	-783
chr1	29322813	29330813	29325654	8000	29326813	-4000	4000	-1159
chr1	160087340	160095340	160095092	8000	160091340	-4000	4000	3752
chr1	160139591	160147591	160141496	8000	160143591	-4000	4000	-2095
chr1	26571030	26579030	26571936	8000	26575030	-4000	4000	-3094
chr1	67585	75585	69767	8000	71585	-4000	4000	-1818
chr1	6575755	6583755	6576613	8000	6579755	-4000	4000	-3142
chr1	10448153	10456153	10451590	8000	10452153	-4000	4000	-563
chr1	12205228	12213228	12206925	8000	12209228	-4000	4000	-2303
chr1	13318598	13326598	13321749	8000	13322598	-4000	4000	-849
chr1	13318598	13326598	13322096	8000	13322598	-4000	4000	-502
chr1	21574410	21582410	21575921	8000	21578410	-4000	4000	-2489
chr1	25496209	25504209	25498317	8000	25500209	-4000	4000	-1892
chr1	26198968	26206968	26200959	8000	26202968	-4000	4000	-2009
chr1	27365110	27373110	27370678	8000	27369110	-4000	4000	1568
chr1	28143166	28151166	28150287	8000	28147166	-4000	4000	3121
chr1	28143166	28151166	28150965	8000	28147166	-4000	4000	3799
chr1	32858268	32866268	32864181	8000	32862268	-4000	4000	1913
chr1	36089932	36097932	36097764	8000	36093932	-4000	4000	3832
chr1	36387238	36395238	36394006	8000	36391238	-4000	4000	2768
chr1	36411827	36419827	36418160	8000	36415827	-4000	4000	2333
chr1	40236921	40244921	40237010	8000	40240921	-4000	4000	-3911
chr1	40236921	40244921	40239074	8000	40240921	-4000	4000	-1847
chr1	40459718	40467718	40463300	8000	40463718	-4000	4000	-418
chr1	42426329	42434329	42430491	8000	42430329	-4000	4000	162
chr1	45623304	45631304	45628191	8000	45627304	-4000	4000	887
chr1	45623304	45631304	45629633	8000	45627304	-4000	4000	2329
chr1	46039661	46047661	46043608	8000	46043661	-4000	4000	-53
chr1	46409848	46417848	46411614	8000	46413848	-4000	4000	-2234
chr1	46815413	46823413	46818160	8000	46819413	-4000	4000	-1253
chr1	47414052	47422052	47416702	8000	47418052	-4000	4000	-1350
chr1	50199772	50207772	50201055	8000	50203772	-4000	4000	-2717
chr1	53081501	53089501	53088212	8000	53085501	-4000	4000	2711
chr1	53761478	53769478	53767766	8000	53765478	-4000	4000	2288
chr1	56714789	56722789	56720212	8000	56718789	-4000	4000	1423
chr1	62208328	62216328	62211118	8000	62212328	-4000	4000	-1210
chr1	67088165	67096165	67093556	8000	67092165	-4000	4000	1391
chr1	67088165	67096165	67095374	8000	67092165	-4000	4000	3209
chr1	68041886	68049886	68046638	8000	68045886	-4000	4000	752
chr1	74022015	74030015	74026962	8000	74026015	-4000	4000	947
chr1	75198129	75206129	75203517	8000	75202129	-4000	4000	1388
chr1	85152889	85160889	85159046	8000	85156889	-4000	4000	2157
chr1	88832255	88840255	88833393	8000	88836255	-4000	4000	-2862
chr1	89047882	89055882	89053432	8000	89051882	-4000	4000	1550
chr1	89929250	89937250	89934049	8000	89933250	-4000	4000	799
chr1	89929250	89937250	89934255	8000	89933250	-4000	4000	1005
chr1	89929250	89937250	89934386	8000	89933250	-4000	4000	1136
chr1	89929250	89937250	89934755	8000	89933250	-4000	4000	1505
chr1	91256766	91264766	91261194	8000	91260766	-4000	4000	428
chr1	93550661	93558661	93551078	8000	93554661	-4000	4000	-3583
chr1	97073743	97081743	97079057	8000	97077743	-4000	4000	1314
chr1	98886245	98894245	98892974	8000	98890245	-4000	4000	2729
chr1	101239713	101247713	101239942	8000	101243713	-4000	4000	-3771
chr1	103621780	103629780	103623968	8000	103625780	-4000	4000	-1812
chr1	103754726	103762726	103754768	8000	103758726	-4000	4000	-3958
chr1	108811898	108819898	108817062	8000	108815898	-4000	4000	1164
chr1	110513217	110521217	110517341	8000	110517217	-4000	4000	124
chr1	110513217	110521217	110517983	8000	110517217	-4000	4000	766
chr1	110668465	110676465	110673836	8000	110672465	-4000	4000	1371
chr1	110668465	110676465	110674341	8000	110672465	-4000	4000	1876
chr1	111410319	111418319	111415298	8000	111414319	-4000	4000	979
chr1	111458773	111466773	111461145	8000	111462773	-4000	4000	-1628
chr1	113890194	113898194	113895706	8000	113894194	-4000	4000	1512
chr1	113973869	113981869	113980588	8000	113977869	-4000	4000	2719
chr1	113973869	113981869	113981687	8000	113977869	-4000	4000	3818
chr1	114669090	114677090	114675598	8000	114673090	-4000	4000	2508
chr1	116510534	116518534	116514813	8000	116514534	-4000	4000	279
chr1	119027216	119035216	119033036	8000	119031216	-4000	4000	1820
chr1	145988435	145996435	145995010	8000	145992435	-4000	4000	2575
chr1	146013468	146021468	146018314	8000	146017468	-4000	4000	846
chr1	147171351	147179351	147179099	8000	147175351	-4000	4000	3748
chr1	147171351	147179351	147179291	8000	147175351	-4000	4000	3940
chr1	147905269	147913269	147908943	8000	147909269	-4000	4000	-326
chr1	149809225	149817225	149813294	8000	149813225	-4000	4000	69
chr1	150141329	150149329	150144733	8000	150145329	-4000	4000	-596
chr1	150694060	150702060	150700163	8000	150698060	-4000	4000	2103
chr1	151766107	151774107	151767204	8000	151770107	-4000	4000	-2903
chr1	151796264	151804264	151802068	8000	151800264	-4000	4000	1804
chr1	151833819	151841819	151838041	8000	151837819	-4000	4000	222
chr1	152149595	152157595	152155725	8000	152153595	-4000	4000	2130
chr1	152149595	152157595	152156919	8000	152153595	-4000	4000	3324
chr1	152405243	152413243	152412198	8000	152409243	-4000	4000	2955
chr1	153066226	153074226	153070740	8000	153070226	-4000	4000	514
chr1	153089135	153097135	153093370	8000	153093135	-4000	4000	235
chr1	153539613	153547613	153541625	8000	153543613	-4000	4000	-1988
chr1	154544147	154552147	154547585	8000	154548147	-4000	4000	-562
chr1	154577695	154585695	154585010	8000	154581695	-4000	4000	3315
chr1	155165409	155173409	155172458	8000	155169409	-4000	4000	3049
chr1	155316666	155324666	155320616	8000	155320666	-4000	4000	-50
chr1	156583719	156591719	156585170	8000	156587719	-4000	4000	-2549
chr1	156664763	156672763	156671754	8000	156668763	-4000	4000	2991
chr1	156664763	156672763	156672275	8000	156668763	-4000	4000	3512
chr1	158254269	158262269	158256921	8000	158258269	-4000	4000	-1348
chr1	158353553	158361553	158354019	8000	158357553	-4000	4000	-3534
chr1	158414210	158422210	158420160	8000	158418210	-4000	4000	1950
chr1	158476936	158484936	158480052	8000	158480936	-4000	4000	-884
chr1	158845506	158853506	158845686	8000	158849506	-4000	4000	-3820
chr1	159439078	159447078	159440023	8000	159443078	-4000	4000	-3055
chr1	159439078	159447078	159440552	8000	159443078	-4000	4000	-2526
chr1	159531078	159539078	159535225	8000	159535078	-4000	4000	147
chr1	159830474	159838474	159832940	8000	159834474	-4000	4000	-1534
chr1	159923039	159931039	159928586	8000	159927039	-4000	4000	1547
chr1	160182980	160190980	160186833	8000	160186980	-4000	4000	-147
chr1	160284594	160292594	160290162	8000	160288594	-4000	4000	1568
chr1	160284594	160292594	160292071	8000	160288594	-4000	4000	3477
chr1	160941025	160949025	160948012	8000	160945025	-4000	4000	2987
chr1	161096346	161104346	161100633	8000	161100346	-4000	4000	287
chr1	161674654	161682654	161677758	8000	161678654	-4000	4000	-896
chr1	161710352	161718352	161713485	8000	161714352	-4000	4000	-867
chr1	161979192	161987192	161983827	8000	161983192	-4000	4000	635
chr1	161979192	161987192	161984192	8000	161983192	-4000	4000	1000
chr1	168691468	168699468	168696561	8000	168695468	-4000	4000	1093
chr1	169128531	169136531	169131293	8000	169132531	-4000	4000	-1238
chr1	169850080	169858080	169854391	8000	169854080	-4000	4000	311
chr1	177278422	177286422	177280940	8000	177282422	-4000	4000	-1482
chr1	177278422	177286422	177281132	8000	177282422	-4000	4000	-1290
chr1	178544602	178552602	178545762	8000	178548602	-4000	4000	-2840
chr1	182895865	182903865	182903110	8000	182899865	-4000	4000	3245
chr1	185098603	185106603	185099870	8000	185102603	-4000	4000	-2733
chr1	185287781	185295781	185290896	8000	185291781	-4000	4000	-885
chr1	190093658	190101658	190098799	8000	190097658	-4000	4000	1141
chr1	192656311	192664311	192659546	8000	192660311	-4000	4000	-765
chr1	196221779	196229779	196228325	8000	196225779	-4000	4000	2546
chr1	196791407	196799407	196793507	8000	196795407	-4000	4000	-1900
chr1	196914713	196922713	196918279	8000	196918713	-4000	4000	-434
chr1	197005678	197013678	197008636	8000	197009678	-4000	4000	-1042
chr1	201035512	201043512	201043330	8000	201039512	-4000	4000	3818
chr1	206924522	206932522	206930380	8000	206928522	-4000	4000	1858
chr1	207140972	207148972	207141157	8000	207144972	-4000	4000	-3815
chr1	211370946	211378946	211372731	8000	211374946	-4000	4000	-2215
chr1	212357853	212365853	212365032	8000	212361853	-4000	4000	3179
chr1	220660461	220668461	220662170	8000	220664461	-4000	4000	-2291
chr1	223001995	223009995	223003515	8000	223005995	-4000	4000	-2480
chr1	223001995	223009995	223003959	8000	223005995	-4000	4000	-2036
chr1	223001995	223009995	223004243	8000	223005995	-4000	4000	-1752
chr1	223105404	223113404	223110461	8000	223109404	-4000	4000	1057
chr1	223105404	223113404	223112462	8000	223109404	-4000	4000	3058
chr1	224189441	224197441	224192483	8000	224193441	-4000	4000	-958
chr1	226227149	226235149	226233089	8000	226231149	-4000	4000	1940
chr1	226356210	226364210	226361534	8000	226360210	-4000	4000	1324
chr1	226627690	226635690	226634610	8000	226631690	-4000	4000	2920
chr1	229426365	229434365	229431408	8000	229430365	-4000	4000	1043
chr1	230686776	230694776	230687064	8000	230690776	-4000	4000	-3712
chr1	231273973	231281973	231275311	8000	231277973	-4000	4000	-2662
chr1	231273973	231281973	231277569	8000	231277973	-4000	4000	-404
chr1	231351023	231359023	231351579	8000	231355023	-4000	4000	-3444
chr1	231359797	231367797	231366292	8000	231363797	-4000	4000	2495
chr1	231359797	231367797	231367580	8000	231363797	-4000	4000	3783
chr1	236545005	236553005	236548356	8000	236549005	-4000	4000	-649
chr1	244836638	244844638	244843085	8000	244840638	-4000	4000	2447
chr1	247095962	247103962	247100466	8000	247099962	-4000	4000	504
chr1	247836928	247844928	247841035	8000	247840928	-4000	4000	107
chr1	248038305	248046305	248038343	8000	248042305	-4000	4000	-3962
chr1	248059407	248067407	248061237	8000	248063407	-4000	4000	-2170
chr1	248451725	248459725	248453088	8000	248455725	-4000	4000	-2637
chr1	248586487	248594487	248593260	8000	248590487	-4000	4000	2773
chr1	1698379	1706379	1704265	8000	1702379	-4000	4000	1886
chr1	35709877	35717877	35716000	8000	35713877	-4000	4000	2123
chr1	37856697	37864697	37857629	8000	37860697	-4000	4000	-3068
chr1	39483177	39491177	39484676	8000	39487177	-4000	4000	-2501
chr1	42840991	42848991	42843248	8000	42844991	-4000	4000	-1743
chr1	43969369	43977369	43972155	8000	43973369	-4000	4000	-1214
chr1	113910086	113918086	113911459	8000	113914086	-4000	4000	-2627
chr1	149919317	149927317	149926722	8000	149923317	-4000	4000	3405
chr1	152080141	152088141	152088045	8000	152084141	-4000	4000	3904
chr1	152298165	152306165	152302663	8000	152302165	-4000	4000	498
chr1	155014523	155022523	155014668	8000	155018523	-4000	4000	-3855
chr1	156208796	156216796	156210509	8000	156212796	-4000	4000	-2287
chr1	156583719	156591719	156585807	8000	156587719	-4000	4000	-1912
chr1	159830474	159838474	159835151	8000	159834474	-4000	4000	677
chr1	159947492	159955492	159951829	8000	159951492	-4000	4000	337
chr1	160674746	160682746	160681260	8000	160678746	-4000	4000	2514
chr1	175152986	175160986	175160690	8000	175156986	-4000	4000	3704
chr1	176841601	176849601	176842514	8000	176845601	-4000	4000	-3087
chr1	198519222	198527222	198523541	8000	198523222	-4000	4000	319
chr1	203163405	203171405	203165656	8000	203167405	-4000	4000	-1749
chr1	206953965	206961965	206960683	8000	206957965	-4000	4000	2718
chr1	212622775	212630775	212625765	8000	212626775	-4000	4000	-1010
chr1	215618891	215626891	215619260	8000	215622891	-4000	4000	-3631
chr1	237829988	237837988	237831530	8000	237833988	-4000	4000	-2458
chr1	247892531	247900531	247895637	8000	247896531	-4000	4000	-894
chr1	113890194	113898194	113896180	8000	113894194	-4000	4000	1986
chr1	119027216	119035216	119033310	8000	119031216	-4000	4000	2094
chr1	168578069	168586069	168580076	8000	168582069	-4000	4000	-1993
chr1	171281978	171289978	171285274	8000	171285978	-4000	4000	-704
chr1	207637765	207645765	207645167	8000	207641765	-4000	4000	3402
chr1	85245953	85253953	85252583	8000	85249953	-4000	4000	2630
chr1	153028900	153036900	153032681	8000	153032900	-4000	4000	-219
chr1	161161723	161169723	161164539	8000	161165723	-4000	4000	-1184
chr1	209609939	209617939	209612910	8000	209613939	-4000	4000	-1029
chr1	159199313	159207313	159206266	8000	159203313	-4000	4000	2953
chr1	247602515	247610515	247605882	8000	247606515	-4000	4000	-633
chr1	116066054	116074054	116066706	8000	116070054	-4000	4000	-3348
chr1	224223334	224231334	224227670	8000	224227334	-4000	4000	336
chr1	148478548	148486548	148483114	8000	148482548	-4000	4000	566
chr1	212988037	212996037	212994772	8000	212992037	-4000	4000	2735
chr1	225978702	225986702	225985475	8000	225982702	-4000	4000	2773
chr1	12843377	12851377	12847985	8000	12847377	-4000	4000	608
chr1	160211376	160219376	160214949	8000	160215376	-4000	4000	-427
chr1	198753476	198761476	198756230	8000	198757476	-4000	4000	-1246
chr1	201892456	201900456	201898351	8000	201896456	-4000	4000	1895
chr1	203163405	203171405	203165249	8000	203167405	-4000	4000	-2156
chr1	35111859	35119859	35115317	8000	35115859	-4000	4000	-542
chr1	40492343	40500343	40495456	8000	40496343	-4000	4000	-887
chr1	113681923	113689923	113683076	8000	113685923	-4000	4000	-2847
chr1	150509789	150517789	150513471	8000	150513789	-4000	4000	-318
chr1	158695678	158703678	158699918	8000	158699678	-4000	4000	240
chr1	201892456	201900456	201900085	8000	201896456	-4000	4000	3629
chr1	209781617	209789617	209782840	8000	209785617	-4000	4000	-2777
chr1	223001995	223009995	223004694	8000	223005995	-4000	4000	-1301
chr1	247836928	247844928	247841770	8000	247840928	-4000	4000	842
chr1	44647724	44655724	44654651	8000	44651724	-4000	4000	2927
chr1	220660461	220668461	220661891	8000	220664461	-4000	4000	-2570
chr1	229301894	229309894	229304984	8000	229305894	-4000	4000	-910
chr1	152298165	152306165	152302758	8000	152302165	-4000	4000	593
chr1	203174931	203182931	203182793	8000	203178931	-4000	4000	3862
chr1	160086563	160094563	160093933	8000	160090563	-4000	4000	3370
chr1	204150819	204158819	204156260	8000	204154819	-4000	4000	1441
chr1	205082142	205090142	205088617	8000	205086142	-4000	4000	2475
chr1	220660461	220668461	220661936	8000	220664461	-4000	4000	-2525
chr1	227842470	227850470	227846078	8000	227846470	-4000	4000	-392
chr1	232979435	232987435	232986031	8000	232983435	-4000	4000	2596
chr1	185114101	185122101	185119908	8000	185118101	-4000	4000	1807
chr1	18481974	18489974	18483220	8000	18485974	-4000	4000	-2754
chr1	47179582	47187582	47187390	8000	47183582	-4000	4000	3808
chr1	204150819	204158819	204156791	8000	204154819	-4000	4000	1972
chr1	66370579	66378579	66374140	8000	66374579	-4000	4000	-439
chr1	100538021	100546021	100540698	8000	100542021	-4000	4000	-1323
chr1	101239713	101247713	101240728	8000	101243713	-4000	4000	-2985
chr1	117624389	117632389	117626423	8000	117628389	-4000	4000	-1966
chr1	151802071	151810071	151802339	8000	151806071	-4000	4000	-3732
chr1	152575381	152583381	152579508	8000	152579381	-4000	4000	127
chr1	201376833	201384833	201381357	8000	201380833	-4000	4000	524
chr1	26472642	26480642	26475197	8000	26476642	-4000	4000	-1445
chr1	40236921	40244921	40236966	8000	40240921	-4000	4000	-3955
chr1	152999856	153007856	153003618	8000	153003856	-4000	4000	-238
chr1	156929094	156937094	156935855	8000	156933094	-4000	4000	2761
chr1	201888587	201896587	201889444	8000	201892587	-4000	4000	-3143
chr1	158606704	158614704	158613776	8000	158610704	-4000	4000	3072
chr1	93881199	93889199	93888577	8000	93885199	-4000	4000	3378
chr1	196221779	196229779	196228101	8000	196225779	-4000	4000	2322
chr1	156930840	156938840	156937334	8000	156934840	-4000	4000	2494
chr1	158254269	158262269	158256183	8000	158258269	-4000	4000	-2086
chr1	152298165	152306165	152304928	8000	152302165	-4000	4000	2763
chr1	45489866	45497866	45494998	8000	45493866	-4000	4000	1132
chr1	145887208	145895208	145892691	8000	145891208	-4000	4000	1483
chr1	145988435	145996435	145993540	8000	145992435	-4000	4000	1105
chr1	212622775	212630775	212625427	8000	212626775	-4000	4000	-1348
chr1	233381148	233389148	233382458	8000	233385148	-4000	4000	-2690
chr1	147752199	147760199	147758535	8000	147756199	-4000	4000	2336
chr1	40247684	40255684	40251622	8000	40251684	-4000	4000	-62
chr1	152080141	152088141	152086979	8000	152084141	-4000	4000	2838
chr1	207014522	207022522	207022092	8000	207018522	-4000	4000	3570
chr1	47145727	47153727	47145900	8000	47149727	-4000	4000	-3827
chr1	44846522	44854522	44850876	8000	44850522	-4000	4000	354
chr1	27662064	27670064	27669338	8000	27666064	-4000	4000	3274
chr1	77084989	77092989	77092238	8000	77088989	-4000	4000	3249
chr1	115281904	115289904	115286435	8000	115285904	-4000	4000	531
chr1	147752199	147760199	147758473	8000	147756199	-4000	4000	2274
chr1	160086563	160094563	160093893	8000	160090563	-4000	4000	3330
chr1	244836638	244844638	244842286	8000	244840638	-4000	4000	1648
chr1	247666812	247674812	247672291	8000	247670812	-4000	4000	1479
chr1	228403935	228411935	228408508	8000	228407935	-4000	4000	573
chr1	3018903	3026903	3022445	8000	3022903	-4000	4000	-458
chr1	171113819	171121819	171117418	8000	171117819	-4000	4000	-401
chr1	223105404	223113404	223112008	8000	223109404	-4000	4000	2604
chr1	150991634	150999634	150997334	8000	150995634	-4000	4000	1700
chr1	26425728	26433728	26426301	8000	26429728	-4000	4000	-3427
chr1	145988435	145996435	145993822	8000	145992435	-4000	4000	1387
chr1	91256766	91264766	91262250	8000	91260766	-4000	4000	1484
chr1	243120428	243128428	243126574	8000	243124428	-4000	4000	2146
chr1	35111859	35119859	35115317	8000	35115859	-4000	4000	-542
chr1	223105404	223113404	223112900	8000	223109404	-4000	4000	3496
chr1	248404020	248412020	248406515	8000	248408020	-4000	4000	-1505
chr1	241991490	241999490	241996060	8000	241995490	-4000	4000	570
chr1	12773906	12781906	12777340	8000	12777906	-4000	4000	-566
chr1	248097103	248105103	248099632	8000	248101103	-4000	4000	-1471
chr1	13111488	13119488	13115870	8000	13115488	-4000	4000	382
chr1	13388629	13396629	13390462	8000	13392629	-4000	4000	-2167
chr1	231351023	231359023	231351344	8000	231355023	-4000	4000	-3679
chr1	247445108	247453108	247451271	8000	247449108	-4000	4000	2163
chr1	13337892	13345892	13344599	8000	13341892	-4000	4000	2707
chr1	74022015	74030015	74026684	8000	74026015	-4000	4000	669
chr1	172607833	172615833	172610396	8000	172611833	-4000	4000	-1437
chr1	247962386	247970386	247965464	8000	247966386	-4000	4000	-922
chr1	159584865	159592865	159587959	8000	159588865	-4000	4000	-906
chr1	171281978	171289978	171282244	8000	171285978	-4000	4000	-3734
chr1	108805523	108813523	108809131	8000	108809523	-4000	4000	-392
chr1	228102679	228110679	228107865	8000	228106679	-4000	4000	1186
chr1	157826911	157834911	157833464	8000	157830911	-4000	4000	2553
chr1	172607833	172615833	172610033	8000	172611833	-4000	4000	-1800
chr1	209609939	209617939	209617542	8000	209613939	-4000	4000	3603
chr1	153977617	153985617	153982426	8000	153981617	-4000	4000	809
chr1	209781617	209789617	209782867	8000	209785617	-4000	4000	-2750
chr1	36084275	36092275	36091640	8000	36088275	-4000	4000	3365
chr1	155082807	155090807	155086499	8000	155086807	-4000	4000	-308
chr1	206924522	206932522	206930412	8000	206928522	-4000	4000	1890
chr1	158394522	158402522	158398573	8000	158398522	-4000	4000	51
chr1	43277877	43285877	43282361	8000	43281877	-4000	4000	484
chr1	66775047	66783047	66777659	8000	66779047	-4000	4000	-1388
chr1	66775047	66783047	66777660	8000	66779047	-4000	4000	-1387
chr1	192576024	192584024	192578631	8000	192580024	-4000	4000	-1393
chr1	244836638	244844638	244842417	8000	244840638	-4000	4000	1779
chr1	247573690	247581690	247574247	8000	247577690	-4000	4000	-3443
chr1	17280233	17288233	17280368	8000	17284233	-4000	4000	-3865
chr1	160750821	160758821	160753117	8000	160754821	-4000	4000	-1704
chr1	247602515	247610515	247605650	8000	247606515	-4000	4000	-865
chr1	247876138	247884138	247876267	8000	247880138	-4000	4000	-3871
chr1	248586487	248594487	248593469	8000	248590487	-4000	4000	2982
chr1	70249052	70257052	70250505	8000	70253052	-4000	4000	-2547
chr1	158414210	158422210	158420557	8000	158418210	-4000	4000	2347
chr1	52344671	52352671	52346100	8000	52348671	-4000	4000	-2571
chr1	78885764	78893764	78893131	8000	78889764	-4000	4000	3367
chr1	196914713	196922713	196915097	8000	196918713	-4000	4000	-3616
chr1	28143166	28151166	28150839	8000	28147166	-4000	4000	3673
chr1	32682211	32690211	32684391	8000	32686211	-4000	4000	-1820
chr1	200173420	200181420	200174022	8000	200177420	-4000	4000	-3398
chr1	11022523	11030523	11026750	8000	11026523	-4000	4000	227
chr1	12205228	12213228	12206933	8000	12209228	-4000	4000	-2295
chr1	16193854	16201854	16199250	8000	16197854	-4000	4000	1396
chr1	17062761	17070761	17069093	8000	17066761	-4000	4000	2332
chr1	27332400	27340400	27334024	8000	27336400	-4000	4000	-2376
chr1	27391814	27399814	27394765	8000	27395814	-4000	4000	-1049
chr1	27608064	27616064	27613017	8000	27612064	-4000	4000	953
chr1	42426329	42434329	42430649	8000	42430329	-4000	4000	320
chr1	43379917	43387917	43384437	8000	43383917	-4000	4000	520
chr1	46925177	46933177	46932821	8000	46929177	-4000	4000	3644
chr1	64829229	64837229	64834635	8000	64833229	-4000	4000	1406
chr1	94525173	94533173	94530413	8000	94529173	-4000	4000	1240
chr1	101239713	101247713	101239714	8000	101243713	-4000	4000	-3999
chr1	110513217	110521217	110517225	8000	110517217	-4000	4000	8
chr1	113890194	113898194	113897923	8000	113894194	-4000	4000	3729
chr1	113910086	113918086	113911196	8000	113914086	-4000	4000	-2890
chr1	113973869	113981869	113979424	8000	113977869	-4000	4000	1555
chr1	115281904	115289904	115285953	8000	115285904	-4000	4000	49
chr1	119390130	119398130	119393843	8000	119394130	-4000	4000	-287
chr1	147905269	147913269	147908288	8000	147909269	-4000	4000	-981
chr1	149880459	149888459	149886247	8000	149884459	-4000	4000	1788
chr1	149924651	149932651	149931299	8000	149928651	-4000	4000	2648
chr1	152672569	152680569	152676008	8000	152676569	-4000	4000	-561
chr1	153977617	153985617	153982047	8000	153981617	-4000	4000	430
chr1	154940076	154948076	154945841	8000	154944076	-4000	4000	1765
chr1	155251979	155259979	155254664	8000	155255979	-4000	4000	-1315
chr1	155942851	155950851	155950413	8000	155946851	-4000	4000	3562
chr1	159058484	159066484	159063507	8000	159062484	-4000	4000	1023
chr1	160139591	160147591	160139946	8000	160143591	-4000	4000	-3645
chr1	161619196	161627196	161624381	8000	161623196	-4000	4000	1185
chr1	185287781	185295781	185290780	8000	185291781	-4000	4000	-1001
chr1	190093658	190101658	190097973	8000	190097658	-4000	4000	315
chr1	209781617	209789617	209788316	8000	209785617	-4000	4000	2699
chr1	219208865	219216865	219211702	8000	219212865	-4000	4000	-1163
chr1	222664007	222672007	222669803	8000	222668007	-4000	4000	1796
chr1	229426365	229434365	229432364	8000	229430365	-4000	4000	1999
chr1	230996733	231004733	230997227	8000	231000733	-4000	4000	-3506
chr1	231351023	231359023	231351394	8000	231355023	-4000	4000	-3629
chr1	235444952	235452952	235450026	8000	235448952	-4000	4000	1074
chr1	245123164	245131164	245123686	8000	245127164	-4000	4000	-3478
chr1	247602515	247610515	247606356	8000	247606515	-4000	4000	-159
chr1	248345713	248353713	248349630	8000	248349713	-4000	4000	-83
chr1	40236921	40244921	40237308	8000	40240921	-4000	4000	-3613
chr1	41474775	41482775	41482547	8000	41478775	-4000	4000	3772
chr1	95243225	95251225	95244478	8000	95247225	-4000	4000	-2747
chr1	165396922	165404922	165401329	8000	165400922	-4000	4000	407
chr1	43619666	43627666	43620841	8000	43623666	-4000	4000	-2825
chr1	11102535	11110535	11108184	8000	11106535	-4000	4000	1649
chr1	156664763	156672763	156670482	8000	156668763	-4000	4000	1719
chr1	152907886	152915886	152911229	8000	152911886	-4000	4000	-657
chr1	232805929	232813929	232807066	8000	232809929	-4000	4000	-2863
chr1	247810660	247818660	247815024	8000	247814660	-4000	4000	364
chr1	203336628	203344628	203342235	8000	203340628	-4000	4000	1607
chr1	12857909	12865909	12859773	8000	12861909	-4000	4000	-2136
chr1	13111488	13119488	13116462	8000	13115488	-4000	4000	974
chr1	13277035	13285035	13281662	8000	13281035	-4000	4000	627
chr1	46312776	46320776	46316767	8000	46316776	-4000	4000	-9
chr1	100079563	100087563	100082000	8000	100083563	-4000	4000	-1563
chr1	150503602	150511602	150505643	8000	150507602	-4000	4000	-1959
chr1	152784426	152792426	152787421	8000	152788426	-4000	4000	-1005
chr1	158254269	158262269	158255321	8000	158258269	-4000	4000	-2948
chr1	168071843	168079843	168075379	8000	168075843	-4000	4000	-464
chr1	186307652	186315652	186313785	8000	186311652	-4000	4000	2133
chr1	12916482	12924482	12917834	8000	12920482	-4000	4000	-2648
chr1	13337892	13345892	13342617	8000	13341892	-4000	4000	725
chr1	41474775	41482775	41479372	8000	41478775	-4000	4000	597
chr1	99305590	99313590	99305972	8000	99309590	-4000	4000	-3618
chr1	158540550	158548550	158547897	8000	158544550	-4000	4000	3347
chr1	196914713	196922713	196918371	8000	196918713	-4000	4000	-342
chr1	209781617	209789617	209788282	8000	209785617	-4000	4000	2665
chr1	39030636	39038636	39034400	8000	39034636	-4000	4000	-236
chr1	161522894	161530894	161526342	8000	161526894	-4000	4000	-552
chr1	202957873	202965873	202962549	8000	202961873	-4000	4000	676
chr1	248487113	248495113	248488850	8000	248491113	-4000	4000	-2263
chr1	152208076	152216076	152213312	8000	152212076	-4000	4000	1236
chr1	156289185	156297185	156294150	8000	156293185	-4000	4000	965
chr1	248059407	248067407	248061003	8000	248063407	-4000	4000	-2404
chr1	162369203	162377203	162373751	8000	162373203	-4000	4000	548
chr1	206924522	206932522	206931520	8000	206928522	-4000	4000	2998
chr1	215233090	215241090	215235026	8000	215237090	-4000	4000	-2064
chr1	222518258	222526258	222522582	8000	222522258	-4000	4000	324
chr1	1698379	1706379	1703847	8000	1702379	-4000	4000	1468
chr1	19676966	19684966	19682530	8000	19680966	-4000	4000	1564
chr1	19810029	19818029	19814795	8000	19814029	-4000	4000	766
chr1	46184683	46192683	46190784	8000	46188683	-4000	4000	2101
chr1	150261078	150269078	150261520	8000	150265078	-4000	4000	-3558
chr1	154271875	154279875	154275636	8000	154275875	-4000	4000	-239
chr1	161161723	161169723	161168125	8000	161165723	-4000	4000	2402
chr1	171113819	171121819	171114038	8000	171117819	-4000	4000	-3781
chr1	211567568	211575568	211575481	8000	211571568	-4000	4000	3913
chr1	247585313	247593313	247588902	8000	247589313	-4000	4000	-411
chr1	40236921	40244921	40240106	8000	40240921	-4000	4000	-815
chr1	43964022	43972022	43970266	8000	43968022	-4000	4000	2244
chr1	158770222	158778222	158777005	8000	158774222	-4000	4000	2783
chr1	53210197	53218197	53210834	8000	53214197	-4000	4000	-3363
chr1	68424822	68432822	68429829	8000	68428822	-4000	4000	1007
chr1	116066054	116074054	116067188	8000	116070054	-4000	4000	-2866
chr1	156664763	156672763	156669526	8000	156668763	-4000	4000	763
chr1	156664763	156672763	156671814	8000	156668763	-4000	4000	3051
chr1	156664763	156672763	156671913	8000	156668763	-4000	4000	3150
chr1	158556606	158564606	158562789	8000	158560606	-4000	4000	2183
chr1	179687272	179695272	179690846	8000	179691272	-4000	4000	-426
chr1	224189441	224197441	224190314	8000	224193441	-4000	4000	-3127
chr1	94525173	94533173	94530436	8000	94529173	-4000	4000	1263
chr1	152683397	152691397	152686892	8000	152687397	-4000	4000	-505
chr1	247919152	247927152	247921113	8000	247923152	-4000	4000	-2039
chr1	3018903	3026903	3021531	8000	3022903	-4000	4000	-1372
chr1	64177498	64185498	64177620	8000	64181498	-4000	4000	-3878
chr1	119419035	119427035	119422220	8000	119423035	-4000	4000	-815
chr1	78885764	78893764	78891642	8000	78889764	-4000	4000	1878
chr1	111474512	111482512	111478146	8000	111478512	-4000	4000	-366
chr1	20614903	20622903	20618548	8000	20618903	-4000	4000	-355
chr1	53210197	53218197	53210297	8000	53214197	-4000	4000	-3900
chr1	13259314	13267314	13260504	8000	13263314	-4000	4000	-2810
chr1	152344735	152352735	152352516	8000	152348735	-4000	4000	3781
chr1	23080030	23088030	23083363	8000	23084030	-4000	4000	-667
chr1	109271751	109279751	109274629	8000	109275751	-4000	4000	-1122
chr1	119615377	119623377	119623040	8000	119619377	-4000	4000	3663
chr1	119419035	119427035	119419573	8000	119423035	-4000	4000	-3462
chr1	161035251	161043251	161039881	8000	161039251	-4000	4000	630
chr1	154544147	154552147	154544931	8000	154548147	-4000	4000	-3216
chr1	89384160	89392160	89385335	8000	89388160	-4000	4000	-2825
chr1	113681923	113689923	113683509	8000	113685923	-4000	4000	-2414
chr1	155165409	155173409	155172864	8000	155169409	-4000	4000	3455
chr1	161161723	161169723	161163559	8000	161165723	-4000	4000	-2164
chr1	46039661	46047661	46043467	8000	46043661	-4000	4000	-194
chr1	248846006	248854006	248847470	8000	248850006	-4000	4000	-2536
chr1	37797137	37805137	37803949	8000	37801137	-4000	4000	2812
chr1	26032464	26040464	26036224	8000	26036464	-4000	4000	-240
chr1	158353553	158361553	158356587	8000	158357553	-4000	4000	-966
chr1	159439078	159447078	159440039	8000	159443078	-4000	4000	-3039
chr1	152881047	152889047	152884684	8000	152885047	-4000	4000	-363
chr1	12857909	12865909	12860056	8000	12861909	-4000	4000	-1853
chr1	62450298	62458298	62457586	8000	62454298	-4000	4000	3288
chr1	158353553	158361553	158354403	8000	158357553	-4000	4000	-3150
chr1	168578069	168586069	168581118	8000	168582069	-4000	4000	-951
chr1	232805929	232813929	232807803	8000	232809929	-4000	4000	-2126
chr1	228096726	228104726	228097913	8000	228100726	-4000	4000	-2813
chr1	39759914	39767914	39763166	8000	39763914	-4000	4000	-748
chr1	119419035	119427035	119422558	8000	119423035	-4000	4000	-477
chr1	145973811	145981811	145978551	8000	145977811	-4000	4000	740
chr1	155165409	155173409	155172759	8000	155169409	-4000	4000	3350
chr1	156208796	156216796	156210243	8000	156212796	-4000	4000	-2553
chr1	169128531	169136531	169132241	8000	169132531	-4000	4000	-290
chr1	182050570	182058570	182056428	8000	182054570	-4000	4000	1858
chr1	247892531	247900531	247895688	8000	247896531	-4000	4000	-843
chr1	152999856	153007856	153003620	8000	153003856	-4000	4000	-236
chr1	201888587	201896587	201889605	8000	201892587	-4000	4000	-2982
chr1	247095962	247103962	247100504	8000	247099962	-4000	4000	542
chr1	26277328	26285328	26284359	8000	26281328	-4000	4000	3031
chr1	66370579	66378579	66372332	8000	66374579	-4000	4000	-2247
chr1	169850080	169858080	169854727	8000	169854080	-4000	4000	647
chr1	245745342	245753342	245749633	8000	245749342	-4000	4000	291
chr1	111181104	111189104	111182208	8000	111185104	-4000	4000	-2896
chr1	46925177	46933177	46930049	8000	46929177	-4000	4000	872
chr1	152999856	153007856	153003422	8000	153003856	-4000	4000	-434
chr1	155893808	155901808	155900438	8000	155897808	-4000	4000	2630
chr1	1414420	1422420	1420868	8000	1418420	-4000	4000	2448
chr1	23553926	23561926	23559051	8000	23557926	-4000	4000	1125
chr1	44811585	44819585	44813470	8000	44815585	-4000	4000	-2115
chr1	66793740	66801740	66798108	8000	66797740	-4000	4000	368
chr1	66984619	66992619	66984625	8000	66988619	-4000	4000	-3994
chr1	116066054	116074054	116067088	8000	116070054	-4000	4000	-2966
chr1	158353553	158361553	158356842	8000	158357553	-4000	4000	-711
chr1	167048836	167056836	167055758	8000	167052836	-4000	4000	2922
chr1	158290774	158298774	158291256	8000	158294774	-4000	4000	-3518
chr1	248358627	248366627	248362046	8000	248362627	-4000	4000	-581
chr1	40544167	40552167	40546659	8000	40548167	-4000	4000	-1508
chr1	109705551	109713551	109713281	8000	109709551	-4000	4000	3730
chr1	116066054	116074054	116067203	8000	116070054	-4000	4000	-2851
chr1	119889533	119897533	119895991	8000	119893533	-4000	4000	2458
chr1	158606704	158614704	158611255	8000	158610704	-4000	4000	551
chr1	159830474	159838474	159833001	8000	159834474	-4000	4000	-1473
chr1	160872540	160880540	160876634	8000	160876540	-4000	4000	94
chr1	171634799	171642799	171636125	8000	171638799	-4000	4000	-2674
chr1	36411827	36419827	36418099	8000	36415827	-4000	4000	2272
chr1	64177498	64185498	64177875	8000	64181498	-4000	4000	-3623
chr1	147905269	147913269	147909119	8000	147909269	-4000	4000	-150
chr1	152660659	152668659	152664341	8000	152664659	-4000	4000	-318
chr1	206460436	206468436	206461043	8000	206464436	-4000	4000	-3393
chr1	247876138	247884138	247876600	8000	247880138	-4000	4000	-3538
chr1	20551020	20559020	20553094	8000	20555020	-4000	4000	-1926
chr1	66775047	66783047	66777383	8000	66779047	-4000	4000	-1664
chr1	85245953	85253953	85252530	8000	85249953	-4000	4000	2577
chr1	152149595	152157595	152156527	8000	152153595	-4000	4000	2932
chr1	158394522	158402522	158399319	8000	158398522	-4000	4000	797
chr1	247095962	247103962	247102092	8000	247099962	-4000	4000	2130
chr1	12205228	12213228	12206895	8000	12209228	-4000	4000	-2333
chr1	24052035	24060035	24057266	8000	24056035	-4000	4000	1231
chr1	152149595	152157595	152156123	8000	152153595	-4000	4000	2528
chr1	159584865	159592865	159588521	8000	159588865	-4000	4000	-344
chr1	152149595	152157595	152154971	8000	152153595	-4000	4000	1376
chr1	179094023	179102023	179095330	8000	179098023	-4000	4000	-2693
chr1	155165409	155173409	155173207	8000	155169409	-4000	4000	3798
chr1	155893808	155901808	155899476	8000	155897808	-4000	4000	1668
chr1	161710352	161718352	161710877	8000	161714352	-4000	4000	-3475
chr1	158476936	158484936	158480047	8000	158480936	-4000	4000	-889
chr1	158606704	158614704	158607000	8000	158610704	-4000	4000	-3704
chr1	78885764	78893764	78891528	8000	78889764	-4000	4000	1764
chr1	151534692	151542692	151536870	8000	151538692	-4000	4000	-1822
chr1	152149595	152157595	152154515	8000	152153595	-4000	4000	920
chr1	154940076	154948076	154944877	8000	154944076	-4000	4000	801
chr1	158290774	158298774	158291337	8000	158294774	-4000	4000	-3437
chr1	160182980	160190980	160186305	8000	160186980	-4000	4000	-675
chr1	190093658	190101658	190098870	8000	190097658	-4000	4000	1212
chr1	196828189	196836189	196830546	8000	196832189	-4000	4000	-1643
chr1	244053476	244061476	244054286	8000	244057476	-4000	4000	-3190
chr1	114991370	114999370	114995058	8000	114995370	-4000	4000	-312
chr1	196828189	196836189	196831911	8000	196832189	-4000	4000	-278
chr1	205763986	205771986	205770734	8000	205767986	-4000	4000	2748
chr1	223391465	223399465	223395119	8000	223395465	-4000	4000	-346
chr1	225395292	225403292	225399135	8000	225399292	-4000	4000	-157
chr1	42426329	42434329	42433211	8000	42430329	-4000	4000	2882
chr1	248569801	248577801	248574683	8000	248573801	-4000	4000	882
chr1	228403935	228411935	228409187	8000	228407935	-4000	4000	1252
chr1	15737392	15745392	15743152	8000	15741392	-4000	4000	1760
chr1	19211660	19219660	19219429	8000	19215660	-4000	4000	3769
chr1	42729093	42737093	42735132	8000	42733093	-4000	4000	2039
chr1	152907886	152915886	152910865	8000	152911886	-4000	4000	-1021
chr1	157826911	157834911	157834632	8000	157830911	-4000	4000	3721
chr1	161724143	161732143	161727490	8000	161728143	-4000	4000	-653
chr1	248177067	248185067	248180557	8000	248181067	-4000	4000	-510
chr1	207014522	207022522	207021982	8000	207018522	-4000	4000	3460
chr1	23553926	23561926	23558041	8000	23557926	-4000	4000	115
chr1	52086716	52094716	52086935	8000	52090716	-4000	4000	-3781
chr1	156459727	156467727	156464385	8000	156463727	-4000	4000	658
chr1	160750821	160758821	160753226	8000	160754821	-4000	4000	-1595
chr1	206102936	206110936	206110247	8000	206106936	-4000	4000	3311
chr1	40544167	40552167	40547166	8000	40548167	-4000	4000	-1001
chr1	206953965	206961965	206960571	8000	206957965	-4000	4000	2606
chr1	209609939	209617939	209611479	8000	209613939	-4000	4000	-2460
chr1	156912429	156920429	156914022	8000	156916429	-4000	4000	-2407
chr1	205653851	205661851	205659259	8000	205657851	-4000	4000	1408
chr1	156664763	156672763	156671923	8000	156668763	-4000	4000	3160
chr1	158414210	158422210	158420212	8000	158418210	-4000	4000	2002
chr1	197149682	197157682	197155458	8000	197153682	-4000	4000	1776
chr1	13821079	13829079	13824233	8000	13825079	-4000	4000	-846
chr1	149809225	149817225	149813312	8000	149813225	-4000	4000	87
chr1	149809225	149817225	149813313	8000	149813225	-4000	4000	88
chr1	152208076	152216076	152213081	8000	152212076	-4000	4000	1005
chr1	192576024	192584024	192579205	8000	192580024	-4000	4000	-819
chr1	161979192	161987192	161984861	8000	161983192	-4000	4000	1669
chr1	158556606	158564606	158563187	8000	158560606	-4000	4000	2581
chr1	113681923	113689923	113683350	8000	113685923	-4000	4000	-2573
chr1	163072802	163080802	163074780	8000	163076802	-4000	4000	-2022
chr1	114669090	114677090	114674772	8000	114673090	-4000	4000	1682
chr1	147905269	147913269	147908573	8000	147909269	-4000	4000	-696
chr1	19916009	19924009	19923541	8000	19920009	-4000	4000	3532
chr1	66775047	66783047	66777253	8000	66779047	-4000	4000	-1794
chr1	156136081	156144081	156137705	8000	156140081	-4000	4000	-2376
chr1	75783575	75791575	75786236	8000	75787575	-4000	4000	-1339
chr1	112907847	112915847	112914109	8000	112911847	-4000	4000	2262
chr1	153035732	153043732	153040321	8000	153039732	-4000	4000	589
chr1	160086563	160094563	160092313	8000	160090563	-4000	4000	1750
chr1	178544602	178552602	178545848	8000	178548602	-4000	4000	-2754
chr1	36176849	36184849	36180061	8000	36180849	-4000	4000	-788
chr1	89384160	89392160	89384229	8000	89388160	-4000	4000	-3931
chr1	223001995	223009995	223004267	8000	223005995	-4000	4000	-1728
chr1	247445108	247453108	247451945	8000	247449108	-4000	4000	2837
chr1	7841177	7849177	7842877	8000	7845177	-4000	4000	-2300
chr1	153326120	153334120	153330717	8000	153330120	-4000	4000	597
chr1	244836638	244844638	244843144	8000	244840638	-4000	4000	2506
chr1	247810660	247818660	247815630	8000	247814660	-4000	4000	970
chr1	248677249	248685249	248681813	8000	248681249	-4000	4000	564
chr1	155942851	155950851	155947921	8000	155946851	-4000	4000	1070
chr1	157826911	157834911	157834727	8000	157830911	-4000	4000	3816
chr1	193086866	193094866	193091678	8000	193090866	-4000	4000	812
chr1	216499246	216507246	216504570	8000	216503246	-4000	4000	1324
chr1	13613957	13621957	13615958	8000	13617957	-4000	4000	-1999
chr1	248404020	248412020	248406139	8000	248408020	-4000	4000	-1881
chr1	152298165	152306165	152305933	8000	152302165	-4000	4000	3768
chr1	247095962	247103962	247100384	8000	247099962	-4000	4000	422
chr1	23692835	23700835	23696006	8000	23696835	-4000	4000	-829
chr1	150642230	150650230	150648726	8000	150646230	-4000	4000	2496
chr1	151796264	151804264	151801269	8000	151800264	-4000	4000	1005
chr1	152149595	152157595	152156764	8000	152153595	-4000	4000	3169
chr1	152575381	152583381	152579622	8000	152579381	-4000	4000	241
chr1	156289185	156297185	156294473	8000	156293185	-4000	4000	1288
chr1	17397699	17405699	17401461	8000	17401699	-4000	4000	-238
chr1	21481005	21489005	21483362	8000	21485005	-4000	4000	-1643
chr1	46628737	46636737	46635482	8000	46632737	-4000	4000	2745
chr1	158394522	158402522	158399046	8000	158398522	-4000	4000	524
chr1	171281978	171289978	171282194	8000	171285978	-4000	4000	-3784
chr1	12857909	12865909	12861256	8000	12861909	-4000	4000	-653
chr1	54752898	54760898	54759031	8000	54756898	-4000	4000	2133
chr1	171634799	171642799	171635859	8000	171638799	-4000	4000	-2940
chr1	223001995	223009995	223003054	8000	223005995	-4000	4000	-2941
chr1	152298165	152306165	152304617	8000	152302165	-4000	4000	2452
chr1	156289185	156297185	156294134	8000	156293185	-4000	4000	949
chr1	13304907	13312907	13306873	8000	13308907	-4000	4000	-2034
chr1	247810660	247818660	247815478	8000	247814660	-4000	4000	818
chr1	54845627	54853627	54852163	8000	54849627	-4000	4000	2536
chr1	152102317	152110317	152109832	8000	152106317	-4000	4000	3515
chr1	152405243	152413243	152409688	8000	152409243	-4000	4000	445
chr1	160182980	160190980	160190846	8000	160186980	-4000	4000	3866
chr1	205079129	205087129	205084414	8000	205083129	-4000	4000	1285
chr1	222664007	222672007	222670228	8000	222668007	-4000	4000	2221
chr1	43277877	43285877	43283069	8000	43281877	-4000	4000	1192
chr1	109705551	109713551	109713174	8000	109709551	-4000	4000	3623
chr1	113973869	113981869	113980400	8000	113977869	-4000	4000	2531
chr1	114669090	114677090	114673963	8000	114673090	-4000	4000	873
chr1	118879046	118887046	118884776	8000	118883046	-4000	4000	1730
chr1	118879046	118887046	118885381	8000	118883046	-4000	4000	2335
chr1	156583719	156591719	156585770	8000	156587719	-4000	4000	-1949
chr1	160826160	160834160	160831361	8000	160830160	-4000	4000	1201
chr1	161042946	161050946	161048554	8000	161046946	-4000	4000	1608
chr1	248470307	248478307	248473564	8000	248474307	-4000	4000	-743
chr1	152672569	152680569	152676052	8000	152676569	-4000	4000	-517
chr1	23355448	23363448	23362983	8000	23359448	-4000	4000	3535
chr1	25358249	25366249	25360770	8000	25362249	-4000	4000	-1479
chr1	100538021	100546021	100539143	8000	100542021	-4000	4000	-2878
chr1	145973811	145981811	145977505	8000	145977811	-4000	4000	-306
chr1	147989592	147997592	147994173	8000	147993592	-4000	4000	581
chr1	152149595	152157595	152155632	8000	152153595	-4000	4000	2037
chr1	169850080	169858080	169855905	8000	169854080	-4000	4000	1825
chr1	231273973	231281973	231275308	8000	231277973	-4000	4000	-2665
chr1	203772372	203780372	203773928	8000	203776372	-4000	4000	-2444
chr1	31625866	31633866	31633252	8000	31629866	-4000	4000	3386
chr1	117949590	117957590	117952002	8000	117953590	-4000	4000	-1588
chr1	150509789	150517789	150510064	8000	150513789	-4000	4000	-3725
chr1	152080141	152088141	152086088	8000	152084141	-4000	4000	1947
chr1	248619557	248627557	248626480	8000	248623557	-4000	4000	2923
chr1	92242402	92250402	92245759	8000	92246402	-4000	4000	-643
chr1	39765523	39773523	39769904	8000	39769523	-4000	4000	381
chr1	46184683	46192683	46185584	8000	46188683	-4000	4000	-3099
chr1	92469043	92477043	92475953	8000	92473043	-4000	4000	2910
chr1	205138505	205146505	205143705	8000	205142505	-4000	4000	1200
chr1	230278122	230286122	230279384	8000	230282122	-4000	4000	-2738
chr1	2317253	2325253	2321445	8000	2321253	-4000	4000	192
chr1	39619435	39627435	39626957	8000	39623435	-4000	4000	3522
chr1	44811585	44819585	44813198	8000	44815585	-4000	4000	-2387
chr1	54752898	54760898	54758711	8000	54756898	-4000	4000	1813
chr1	150694060	150702060	150698704	8000	150698060	-4000	4000	644
chr1	152102317	152110317	152107693	8000	152106317	-4000	4000	1376
chr1	152102317	152110317	152108131	8000	152106317	-4000	4000	1814
chr1	152344735	152352735	152352096	8000	152348735	-4000	4000	3361
chr1	155134857	155142857	155140176	8000	155138857	-4000	4000	1319
chr1	159439078	159447078	159440709	8000	159443078	-4000	4000	-2369
chr1	161096346	161104346	161100107	8000	161100346	-4000	4000	-239
chr1	161724143	161732143	161725997	8000	161728143	-4000	4000	-2146
chr1	179550735	179558735	179551367	8000	179554735	-4000	4000	-3368
chr1	209781617	209789617	209783376	8000	209785617	-4000	4000	-2241
chr1	212622775	212630775	212625412	8000	212626775	-4000	4000	-1363
chr1	234320511	234328511	234323123	8000	234324511	-4000	4000	-1388
chr1	248097103	248105103	248099903	8000	248101103	-4000	4000	-1200
chr1	67394724	67402724	67396343	8000	67398724	-4000	4000	-2381
chr1	155285293	155293293	155287215	8000	155289293	-4000	4000	-2078
chr1	207140972	207148972	207144592	8000	207144972	-4000	4000	-380
chr1	248387811	248395811	248388289	8000	248391811	-4000	4000	-3522
chr1	244404494	244412494	244408880	8000	244408494	-4000	4000	386
chr1	150805713	150813713	150811308	8000	150809713	-4000	4000	1595
chr1	196743504	196751504	196743511	8000	196747504	-4000	4000	-3993
chr1	11971538	11979538	11974738	8000	11975538	-4000	4000	-800
chr1	12857909	12865909	12859132	8000	12861909	-4000	4000	-2777
chr1	12875212	12883212	12883201	8000	12879212	-4000	4000	3989
chr1	13111488	13119488	13116396	8000	13115488	-4000	4000	908
chr1	13218705	13226705	13225901	8000	13222705	-4000	4000	3196
chr1	17823063	17831063	17823249	8000	17827063	-4000	4000	-3814
chr1	21592221	21600221	21599539	8000	21596221	-4000	4000	3318
chr1	43964022	43972022	43971096	8000	43968022	-4000	4000	3074
chr1	46184683	46192683	46185308	8000	46188683	-4000	4000	-3375
chr1	56714789	56722789	56719607	8000	56718789	-4000	4000	818
chr1	63321128	63329128	63323502	8000	63325128	-4000	4000	-1626
chr1	64177498	64185498	64178010	8000	64181498	-4000	4000	-3488
chr1	93862284	93870284	93869937	8000	93866284	-4000	4000	3653
chr1	115281904	115289904	115286682	8000	115285904	-4000	4000	778
chr1	115696021	115704021	115701341	8000	115700021	-4000	4000	1320
chr1	147752199	147760199	147758509	8000	147756199	-4000	4000	2310
chr1	147905269	147913269	147908135	8000	147909269	-4000	4000	-1134
chr1	149778689	149786689	149784156	8000	149782689	-4000	4000	1467
chr1	150304979	150312979	150308092	8000	150308979	-4000	4000	-887
chr1	152298165	152306165	152304010	8000	152302165	-4000	4000	1845
chr1	152405243	152413243	152409382	8000	152409243	-4000	4000	139
chr1	156304968	156312968	156309031	8000	156308968	-4000	4000	63
chr1	158353553	158361553	158356201	8000	158357553	-4000	4000	-1352
chr1	160424670	160432670	160425241	8000	160428670	-4000	4000	-3429
chr1	161979192	161987192	161983897	8000	161983192	-4000	4000	705
chr1	162369203	162377203	162374496	8000	162373203	-4000	4000	1293
chr1	170549834	170557834	170552671	8000	170553834	-4000	4000	-1163
chr1	205763986	205771986	205771499	8000	205767986	-4000	4000	3513
chr1	214660571	214668571	214663697	8000	214664571	-4000	4000	-874
chr1	220144041	220152041	220147845	8000	220148041	-4000	4000	-196
chr1	224189441	224197441	224189760	8000	224193441	-4000	4000	-3681
chr1	22599595	22607595	22602854	8000	22603595	-4000	4000	-741
chr1	160354952	160362952	160356333	8000	160358952	-4000	4000	-2619
chr1	200911742	200919742	200913672	8000	200915742	-4000	4000	-2070
chr1	149880459	149888459	149886147	8000	149884459	-4000	4000	1688
chr1	183241127	183249127	183243455	8000	183245127	-4000	4000	-1672
chr1	236760631	236768631	236761131	8000	236764631	-4000	4000	-3500
chr1	236760631	236768631	236762489	8000	236764631	-4000	4000	-2142
chr1	51283258	51291258	51288899	8000	51287258	-4000	4000	1641
chr1	149924651	149932651	149930750	8000	149928651	-4000	4000	2099
chr1	156929094	156937094	156935921	8000	156933094	-4000	4000	2827
chr1	205298063	205306063	205303451	8000	205302063	-4000	4000	1388
chr1	149809225	149817225	149812366	8000	149813225	-4000	4000	-859
chr1	152683397	152691397	152687193	8000	152687397	-4000	4000	-204
chr1	159051155	159059155	159053532	8000	159055155	-4000	4000	-1623
chr1	159531078	159539078	159535906	8000	159535078	-4000	4000	828
chr1	230686776	230694776	230691541	8000	230690776	-4000	4000	765
chr1	12857909	12865909	12859706	8000	12861909	-4000	4000	-2203
chr1	15730769	15738769	15731989	8000	15734769	-4000	4000	-2780
chr1	108218464	108226464	108223673	8000	108222464	-4000	4000	1209
chr1	119907553	119915553	119915238	8000	119911553	-4000	4000	3685
chr1	150503602	150511602	150509751	8000	150507602	-4000	4000	2149
chr1	150642230	150650230	150647802	8000	150646230	-4000	4000	1572
chr1	151360304	151368304	151366779	8000	151364304	-4000	4000	2475
chr1	152405243	152413243	152409631	8000	152409243	-4000	4000	388
chr1	152758052	152766052	152760698	8000	152762052	-4000	4000	-1354
chr1	153052120	153060120	153056437	8000	153056120	-4000	4000	317
chr1	160368846	160376846	160372643	8000	160372846	-4000	4000	-203
chr1	160993957	161001957	160997657	8000	160997957	-4000	4000	-300
chr1	200173420	200181420	200174250	8000	200177420	-4000	4000	-3170
chr1	216499246	216507246	216505640	8000	216503246	-4000	4000	2394
chr1	248038305	248046305	248038883	8000	248042305	-4000	4000	-3422
chr1	26472642	26480642	26474009	8000	26476642	-4000	4000	-2633
chr1	38020820	38028820	38023655	8000	38024820	-4000	4000	-1165
chr1	119419035	119427035	119422171	8000	119423035	-4000	4000	-864
chr1	152298165	152306165	152306096	8000	152302165	-4000	4000	3931
chr1	153977617	153985617	153982589	8000	153981617	-4000	4000	972
chr1	178544602	178552602	178545843	8000	178548602	-4000	4000	-2759
chr1	39891426	39899426	39897697	8000	39895426	-4000	4000	2271
chr1	74564117	74572117	74571389	8000	74568117	-4000	4000	3272
chr1	111458773	111466773	111460948	8000	111462773	-4000	4000	-1825
chr1	153977617	153985617	153981910	8000	153981617	-4000	4000	293
chr2	159767851	159775851	159771745	8000	159771851	-4000	4000	-106
chr2	10050836	10058836	10052353	8000	10054836	-4000	4000	-2483
chr2	1539711	1547711	1542470	8000	1543711	-4000	4000	-1241
chr2	31169056	31177056	31174657	8000	31173056	-4000	4000	1601
chr2	95382077	95390077	95385853	8000	95386077	-4000	4000	-224
chr2	98394601	98402601	98397126	8000	98398601	-4000	4000	-1475
chr2	108505415	108513415	108507688	8000	108509415	-4000	4000	-1727
chr2	210017421	210025421	210023065	8000	210021421	-4000	4000	1644
chr2	138012364	138020364	138014544	8000	138016364	-4000	4000	-1820
chr2	5697385	5705385	5698425	8000	5701385	-4000	4000	-2960
chr2	197564224	197572224	197572121	8000	197568224	-4000	4000	3897
chr2	184935492	184943492	184937401	8000	184939492	-4000	4000	-2091
chr2	15630346	15638346	15630778	8000	15634346	-4000	4000	-3568
chr2	23704611	23712611	23706502	8000	23708611	-4000	4000	-2109
chr2	28640142	28648142	28643117	8000	28644142	-4000	4000	-1025
chr2	86139932	86147932	86144411	8000	86143932	-4000	4000	479
chr2	127179832	127187832	127187265	8000	127183832	-4000	4000	3433
chr2	132642582	132650582	132645228	8000	132646582	-4000	4000	-1354
chr2	108261351	108269351	108265255	8000	108265351	-4000	4000	-96
chr2	127857630	127865630	127863256	8000	127861630	-4000	4000	1626
chr2	10566754	10574754	10571929	8000	10570754	-4000	4000	1175
chr2	26453203	26461203	26453345	8000	26457203	-4000	4000	-3858
chr2	30640225	30648225	30640652	8000	30644225	-4000	4000	-3573
chr2	63115559	63123559	63121831	8000	63119559	-4000	4000	2272
chr2	75648000	75656000	75652150	8000	75652000	-4000	4000	150
chr2	88109384	88117384	88110450	8000	88113384	-4000	4000	-2934
chr2	96180859	96188859	96186885	8000	96184859	-4000	4000	2026
chr2	136110349	136118349	136115496	8000	136114349	-4000	4000	1147
chr2	216098783	216106783	216099989	8000	216102783	-4000	4000	-2794
chr2	70291975	70299975	70297307	8000	70295975	-4000	4000	1332
chr2	197384515	197392515	197392145	8000	197388515	-4000	4000	3630
chr2	95180317	95188317	95182110	8000	95184317	-4000	4000	-2207
chr2	20244691	20252691	20251506	8000	20248691	-4000	4000	2815
chr2	26577205	26585205	26582830	8000	26581205	-4000	4000	1625
chr2	30156533	30164533	30158832	8000	30160533	-4000	4000	-1701
chr2	157410619	157418619	157416002	8000	157414619	-4000	4000	1383
chr2	191025576	191033576	191029716	8000	191029576	-4000	4000	140
chr2	1539711	1547711	1542642	8000	1543711	-4000	4000	-1069
chr2	219612451	219620451	219614533	8000	219616451	-4000	4000	-1918
chr2	73813147	73821147	73813769	8000	73817147	-4000	4000	-3378
chr2	108009994	108017994	108010904	8000	108013994	-4000	4000	-3090
chr2	169123109	169131109	169128551	8000	169127109	-4000	4000	1442
chr2	167255753	167263753	167259207	8000	167259753	-4000	4000	-546
chr2	219637980	219645980	219638782	8000	219641980	-4000	4000	-3198
chr2	19347485	19355485	19352288	8000	19351485	-4000	4000	803
chr2	31169056	31177056	31174621	8000	31173056	-4000	4000	1565
chr2	174425575	174433575	174427720	8000	174429575	-4000	4000	-1855
chr2	100992829	101000829	100995682	8000	100996829	-4000	4000	-1147
chr2	152645826	152653826	152647854	8000	152649826	-4000	4000	-1972
chr2	27578720	27586720	27581560	8000	27582720	-4000	4000	-1160
chr2	80644861	80652861	80647802	8000	80648861	-4000	4000	-1059
chr2	218364099	218372099	218367483	8000	218368099	-4000	4000	-616
chr2	218446251	218454251	218449377	8000	218450251	-4000	4000	-874
chr2	187337964	187345964	187345401	8000	187341964	-4000	4000	3437
chr2	43763987	43771987	43767043	8000	43767987	-4000	4000	-944
chr2	130135287	130143287	130142971	8000	130139287	-4000	4000	3684
chr2	165388310	165396310	165388796	8000	165392310	-4000	4000	-3514
chr2	37197612	37205612	37202104	8000	37201612	-4000	4000	492
chr2	106074155	106082155	106077885	8000	106078155	-4000	4000	-270
chr2	172078430	172086430	172080406	8000	172082430	-4000	4000	-2024
chr2	58155920	58163920	58159703	8000	58159920	-4000	4000	-217
chr2	96108876	96116876	96113902	8000	96112876	-4000	4000	1026
chr2	104854574	104862574	104856879	8000	104858574	-4000	4000	-1695
chr2	241223264	241231264	241230840	8000	241227264	-4000	4000	3576
chr2	227813564	227821564	227815477	8000	227817564	-4000	4000	-2087
chr2	79081023	79089023	79085140	8000	79085023	-4000	4000	117
chr2	102024544	102032544	102028236	8000	102028544	-4000	4000	-308
chr2	189873629	189881629	189877398	8000	189877629	-4000	4000	-231
chr2	74528258	74536258	74528935	8000	74532258	-4000	4000	-3323
chr2	37246502	37254502	37248327	8000	37250502	-4000	4000	-2175
chr2	26185663	26193663	26187551	8000	26189663	-4000	4000	-2112
chr2	135835626	135843626	135836899	8000	135839626	-4000	4000	-2727
chr2	173264015	173272015	173266081	8000	173268015	-4000	4000	-1934
chr2	218133251	218141251	218135734	8000	218137251	-4000	4000	-1517
chr2	27487883	27495883	27493936	8000	27491883	-4000	4000	2053
chr2	96701929	96709929	96707222	8000	96705929	-4000	4000	1293
chr2	240025491	240033491	240029284	8000	240029491	-4000	4000	-207
chr2	73286929	73294929	73291880	8000	73290929	-4000	4000	951
chr2	36547135	36555135	36549978	8000	36551135	-4000	4000	-1157
chr2	218958155	218966155	218961963	8000	218962155	-4000	4000	-192
chr2	84817650	84825650	84824026	8000	84821650	-4000	4000	2376
chr2	115841780	115849780	115844169	8000	115845780	-4000	4000	-1611
chr2	205794133	205802133	205794830	8000	205798133	-4000	4000	-3303
chr2	38063142	38071142	38071064	8000	38067142	-4000	4000	3922
chr2	38958206	38966206	38960062	8000	38962206	-4000	4000	-2144
chr2	88109384	88117384	88110480	8000	88113384	-4000	4000	-2904
chr2	18551545	18559545	18555624	8000	18555545	-4000	4000	79
chr2	138012364	138020364	138014237	8000	138016364	-4000	4000	-2127
chr2	219534772	219542772	219535261	8000	219538772	-4000	4000	-3511
chr2	84817650	84825650	84819446	8000	84821650	-4000	4000	-2204
chr2	131349709	131357709	131353057	8000	131353709	-4000	4000	-652
chr2	167255753	167263753	167258440	8000	167259753	-4000	4000	-1313
chr2	210017421	210025421	210020391	8000	210021421	-4000	4000	-1030
chr2	24766702	24774702	24768386	8000	24770702	-4000	4000	-2316
chr2	72888158	72896158	72888369	8000	72892158	-4000	4000	-3789
chr2	79119409	79127409	79121942	8000	79123409	-4000	4000	-1467
chr2	108683246	108691246	108683962	8000	108687246	-4000	4000	-3284
chr2	233769300	233777300	233772349	8000	233773300	-4000	4000	-951
chr2	172078430	172086430	172080169	8000	172082430	-4000	4000	-2261
chr2	205794133	205802133	205795011	8000	205798133	-4000	4000	-3122
chr2	197704395	197712395	197706553	8000	197708395	-4000	4000	-1842
chr2	67408089	67416089	67409921	8000	67412089	-4000	4000	-2168
chr2	73224010	73232010	73228380	8000	73228010	-4000	4000	370
chr2	171779405	171787405	171785159	8000	171783405	-4000	4000	1754
chr2	201476846	201484846	201477686	8000	201480846	-4000	4000	-3160
chr2	218086581	218094581	218089865	8000	218090581	-4000	4000	-716
chr2	96820526	96828526	96825159	8000	96824526	-4000	4000	633
chr2	230399732	230407732	230401347	8000	230403732	-4000	4000	-2385
chr2	10910225	10918225	10912850	8000	10914225	-4000	4000	-1375
chr2	20997429	21005429	21001975	8000	21001429	-4000	4000	546
chr2	27578720	27586720	27578958	8000	27582720	-4000	4000	-3762
chr2	68127238	68135238	68131393	8000	68131238	-4000	4000	155
chr2	96139169	96147169	96144259	8000	96143169	-4000	4000	1090
chr2	112025561	112033561	112028414	8000	112029561	-4000	4000	-1147
chr2	130187745	130195745	130191968	8000	130191745	-4000	4000	223
chr2	201616184	201624184	201618982	8000	201620184	-4000	4000	-1202
chr2	208117607	208125607	208121743	8000	208121607	-4000	4000	136
chr2	227679763	227687763	227687375	8000	227683763	-4000	4000	3612
chr2	113130016	113138016	113132687	8000	113134016	-4000	4000	-1329
chr2	219637980	219645980	219641890	8000	219641980	-4000	4000	-90
chr2	28640142	28648142	28642984	8000	28644142	-4000	4000	-1158
chr2	38781002	38789002	38781691	8000	38785002	-4000	4000	-3311
chr2	165388310	165396310	165388864	8000	165392310	-4000	4000	-3446
chr2	10423617	10431617	10426928	8000	10427617	-4000	4000	-689
chr2	73725104	73733104	73732238	8000	73729104	-4000	4000	3134
chr2	79119409	79127409	79123356	8000	79123409	-4000	4000	-53
chr2	130069535	130077535	130075376	8000	130073535	-4000	4000	1841
chr2	130187745	130195745	130195085	8000	130191745	-4000	4000	3340
chr2	189008746	189016746	189010212	8000	189012746	-4000	4000	-2534
chr2	237320003	237328003	237325567	8000	237324003	-4000	4000	1564
chr2	187460230	187468230	187467847	8000	187464230	-4000	4000	3617
chr2	218998846	219006846	219006196	8000	219002846	-4000	4000	3350
chr2	127425242	127433242	127428776	8000	127429242	-4000	4000	-466
chr2	166399573	166407573	166405681	8000	166403573	-4000	4000	2108
chr2	165388310	165396310	165389438	8000	165392310	-4000	4000	-2872
chr2	158678879	158686879	158680575	8000	158682879	-4000	4000	-2304
chr2	238148947	238156947	238149006	8000	238152947	-4000	4000	-3941
chr2	111116610	111124610	111117739	8000	111120610	-4000	4000	-2871
chr2	127857630	127865630	127865189	8000	127861630	-4000	4000	3559
chr2	42438017	42446017	42444341	8000	42442017	-4000	4000	2324
chr2	218158841	218166841	218164894	8000	218162841	-4000	4000	2053
chr2	27619217	27627217	27622885	8000	27623217	-4000	4000	-332
chr2	156320437	156328437	156326731	8000	156324437	-4000	4000	2294
chr2	157410619	157418619	157416092	8000	157414619	-4000	4000	1473
chr2	209730118	209738118	209734023	8000	209734118	-4000	4000	-95
chr2	3698671	3706671	3701595	8000	3702671	-4000	4000	-1076
chr2	219323407	219331407	219327416	8000	219327407	-4000	4000	9
chr2	73915865	73923865	73919524	8000	73919865	-4000	4000	-341
chr2	112025561	112033561	112028774	8000	112029561	-4000	4000	-787
chr2	178521989	178529989	178526793	8000	178525989	-4000	4000	804
chr2	10910225	10918225	10912914	8000	10914225	-4000	4000	-1311
chr2	121333776	121341776	121340870	8000	121337776	-4000	4000	3094
chr2	130187745	130195745	130194135	8000	130191745	-4000	4000	2390
chr2	113061382	113069382	113062150	8000	113065382	-4000	4000	-3232
chr2	48958157	48966157	48963378	8000	48962157	-4000	4000	1221
chr2	61183463	61191463	61190538	8000	61187463	-4000	4000	3075
chr2	19347485	19355485	19352344	8000	19351485	-4000	4000	859
chr2	27647511	27655511	27650898	8000	27651511	-4000	4000	-613
chr2	79153003	79161003	79157280	8000	79157003	-4000	4000	277
chr2	68941232	68949232	68946222	8000	68945232	-4000	4000	990
chr2	79081023	79089023	79086470	8000	79085023	-4000	4000	1447
chr2	74553883	74561883	74558858	8000	74557883	-4000	4000	975
chr2	96108876	96116876	96115101	8000	96112876	-4000	4000	2225
chr2	24815169	24823169	24817747	8000	24819169	-4000	4000	-1422
chr2	119435843	119443843	119437275	8000	119439843	-4000	4000	-2568
chr2	169808064	169816064	169812357	8000	169812064	-4000	4000	293
chr2	108305915	108313915	108308580	8000	108309915	-4000	4000	-1335
chr2	88552741	88560741	88558917	8000	88556741	-4000	4000	2176
chr2	24815169	24823169	24816663	8000	24819169	-4000	4000	-2506
chr2	27578720	27586720	27580547	8000	27582720	-4000	4000	-2173
chr2	38063142	38071142	38070910	8000	38067142	-4000	4000	3768
chr2	101890690	101898690	101891797	8000	101894690	-4000	4000	-2893
chr2	110633528	110641528	110641157	8000	110637528	-4000	4000	3629
chr2	236578354	236586354	236581042	8000	236582354	-4000	4000	-1312
chr2	30156533	30164533	30156656	8000	30160533	-4000	4000	-3877
chr2	54968025	54976025	54970337	8000	54972025	-4000	4000	-1688
chr2	54968025	54976025	54973128	8000	54972025	-4000	4000	1103
chr2	70145885	70153885	70150403	8000	70149885	-4000	4000	518
chr2	74104176	74112176	74106570	8000	74108176	-4000	4000	-1606
chr2	74104176	74112176	74108001	8000	74108176	-4000	4000	-175
chr2	96326517	96334517	96328231	8000	96330517	-4000	4000	-2286
chr2	99396475	99404475	99396818	8000	99400475	-4000	4000	-3657
chr2	135835626	135843626	135836654	8000	135839626	-4000	4000	-2972
chr2	169641425	169649425	169649278	8000	169645425	-4000	4000	3853
chr2	181531041	181539041	181535429	8000	181535041	-4000	4000	388
chr2	201476846	201484846	201480143	8000	201480846	-4000	4000	-703
chr2	219637980	219645980	219640927	8000	219641980	-4000	4000	-1053
chr2	231169116	231177116	231170605	8000	231173116	-4000	4000	-2511
chr2	238240044	238248044	238246473	8000	238244044	-4000	4000	2429
chr2	241869823	241877823	241869828	8000	241873823	-4000	4000	-3995
chr2	218342793	218350793	218346607	8000	218346793	-4000	4000	-186
chr2	42763089	42771089	42767624	8000	42767089	-4000	4000	535
chr2	214406501	214414501	214410319	8000	214410501	-4000	4000	-182
chr2	233031057	233039057	233034587	8000	233035057	-4000	4000	-470
chr2	174344022	174352022	174349152	8000	174348022	-4000	4000	1130
chr2	5697385	5705385	5698402	8000	5701385	-4000	4000	-2983
chr2	70291975	70299975	70293696	8000	70295975	-4000	4000	-2279
chr2	132642582	132650582	132645356	8000	132646582	-4000	4000	-1226
chr2	20997429	21005429	21003275	8000	21001429	-4000	4000	1846
chr2	74553883	74561883	74556465	8000	74557883	-4000	4000	-1418
chr2	130135287	130143287	130139896	8000	130139287	-4000	4000	609
chr2	172095438	172103438	172102498	8000	172099438	-4000	4000	3060
chr2	186761959	186769959	186762103	8000	186765959	-4000	4000	-3856
chr2	106387290	106395290	106391165	8000	106391290	-4000	4000	-125
chr2	174743592	174751592	174748036	8000	174747592	-4000	4000	444
chr2	79119409	79127409	79122912	8000	79123409	-4000	4000	-497
chr2	72938036	72946036	72944951	8000	72942036	-4000	4000	2915
chr2	222195887	222203887	222201934	8000	222199887	-4000	4000	2047
chr2	241671747	241679747	241676084	8000	241675747	-4000	4000	337
chr2	237809682	237817682	237813593	8000	237813682	-4000	4000	-89
chr2	15162914	15170914	15167310	8000	15166914	-4000	4000	396
chr2	118838171	118846171	118842241	8000	118842171	-4000	4000	70
chr2	127044027	127052027	127048411	8000	127048027	-4000	4000	384
chr2	112115318	112123318	112116163	8000	112119318	-4000	4000	-3155
chr2	159228659	159236659	159232263	8000	159232659	-4000	4000	-396
chr2	132642582	132650582	132645423	8000	132646582	-4000	4000	-1159
chr2	206110817	206118817	206116155	8000	206114817	-4000	4000	1338
chr2	173364997	173372997	173367761	8000	173368997	-4000	4000	-1236
chr2	66569869	66577869	66571357	8000	66573869	-4000	4000	-2512
chr2	95081369	95089369	95087492	8000	95085369	-4000	4000	2123
chr2	25156853	25164853	25161252	8000	25160853	-4000	4000	399
chr2	240135026	240143026	240140081	8000	240139026	-4000	4000	1055
chr2	16545459	16553459	16552743	8000	16549459	-4000	4000	3284
chr2	42763089	42771089	42767327	8000	42767089	-4000	4000	238
chr2	200904977	200912977	200911089	8000	200908977	-4000	4000	2112
chr2	68651862	68659862	68655410	8000	68655862	-4000	4000	-452
chr2	208156740	208164740	208160905	8000	208160740	-4000	4000	165
chr2	29188774	29196774	29193455	8000	29192774	-4000	4000	681
chr2	79024505	79032505	79027903	8000	79028505	-4000	4000	-602
chr2	208156740	208164740	208161045	8000	208160740	-4000	4000	305
chr2	219509898	219517898	219514946	8000	219513898	-4000	4000	1048
chr2	135835626	135843626	135836824	8000	135839626	-4000	4000	-2802
chr2	132667788	132675788	132673219	8000	132671788	-4000	4000	1431
chr2	158132154	158140154	158134835	8000	158136154	-4000	4000	-1319
chr2	27578720	27586720	27580249	8000	27582720	-4000	4000	-2471
chr2	74528258	74536258	74535716	8000	74532258	-4000	4000	3458
chr2	96017946	96025946	96023348	8000	96021946	-4000	4000	1402
chr2	176169102	176177102	176169485	8000	176173102	-4000	4000	-3617
chr2	118990660	118998660	118994626	8000	118994660	-4000	4000	-34
chr2	27126812	27134812	27132725	8000	27130812	-4000	4000	1913
chr2	19347485	19355485	19352157	8000	19351485	-4000	4000	672
chr2	43806010	43814010	43813130	8000	43810010	-4000	4000	3120
chr2	44316310	44324310	44321357	8000	44320310	-4000	4000	1047
chr2	112115318	112123318	112116127	8000	112119318	-4000	4000	-3191
chr2	112914882	112922882	112917656	8000	112918882	-4000	4000	-1226
chr2	169808064	169816064	169810972	8000	169812064	-4000	4000	-1092
chr2	174344022	174352022	174348736	8000	174348022	-4000	4000	714
chr2	199265500	199273500	199272531	8000	199269500	-4000	4000	3031
chr2	85694852	85702852	85696001	8000	85698852	-4000	4000	-2851
chr2	120290710	120298710	120293517	8000	120294710	-4000	4000	-1193
chr2	191830310	191838310	191836049	8000	191834310	-4000	4000	1739
chr2	165388310	165396310	165389122	8000	165392310	-4000	4000	-3188
chr2	208124137	208132137	208129641	8000	208128137	-4000	4000	1504
chr2	80644861	80652861	80647872	8000	80648861	-4000	4000	-989
chr2	105239467	105247467	105242918	8000	105243467	-4000	4000	-549
chr2	85589406	85597406	85591744	8000	85593406	-4000	4000	-1662
chr2	275558	283558	283135	8000	279558	-4000	4000	3577
chr2	55232595	55240595	55240140	8000	55236595	-4000	4000	3545
chr2	201616184	201624184	201619083	8000	201620184	-4000	4000	-1101
chr2	218342793	218350793	218344893	8000	218346793	-4000	4000	-1900
chr2	224374698	224382698	224380047	8000	224378698	-4000	4000	1349
chr2	149565637	149573637	149569862	8000	149569637	-4000	4000	225
chr2	219050424	219058424	219057605	8000	219054424	-4000	4000	3181
chr2	74679853	74687853	74680046	8000	74683853	-4000	4000	-3807
chr2	184935492	184943492	184938981	8000	184939492	-4000	4000	-511
chr2	127634381	127642381	127642166	8000	127638381	-4000	4000	3785
chr2	197704395	197712395	197705880	8000	197708395	-4000	4000	-2515
chr2	206158928	206166928	206162880	8000	206162928	-4000	4000	-48
chr2	27578720	27586720	27579072	8000	27582720	-4000	4000	-3648
chr2	33395509	33403509	33397258	8000	33399509	-4000	4000	-2251
chr2	55232595	55240595	55232665	8000	55236595	-4000	4000	-3930
chr2	73208513	73216513	73210809	8000	73212513	-4000	4000	-1704
chr2	95595778	95603778	95596225	8000	95599778	-4000	4000	-3553
chr2	109500634	109508634	109501641	8000	109504634	-4000	4000	-2993
chr2	127857630	127865630	127864151	8000	127861630	-4000	4000	2521
chr2	130764134	130772134	130765851	8000	130768134	-4000	4000	-2283
chr2	157410619	157418619	157415759	8000	157414619	-4000	4000	1140
chr2	208354746	208362746	208356649	8000	208358746	-4000	4000	-2097
chr2	218633184	218641184	218638347	8000	218637184	-4000	4000	1163
chr2	230030982	230038982	230035923	8000	230034982	-4000	4000	941
chr2	64589005	64597005	64592011	8000	64593005	-4000	4000	-994
chr2	70826211	70834211	70833741	8000	70830211	-4000	4000	3530
chr2	156320437	156328437	156327981	8000	156324437	-4000	4000	3544
chr2	189027898	189035898	189035114	8000	189031898	-4000	4000	3216
chr2	219637980	219645980	219639723	8000	219641980	-4000	4000	-2257
chr2	20997429	21005429	21002399	8000	21001429	-4000	4000	970
chr2	74104176	74112176	74105593	8000	74108176	-4000	4000	-2583
chr2	108305915	108313915	108308569	8000	108309915	-4000	4000	-1346
chr2	240041077	240049077	240045802	8000	240045077	-4000	4000	725
chr2	19988052	19996052	19990072	8000	19992052	-4000	4000	-1980
chr2	206171316	206179316	206176959	8000	206175316	-4000	4000	1643
chr2	100479280	100487280	100481147	8000	100483280	-4000	4000	-2133
chr2	218392894	218400894	218394705	8000	218396894	-4000	4000	-2189
chr2	210675107	210683107	210675763	8000	210679107	-4000	4000	-3344
chr2	213730	221730	218826	8000	217730	-4000	4000	1096
chr2	108261351	108269351	108265312	8000	108265351	-4000	4000	-39
chr2	55232595	55240595	55236788	8000	55236595	-4000	4000	193
chr2	219245710	219253710	219251682	8000	219249710	-4000	4000	1972
chr2	108890471	108898471	108897208	8000	108894471	-4000	4000	2737
chr2	212995691	213003691	213003193	8000	212999691	-4000	4000	3502
chr2	227610538	227618538	227611240	8000	227614538	-4000	4000	-3298
chr2	26453203	26461203	26455171	8000	26457203	-4000	4000	-2032
chr2	27132848	27140848	27137950	8000	27136848	-4000	4000	1102
chr2	208117607	208125607	208124118	8000	208121607	-4000	4000	2511
chr2	9484486	9492486	9488319	8000	9488486	-4000	4000	-167
chr2	241490841	241498841	241498746	8000	241494841	-4000	4000	3905
chr2	44942071	44950071	44942685	8000	44946071	-4000	4000	-3386
chr2	44942071	44950071	44942686	8000	44946071	-4000	4000	-3385
chr2	15162914	15170914	15166997	8000	15166914	-4000	4000	83
chr2	31518480	31526480	31526088	8000	31522480	-4000	4000	3608
chr2	27023219	27031219	27024240	8000	27027219	-4000	4000	-2979
chr2	43763987	43771987	43765855	8000	43767987	-4000	4000	-2132
chr2	74501043	74509043	74506797	8000	74505043	-4000	4000	1754
chr2	74501043	74509043	74506798	8000	74505043	-4000	4000	1755
chr2	206171316	206179316	206176804	8000	206175316	-4000	4000	1488
chr2	74207604	74215604	74209961	8000	74211604	-4000	4000	-1643
chr2	127634381	127642381	127640893	8000	127638381	-4000	4000	2512
chr2	232475827	232483827	232483107	8000	232479827	-4000	4000	3280
chr2	218158841	218166841	218164376	8000	218162841	-4000	4000	1535
chr2	10910225	10918225	10913539	8000	10914225	-4000	4000	-686
chr2	127425242	127433242	127428419	8000	127429242	-4000	4000	-823
chr2	131529666	131537666	131532705	8000	131533666	-4000	4000	-961
chr2	178427292	178435292	178432162	8000	178431292	-4000	4000	870
chr2	187460230	187468230	187467924	8000	187464230	-4000	4000	3694
chr2	10910225	10918225	10913537	8000	10914225	-4000	4000	-688
chr2	3640644	3648644	3643873	8000	3644644	-4000	4000	-771
chr2	74501043	74509043	74507061	8000	74505043	-4000	4000	2018
chr2	74889359	74897359	74890802	8000	74893359	-4000	4000	-2557
chr2	42763089	42771089	42770180	8000	42767089	-4000	4000	3091
chr2	84817650	84825650	84824159	8000	84821650	-4000	4000	2509
chr2	110633528	110641528	110641135	8000	110637528	-4000	4000	3607
chr2	158132154	158140154	158134773	8000	158136154	-4000	4000	-1381
chr2	240041077	240049077	240042910	8000	240045077	-4000	4000	-2167
chr2	230030982	230038982	230037213	8000	230034982	-4000	4000	2231
chr2	230399732	230407732	230400266	8000	230403732	-4000	4000	-3466
chr2	38793729	38801729	38798230	8000	38797729	-4000	4000	501
chr2	182829275	182837275	182834708	8000	182833275	-4000	4000	1433
chr2	98394601	98402601	98397032	8000	98398601	-4000	4000	-1569
chr2	172085677	172093677	172088191	8000	172089677	-4000	4000	-1486
chr2	43882224	43890224	43888593	8000	43886224	-4000	4000	2369
chr2	189027898	189035898	189034213	8000	189031898	-4000	4000	2315
chr2	27440377	27448377	27440692	8000	27444377	-4000	4000	-3685
chr2	238164900	238172900	238170650	8000	238168900	-4000	4000	1750
chr2	238164900	238172900	238170651	8000	238168900	-4000	4000	1751
chr2	181531041	181539041	181538124	8000	181535041	-4000	4000	3083
chr2	27647511	27655511	27652860	8000	27651511	-4000	4000	1349
chr2	96548634	96556634	96552117	8000	96552634	-4000	4000	-517
chr2	73813147	73821147	73816685	8000	73817147	-4000	4000	-462
chr2	73954961	73962961	73957136	8000	73958961	-4000	4000	-1825
chr2	112184218	112192218	112187248	8000	112188218	-4000	4000	-970
chr2	151376046	151384046	151379596	8000	151380046	-4000	4000	-450
chr2	176169102	176177102	176169133	8000	176173102	-4000	4000	-3969
chr2	186761959	186769959	186762122	8000	186765959	-4000	4000	-3837
chr2	210675107	210683107	210678077	8000	210679107	-4000	4000	-1030
chr2	230399732	230407732	230403041	8000	230403732	-4000	4000	-691
chr2	26186635	26194635	26194603	8000	26190635	-4000	4000	3968
chr2	88118982	88126982	88126189	8000	88122982	-4000	4000	3207
chr2	101267219	101275219	101273283	8000	101271219	-4000	4000	2064
chr2	10781110	10789110	10784444	8000	10785110	-4000	4000	-666
chr2	73208513	73216513	73210875	8000	73212513	-4000	4000	-1638
chr2	88525585	88533585	88526488	8000	88529585	-4000	4000	-3097
chr2	232456753	232464753	232458288	8000	232460753	-4000	4000	-2465
chr2	112914882	112922882	112918564	8000	112918882	-4000	4000	-318
chr2	227610538	227618538	227611649	8000	227614538	-4000	4000	-2889
chr2	73286929	73294929	73292301	8000	73290929	-4000	4000	1372
chr2	48958157	48966157	48962933	8000	48962157	-4000	4000	776
chr2	63053836	63061836	63056342	8000	63057836	-4000	4000	-1494
chr2	88552741	88560741	88557698	8000	88556741	-4000	4000	957
chr2	74513148	74521148	74515659	8000	74517148	-4000	4000	-1489
chr2	20196797	20204797	20204001	8000	20200797	-4000	4000	3204
chr2	241800287	241808287	241804056	8000	241804287	-4000	4000	-231
chr2	223592940	223600940	223597334	8000	223596940	-4000	4000	394
chr2	131529666	131537666	131530586	8000	131533666	-4000	4000	-3080
chr2	186823475	186831475	186828626	8000	186827475	-4000	4000	1151
chr2	231169116	231177116	231170662	8000	231173116	-4000	4000	-2454
chr2	27305492	27313492	27309974	8000	27309492	-4000	4000	482
chr2	84817650	84825650	84819306	8000	84821650	-4000	4000	-2344
chr2	88525585	88533585	88529260	8000	88529585	-4000	4000	-325
chr2	118838171	118846171	118842992	8000	118842171	-4000	4000	821
chr2	162263074	162271074	162267207	8000	162267074	-4000	4000	133
chr2	218364099	218372099	218364728	8000	218368099	-4000	4000	-3371
chr2	138665157	138673157	138670812	8000	138669157	-4000	4000	1655
chr2	230309215	230317215	230312738	8000	230313215	-4000	4000	-477
chr2	102710630	102718630	102718540	8000	102714630	-4000	4000	3910
chr2	42054517	42062517	42057661	8000	42058517	-4000	4000	-856
chr2	159228659	159236659	159229612	8000	159232659	-4000	4000	-3047
chr2	218158841	218166841	218164447	8000	218162841	-4000	4000	1606
chr2	218158841	218166841	218164448	8000	218162841	-4000	4000	1607
chr2	218998846	219006846	219004299	8000	219002846	-4000	4000	1453
chr2	223971045	223979045	223975870	8000	223975045	-4000	4000	825
chr2	241845884	241853884	241851209	8000	241849884	-4000	4000	1325
chr2	27578720	27586720	27581333	8000	27582720	-4000	4000	-1387
chr2	241580405	241588405	241584625	8000	241584405	-4000	4000	220
chr2	149470138	149478138	149471078	8000	149474138	-4000	4000	-3060
chr2	32220379	32228379	32220387	8000	32224379	-4000	4000	-3992
chr2	191025576	191033576	191033551	8000	191029576	-4000	4000	3975
chr2	24766702	24774702	24770527	8000	24770702	-4000	4000	-175
chr2	113130016	113138016	113131137	8000	113134016	-4000	4000	-2879
chr2	26946351	26954351	26946920	8000	26950351	-4000	4000	-3431
chr2	42763089	42771089	42770183	8000	42767089	-4000	4000	3094
chr2	73286929	73294929	73292188	8000	73290929	-4000	4000	1259
chr2	96108876	96116876	96115763	8000	96112876	-4000	4000	2887
chr2	96326517	96334517	96327719	8000	96330517	-4000	4000	-2798
chr2	153473338	153481338	153478163	8000	153477338	-4000	4000	825
chr2	186505361	186513361	186506716	8000	186509361	-4000	4000	-2645
chr2	212995691	213003691	213003402	8000	212999691	-4000	4000	3711
chr2	227813564	227821564	227815557	8000	227817564	-4000	4000	-2007
chr2	241490841	241498841	241498653	8000	241494841	-4000	4000	3812
chr2	97735862	97743862	97738078	8000	97739862	-4000	4000	-1784
chr2	68651862	68659862	68655273	8000	68655862	-4000	4000	-589
chr2	46382697	46390697	46384595	8000	46386697	-4000	4000	-2102
chr2	218811293	218819293	218812953	8000	218815293	-4000	4000	-2340
chr2	11638788	11646788	11640475	8000	11642788	-4000	4000	-2313
chr2	19906263	19914263	19914213	8000	19910263	-4000	4000	3950
chr2	224374698	224382698	224380189	8000	224378698	-4000	4000	1491
chr2	73249021	73257021	73249145	8000	73253021	-4000	4000	-3876
chr2	241813413	241821413	241816753	8000	241817413	-4000	4000	-660
chr2	63888146	63896146	63890153	8000	63892146	-4000	4000	-1993
chr2	38958206	38966206	38960561	8000	38962206	-4000	4000	-1645
chr2	30906467	30914467	30910752	8000	30910467	-4000	4000	285
chr2	24059321	24067321	24063045	8000	24063321	-4000	4000	-276
chr2	241845884	241853884	241852729	8000	241849884	-4000	4000	2845
chr2	24815169	24823169	24817713	8000	24819169	-4000	4000	-1456
chr2	191025576	191033576	191031487	8000	191029576	-4000	4000	1911
chr2	106387290	106395290	106391185	8000	106391290	-4000	4000	-105
chr2	118990660	118998660	118993258	8000	118994660	-4000	4000	-1402
chr2	149211262	149219262	149214789	8000	149215262	-4000	4000	-473
chr2	218977087	218985087	218985031	8000	218981087	-4000	4000	3944
chr2	219546595	219554595	219554584	8000	219550595	-4000	4000	3989
chr2	109500634	109508634	109501508	8000	109504634	-4000	4000	-3126
chr2	26577205	26585205	26579422	8000	26581205	-4000	4000	-1783
chr2	61134034	61142034	61134211	8000	61138034	-4000	4000	-3823
chr2	79081023	79089023	79086734	8000	79085023	-4000	4000	1711
chr2	85540720	85548720	85542131	8000	85544720	-4000	4000	-2589
chr2	119435843	119443843	119437050	8000	119439843	-4000	4000	-2793
chr2	223592940	223600940	223598750	8000	223596940	-4000	4000	1810
chr2	25156853	25164853	25164728	8000	25160853	-4000	4000	3875
chr2	132642582	132650582	132645490	8000	132646582	-4000	4000	-1092
chr2	42763089	42771089	42769919	8000	42767089	-4000	4000	2830
chr2	203869965	203877965	203870886	8000	203873965	-4000	4000	-3079
chr2	113130016	113138016	113131131	8000	113134016	-4000	4000	-2885
chr2	206171316	206179316	206177112	8000	206175316	-4000	4000	1796
chr2	171554129	171562129	171554793	8000	171558129	-4000	4000	-3336
chr2	62496218	62504218	62502473	8000	62500218	-4000	4000	2255
chr2	130069535	130077535	130075463	8000	130073535	-4000	4000	1928
chr2	130135287	130143287	130143283	8000	130139287	-4000	4000	3996
chr2	98394601	98402601	98396724	8000	98398601	-4000	4000	-1877
chr2	129978738	129986738	129980852	8000	129982738	-4000	4000	-1886
chr2	189666831	189674831	189670586	8000	189670831	-4000	4000	-245
chr2	208124137	208132137	208128283	8000	208128137	-4000	4000	146
chr2	218870233	218878233	218871188	8000	218874233	-4000	4000	-3045
chr2	10052473	10060473	10058919	8000	10056473	-4000	4000	2446
chr2	165388310	165396310	165388828	8000	165392310	-4000	4000	-3482
chr2	79119409	79127409	79121649	8000	79123409	-4000	4000	-1760
chr2	184935492	184943492	184938630	8000	184939492	-4000	4000	-862
chr2	232378889	232386889	232380275	8000	232382889	-4000	4000	-2614
chr2	232406714	232414714	232408356	8000	232410714	-4000	4000	-2358
chr2	26946351	26954351	26947203	8000	26950351	-4000	4000	-3148
chr2	46382697	46390697	46384925	8000	46386697	-4000	4000	-1772
chr2	150464195	150472195	150471632	8000	150468195	-4000	4000	3437
chr2	236161236	236169236	236166385	8000	236165236	-4000	4000	1149
chr2	102394777	102402777	102396716	8000	102398777	-4000	4000	-2061
chr2	115841780	115849780	115844038	8000	115845780	-4000	4000	-1742
chr2	184935492	184943492	184936062	8000	184939492	-4000	4000	-3430
chr2	206158928	206166928	206161387	8000	206162928	-4000	4000	-1541
chr2	161988245	161996245	161993077	8000	161992245	-4000	4000	832
chr2	164488417	164496417	164492885	8000	164492417	-4000	4000	468
chr2	99396475	99404475	99401201	8000	99400475	-4000	4000	726
chr2	218158841	218166841	218164214	8000	218162841	-4000	4000	1373
chr2	240025491	240033491	240029992	8000	240029491	-4000	4000	501
chr2	218811293	218819293	218814990	8000	218815293	-4000	4000	-303
chr2	206310427	206318427	206310996	8000	206314427	-4000	4000	-3431
chr2	10052473	10060473	10058928	8000	10056473	-4000	4000	2455
chr2	12738734	12746734	12741368	8000	12742734	-4000	4000	-1366
chr2	64088652	64096652	64094682	8000	64092652	-4000	4000	2030
chr2	69453997	69461997	69460482	8000	69457997	-4000	4000	2485
chr2	70804643	70812643	70809040	8000	70808643	-4000	4000	397
chr2	108261351	108269351	108264998	8000	108265351	-4000	4000	-353
chr2	127857630	127865630	127864009	8000	127861630	-4000	4000	2379
chr2	169641425	169649425	169645983	8000	169645425	-4000	4000	558
chr2	176091944	176099944	176095519	8000	176095944	-4000	4000	-425
chr2	176115937	176123937	176117512	8000	176119937	-4000	4000	-2425
chr2	176169102	176177102	176172403	8000	176173102	-4000	4000	-699
chr2	216855458	216863458	216859517	8000	216859458	-4000	4000	59
chr2	219323407	219331407	219329166	8000	219327407	-4000	4000	1759
chr2	68393453	68401453	68394118	8000	68397453	-4000	4000	-3335
chr2	189008746	189016746	189009173	8000	189012746	-4000	4000	-3573
chr2	96701929	96709929	96702722	8000	96705929	-4000	4000	-3207
chr2	25922598	25930598	25928037	8000	25926598	-4000	4000	1439
chr2	8680461	8688461	8682419	8000	8684461	-4000	4000	-2042
chr2	172085677	172093677	172086680	8000	172089677	-4000	4000	-2997
chr2	10781110	10789110	10784391	8000	10785110	-4000	4000	-719
chr2	96701929	96709929	96703209	8000	96705929	-4000	4000	-2720
chr2	236578354	236586354	236580963	8000	236582354	-4000	4000	-1391
chr2	15943007	15951007	15945903	8000	15947007	-4000	4000	-1104
chr2	85540720	85548720	85542369	8000	85544720	-4000	4000	-2351
chr2	127634381	127642381	127639127	8000	127638381	-4000	4000	746
chr2	186505361	186513361	186505788	8000	186509361	-4000	4000	-3573
chr2	72171984	72179984	72179360	8000	72175984	-4000	4000	3376
chr2	232378889	232386889	232379891	8000	232382889	-4000	4000	-2998
chr2	129978738	129986738	129980065	8000	129982738	-4000	4000	-2673
chr2	206110817	206118817	206116379	8000	206114817	-4000	4000	1562
chr2	238164900	238172900	238167377	8000	238168900	-4000	4000	-1523
chr2	178427292	178435292	178432077	8000	178431292	-4000	4000	785
chr2	227920344	227928344	227921544	8000	227924344	-4000	4000	-2800
chr2	85833120	85841120	85840473	8000	85837120	-4000	4000	3353
chr2	218751416	218759416	218752809	8000	218755416	-4000	4000	-2607
chr2	118838171	118846171	118843011	8000	118842171	-4000	4000	840
chr2	98309299	98317299	98311872	8000	98313299	-4000	4000	-1427
chr2	241869823	241877823	241872918	8000	241873823	-4000	4000	-905
chr2	127634381	127642381	127637398	8000	127638381	-4000	4000	-983
chr2	127634381	127642381	127637399	8000	127638381	-4000	4000	-982
chr2	190199484	190207484	190203219	8000	190203484	-4000	4000	-265
chr2	238240044	238248044	238244371	8000	238244044	-4000	4000	327
chr2	85387752	85395752	85389749	8000	85391752	-4000	4000	-2003
chr2	167255753	167263753	167258485	8000	167259753	-4000	4000	-1268
chr2	71075808	71083808	71076633	8000	71079808	-4000	4000	-3175
chr2	170651171	170659171	170653032	8000	170655171	-4000	4000	-2139
chr2	43882224	43890224	43888460	8000	43886224	-4000	4000	2236
chr2	11654178	11662178	11658542	8000	11658178	-4000	4000	364
chr2	12738734	12746734	12740712	8000	12742734	-4000	4000	-2022
chr2	26453203	26461203	26460105	8000	26457203	-4000	4000	2902
chr2	27132848	27140848	27133296	8000	27136848	-4000	4000	-3552
chr2	27578720	27586720	27579653	8000	27582720	-4000	4000	-3067
chr2	37197612	37205612	37201684	8000	37201612	-4000	4000	72
chr2	70981942	70989942	70989816	8000	70985942	-4000	4000	3874
chr2	84817650	84825650	84823970	8000	84821650	-4000	4000	2320
chr2	95180317	95188317	95182324	8000	95184317	-4000	4000	-1993
chr2	97651939	97659939	97657488	8000	97655939	-4000	4000	1549
chr2	108009994	108017994	108011024	8000	108013994	-4000	4000	-2970
chr2	108890471	108898471	108897157	8000	108894471	-4000	4000	2686
chr2	205794133	205802133	205795022	8000	205798133	-4000	4000	-3111
chr2	210183126	210191126	210188699	8000	210187126	-4000	4000	1573
chr2	215356440	215364440	215361587	8000	215360440	-4000	4000	1147
chr2	218446251	218454251	218449276	8000	218450251	-4000	4000	-975
chr2	230817075	230825075	230818950	8000	230821075	-4000	4000	-2125
chr2	11654178	11662178	11662009	8000	11658178	-4000	4000	3831
chr2	24939636	24947636	24944613	8000	24943636	-4000	4000	977
chr2	70291975	70299975	70297307	8000	70295975	-4000	4000	1332
chr2	95382077	95390077	95385787	8000	95386077	-4000	4000	-290
chr2	96701929	96709929	96704491	8000	96705929	-4000	4000	-1438
chr2	106089308	106097308	106096739	8000	106093308	-4000	4000	3431
chr2	134955342	134963342	134956790	8000	134959342	-4000	4000	-2552
chr2	171779405	171787405	171785392	8000	171783405	-4000	4000	1987
chr2	174794809	174802809	174799939	8000	174798809	-4000	4000	1130
chr2	177619244	177627244	177626217	8000	177623244	-4000	4000	2973
chr2	219534772	219542772	219541675	8000	219538772	-4000	4000	2903
chr2	238148947	238156947	238150838	8000	238152947	-4000	4000	-2109
chr2	189556590	189564590	189563865	8000	189560590	-4000	4000	3275
chr2	164488417	164496417	164492885	8000	164492417	-4000	4000	468
chr2	179437982	179445982	179443364	8000	179441982	-4000	4000	1382
chr2	190199484	190207484	190205129	8000	190203484	-4000	4000	1645
chr2	10910225	10918225	10912738	8000	10914225	-4000	4000	-1487
chr2	208117607	208125607	208121701	8000	208121607	-4000	4000	94
chr2	101393359	101401359	101397683	8000	101397359	-4000	4000	324
chr2	97651939	97659939	97658433	8000	97655939	-4000	4000	2494
chr2	55543292	55551292	55548842	8000	55547292	-4000	4000	1550
chr2	27578720	27586720	27582028	8000	27582720	-4000	4000	-692
chr2	165388310	165396310	165389265	8000	165392310	-4000	4000	-3045
chr2	197704395	197712395	197706828	8000	197708395	-4000	4000	-1567
chr2	10910225	10918225	10913236	8000	10914225	-4000	4000	-989
chr2	62496218	62504218	62501196	8000	62500218	-4000	4000	978
chr2	62496218	62504218	62501412	8000	62500218	-4000	4000	1194
chr2	68280171	68288171	68284433	8000	68284171	-4000	4000	262
chr2	73286929	73294929	73291496	8000	73290929	-4000	4000	567
chr2	73813147	73821147	73816181	8000	73817147	-4000	4000	-966
chr2	79081023	79089023	79087589	8000	79085023	-4000	4000	2566
chr2	100992829	101000829	100995646	8000	100996829	-4000	4000	-1183
chr2	102707355	102715355	102708356	8000	102711355	-4000	4000	-2999
chr2	118106997	118114997	118107118	8000	118110997	-4000	4000	-3879
chr2	157410619	157418619	157415632	8000	157414619	-4000	4000	1013
chr2	176115937	176123937	176116920	8000	176119937	-4000	4000	-3017
chr2	206310427	206318427	206310640	8000	206314427	-4000	4000	-3787
chr2	206310427	206318427	206311620	8000	206314427	-4000	4000	-2807
chr2	208117607	208125607	208121735	8000	208121607	-4000	4000	128
chr2	227813564	227821564	227817285	8000	227817564	-4000	4000	-279
chr2	69956089	69964089	69960704	8000	69960089	-4000	4000	615
chr2	69956089	69964089	69961051	8000	69960089	-4000	4000	962
chr2	88552741	88560741	88557823	8000	88556741	-4000	4000	1082
chr2	159314979	159322979	159320345	8000	159318979	-4000	4000	1366
chr2	190367665	190375665	190371354	8000	190371665	-4000	4000	-311
chr2	219245710	219253710	219251226	8000	219249710	-4000	4000	1516
chr2	15943007	15951007	15945984	8000	15947007	-4000	4000	-1023
chr2	18551545	18559545	18555545	8000	18555545	-4000	4000	0
chr2	25156853	25164853	25161562	8000	25160853	-4000	4000	709
chr2	26185663	26193663	26188270	8000	26189663	-4000	4000	-1393
chr2	26453203	26461203	26460855	8000	26457203	-4000	4000	3652
chr2	36547135	36555135	36549738	8000	36551135	-4000	4000	-1397
chr2	38289954	38297954	38296689	8000	38293954	-4000	4000	2735
chr2	68976980	68984980	68977690	8000	68980980	-4000	4000	-3290
chr2	74679853	74687853	74681897	8000	74683853	-4000	4000	-1956
chr2	86209993	86217993	86210633	8000	86213993	-4000	4000	-3360
chr2	86209993	86217993	86214094	8000	86213993	-4000	4000	101
chr2	100479280	100487280	100481164	8000	100483280	-4000	4000	-2116
chr2	104854574	104862574	104856663	8000	104858574	-4000	4000	-1911
chr2	109538799	109546799	109546222	8000	109542799	-4000	4000	3423
chr2	127697027	127705027	127703102	8000	127701027	-4000	4000	2075
chr2	127697027	127705027	127704285	8000	127701027	-4000	4000	3258
chr2	127697027	127705027	127704574	8000	127701027	-4000	4000	3547
chr2	127857630	127865630	127864204	8000	127861630	-4000	4000	2574
chr2	127857630	127865630	127864458	8000	127861630	-4000	4000	2828
chr2	127857630	127865630	127865181	8000	127861630	-4000	4000	3551
chr2	129978738	129986738	129981041	8000	129982738	-4000	4000	-1697
chr2	130726336	130734336	130729217	8000	130730336	-4000	4000	-1119
chr2	134955342	134963342	134956191	8000	134959342	-4000	4000	-3151
chr2	134955342	134963342	134956740	8000	134959342	-4000	4000	-2602
chr2	134955342	134963342	134956925	8000	134959342	-4000	4000	-2417
chr2	135783850	135791850	135784600	8000	135787850	-4000	4000	-3250
chr2	165388310	165396310	165390547	8000	165392310	-4000	4000	-1763
chr2	175068250	175076250	175074628	8000	175072250	-4000	4000	2378
chr2	184935492	184943492	184938928	8000	184939492	-4000	4000	-564
chr2	190199484	190207484	190202643	8000	190203484	-4000	4000	-841
chr2	201483421	201491421	201491361	8000	201487421	-4000	4000	3940
chr2	229353629	229361629	229358287	8000	229357629	-4000	4000	658
chr2	230903318	230911318	230911057	8000	230907318	-4000	4000	3739
chr2	236578354	236586354	236580879	8000	236582354	-4000	4000	-1475
chr2	240613705	240621705	240617391	8000	240617705	-4000	4000	-314
chr2	241671747	241679747	241672110	8000	241675747	-4000	4000	-3637
chr2	9401683	9409683	9406845	8000	9405683	-4000	4000	1162
chr2	42054517	42062517	42055317	8000	42058517	-4000	4000	-3200
chr2	60446520	60454520	60452455	8000	60450520	-4000	4000	1935
chr2	61820848	61828848	61826565	8000	61824848	-4000	4000	1717
chr2	74104176	74112176	74105893	8000	74108176	-4000	4000	-2283
chr2	79119409	79127409	79120860	8000	79123409	-4000	4000	-2549
chr2	113639396	113647396	113642238	8000	113643396	-4000	4000	-1158
chr2	118990660	118998660	118994423	8000	118994660	-4000	4000	-237
chr2	150464195	150472195	150470188	8000	150468195	-4000	4000	1993
chr2	160095667	160103667	160101759	8000	160099667	-4000	4000	2092
chr2	169524508	169532508	169529797	8000	169528508	-4000	4000	1289
chr2	171779405	171787405	171785440	8000	171783405	-4000	4000	2035
chr2	218446251	218454251	218449292	8000	218450251	-4000	4000	-959
chr2	241490841	241498841	241498618	8000	241494841	-4000	4000	3777
chr2	86209993	86217993	86216886	8000	86213993	-4000	4000	2893
chr2	214721646	214729646	214728871	8000	214725646	-4000	4000	3225
chr2	227358038	227366038	227363631	8000	227362038	-4000	4000	1593
chr2	157410619	157418619	157415916	8000	157414619	-4000	4000	1297
chr2	72171984	72179984	72179409	8000	72175984	-4000	4000	3425
chr2	229353629	229361629	229358440	8000	229357629	-4000	4000	811
chr2	112914882	112922882	112918595	8000	112918882	-4000	4000	-287
chr2	11654178	11662178	11658507	8000	11658178	-4000	4000	329
chr2	79081023	79089023	79085798	8000	79085023	-4000	4000	775
chr2	96373091	96381091	96373488	8000	96377091	-4000	4000	-3603
chr2	110118311	110126311	110125679	8000	110122311	-4000	4000	3368
chr2	208124137	208132137	208129613	8000	208128137	-4000	4000	1476
chr2	218158841	218166841	218164885	8000	218162841	-4000	4000	2044
chr2	218811293	218819293	218813048	8000	218815293	-4000	4000	-2245
chr2	162166684	162174684	162173201	8000	162170684	-4000	4000	2517
chr2	226995215	227003215	226995523	8000	226999215	-4000	4000	-3692
chr2	68941232	68949232	68945345	8000	68945232	-4000	4000	113
chr2	84817650	84825650	84824041	8000	84821650	-4000	4000	2391
chr2	20997429	21005429	21002896	8000	21001429	-4000	4000	1467
chr2	88023205	88031205	88028527	8000	88027205	-4000	4000	1322
chr2	227920344	227928344	227923974	8000	227924344	-4000	4000	-370
chr2	74679853	74687853	74679862	8000	74683853	-4000	4000	-3991
chr2	218818383	218826383	218824283	8000	218822383	-4000	4000	1900
chr2	27578720	27586720	27581609	8000	27582720	-4000	4000	-1111
chr2	3640644	3648644	3643527	8000	3644644	-4000	4000	-1117
chr2	206110817	206118817	206116082	8000	206114817	-4000	4000	1265
chr2	203869965	203877965	203872726	8000	203873965	-4000	4000	-1239
chr2	112537739	112545739	112542384	8000	112541739	-4000	4000	645
chr2	184935492	184943492	184939256	8000	184939492	-4000	4000	-236
chr2	130135287	130143287	130141266	8000	130139287	-4000	4000	1979
chr2	135721270	135729270	135725199	8000	135725270	-4000	4000	-71
chr2	240041077	240049077	240045443	8000	240045077	-4000	4000	366
chr2	96108876	96116876	96115607	8000	96112876	-4000	4000	2731
chr2	118106997	118114997	118107111	8000	118110997	-4000	4000	-3886
chr2	181926738	181934738	181929566	8000	181930738	-4000	4000	-1172
chr2	206171316	206179316	206176528	8000	206175316	-4000	4000	1212
chr2	219323407	219331407	219329174	8000	219327407	-4000	4000	1767
chr2	108009994	108017994	108010352	8000	108013994	-4000	4000	-3642
chr2	86488716	86496716	86490992	8000	86492716	-4000	4000	-1724
chr2	165388310	165396310	165389087	8000	165392310	-4000	4000	-3223
chr2	44942071	44950071	44942771	8000	44946071	-4000	4000	-3300
chr2	178459664	178467664	178460383	8000	178463664	-4000	4000	-3281
chr2	27578720	27586720	27579146	8000	27582720	-4000	4000	-3574
chr2	32220379	32228379	32220618	8000	32224379	-4000	4000	-3761
chr2	86488716	86496716	86489434	8000	86492716	-4000	4000	-3282
chr2	218158841	218166841	218164124	8000	218162841	-4000	4000	1283
chr2	79081023	79089023	79087596	8000	79085023	-4000	4000	2573
chr2	218818383	218826383	218823827	8000	218822383	-4000	4000	1444
chr2	131529666	131537666	131532696	8000	131533666	-4000	4000	-970
chr2	54968025	54976025	54972946	8000	54972025	-4000	4000	921
chr2	62143247	62151247	62146838	8000	62147247	-4000	4000	-409
chr2	32153637	32161637	32154456	8000	32157637	-4000	4000	-3181
chr2	73813147	73821147	73815712	8000	73817147	-4000	4000	-1435
chr2	174743592	174751592	174748634	8000	174747592	-4000	4000	1042
chr2	9401683	9409683	9407083	8000	9405683	-4000	4000	1400
chr2	143764352	143772352	143768112	8000	143768352	-4000	4000	-240
chr2	238148947	238156947	238149044	8000	238152947	-4000	4000	-3903
chr2	84817650	84825650	84821839	8000	84821650	-4000	4000	189
chr2	19347485	19355485	19351638	8000	19351485	-4000	4000	153
chr2	27578720	27586720	27581252	8000	27582720	-4000	4000	-1468
chr2	112914882	112922882	112917777	8000	112918882	-4000	4000	-1105
chr2	182829275	182837275	182834751	8000	182833275	-4000	4000	1476
chr2	210183126	210191126	210189036	8000	210187126	-4000	4000	1910
chr2	210183126	210191126	210189037	8000	210187126	-4000	4000	1911
chr2	165388310	165396310	165389540	8000	165392310	-4000	4000	-2770
chr2	101890690	101898690	101891719	8000	101894690	-4000	4000	-2971
chr2	143764352	143772352	143768197	8000	143768352	-4000	4000	-155
chr2	105353712	105361712	105361355	8000	105357712	-4000	4000	3643
chr2	74528258	74536258	74535676	8000	74532258	-4000	4000	3418
chr2	189556590	189564590	189563875	8000	189560590	-4000	4000	3285
chr2	69956089	69964089	69961165	8000	69960089	-4000	4000	1076
chr2	85694852	85702852	85695332	8000	85698852	-4000	4000	-3520
chr2	119298225	119306225	119302540	8000	119302225	-4000	4000	315
chr2	176128695	176136695	176131549	8000	176132695	-4000	4000	-1146
chr2	167255753	167263753	167258848	8000	167259753	-4000	4000	-905
chr2	49914503	49922503	49922234	8000	49918503	-4000	4000	3731
chr2	206617127	206625127	206617610	8000	206621127	-4000	4000	-3517
chr2	95180317	95188317	95181806	8000	95184317	-4000	4000	-2511
chr2	101267219	101275219	101269323	8000	101271219	-4000	4000	-1896
chr2	143764352	143772352	143768025	8000	143768352	-4000	4000	-327
chr2	241813413	241821413	241816221	8000	241817413	-4000	4000	-1192
chr2	38958206	38966206	38966129	8000	38962206	-4000	4000	3923
chr2	206965474	206973474	206968338	8000	206969474	-4000	4000	-1136
chr2	227975955	227983955	227981749	8000	227979955	-4000	4000	1794
chr2	20196797	20204797	20202780	8000	20200797	-4000	4000	1983
chr2	27519684	27527684	27523384	8000	27523684	-4000	4000	-300
chr2	179437982	179445982	179443244	8000	179441982	-4000	4000	1262
chr2	186761959	186769959	186762606	8000	186765959	-4000	4000	-3353
chr2	218593080	218601080	218593830	8000	218597080	-4000	4000	-3250
chr2	191830310	191838310	191836560	8000	191834310	-4000	4000	2250
chr2	95180317	95188317	95181385	8000	95184317	-4000	4000	-2932
chr2	119261652	119269652	119263082	8000	119265652	-4000	4000	-2570
chr2	130135287	130143287	130141179	8000	130139287	-4000	4000	1892
chr2	189873629	189881629	189877340	8000	189877629	-4000	4000	-289
chr2	79119409	79127409	79123158	8000	79123409	-4000	4000	-251
chr2	104854574	104862574	104856966	8000	104858574	-4000	4000	-1608
chr2	70981942	70989942	70984748	8000	70985942	-4000	4000	-1194
chr2	173264015	173272015	173266565	8000	173268015	-4000	4000	-1450
chr2	186505361	186513361	186505816	8000	186509361	-4000	4000	-3545
chr2	219489629	219497629	219492156	8000	219493629	-4000	4000	-1473
chr2	68941232	68949232	68946057	8000	68945232	-4000	4000	825
chr2	218133251	218141251	218135699	8000	218137251	-4000	4000	-1552
chr2	174344022	174352022	174348613	8000	174348022	-4000	4000	591
chr2	10050836	10058836	10052629	8000	10054836	-4000	4000	-2207
chr2	46183990	46191990	46186236	8000	46187990	-4000	4000	-1754
chr2	46382697	46390697	46386450	8000	46386697	-4000	4000	-247
chr2	54968025	54976025	54972256	8000	54972025	-4000	4000	231
chr2	85589406	85597406	85591736	8000	85593406	-4000	4000	-1670
chr2	85833120	85841120	85840391	8000	85837120	-4000	4000	3271
chr2	189008746	189016746	189009220	8000	189012746	-4000	4000	-3526
chr2	210017421	210025421	210019757	8000	210021421	-4000	4000	-1664
chr2	214406501	214414501	214414266	8000	214410501	-4000	4000	3765
chr2	218958155	218966155	218961804	8000	218962155	-4000	4000	-351
chr2	63042487	63050487	63045672	8000	63046487	-4000	4000	-815
chr2	73636723	73644723	73641547	8000	73640723	-4000	4000	824
chr2	186761959	186769959	186762083	8000	186765959	-4000	4000	-3876
chr2	27132848	27140848	27137088	8000	27136848	-4000	4000	240
chr2	218342793	218350793	218346583	8000	218346793	-4000	4000	-210
chr2	112659825	112667825	112663529	8000	112663825	-4000	4000	-296
chr2	214721646	214729646	214728650	8000	214725646	-4000	4000	3004
chr2	232406714	232414714	232409936	8000	232410714	-4000	4000	-778
chr2	169524508	169532508	169525637	8000	169528508	-4000	4000	-2871
chr2	215938584	215946584	215944787	8000	215942584	-4000	4000	2203
chr2	85540720	85548720	85542256	8000	85544720	-4000	4000	-2464
chr2	68941232	68949232	68946086	8000	68945232	-4000	4000	854
chr2	112184218	112192218	112187460	8000	112188218	-4000	4000	-758
chr2	165388310	165396310	165389674	8000	165392310	-4000	4000	-2636
chr2	127044027	127052027	127048601	8000	127048027	-4000	4000	574
chr2	173364997	173372997	173365545	8000	173368997	-4000	4000	-3452
chr2	236161236	236169236	236166192	8000	236165236	-4000	4000	956
chr2	105260391	105268391	105267416	8000	105264391	-4000	4000	3025
chr2	37637882	37645882	37645629	8000	37641882	-4000	4000	3747
chr2	206310427	206318427	206311212	8000	206314427	-4000	4000	-3215
chr2	79119409	79127409	79122124	8000	79123409	-4000	4000	-1285
chr2	47156084	47164084	47162378	8000	47160084	-4000	4000	2294
chr2	230309215	230317215	230312702	8000	230313215	-4000	4000	-513
chr2	70804643	70812643	70809815	8000	70808643	-4000	4000	1172
chr2	225650018	225658018	225651993	8000	225654018	-4000	4000	-2025
chr2	1539711	1547711	1542619	8000	1543711	-4000	4000	-1092
chr2	10207725	10215725	10210333	8000	10211725	-4000	4000	-1392
chr2	19347485	19355485	19353334	8000	19351485	-4000	4000	1849
chr2	24196849	24204849	24204378	8000	24200849	-4000	4000	3529
chr2	27132848	27140848	27133200	8000	27136848	-4000	4000	-3648
chr2	27249684	27257684	27256403	8000	27253684	-4000	4000	2719
chr2	27305492	27313492	27309931	8000	27309492	-4000	4000	439
chr2	27578720	27586720	27581597	8000	27582720	-4000	4000	-1123
chr2	27578720	27586720	27582362	8000	27582720	-4000	4000	-358
chr2	36547135	36555135	36553042	8000	36551135	-4000	4000	1907
chr2	38063142	38071142	38070998	8000	38067142	-4000	4000	3856
chr2	38289954	38297954	38296087	8000	38293954	-4000	4000	2133
chr2	49914503	49922503	49922227	8000	49918503	-4000	4000	3724
chr2	67408089	67416089	67410137	8000	67412089	-4000	4000	-1952
chr2	69392113	69400113	69396253	8000	69396113	-4000	4000	140
chr2	70291975	70299975	70293647	8000	70295975	-4000	4000	-2328
chr2	71075808	71083808	71078379	8000	71079808	-4000	4000	-1429
chr2	74513148	74521148	74515651	8000	74517148	-4000	4000	-1497
chr2	74553883	74561883	74554797	8000	74557883	-4000	4000	-3086
chr2	79081023	79089023	79085734	8000	79085023	-4000	4000	711
chr2	87751960	87759960	87756862	8000	87755960	-4000	4000	902
chr2	88118982	88126982	88123136	8000	88122982	-4000	4000	154
chr2	94872823	94880823	94873517	8000	94876823	-4000	4000	-3306
chr2	96326517	96334517	96327222	8000	96330517	-4000	4000	-3295
chr2	96701929	96709929	96704293	8000	96705929	-4000	4000	-1636
chr2	99396475	99404475	99399333	8000	99400475	-4000	4000	-1142
chr2	109538799	109546799	109546073	8000	109542799	-4000	4000	3274
chr2	120988653	120996653	120990451	8000	120992653	-4000	4000	-2202
chr2	130135287	130143287	130140020	8000	130139287	-4000	4000	733
chr2	130147392	130155392	130153139	8000	130151392	-4000	4000	1747
chr2	130764134	130772134	130764445	8000	130768134	-4000	4000	-3689
chr2	136110349	136118349	136115730	8000	136114349	-4000	4000	1381
chr2	153473338	153481338	153478328	8000	153477338	-4000	4000	990
chr2	156320437	156328437	156325679	8000	156324437	-4000	4000	1242
chr2	159767851	159775851	159771874	8000	159771851	-4000	4000	23
chr2	162367407	162375407	162371995	8000	162371407	-4000	4000	588
chr2	169808064	169816064	169808871	8000	169812064	-4000	4000	-3193
chr2	171554129	171562129	171554753	8000	171558129	-4000	4000	-3376
chr2	174425575	174433575	174427983	8000	174429575	-4000	4000	-1592
chr2	175068250	175076250	175074821	8000	175072250	-4000	4000	2571
chr2	184935492	184943492	184938325	8000	184939492	-4000	4000	-1167
chr2	189008746	189016746	189010278	8000	189012746	-4000	4000	-2468
chr2	189008746	189016746	189011926	8000	189012746	-4000	4000	-820
chr2	189471552	189479552	189475358	8000	189475552	-4000	4000	-194
chr2	191025576	191033576	191029608	8000	191029576	-4000	4000	32
chr2	191025576	191033576	191031474	8000	191029576	-4000	4000	1898
chr2	197546726	197554726	197550722	8000	197550726	-4000	4000	-4
chr2	197564224	197572224	197572172	8000	197568224	-4000	4000	3948
chr2	202034441	202042441	202036143	8000	202038441	-4000	4000	-2298
chr2	203390345	203398345	203391100	8000	203394345	-4000	4000	-3245
chr2	208138573	208146573	208145974	8000	208142573	-4000	4000	3401
chr2	208232229	208240229	208239212	8000	208236229	-4000	4000	2983
chr2	214406501	214414501	214414193	8000	214410501	-4000	4000	3692
chr2	216479053	216487053	216482785	8000	216483053	-4000	4000	-268
chr2	218977087	218985087	218982164	8000	218981087	-4000	4000	1077
chr2	219050424	219058424	219057465	8000	219054424	-4000	4000	3041
chr2	219205772	219213772	219213255	8000	219209772	-4000	4000	3483
chr2	223753258	223761258	223758648	8000	223757258	-4000	4000	1390
chr2	230399732	230407732	230401341	8000	230403732	-4000	4000	-2391
chr2	230399732	230407732	230402954	8000	230403732	-4000	4000	-778
chr2	231169116	231177116	231170659	8000	231173116	-4000	4000	-2457
chr2	231519187	231527187	231525077	8000	231523187	-4000	4000	1890
chr2	233343055	233351055	233346924	8000	233347055	-4000	4000	-131
chr2	236578354	236586354	236580564	8000	236582354	-4000	4000	-1790
chr2	240613705	240621705	240616420	8000	240617705	-4000	4000	-1285
chr2	171554129	171562129	171554839	8000	171558129	-4000	4000	-3290
chr2	200849009	200857009	200853945	8000	200853009	-4000	4000	936
chr2	200849009	200857009	200853946	8000	200853009	-4000	4000	937
chr2	20244691	20252691	20250378	8000	20248691	-4000	4000	1687
chr2	96326517	96334517	96327950	8000	96330517	-4000	4000	-2567
chr2	201640870	201648870	201647716	8000	201644870	-4000	4000	2846
chr2	216098783	216106783	216100934	8000	216102783	-4000	4000	-1849
chr2	219489629	219497629	219490892	8000	219493629	-4000	4000	-2737
chr2	79081023	79089023	79085562	8000	79085023	-4000	4000	539
chr2	135783850	135791850	135790788	8000	135787850	-4000	4000	2938
chr2	9401683	9409683	9404913	8000	9405683	-4000	4000	-770
chr2	85787383	85795383	85787899	8000	85791383	-4000	4000	-3484
chr2	230399732	230407732	230400361	8000	230403732	-4000	4000	-3371
chr2	3640644	3648644	3644017	8000	3644644	-4000	4000	-627
chr2	71682763	71690763	71686486	8000	71686763	-4000	4000	-277
chr2	70826211	70834211	70832999	8000	70830211	-4000	4000	2788
chr2	223592940	223600940	223597518	8000	223596940	-4000	4000	578
chr2	15162914	15170914	15166979	8000	15166914	-4000	4000	65
chr2	45001182	45009182	45008980	8000	45005182	-4000	4000	3798
chr2	74553883	74561883	74556793	8000	74557883	-4000	4000	-1090
chr2	79153003	79161003	79157257	8000	79157003	-4000	4000	254
chr2	48511391	48519391	48514722	8000	48515391	-4000	4000	-669
chr2	177219958	177227958	177220304	8000	177223958	-4000	4000	-3654
chr2	241102099	241110099	241106715	8000	241106099	-4000	4000	616
chr2	1627887	1635887	1633908	8000	1631887	-4000	4000	2021
chr2	74104176	74112176	74105627	8000	74108176	-4000	4000	-2549
chr2	233291674	233299674	233295406	8000	233295674	-4000	4000	-268
chr2	230309215	230317215	230311561	8000	230313215	-4000	4000	-1654
chr2	9469101	9477101	9471389	8000	9473101	-4000	4000	-1712
chr2	10910225	10918225	10913741	8000	10914225	-4000	4000	-484
chr2	11440375	11448375	11447732	8000	11444375	-4000	4000	3357
chr2	11654178	11662178	11660120	8000	11658178	-4000	4000	1942
chr2	12738734	12746734	12740619	8000	12742734	-4000	4000	-2115
chr2	19347485	19355485	19353208	8000	19351485	-4000	4000	1723
chr2	20997429	21005429	21005181	8000	21001429	-4000	4000	3752
chr2	23744664	23752664	23751920	8000	23748664	-4000	4000	3256
chr2	26946351	26954351	26946951	8000	26950351	-4000	4000	-3400
chr2	27440377	27448377	27445825	8000	27444377	-4000	4000	1448
chr2	27578720	27586720	27578975	8000	27582720	-4000	4000	-3745
chr2	27578720	27586720	27579272	8000	27582720	-4000	4000	-3448
chr2	27578720	27586720	27580902	8000	27582720	-4000	4000	-1818
chr2	31169056	31177056	31174475	8000	31173056	-4000	4000	1419
chr2	38793729	38801729	38798129	8000	38797729	-4000	4000	400
chr2	39713963	39721963	39717331	8000	39717963	-4000	4000	-632
chr2	43882224	43890224	43888604	8000	43886224	-4000	4000	2380
chr2	44316310	44324310	44320625	8000	44320310	-4000	4000	315
chr2	47383601	47391601	47386687	8000	47387601	-4000	4000	-914
chr2	61820848	61828848	61826570	8000	61824848	-4000	4000	1722
chr2	63053836	63061836	63054067	8000	63057836	-4000	4000	-3769
chr2	65267253	65275253	65268730	8000	65271253	-4000	4000	-2523
chr2	70981942	70989942	70984199	8000	70985942	-4000	4000	-1743
chr2	73636723	73644723	73641045	8000	73640723	-4000	4000	322
chr2	73813147	73821147	73816173	8000	73817147	-4000	4000	-974
chr2	84817650	84825650	84821881	8000	84821650	-4000	4000	231
chr2	85578031	85586031	85581746	8000	85582031	-4000	4000	-285
chr2	85694852	85702852	85698665	8000	85698852	-4000	4000	-187
chr2	88525585	88533585	88529169	8000	88529585	-4000	4000	-416
chr2	98309299	98317299	98311868	8000	98313299	-4000	4000	-1431
chr2	98615106	98623106	98616210	8000	98619106	-4000	4000	-2896
chr2	98615106	98623106	98621548	8000	98619106	-4000	4000	2442
chr2	101267219	101275219	101269471	8000	101271219	-4000	4000	-1748
chr2	101890690	101898690	101891618	8000	101894690	-4000	4000	-3072
chr2	102024544	102032544	102024695	8000	102028544	-4000	4000	-3849
chr2	102175874	102183874	102176753	8000	102179874	-4000	4000	-3121
chr2	108305915	108313915	108308545	8000	108309915	-4000	4000	-1370
chr2	112659825	112667825	112663036	8000	112663825	-4000	4000	-789
chr2	112825751	112833751	112830275	8000	112829751	-4000	4000	524
chr2	112914882	112922882	112915230	8000	112918882	-4000	4000	-3652
chr2	112914882	112922882	112917697	8000	112918882	-4000	4000	-1185
chr2	117828377	117836377	117829390	8000	117832377	-4000	4000	-2987
chr2	119368550	119376550	119372300	8000	119372550	-4000	4000	-250
chr2	120290710	120298710	120293179	8000	120294710	-4000	4000	-1531
chr2	120988653	120996653	120990450	8000	120992653	-4000	4000	-2203
chr2	127179832	127187832	127187178	8000	127183832	-4000	4000	3346
chr2	129978738	129986738	129980790	8000	129982738	-4000	4000	-1948
chr2	130187745	130195745	130193954	8000	130191745	-4000	4000	2209
chr2	132642582	132650582	132645368	8000	132646582	-4000	4000	-1214
chr2	136110349	136118349	136115324	8000	136114349	-4000	4000	975
chr2	138665157	138673157	138671316	8000	138669157	-4000	4000	2159
chr2	150464195	150472195	150470196	8000	150468195	-4000	4000	2001
chr2	151266470	151274470	151271722	8000	151270470	-4000	4000	1252
chr2	158167073	158175073	158172220	8000	158171073	-4000	4000	1147
chr2	166191185	166199185	166199103	8000	166195185	-4000	4000	3918
chr2	166399573	166407573	166405507	8000	166403573	-4000	4000	1934
chr2	169808064	169816064	169810282	8000	169812064	-4000	4000	-1782
chr2	172078430	172086430	172080340	8000	172082430	-4000	4000	-2090
chr2	174794809	174802809	174800269	8000	174798809	-4000	4000	1460
chr2	178427292	178435292	178432079	8000	178431292	-4000	4000	787
chr2	184935492	184943492	184937555	8000	184939492	-4000	4000	-1937
chr2	184935492	184943492	184937875	8000	184939492	-4000	4000	-1617
chr2	186761959	186769959	186762735	8000	186765959	-4000	4000	-3224
chr2	186823475	186831475	186828616	8000	186827475	-4000	4000	1141
chr2	189666831	189674831	189667825	8000	189670831	-4000	4000	-3006
chr2	189666831	189674831	189670620	8000	189670831	-4000	4000	-211
chr2	190199484	190207484	190200263	8000	190203484	-4000	4000	-3221
chr2	190199484	190207484	190204941	8000	190203484	-4000	4000	1457
chr2	201483421	201491421	201487706	8000	201487421	-4000	4000	285
chr2	203734912	203742912	203735069	8000	203738912	-4000	4000	-3843
chr2	206310427	206318427	206311574	8000	206314427	-4000	4000	-2853
chr2	214406501	214414501	214414392	8000	214410501	-4000	4000	3891
chr2	216098783	216106783	216100182	8000	216102783	-4000	4000	-2601
chr2	216855458	216863458	216860030	8000	216859458	-4000	4000	572
chr2	218250356	218258356	218254104	8000	218254356	-4000	4000	-252
chr2	218698716	218706716	218702141	8000	218702716	-4000	4000	-575
chr2	219494287	219502287	219501904	8000	219498287	-4000	4000	3617
chr2	227310792	227318792	227311972	8000	227314792	-4000	4000	-2820
chr2	227813564	227821564	227813896	8000	227817564	-4000	4000	-3668
chr2	227975955	227983955	227981857	8000	227979955	-4000	4000	1902
chr2	230875248	230883248	230875641	8000	230879248	-4000	4000	-3607
chr2	232544115	232552115	232549674	8000	232548115	-4000	4000	1559
chr2	233769300	233777300	233772637	8000	233773300	-4000	4000	-663
chr2	236578354	236586354	236580483	8000	236582354	-4000	4000	-1871
chr2	238396897	238404897	238398909	8000	238400897	-4000	4000	-1988
chr2	240041077	240049077	240041984	8000	240045077	-4000	4000	-3093
chr2	9401683	9409683	9406944	8000	9405683	-4000	4000	1261
chr2	16545459	16553459	16552899	8000	16549459	-4000	4000	3440
chr2	27690976	27698976	27694645	8000	27694976	-4000	4000	-331
chr2	38289954	38297954	38296701	8000	38293954	-4000	4000	2747
chr2	47156084	47164084	47162658	8000	47160084	-4000	4000	2574
chr2	62496218	62504218	62501134	8000	62500218	-4000	4000	916
chr2	86780610	86788610	86788551	8000	86784610	-4000	4000	3941
chr2	240613705	240621705	240617022	8000	240617705	-4000	4000	-683
chr2	9469101	9477101	9472931	8000	9473101	-4000	4000	-170
chr2	70961373	70969373	70964437	8000	70965373	-4000	4000	-936
chr2	208124137	208132137	208129787	8000	208128137	-4000	4000	1650
chr2	227358038	227366038	227363611	8000	227362038	-4000	4000	1573
chr2	235051714	235059714	235054154	8000	235055714	-4000	4000	-1560
chr2	80644861	80652861	80648154	8000	80648861	-4000	4000	-707
chr2	176091944	176099944	176093603	8000	176095944	-4000	4000	-2341
chr2	184935492	184943492	184938102	8000	184939492	-4000	4000	-1390
chr2	73813147	73821147	73816377	8000	73817147	-4000	4000	-770
chr2	191830310	191838310	191836655	8000	191834310	-4000	4000	2345
chr2	64088652	64096652	64094803	8000	64092652	-4000	4000	2151
chr2	97735862	97743862	97738041	8000	97739862	-4000	4000	-1821
chr2	105095960	105103960	105097303	8000	105099960	-4000	4000	-2657
chr2	206310427	206318427	206311057	8000	206314427	-4000	4000	-3370
chr2	216098783	216106783	216100115	8000	216102783	-4000	4000	-2668
chr2	130069535	130077535	130075262	8000	130073535	-4000	4000	1727
chr2	190199484	190207484	190205229	8000	190203484	-4000	4000	1745
chr2	72938036	72946036	72943590	8000	72942036	-4000	4000	1554
chr2	154854354	154862354	154854765	8000	154858354	-4000	4000	-3589
chr2	208124137	208132137	208128271	8000	208128137	-4000	4000	134
chr2	112659825	112667825	112663068	8000	112663825	-4000	4000	-757
chr2	86488716	86496716	86490997	8000	86492716	-4000	4000	-1719
chr2	101267219	101275219	101269580	8000	101271219	-4000	4000	-1639
chr2	209730118	209738118	209731472	8000	209734118	-4000	4000	-2646
chr2	199265500	199273500	199272560	8000	199269500	-4000	4000	3060
chr2	219232598	219240598	219237940	8000	219236598	-4000	4000	1342
chr2	162138882	162146882	162145610	8000	162142882	-4000	4000	2728
chr2	231728433	231736433	231732996	8000	231732433	-4000	4000	563
chr2	232456753	232464753	232458953	8000	232460753	-4000	4000	-1800
chr2	74553883	74561883	74556597	8000	74557883	-4000	4000	-1286
chr2	189556590	189564590	189562024	8000	189560590	-4000	4000	1434
chr2	240135026	240143026	240139173	8000	240139026	-4000	4000	147
chr2	96017946	96025946	96023054	8000	96021946	-4000	4000	1108
chr2	72125238	72133238	72133205	8000	72129238	-4000	4000	3967
chr2	200904977	200912977	200911387	8000	200908977	-4000	4000	2410
chr2	218818383	218826383	218823719	8000	218822383	-4000	4000	1336
chr2	219285623	219293623	219290559	8000	219289623	-4000	4000	936
chr2	97735862	97743862	97738040	8000	97739862	-4000	4000	-1822
chr2	201640870	201648870	201645370	8000	201644870	-4000	4000	500
chr2	232475827	232483827	232482606	8000	232479827	-4000	4000	2779
chr2	237551322	237559322	237552404	8000	237555322	-4000	4000	-2918
chr2	38063142	38071142	38067926	8000	38067142	-4000	4000	784
chr2	159228659	159236659	159230902	8000	159232659	-4000	4000	-1757
chr2	79119409	79127409	79120817	8000	79123409	-4000	4000	-2592
chr2	85387752	85395752	85390230	8000	85391752	-4000	4000	-1522
chr2	241845884	241853884	241851118	8000	241849884	-4000	4000	1234
chr2	233031057	233039057	233034940	8000	233035057	-4000	4000	-117
chr2	67408089	67416089	67410122	8000	67412089	-4000	4000	-1967
chr2	79081023	79089023	79085649	8000	79085023	-4000	4000	626
chr2	38793729	38801729	38798369	8000	38797729	-4000	4000	640
chr2	219534772	219542772	219541058	8000	219538772	-4000	4000	2286
chr2	115841780	115849780	115844266	8000	115845780	-4000	4000	-1514
chr2	140227423	140235423	140233268	8000	140231423	-4000	4000	1845
chr2	71075808	71083808	71078558	8000	71079808	-4000	4000	-1250
chr2	74148528	74156528	74156512	8000	74152528	-4000	4000	3984
chr2	96326517	96334517	96328176	8000	96330517	-4000	4000	-2341
chr2	79153003	79161003	79157626	8000	79157003	-4000	4000	623
chr2	173264015	173272015	173266840	8000	173268015	-4000	4000	-1175
chr2	190505205	190513205	190510407	8000	190509205	-4000	4000	1202
chr2	39713963	39721963	39717398	8000	39717963	-4000	4000	-565
chr2	74553883	74561883	74556693	8000	74557883	-4000	4000	-1190
chr2	206310427	206318427	206311591	8000	206314427	-4000	4000	-2836
chr2	131356492	131364492	131363285	8000	131360492	-4000	4000	2793
chr2	112585275	112593275	112586009	8000	112589275	-4000	4000	-3266
chr2	11440375	11448375	11447672	8000	11444375	-4000	4000	3297
chr2	27239943	27247943	27242764	8000	27243943	-4000	4000	-1179
chr2	27377195	27385195	27383976	8000	27381195	-4000	4000	2781
chr2	70981942	70989942	70984811	8000	70985942	-4000	4000	-1131
chr2	73813147	73821147	73813499	8000	73817147	-4000	4000	-3648
chr2	74131400	74139400	74135517	8000	74135400	-4000	4000	117
chr2	112732349	112740349	112738815	8000	112736349	-4000	4000	2466
chr2	115841780	115849780	115842294	8000	115845780	-4000	4000	-3486
chr2	118106997	118114997	118108316	8000	118110997	-4000	4000	-2681
chr2	136110349	136118349	136115555	8000	136114349	-4000	4000	1206
chr2	172095438	172103438	172101403	8000	172099438	-4000	4000	1965
chr2	199265500	199273500	199272341	8000	199269500	-4000	4000	2841
chr2	202299661	202307661	202303540	8000	202303661	-4000	4000	-121
chr2	206617127	206625127	206617737	8000	206621127	-4000	4000	-3390
chr2	218633184	218641184	218635869	8000	218637184	-4000	4000	-1315
chr2	230903318	230911318	230910519	8000	230907318	-4000	4000	3201
chr2	233031057	233039057	233034571	8000	233035057	-4000	4000	-486
chr2	233769300	233777300	233772421	8000	233773300	-4000	4000	-879
chr2	240041077	240049077	240045564	8000	240045077	-4000	4000	487
chr2	11654178	11662178	11658595	8000	11658178	-4000	4000	417
chr2	118990660	118998660	118993200	8000	118994660	-4000	4000	-1460
chr2	101003228	101011228	101007972	8000	101007228	-4000	4000	744
chr2	164488417	164496417	164492885	8000	164492417	-4000	4000	468
chr2	230903318	230911318	230910533	8000	230907318	-4000	4000	3215
chr2	12738734	12746734	12740511	8000	12742734	-4000	4000	-2223
chr2	70145885	70153885	70150430	8000	70149885	-4000	4000	545
chr2	71075808	71083808	71078345	8000	71079808	-4000	4000	-1463
chr2	96139169	96147169	96144341	8000	96143169	-4000	4000	1172
chr2	232406714	232414714	232407136	8000	232410714	-4000	4000	-3578
chr2	169808064	169816064	169812319	8000	169812064	-4000	4000	255
chr2	161988245	161996245	161993362	8000	161992245	-4000	4000	1117
chr2	201640870	201648870	201645392	8000	201644870	-4000	4000	522
chr2	205794133	205802133	205797762	8000	205798133	-4000	4000	-371
chr2	26577205	26585205	26583796	8000	26581205	-4000	4000	2591
chr2	126692667	126700667	126696163	8000	126696667	-4000	4000	-504
chr2	233769300	233777300	233772280	8000	233773300	-4000	4000	-1020
chr2	26946351	26954351	26947019	8000	26950351	-4000	4000	-3332
chr2	26946351	26954351	26947365	8000	26950351	-4000	4000	-2986
chr2	97752333	97760333	97759001	8000	97756333	-4000	4000	2668
chr2	20997429	21005429	21005266	8000	21001429	-4000	4000	3837
chr2	37246502	37254502	37253207	8000	37250502	-4000	4000	2705
chr2	38289954	38297954	38296700	8000	38293954	-4000	4000	2746
chr2	68651862	68659862	68654918	8000	68655862	-4000	4000	-944
chr2	162138882	162146882	162143369	8000	162142882	-4000	4000	487
chr2	169092167	169100167	169095810	8000	169096167	-4000	4000	-357
chr2	1785113	1793113	1791932	8000	1789113	-4000	4000	2819
chr2	31863809	31871809	31868487	8000	31867809	-4000	4000	678
chr2	55861967	55869967	55867107	8000	55865967	-4000	4000	1140
chr2	106387290	106395290	106387665	8000	106391290	-4000	4000	-3625
chr2	108781809	108789809	108788054	8000	108785809	-4000	4000	2245
chr2	219546595	219554595	219552178	8000	219550595	-4000	4000	1583
chr2	231519187	231527187	231525342	8000	231523187	-4000	4000	2155
chr2	237809682	237817682	237817040	8000	237813682	-4000	4000	3358
chr2	25922598	25930598	25927129	8000	25926598	-4000	4000	531
chr2	101003228	101011228	101008021	8000	101007228	-4000	4000	793
chr2	130069535	130077535	130074258	8000	130073535	-4000	4000	723
chr2	223753258	223761258	223758498	8000	223757258	-4000	4000	1240
chr2	101890690	101898690	101891272	8000	101894690	-4000	4000	-3418
chr2	216660436	216668436	216663770	8000	216664436	-4000	4000	-666
chr2	222195887	222203887	222201216	8000	222199887	-4000	4000	1329
chr2	3640644	3648644	3643820	8000	3644644	-4000	4000	-824
chr2	191830310	191838310	191836181	8000	191834310	-4000	4000	1871
chr2	227679763	227687763	227687232	8000	227683763	-4000	4000	3469
chr2	12738734	12746734	12740470	8000	12742734	-4000	4000	-2264
chr2	181531041	181539041	181534368	8000	181535041	-4000	4000	-673
chr2	48958157	48966157	48962783	8000	48962157	-4000	4000	626
chr2	190367665	190375665	190371312	8000	190371665	-4000	4000	-353
chr2	43763987	43771987	43765516	8000	43767987	-4000	4000	-2471
chr2	73813147	73821147	73813904	8000	73817147	-4000	4000	-3243
chr2	97699066	97707066	97702666	8000	97703066	-4000	4000	-400
chr2	106387290	106395290	106391317	8000	106391290	-4000	4000	27
chr2	10910225	10918225	10913425	8000	10914225	-4000	4000	-800
chr2	108781809	108789809	108783672	8000	108785809	-4000	4000	-2137
chr2	229759837	229767837	229767318	8000	229763837	-4000	4000	3481
chr2	167255753	167263753	167259340	8000	167259753	-4000	4000	-413
chr2	74528258	74536258	74534561	8000	74532258	-4000	4000	2303
chr2	27619217	27627217	27626987	8000	27623217	-4000	4000	3770
chr2	101267219	101275219	101269619	8000	101271219	-4000	4000	-1600
chr2	121722945	121730945	121730802	8000	121726945	-4000	4000	3857
chr2	189556590	189564590	189563796	8000	189560590	-4000	4000	3206
chr2	70291975	70299975	70296011	8000	70295975	-4000	4000	36
chr2	169641425	169649425	169645721	8000	169645425	-4000	4000	296
chr2	233203903	233211903	233204320	8000	233207903	-4000	4000	-3583
chr2	10050836	10058836	10052454	8000	10054836	-4000	4000	-2382
chr2	70804643	70812643	70809790	8000	70808643	-4000	4000	1147
chr2	106387290	106395290	106391063	8000	106391290	-4000	4000	-227
chr2	138665157	138673157	138671647	8000	138669157	-4000	4000	2490
chr2	187460230	187468230	187467043	8000	187464230	-4000	4000	2813
chr2	25156853	25164853	25160982	8000	25160853	-4000	4000	129
chr2	84817650	84825650	84823990	8000	84821650	-4000	4000	2340
chr2	210427249	210435249	210434446	8000	210431249	-4000	4000	3197
chr2	231590276	231598276	231593042	8000	231594276	-4000	4000	-1234
chr2	232475827	232483827	232482433	8000	232479827	-4000	4000	2606
chr2	73758184	73766184	73762742	8000	73762184	-4000	4000	558
chr2	232475827	232483827	232480751	8000	232479827	-4000	4000	924
chr2	31518480	31526480	31526076	8000	31522480	-4000	4000	3596
chr2	79024505	79032505	79026747	8000	79028505	-4000	4000	-1758
chr2	214574976	214582976	214575758	8000	214578976	-4000	4000	-3218
chr2	49914503	49922503	49921993	8000	49918503	-4000	4000	3490
chr2	11654178	11662178	11660084	8000	11658178	-4000	4000	1906
chr2	135835626	135843626	135840836	8000	135839626	-4000	4000	1210
chr2	275558	283558	279771	8000	279558	-4000	4000	213
chr2	20997429	21005429	21001876	8000	21001429	-4000	4000	447
chr2	55861967	55869967	55866762	8000	55865967	-4000	4000	795
chr2	136110349	136118349	136116194	8000	136114349	-4000	4000	1845
chr2	172085677	172093677	172088685	8000	172089677	-4000	4000	-992
chr2	219489629	219497629	219491796	8000	219493629	-4000	4000	-1833
chr2	233769300	233777300	233772400	8000	233773300	-4000	4000	-900
chr2	238164900	238172900	238170459	8000	238168900	-4000	4000	1559
chr2	27578720	27586720	27579661	8000	27582720	-4000	4000	-3059
chr2	164488417	164496417	164492885	8000	164492417	-4000	4000	468
chr2	27037694	27045694	27040363	8000	27041694	-4000	4000	-1331
chr2	44316310	44324310	44321873	8000	44320310	-4000	4000	1563
chr2	149022759	149030759	149026641	8000	149026759	-4000	4000	-118
chr2	98789846	98797846	98794411	8000	98793846	-4000	4000	565
chr2	174344022	174352022	174350706	8000	174348022	-4000	4000	2684
chr2	206310427	206318427	206311275	8000	206314427	-4000	4000	-3152
chr2	215356440	215364440	215361569	8000	215360440	-4000	4000	1129
chr2	60446520	60454520	60452524	8000	60450520	-4000	4000	2004
chr2	201225406	201233406	201229333	8000	201229406	-4000	4000	-73
chr2	69956089	69964089	69960562	8000	69960089	-4000	4000	473
chr2	171779405	171787405	171785426	8000	171783405	-4000	4000	2021
chr2	33395509	33403509	33397174	8000	33399509	-4000	4000	-2335
chr2	72125238	72133238	72132380	8000	72129238	-4000	4000	3142
chr2	80644861	80652861	80647802	8000	80648861	-4000	4000	-1059
chr2	18551545	18559545	18555254	8000	18555545	-4000	4000	-291
chr2	186823475	186831475	186828675	8000	186827475	-4000	4000	1200
chr2	9484486	9492486	9490215	8000	9488486	-4000	4000	1729
chr2	222940639	222948639	222941500	8000	222944639	-4000	4000	-3139
chr2	8680461	8688461	8682075	8000	8684461	-4000	4000	-2386
chr2	95180317	95188317	95181554	8000	95184317	-4000	4000	-2763
chr2	237320003	237328003	237324698	8000	237324003	-4000	4000	695
chr2	88525585	88533585	88529542	8000	88529585	-4000	4000	-43
chr2	189008746	189016746	189010812	8000	189012746	-4000	4000	-1934
chr2	191421389	191429389	191423986	8000	191425389	-4000	4000	-1403
chr2	230399732	230407732	230403127	8000	230403732	-4000	4000	-605
chr2	240025491	240033491	240030159	8000	240029491	-4000	4000	668
chr2	9401683	9409683	9407025	8000	9405683	-4000	4000	1342
chr2	172085677	172093677	172086870	8000	172089677	-4000	4000	-2807
chr2	218158841	218166841	218164301	8000	218162841	-4000	4000	1460
chr2	74457057	74465057	74463474	8000	74461057	-4000	4000	2417
chr2	112115318	112123318	112116141	8000	112119318	-4000	4000	-3177
chr2	219232598	219240598	219239673	8000	219236598	-4000	4000	3075
chr2	183157680	183165680	183158287	8000	183161680	-4000	4000	-3393
chr2	230903318	230911318	230910910	8000	230907318	-4000	4000	3592
chr2	219050424	219058424	219055681	8000	219054424	-4000	4000	1257
chr2	98394601	98402601	98397126	8000	98398601	-4000	4000	-1475
chr2	176169102	176177102	176169372	8000	176173102	-4000	4000	-3730
chr2	191025576	191033576	191031503	8000	191029576	-4000	4000	1927
chr2	96017946	96025946	96023398	8000	96021946	-4000	4000	1452
chr2	230399732	230407732	230402923	8000	230403732	-4000	4000	-809
chr2	222195887	222203887	222201230	8000	222199887	-4000	4000	1343
chr2	206310427	206318427	206311211	8000	206314427	-4000	4000	-3216
chr2	218870233	218878233	218871703	8000	218874233	-4000	4000	-2530
chr2	64088652	64096652	64094982	8000	64092652	-4000	4000	2330
chr2	98394601	98402601	98396940	8000	98398601	-4000	4000	-1661
chr2	152112801	152120801	152120697	8000	152116801	-4000	4000	3896
chr2	157732251	157740251	157737385	8000	157736251	-4000	4000	1134
chr2	233769300	233777300	233772633	8000	233773300	-4000	4000	-667
chr2	79024505	79032505	79026771	8000	79028505	-4000	4000	-1734
chr2	79024505	79032505	79026772	8000	79028505	-4000	4000	-1733
chr2	230399732	230407732	230401049	8000	230403732	-4000	4000	-2683
chr2	39732060	39740060	39736844	8000	39736060	-4000	4000	784
chr2	130135287	130143287	130140020	8000	130139287	-4000	4000	733
chr2	119261652	119269652	119263290	8000	119265652	-4000	4000	-2362
chr2	12738734	12746734	12740804	8000	12742734	-4000	4000	-1930
chr2	98595314	98603314	98600605	8000	98599314	-4000	4000	1291
chr2	232856605	232864605	232856888	8000	232860605	-4000	4000	-3717
chr2	27094889	27102889	27101172	8000	27098889	-4000	4000	2283
chr2	27377195	27385195	27383440	8000	27381195	-4000	4000	2245
chr2	68941232	68949232	68947203	8000	68945232	-4000	4000	1971
chr2	86780610	86788610	86785789	8000	86784610	-4000	4000	1179
chr2	96326517	96334517	96326917	8000	96330517	-4000	4000	-3600
chr2	102024544	102032544	102024639	8000	102028544	-4000	4000	-3905
chr2	102707355	102715355	102708370	8000	102711355	-4000	4000	-2985
chr2	113004044	113012044	113005992	8000	113008044	-4000	4000	-2052
chr2	115841780	115849780	115842316	8000	115845780	-4000	4000	-3464
chr2	149211262	149219262	149214836	8000	149215262	-4000	4000	-426
chr2	174425575	174433575	174427895	8000	174429575	-4000	4000	-1680
chr2	186761959	186769959	186762801	8000	186765959	-4000	4000	-3158
chr2	218342793	218350793	218344564	8000	218346793	-4000	4000	-2229
chr2	218751416	218759416	218751704	8000	218755416	-4000	4000	-3712
chr2	241091568	241099568	241097333	8000	241095568	-4000	4000	1765
chr2	176186907	176194907	176190684	8000	176190907	-4000	4000	-223
chr2	113071843	113079843	113075251	8000	113075843	-4000	4000	-592
chr2	96017946	96025946	96023332	8000	96021946	-4000	4000	1386
chr2	74501043	74509043	74507207	8000	74505043	-4000	4000	2164
chr2	36810794	36818794	36814447	8000	36814794	-4000	4000	-347
chr2	30156533	30164533	30158973	8000	30160533	-4000	4000	-1560
chr2	55283842	55291842	55288438	8000	55287842	-4000	4000	596
chr2	74966128	74974128	74969570	8000	74970128	-4000	4000	-558
chr2	233343055	233351055	233346855	8000	233347055	-4000	4000	-200
chr2	239044168	239052168	239050877	8000	239048168	-4000	4000	2709
chr2	240025491	240033491	240029875	8000	240029491	-4000	4000	384
chr2	222195887	222203887	222201138	8000	222199887	-4000	4000	1251
chr2	161988245	161996245	161993077	8000	161992245	-4000	4000	832
chr2	189008746	189016746	189011851	8000	189012746	-4000	4000	-895
chr3	11259557	11267557	11259653	8000	11263557	-4000	4000	-3904
chr3	46511385	46519385	46519054	8000	46515385	-4000	4000	3669
chr3	13812258	13820258	13819294	8000	13816258	-4000	4000	3036
chr3	52690486	52698486	52696597	8000	52694486	-4000	4000	2111
chr3	182917629	182925629	182918280	8000	182921629	-4000	4000	-3349
chr3	14930571	14938571	14932722	8000	14934571	-4000	4000	-1849
chr3	33146043	33154043	33153616	8000	33150043	-4000	4000	3573
chr3	32992609	33000609	32996989	8000	32996609	-4000	4000	380
chr3	39259495	39267495	39265654	8000	39263495	-4000	4000	2159
chr3	196828647	196836647	196829146	8000	196832647	-4000	4000	-3501
chr3	186101668	186109668	186108464	8000	186105668	-4000	4000	2796
chr3	38544057	38552057	38551545	8000	38548057	-4000	4000	3488
chr3	49353176	49361176	49360170	8000	49357176	-4000	4000	2994
chr3	57193838	57201838	57198473	8000	57197838	-4000	4000	635
chr3	69102092	69110092	69108878	8000	69106092	-4000	4000	2786
chr3	169833773	169841773	169839987	8000	169837773	-4000	4000	2214
chr3	165182720	165190720	165188383	8000	165186720	-4000	4000	1663
chr3	138057990	138065990	138062838	8000	138061990	-4000	4000	848
chr3	172885357	172893357	172889619	8000	172889357	-4000	4000	262
chr3	3140628	3148628	3147464	8000	3144628	-4000	4000	2836
chr3	15663236	15671236	15670391	8000	15667236	-4000	4000	3155
chr3	17086604	17094604	17089894	8000	17090604	-4000	4000	-710
chr3	50284114	50292114	50286530	8000	50288114	-4000	4000	-1584
chr3	98387631	98395631	98391062	8000	98391631	-4000	4000	-569
chr3	142445007	142453007	142451456	8000	142449007	-4000	4000	2449
chr3	170301977	170309977	170303081	8000	170305977	-4000	4000	-2896
chr3	172626249	172634249	172633308	8000	172630249	-4000	4000	3059
chr3	186617318	186625318	186620726	8000	186621318	-4000	4000	-592
chr3	186674234	186682234	186677649	8000	186678234	-4000	4000	-585
chr3	195510428	195518428	195516718	8000	195514428	-4000	4000	2290
chr3	191261615	191269615	191268257	8000	191265615	-4000	4000	2642
chr3	38314575	38322575	38316407	8000	38318575	-4000	4000	-2168
chr3	113282930	113290930	113285545	8000	113286930	-4000	4000	-1385
chr3	43051871	43059871	43053563	8000	43055871	-4000	4000	-2308
chr3	47342816	47350816	47343758	8000	47346816	-4000	4000	-3058
chr3	77645964	77653964	77646096	8000	77649964	-4000	4000	-3868
chr3	143120014	143128014	143122056	8000	143124014	-4000	4000	-1958
chr3	181710436	181718436	181712610	8000	181714436	-4000	4000	-1826
chr3	49801030	49809030	49807806	8000	49805030	-4000	4000	2776
chr3	13812258	13820258	13819288	8000	13816258	-4000	4000	3030
chr3	167235843	167243843	167240908	8000	167239843	-4000	4000	1065
chr3	36708421	36716421	36715426	8000	36712421	-4000	4000	3005
chr3	156535553	156543553	156536862	8000	156539553	-4000	4000	-2691
chr3	165768904	165776904	165773438	8000	165772904	-4000	4000	534
chr3	184102995	184110995	184105791	8000	184106995	-4000	4000	-1204
chr3	46356940	46364940	46358654	8000	46360940	-4000	4000	-2286
chr3	49172486	49180486	49174942	8000	49176486	-4000	4000	-1544
chr3	55070557	55078557	55073827	8000	55074557	-4000	4000	-730
chr3	113960137	113968137	113960995	8000	113964137	-4000	4000	-3142
chr3	186674234	186682234	186677599	8000	186678234	-4000	4000	-635
chr3	151824488	151832488	151827868	8000	151828488	-4000	4000	-620
chr3	13812258	13820258	13819072	8000	13816258	-4000	4000	2814
chr3	190301707	190309707	190308239	8000	190305707	-4000	4000	2532
chr3	62365681	62373681	62369766	8000	62369681	-4000	4000	85
chr3	122905082	122913082	122912043	8000	122909082	-4000	4000	2961
chr3	129973935	129981935	129976806	8000	129977935	-4000	4000	-1129
chr3	15446133	15454133	15451110	8000	15450133	-4000	4000	977
chr3	24113153	24121153	24118591	8000	24117153	-4000	4000	1438
chr3	46356940	46364940	46358231	8000	46360940	-4000	4000	-2709
chr3	123606049	123614049	123614026	8000	123610049	-4000	4000	3977
chr3	154268546	154276546	154275753	8000	154272546	-4000	4000	3207
chr3	38544057	38552057	38550236	8000	38548057	-4000	4000	2179
chr3	149314498	149322498	149321194	8000	149318498	-4000	4000	2696
chr3	154253827	154261827	154254740	8000	154257827	-4000	4000	-3087
chr3	38841764	38849764	38847558	8000	38845764	-4000	4000	1794
chr3	118896557	118904557	118902892	8000	118900557	-4000	4000	2335
chr3	130480844	130488844	130484037	8000	130484844	-4000	4000	-807
chr3	190301707	190309707	190308213	8000	190305707	-4000	4000	2506
chr3	98280070	98288070	98283434	8000	98284070	-4000	4000	-636
chr3	37046846	37054846	37053634	8000	37050846	-4000	4000	2788
chr3	10281796	10289796	10287051	8000	10285796	-4000	4000	1255
chr3	185186624	185194624	185193266	8000	185190624	-4000	4000	2642
chr3	39179210	39187210	39186991	8000	39183210	-4000	4000	3781
chr3	194335768	194343768	194342110	8000	194339768	-4000	4000	2342
chr3	154268546	154276546	154276197	8000	154272546	-4000	4000	3651
chr3	178840429	178848429	178842890	8000	178844429	-4000	4000	-1539
chr3	38314575	38322575	38318202	8000	38318575	-4000	4000	-373
chr3	44910990	44918990	44913801	8000	44914990	-4000	4000	-1189
chr3	49853988	49861988	49859274	8000	49857988	-4000	4000	1286
chr3	184578408	184586408	184580798	8000	184582408	-4000	4000	-1610
chr3	187664912	187672912	187669060	8000	187668912	-4000	4000	148
chr3	11553665	11561665	11557264	8000	11557665	-4000	4000	-401
chr3	45078277	45086277	45086068	8000	45082277	-4000	4000	3791
chr3	98280070	98288070	98283171	8000	98284070	-4000	4000	-899
chr3	129547467	129555467	129549196	8000	129551467	-4000	4000	-2271
chr3	183118215	183126215	183123678	8000	183122215	-4000	4000	1463
chr3	194335768	194343768	194342577	8000	194339768	-4000	4000	2809
chr3	123606049	123614049	123613846	8000	123610049	-4000	4000	3797
chr3	13812258	13820258	13819295	8000	13816258	-4000	4000	3037
chr3	122905082	122913082	122912872	8000	122909082	-4000	4000	3790
chr3	49020325	49028325	49022530	8000	49024325	-4000	4000	-1795
chr3	125524858	125532858	125529336	8000	125528858	-4000	4000	478
chr3	49273144	49281144	49274119	8000	49277144	-4000	4000	-3025
chr3	97940984	97948984	97942778	8000	97944984	-4000	4000	-2206
chr3	122735999	122743999	122740823	8000	122739999	-4000	4000	824
chr3	97940984	97948984	97942778	8000	97944984	-4000	4000	-2206
chr3	119803570	119811570	119807352	8000	119807570	-4000	4000	-218
chr3	141922549	141930549	141925705	8000	141926549	-4000	4000	-844
chr3	42253825	42261825	42258208	8000	42257825	-4000	4000	383
chr3	9890349	9898349	9893024	8000	9894349	-4000	4000	-1325
chr3	52690486	52698486	52693226	8000	52694486	-4000	4000	-1260
chr3	187664912	187672912	187669243	8000	187668912	-4000	4000	331
chr3	46356940	46364940	46358373	8000	46360940	-4000	4000	-2567
chr3	50316027	50324027	50319639	8000	50320027	-4000	4000	-388
chr3	73378431	73386431	73383733	8000	73382431	-4000	4000	1302
chr3	98280070	98288070	98283352	8000	98284070	-4000	4000	-718
chr3	112009887	112017887	112011815	8000	112013887	-4000	4000	-2072
chr3	49883002	49891002	49887427	8000	49887002	-4000	4000	425
chr3	113282930	113290930	113284562	8000	113286930	-4000	4000	-2368
chr3	100744964	100752964	100752803	8000	100748964	-4000	4000	3839
chr3	171596404	171604404	171603085	8000	171600404	-4000	4000	2681
chr3	127676926	127684926	127680113	8000	127680926	-4000	4000	-813
chr3	10097932	10105932	10104750	8000	10101932	-4000	4000	2818
chr3	142445007	142453007	142450671	8000	142449007	-4000	4000	1664
chr3	115717490	115725490	115720829	8000	115721490	-4000	4000	-661
chr3	51714613	51722613	51715260	8000	51718613	-4000	4000	-3353
chr3	73059337	73067337	73065426	8000	73063337	-4000	4000	2089
chr3	170082732	170090732	170084314	8000	170086732	-4000	4000	-2418
chr3	184289031	184297031	184290270	8000	184293031	-4000	4000	-2761
chr3	192792815	192800815	192798931	8000	192796815	-4000	4000	2116
chr3	33146043	33154043	33152561	8000	33150043	-4000	4000	2518
chr3	150737125	150745125	150742084	8000	150741125	-4000	4000	959
chr3	98517133	98525133	98521228	8000	98521133	-4000	4000	95
chr3	149158410	149166410	149160126	8000	149162410	-4000	4000	-2284
chr3	184578408	184586408	184581610	8000	184582408	-4000	4000	-798
chr3	43051871	43059871	43053679	8000	43055871	-4000	4000	-2192
chr3	45078277	45086277	45085679	8000	45082277	-4000	4000	3402
chr3	46356940	46364940	46357543	8000	46360940	-4000	4000	-3397
chr3	49117114	49125114	49122729	8000	49121114	-4000	4000	1615
chr3	122523924	122531924	122528636	8000	122527924	-4000	4000	712
chr3	146188335	146196335	146194336	8000	146192335	-4000	4000	2001
chr3	196502879	196510879	196503222	8000	196506879	-4000	4000	-3657
chr3	133393775	133401775	133400362	8000	133397775	-4000	4000	2587
chr3	184035369	184043369	184038616	8000	184039369	-4000	4000	-753
chr3	46012990	46020990	46020972	8000	46016990	-4000	4000	3982
chr3	48560073	48568073	48565185	8000	48564073	-4000	4000	1112
chr3	48616759	48624759	48621492	8000	48620759	-4000	4000	733
chr3	49117114	49125114	49122810	8000	49121114	-4000	4000	1696
chr3	49720294	49728294	49727204	8000	49724294	-4000	4000	2910
chr3	53863066	53871066	53868796	8000	53867066	-4000	4000	1730
chr3	73378431	73386431	73384569	8000	73382431	-4000	4000	2138
chr3	128458437	128466437	128462640	8000	128462437	-4000	4000	203
chr3	135256467	135264467	135259156	8000	135260467	-4000	4000	-1311
chr3	146065440	146073440	146071099	8000	146069440	-4000	4000	1659
chr3	184578408	184586408	184581608	8000	184582408	-4000	4000	-800
chr3	169079499	169087499	169084948	8000	169083499	-4000	4000	1449
chr3	134595923	134603923	134603857	8000	134599923	-4000	4000	3934
chr3	172626249	172634249	172634058	8000	172630249	-4000	4000	3809
chr3	51953454	51961454	51958937	8000	51957454	-4000	4000	1483
chr3	62365681	62373681	62371314	8000	62369681	-4000	4000	1633
chr3	146065440	146073440	146073327	8000	146069440	-4000	4000	3887
chr3	32992609	33000609	32996848	8000	32996609	-4000	4000	239
chr3	39179210	39187210	39185748	8000	39183210	-4000	4000	2538
chr3	73378431	73386431	73384794	8000	73382431	-4000	4000	2363
chr3	108851005	108859005	108853749	8000	108855005	-4000	4000	-1256
chr3	120680938	120688938	120682316	8000	120684938	-4000	4000	-2622
chr3	130673044	130681044	130675559	8000	130677044	-4000	4000	-1485
chr3	142709664	142717664	142711966	8000	142713664	-4000	4000	-1698
chr3	149365022	149373022	149371684	8000	149369022	-4000	4000	2662
chr3	155179704	155187704	155180599	8000	155183704	-4000	4000	-3105
chr3	182917629	182925629	182918224	8000	182921629	-4000	4000	-3405
chr3	187116948	187124948	187120988	8000	187120948	-4000	4000	40
chr3	187197462	187205462	187199618	8000	187201462	-4000	4000	-1844
chr3	43075229	43083229	43080042	8000	43079229	-4000	4000	813
chr3	156702770	156710770	156704888	8000	156706770	-4000	4000	-1882
chr3	179236093	179244093	179242830	8000	179240093	-4000	4000	2737
chr3	58560117	58568117	58567244	8000	58564117	-4000	4000	3127
chr3	3053959	3061959	3057718	8000	3057959	-4000	4000	-241
chr3	138940224	138948224	138946516	8000	138944224	-4000	4000	2292
chr3	38003496	38011496	38010503	8000	38007496	-4000	4000	3007
chr3	192792815	192800815	192797181	8000	192796815	-4000	4000	366
chr3	101562446	101570446	101565611	8000	101566446	-4000	4000	-835
chr3	138648698	138656698	138655451	8000	138652698	-4000	4000	2753
chr3	9784219	9792219	9789945	8000	9788219	-4000	4000	1726
chr3	52541352	52549352	52547895	8000	52545352	-4000	4000	2543
chr3	139513434	139521434	139517646	8000	139517434	-4000	4000	212
chr3	51890876	51898876	51895252	8000	51894876	-4000	4000	376
chr3	184238329	184246329	184245768	8000	184242329	-4000	4000	3439
chr3	27368721	27376721	27376632	8000	27372721	-4000	4000	3911
chr3	142803888	142811888	142806433	8000	142807888	-4000	4000	-1455
chr3	108545864	108553864	108551286	8000	108549864	-4000	4000	1422
chr3	161499942	161507942	161503600	8000	161503942	-4000	4000	-342
chr3	187116948	187124948	187121142	8000	187120948	-4000	4000	194
chr3	119585945	119593945	119587847	8000	119589945	-4000	4000	-2098
chr3	9744019	9752019	9750183	8000	9748019	-4000	4000	2164
chr3	39179210	39187210	39186712	8000	39183210	-4000	4000	3502
chr3	43075229	43083229	43081285	8000	43079229	-4000	4000	2056
chr3	128475427	128483427	128481005	8000	128479427	-4000	4000	1578
chr3	14930571	14938571	14933243	8000	14934571	-4000	4000	-1328
chr3	33146043	33154043	33153223	8000	33150043	-4000	4000	3180
chr3	46356940	46364940	46358473	8000	46360940	-4000	4000	-2467
chr3	142811922	142819922	142818424	8000	142815922	-4000	4000	2502
chr3	42688544	42696544	42691928	8000	42692544	-4000	4000	-616
chr3	50343330	50351330	50348728	8000	50347330	-4000	4000	1398
chr3	52805009	52813009	52807005	8000	52809009	-4000	4000	-2004
chr3	53863066	53871066	53868752	8000	53867066	-4000	4000	1686
chr3	98261356	98269356	98265029	8000	98265356	-4000	4000	-327
chr3	113438718	113446718	113445261	8000	113442718	-4000	4000	2543
chr3	122635047	122643047	122636033	8000	122639047	-4000	4000	-3014
chr3	189893276	189901276	189894348	8000	189897276	-4000	4000	-2928
chr3	126338635	126346635	126343759	8000	126342635	-4000	4000	1124
chr3	186101668	186109668	186105304	8000	186105668	-4000	4000	-364
chr3	49117114	49125114	49124888	8000	49121114	-4000	4000	3774
chr3	46831111	46839111	46833740	8000	46835111	-4000	4000	-1371
chr3	185186624	185194624	185192380	8000	185190624	-4000	4000	1756
chr3	186785880	186793880	186786163	8000	186789880	-4000	4000	-3717
chr3	45078277	45086277	45085621	8000	45082277	-4000	4000	3344
chr3	129531344	129539344	129532728	8000	129535344	-4000	4000	-2616
chr3	107374635	107382635	107377665	8000	107378635	-4000	4000	-970
chr3	180598858	180606858	180603256	8000	180602858	-4000	4000	398
chr3	184056673	184064673	184060488	8000	184060673	-4000	4000	-185
chr3	197885077	197893077	197892643	8000	197889077	-4000	4000	3566
chr3	52250434	52258434	52256479	8000	52254434	-4000	4000	2045
chr3	121627399	121635399	121631842	8000	121631399	-4000	4000	443
chr3	46496950	46504950	46498111	8000	46500950	-4000	4000	-2839
chr3	113960137	113968137	113965097	8000	113964137	-4000	4000	960
chr3	186740410	186748410	186742089	8000	186744410	-4000	4000	-2321
chr3	36544007	36552007	36546332	8000	36548007	-4000	4000	-1675
chr3	129273773	129281773	129279823	8000	129277773	-4000	4000	2050
chr3	154330943	154338943	154337964	8000	154334943	-4000	4000	3021
chr3	165182720	165190720	165190297	8000	165186720	-4000	4000	3577
chr3	186674234	186682234	186677764	8000	186678234	-4000	4000	-470
chr3	49531618	49539618	49534021	8000	49535618	-4000	4000	-1597
chr3	112127004	112135004	112130395	8000	112131004	-4000	4000	-609
chr3	159992019	160000019	159993063	8000	159996019	-4000	4000	-2956
chr3	186785880	186793880	186789778	8000	186789880	-4000	4000	-102
chr3	7737533	7745533	7740986	8000	7741533	-4000	4000	-547
chr3	12188032	12196032	12190951	8000	12192032	-4000	4000	-1081
chr3	149026127	149034127	149032250	8000	149030127	-4000	4000	2123
chr3	52829121	52837121	52833406	8000	52833121	-4000	4000	285
chr3	89478134	89486134	89479978	8000	89482134	-4000	4000	-2156
chr3	9912402	9920402	9917414	8000	9916402	-4000	4000	1012
chr3	142445007	142453007	142451516	8000	142449007	-4000	4000	2509
chr3	47558238	47566238	47562432	8000	47562238	-4000	4000	194
chr3	122726840	122734840	122728448	8000	122730840	-4000	4000	-2392
chr3	178840429	178848429	178843271	8000	178844429	-4000	4000	-1158
chr3	40308424	40316424	40312169	8000	40312424	-4000	4000	-255
chr3	122905082	122913082	122910946	8000	122909082	-4000	4000	1864
chr3	128458437	128466437	128462995	8000	128462437	-4000	4000	558
chr3	184180214	184188214	184187957	8000	184184214	-4000	4000	3743
chr3	98261356	98269356	98264792	8000	98265356	-4000	4000	-564
chr3	137762334	137770334	137765468	8000	137766334	-4000	4000	-866
chr3	194685037	194693037	194687123	8000	194689037	-4000	4000	-1914
chr3	48221491	48229491	48223500	8000	48225491	-4000	4000	-1991
chr3	112358812	112366812	112361812	8000	112362812	-4000	4000	-1000
chr3	39259495	39267495	39266311	8000	39263495	-4000	4000	2816
chr3	128458437	128466437	128462906	8000	128462437	-4000	4000	469
chr3	194335768	194343768	194341207	8000	194339768	-4000	4000	1439
chr3	122117139	122125139	122118050	8000	122121139	-4000	4000	-3089
chr3	120160645	120168645	120167865	8000	120164645	-4000	4000	3220
chr3	134595923	134603923	134603558	8000	134599923	-4000	4000	3635
chr3	9744019	9752019	9750397	8000	9748019	-4000	4000	2378
chr3	172501508	172509508	172506651	8000	172505508	-4000	4000	1143
chr3	113282930	113290930	113286811	8000	113286930	-4000	4000	-119
chr3	197885077	197893077	197891522	8000	197889077	-4000	4000	2445
chr3	3140628	3148628	3147655	8000	3144628	-4000	4000	3027
chr3	38489142	38497142	38489417	8000	38493142	-4000	4000	-3725
chr3	38489142	38497142	38492376	8000	38493142	-4000	4000	-766
chr3	143120014	143128014	143121301	8000	143124014	-4000	4000	-2713
chr3	143120014	143128014	143121302	8000	143124014	-4000	4000	-2712
chr3	98387631	98395631	98391582	8000	98391631	-4000	4000	-49
chr3	184386736	184394736	184389433	8000	184390736	-4000	4000	-1303
chr3	58498360	58506360	58501648	8000	58502360	-4000	4000	-712
chr3	108374285	108382285	108375785	8000	108378285	-4000	4000	-2500
chr3	122905082	122913082	122911501	8000	122909082	-4000	4000	2419
chr3	129273773	129281773	129277293	8000	129277773	-4000	4000	-480
chr3	9912402	9920402	9917891	8000	9916402	-4000	4000	1489
chr3	33492245	33500245	33497407	8000	33496245	-4000	4000	1162
chr3	38544057	38552057	38551157	8000	38548057	-4000	4000	3100
chr3	39179210	39187210	39184962	8000	39183210	-4000	4000	1752
chr3	47581269	47589269	47587206	8000	47585269	-4000	4000	1937
chr3	47581269	47589269	47587352	8000	47585269	-4000	4000	2083
chr3	122735999	122743999	122740545	8000	122739999	-4000	4000	546
chr3	126432556	126440556	126439696	8000	126436556	-4000	4000	3140
chr3	138294384	138302384	138301487	8000	138298384	-4000	4000	3103
chr3	184102995	184110995	184104791	8000	184106995	-4000	4000	-2204
chr3	190655750	190663750	190656560	8000	190659750	-4000	4000	-3190
chr3	198039720	198047720	198043578	8000	198043720	-4000	4000	-142
chr3	45819316	45827316	45826216	8000	45823316	-4000	4000	2900
chr3	49025707	49033707	49033202	8000	49029707	-4000	4000	3495
chr3	184364596	184372596	184368317	8000	184368596	-4000	4000	-279
chr3	11259557	11267557	11259953	8000	11263557	-4000	4000	-3604
chr3	44719831	44727831	44721521	8000	44723831	-4000	4000	-2310
chr3	58498360	58506360	58501075	8000	58502360	-4000	4000	-1285
chr3	177015340	177023340	177022839	8000	177019340	-4000	4000	3499
chr3	183680519	183688519	183684344	8000	183684519	-4000	4000	-175
chr3	30722197	30730197	30728316	8000	30726197	-4000	4000	2119
chr3	114230631	114238631	114237078	8000	114234631	-4000	4000	2447
chr3	165182720	165190720	165187580	8000	165186720	-4000	4000	860
chr3	172397669	172405669	172398863	8000	172401669	-4000	4000	-2806
chr3	32952349	32960349	32954205	8000	32956349	-4000	4000	-2144
chr3	112811709	112819709	112815739	8000	112815709	-4000	4000	30
chr3	38003496	38011496	38006188	8000	38007496	-4000	4000	-1308
chr3	49853988	49861988	49861601	8000	49857988	-4000	4000	3613
chr3	190301707	190309707	190308238	8000	190305707	-4000	4000	2531
chr3	49786732	49794732	49791736	8000	49790732	-4000	4000	1004
chr3	56617837	56625837	56619365	8000	56621837	-4000	4000	-2472
chr3	98517133	98525133	98518960	8000	98521133	-4000	4000	-2173
chr3	69050730	69058730	69052060	8000	69054730	-4000	4000	-2670
chr3	49801030	49809030	49808098	8000	49805030	-4000	4000	3068
chr3	129397321	129405321	129401661	8000	129401321	-4000	4000	340
chr3	149026127	149034127	149026498	8000	149030127	-4000	4000	-3629
chr3	186740410	186748410	186742066	8000	186744410	-4000	4000	-2344
chr3	170992347	171000347	170997942	8000	170996347	-4000	4000	1595
chr3	38139022	38147022	38141360	8000	38143022	-4000	4000	-1662
chr3	38544057	38552057	38551286	8000	38548057	-4000	4000	3229
chr3	119625811	119633811	119629445	8000	119629811	-4000	4000	-366
chr3	156535553	156543553	156536864	8000	156539553	-4000	4000	-2689
chr3	156535553	156543553	156543206	8000	156539553	-4000	4000	3653
chr3	33146043	33154043	33152561	8000	33150043	-4000	4000	2518
chr3	170082732	170090732	170084346	8000	170086732	-4000	4000	-2386
chr3	183011218	183019218	183015405	8000	183015218	-4000	4000	187
chr3	50645291	50653291	50646822	8000	50649291	-4000	4000	-2469
chr3	114230631	114238631	114236919	8000	114234631	-4000	4000	2288
chr3	57289699	57297699	57296396	8000	57293699	-4000	4000	2697
chr3	101320205	101328205	101327740	8000	101324205	-4000	4000	3535
chr3	87989839	87997839	87990825	8000	87993839	-4000	4000	-3014
chr3	151880619	151888619	151880667	8000	151884619	-4000	4000	-3952
chr3	132364298	132372298	132368191	8000	132368298	-4000	4000	-107
chr3	165182720	165190720	165189015	8000	165186720	-4000	4000	2295
chr3	184035369	184043369	184038038	8000	184039369	-4000	4000	-1331
chr3	39179210	39187210	39186127	8000	39183210	-4000	4000	2917
chr3	127668802	127676802	127676299	8000	127672802	-4000	4000	3497
chr3	190655750	190663750	190656164	8000	190659750	-4000	4000	-3586
chr3	142709664	142717664	142712670	8000	142713664	-4000	4000	-994
chr3	132554142	132562142	132559006	8000	132558142	-4000	4000	864
chr3	196464783	196472783	196472723	8000	196468783	-4000	4000	3940
chr3	72745277	72753277	72750245	8000	72749277	-4000	4000	968
chr3	187368076	187376076	187371001	8000	187372076	-4000	4000	-1075
chr3	58168251	58176251	58168475	8000	58172251	-4000	4000	-3776
chr3	27711949	27719949	27718854	8000	27715949	-4000	4000	2905
chr3	48621723	48629723	48627966	8000	48625723	-4000	4000	2243
chr3	42688544	42696544	42689004	8000	42692544	-4000	4000	-3540
chr3	23887640	23895640	23893232	8000	23891640	-4000	4000	1592
chr3	1400217	1408217	1403343	8000	1404217	-4000	4000	-874
chr3	15663236	15671236	15670395	8000	15667236	-4000	4000	3159
chr3	52690486	52698486	52690752	8000	52694486	-4000	4000	-3734
chr3	118896557	118904557	118902473	8000	118900557	-4000	4000	1916
chr3	133586261	133594261	133588210	8000	133590261	-4000	4000	-2051
chr3	168004689	168012689	168010817	8000	168008689	-4000	4000	2128
chr3	186785880	186793880	186789210	8000	186789880	-4000	4000	-670
chr3	194335768	194343768	194341881	8000	194339768	-4000	4000	2113
chr3	50316027	50324027	50319897	8000	50320027	-4000	4000	-130
chr3	10097932	10105932	10104504	8000	10101932	-4000	4000	2572
chr3	70955226	70963226	70959217	8000	70959226	-4000	4000	-9
chr3	101644889	101652889	101651357	8000	101648889	-4000	4000	2468
chr3	126956420	126964420	126957439	8000	126960420	-4000	4000	-2981
chr3	150737125	150745125	150741414	8000	150741125	-4000	4000	289
chr3	49883002	49891002	49887165	8000	49887002	-4000	4000	163
chr3	142803888	142811888	142806250	8000	142807888	-4000	4000	-1638
chr3	192792815	192800815	192799272	8000	192796815	-4000	4000	2457
chr3	58498360	58506360	58501015	8000	58502360	-4000	4000	-1345
chr3	46356940	46364940	46358518	8000	46360940	-4000	4000	-2422
chr3	178840429	178848429	178842923	8000	178844429	-4000	4000	-1506
chr3	49786732	49794732	49793714	8000	49790732	-4000	4000	2982
chr3	122905082	122913082	122910031	8000	122909082	-4000	4000	949
chr3	46356940	46364940	46358488	8000	46360940	-4000	4000	-2452
chr3	9890349	9898349	9893449	8000	9894349	-4000	4000	-900
chr3	48621723	48629723	48627048	8000	48625723	-4000	4000	1325
chr3	180978753	180986753	180984666	8000	180982753	-4000	4000	1913
chr3	190655750	190663750	190656512	8000	190659750	-4000	4000	-3238
chr3	52690486	52698486	52692922	8000	52694486	-4000	4000	-1564
chr3	52690486	52698486	52695945	8000	52694486	-4000	4000	1459
chr3	184180214	184188214	184187955	8000	184184214	-4000	4000	3741
chr3	73378431	73386431	73384627	8000	73382431	-4000	4000	2196
chr3	137762334	137770334	137765110	8000	137766334	-4000	4000	-1224
chr3	98084102	98092102	98087874	8000	98088102	-4000	4000	-228
chr3	138029655	138037655	138031287	8000	138033655	-4000	4000	-2368
chr3	142445007	142453007	142451327	8000	142449007	-4000	4000	2320
chr3	49091932	49099932	49098671	8000	49095932	-4000	4000	2739
chr3	100691479	100699479	100694853	8000	100695479	-4000	4000	-626
chr3	112358812	112366812	112361812	8000	112362812	-4000	4000	-1000
chr3	102475841	102483841	102477443	8000	102479841	-4000	4000	-2398
chr3	23887640	23895640	23890515	8000	23891640	-4000	4000	-1125
chr3	119424949	119432949	119432083	8000	119428949	-4000	4000	3134
chr3	138490344	138498344	138498046	8000	138494344	-4000	4000	3702
chr3	194390821	194398821	194397698	8000	194394821	-4000	4000	2877
chr3	131346465	131354465	131349647	8000	131350465	-4000	4000	-818
chr3	186617318	186625318	186620701	8000	186621318	-4000	4000	-617
chr3	151433072	151441072	151436840	8000	151437072	-4000	4000	-232
chr3	184578408	184586408	184580796	8000	184582408	-4000	4000	-1612
chr3	184578408	184586408	184581359	8000	184582408	-4000	4000	-1049
chr3	48560073	48568073	48567603	8000	48564073	-4000	4000	3530
chr3	89478134	89486134	89479695	8000	89482134	-4000	4000	-2439
chr3	128458437	128466437	128462532	8000	128462437	-4000	4000	95
chr3	191261615	191269615	191268413	8000	191265615	-4000	4000	2798
chr3	69015827	69023827	69023189	8000	69019827	-4000	4000	3362
chr3	75663220	75671220	75665623	8000	75667220	-4000	4000	-1597
chr3	37046846	37054846	37047678	8000	37050846	-4000	4000	-3168
chr3	87255404	87263404	87259925	8000	87259404	-4000	4000	521
chr3	28321142	28329142	28323582	8000	28325142	-4000	4000	-1560
chr3	42701756	42709756	42708970	8000	42705756	-4000	4000	3214
chr3	185639130	185647130	185643861	8000	185643130	-4000	4000	731
chr3	138156988	138164988	138163983	8000	138160988	-4000	4000	2995
chr3	39259495	39267495	39265156	8000	39263495	-4000	4000	1661
chr3	69050730	69058730	69052169	8000	69054730	-4000	4000	-2561
chr3	129973935	129981935	129977040	8000	129977935	-4000	4000	-895
chr3	39393351	39401351	39394551	8000	39397351	-4000	4000	-2800
chr3	33146043	33154043	33152762	8000	33150043	-4000	4000	2719
chr3	146065440	146073440	146070854	8000	146069440	-4000	4000	1414
chr3	51829389	51837389	51830485	8000	51833389	-4000	4000	-2904
chr3	44328098	44336098	44331841	8000	44332098	-4000	4000	-257
chr3	101644889	101652889	101651460	8000	101648889	-4000	4000	2571
chr3	185186624	185194624	185192174	8000	185190624	-4000	4000	1550
chr3	170884418	170892418	170889659	8000	170888418	-4000	4000	1241
chr3	119585945	119593945	119587476	8000	119589945	-4000	4000	-2469
chr3	164974898	164982898	164982286	8000	164978898	-4000	4000	3388
chr3	159992019	160000019	159993038	8000	159996019	-4000	4000	-2981
chr3	149158410	149166410	149162861	8000	149162410	-4000	4000	451
chr3	191261615	191269615	191268391	8000	191265615	-4000	4000	2776
chr3	62394346	62402346	62399566	8000	62398346	-4000	4000	1220
chr3	46831111	46839111	46831974	8000	46835111	-4000	4000	-3137
chr3	98350819	98358819	98354029	8000	98354819	-4000	4000	-790
chr3	101644889	101652889	101651505	8000	101648889	-4000	4000	2616
chr3	184386736	184394736	184386849	8000	184390736	-4000	4000	-3887
chr3	46408997	46416997	46409106	8000	46412997	-4000	4000	-3891
chr3	185629551	185637551	185630057	8000	185633551	-4000	4000	-3494
chr3	186785880	186793880	186787887	8000	186789880	-4000	4000	-1993
chr3	75663220	75671220	75665984	8000	75667220	-4000	4000	-1236
chr3	119207732	119215732	119212310	8000	119211732	-4000	4000	578
chr3	142709664	142717664	142711583	8000	142713664	-4000	4000	-2081
chr3	120160645	120168645	120167189	8000	120164645	-4000	4000	2544
chr3	122905082	122913082	122910054	8000	122909082	-4000	4000	972
chr3	45751449	45759449	45759042	8000	45755449	-4000	4000	3593
chr3	25593984	25601984	25596883	8000	25597984	-4000	4000	-1101
chr3	38489142	38497142	38489587	8000	38493142	-4000	4000	-3555
chr3	194390821	194398821	194397690	8000	194394821	-4000	4000	2869
chr3	191261615	191269615	191268256	8000	191265615	-4000	4000	2641
chr3	47342816	47350816	47343633	8000	47346816	-4000	4000	-3183
chr3	158825719	158833719	158826053	8000	158829719	-4000	4000	-3666
chr3	32164709	32172709	32167394	8000	32168709	-4000	4000	-1315
chr3	50316027	50324027	50320084	8000	50320027	-4000	4000	57
chr3	98165774	98173774	98169602	8000	98169774	-4000	4000	-172
chr3	108039091	108047091	108046314	8000	108043091	-4000	4000	3223
chr3	112917205	112925205	112923754	8000	112921205	-4000	4000	2549
chr3	122408334	122416334	122416014	8000	122412334	-4000	4000	3680
chr3	169785716	169793716	169786918	8000	169789716	-4000	4000	-2798
chr3	44719831	44727831	44721796	8000	44723831	-4000	4000	-2035
chr3	133586261	133594261	133587996	8000	133590261	-4000	4000	-2265
chr3	132535032	132543032	132538216	8000	132539032	-4000	4000	-816
chr3	39134903	39142903	39136396	8000	39138903	-4000	4000	-2507
chr3	46372206	46380206	46373303	8000	46376206	-4000	4000	-2903
chr3	47409435	47417435	47414278	8000	47413435	-4000	4000	843
chr3	8746381	8754381	8752492	8000	8750381	-4000	4000	2111
chr3	30690142	30698142	30691657	8000	30694142	-4000	4000	-2485
chr3	38003496	38011496	38006656	8000	38007496	-4000	4000	-840
chr3	52899572	52907572	52904716	8000	52903572	-4000	4000	1144
chr3	73378431	73386431	73384643	8000	73382431	-4000	4000	2212
chr3	58188257	58196257	58192695	8000	58192257	-4000	4000	438
chr3	164974898	164982898	164979222	8000	164978898	-4000	4000	324
chr3	62365681	62373681	62370310	8000	62369681	-4000	4000	629
chr3	108903792	108911792	108908032	8000	108907792	-4000	4000	240
chr3	49853988	49861988	49861527	8000	49857988	-4000	4000	3539
chr3	112459966	112467966	112466252	8000	112463966	-4000	4000	2286
chr3	135256467	135264467	135259133	8000	135260467	-4000	4000	-1334
chr3	52071226	52079226	52075933	8000	52075226	-4000	4000	707
chr3	183174041	183182041	183180086	8000	183178041	-4000	4000	2045
chr3	119803570	119811570	119810140	8000	119807570	-4000	4000	2570
chr3	135256467	135264467	135259988	8000	135260467	-4000	4000	-479
chr3	187074553	187082553	187076989	8000	187078553	-4000	4000	-1564
chr3	11035247	11043247	11037221	8000	11039247	-4000	4000	-2026
chr3	120680938	120688938	120682146	8000	120684938	-4000	4000	-2792
chr3	25593984	25601984	25596537	8000	25597984	-4000	4000	-1447
chr3	129531344	129539344	129533715	8000	129535344	-4000	4000	-1629
chr3	9744019	9752019	9745831	8000	9748019	-4000	4000	-2188
chr3	23587794	23595794	23590097	8000	23591794	-4000	4000	-1697
chr3	45751449	45759449	45759035	8000	45755449	-4000	4000	3586
chr3	46262706	46270706	46265537	8000	46266706	-4000	4000	-1169
chr3	46431645	46439645	46437948	8000	46435645	-4000	4000	2303
chr3	49254106	49262106	49256987	8000	49258106	-4000	4000	-1119
chr3	49883002	49891002	49890552	8000	49887002	-4000	4000	3550
chr3	50217486	50225486	50220095	8000	50221486	-4000	4000	-1391
chr3	55070557	55078557	55074502	8000	55074557	-4000	4000	-55
chr3	97940984	97948984	97944963	8000	97944984	-4000	4000	-21
chr3	105651461	105659461	105659001	8000	105655461	-4000	4000	3540
chr3	112009887	112017887	112013459	8000	112013887	-4000	4000	-428
chr3	119625811	119633811	119628700	8000	119629811	-4000	4000	-1111
chr3	121940188	121948188	121940837	8000	121944188	-4000	4000	-3351
chr3	122726840	122734840	122728403	8000	122730840	-4000	4000	-2437
chr3	136144917	136152917	136152179	8000	136148917	-4000	4000	3262
chr3	150655885	150663885	150660068	8000	150659885	-4000	4000	183
chr3	184056673	184064673	184059550	8000	184060673	-4000	4000	-1123
chr3	194335768	194343768	194342684	8000	194339768	-4000	4000	2916
chr3	75663220	75671220	75666025	8000	75667220	-4000	4000	-1195
chr3	146511180	146519180	146515955	8000	146515180	-4000	4000	775
chr3	108954248	108962248	108959096	8000	108958248	-4000	4000	848
chr3	108954248	108962248	108959097	8000	108958248	-4000	4000	849
chr3	165182720	165190720	165190085	8000	165186720	-4000	4000	3365
chr3	30690142	30698142	30691458	8000	30694142	-4000	4000	-2684
chr3	5215958	5223958	5216882	8000	5219958	-4000	4000	-3076
chr3	40308424	40316424	40312159	8000	40312424	-4000	4000	-265
chr3	48982382	48990382	48983429	8000	48986382	-4000	4000	-2953
chr3	69102092	69110092	69108562	8000	69106092	-4000	4000	2470
chr3	87255404	87263404	87260046	8000	87259404	-4000	4000	642
chr3	93869051	93877051	93874188	8000	93873051	-4000	4000	1137
chr3	97940984	97948984	97944679	8000	97944984	-4000	4000	-305
chr3	113282930	113290930	113285507	8000	113286930	-4000	4000	-1423
chr3	122408334	122416334	122416007	8000	122412334	-4000	4000	3673
chr3	129083575	129091575	129091257	8000	129087575	-4000	4000	3682
chr3	133928701	133936701	133932807	8000	133932701	-4000	4000	106
chr3	138057990	138065990	138064655	8000	138061990	-4000	4000	2665
chr3	165182720	165190720	165190618	8000	165186720	-4000	4000	3898
chr3	172397669	172405669	172398327	8000	172401669	-4000	4000	-3342
chr3	181710436	181718436	181712483	8000	181714436	-4000	4000	-1953
chr3	186740410	186748410	186743831	8000	186744410	-4000	4000	-579
chr3	186785880	186793880	186786241	8000	186789880	-4000	4000	-3639
chr3	196464783	196472783	196472395	8000	196468783	-4000	4000	3612
chr3	196931402	196939402	196931877	8000	196935402	-4000	4000	-3525
chr3	55070557	55078557	55073495	8000	55074557	-4000	4000	-1062
chr3	9744019	9752019	9750183	8000	9748019	-4000	4000	2164
chr3	14108077	14116077	14112481	8000	14112077	-4000	4000	404
chr3	165182720	165190720	165187981	8000	165186720	-4000	4000	1261
chr3	136144917	136152917	136151932	8000	136148917	-4000	4000	3015
chr3	35790496	35798496	35792422	8000	35794496	-4000	4000	-2074
chr3	128475427	128483427	128480752	8000	128479427	-4000	4000	1325
chr3	194398672	194406672	194404074	8000	194402672	-4000	4000	1402
chr3	51890876	51898876	51894925	8000	51894876	-4000	4000	49
chr3	44656791	44664791	44659730	8000	44660791	-4000	4000	-1061
chr3	72367825	72375825	72374710	8000	72371825	-4000	4000	2885
chr3	39259495	39267495	39265168	8000	39263495	-4000	4000	1673
chr3	195564705	195572705	195571351	8000	195568705	-4000	4000	2646
chr3	38274757	38282757	38276074	8000	38278757	-4000	4000	-2683
chr3	40424744	40432744	40427528	8000	40428744	-4000	4000	-1216
chr3	44733083	44741083	44734544	8000	44737083	-4000	4000	-2539
chr3	45078277	45086277	45085745	8000	45082277	-4000	4000	3468
chr3	49355139	49363139	49362531	8000	49359139	-4000	4000	3392
chr3	52805009	52813009	52808572	8000	52809009	-4000	4000	-437
chr3	108903792	108911792	108908017	8000	108907792	-4000	4000	225
chr3	119424949	119432949	119432155	8000	119428949	-4000	4000	3206
chr3	129163827	129171827	129170292	8000	129167827	-4000	4000	2465
chr3	197885077	197893077	197889523	8000	197889077	-4000	4000	446
chr3	11786442	11794442	11790520	8000	11790442	-4000	4000	78
chr3	19875472	19883472	19882701	8000	19879472	-4000	4000	3229
chr3	23587794	23595794	23590270	8000	23591794	-4000	4000	-1524
chr3	33492245	33500245	33497894	8000	33496245	-4000	4000	1649
chr3	38841764	38849764	38847530	8000	38845764	-4000	4000	1766
chr3	40514736	40522736	40516545	8000	40518736	-4000	4000	-2191
chr3	44733083	44741083	44735146	8000	44737083	-4000	4000	-1937
chr3	44733083	44741083	44736001	8000	44737083	-4000	4000	-1082
chr3	45819316	45827316	45825994	8000	45823316	-4000	4000	2678
chr3	47581269	47589269	47586910	8000	47585269	-4000	4000	1641
chr3	49801030	49809030	49804875	8000	49805030	-4000	4000	-155
chr3	51380198	51388198	51382381	8000	51384198	-4000	4000	-1817
chr3	72745277	72753277	72750562	8000	72749277	-4000	4000	1285
chr3	75663220	75671220	75664485	8000	75667220	-4000	4000	-2735
chr3	98517133	98525133	98518884	8000	98521133	-4000	4000	-2249
chr3	108903792	108911792	108907875	8000	108907792	-4000	4000	83
chr3	119585945	119593945	119587819	8000	119589945	-4000	4000	-2126
chr3	122635047	122643047	122636082	8000	122639047	-4000	4000	-2965
chr3	126002357	126010357	126008787	8000	126006357	-4000	4000	2430
chr3	138294384	138302384	138296052	8000	138298384	-4000	4000	-2332
chr3	150737125	150745125	150741833	8000	150741125	-4000	4000	708
chr3	161340798	161348798	161346130	8000	161344798	-4000	4000	1332
chr3	182917629	182925629	182918797	8000	182921629	-4000	4000	-2832
chr3	184289031	184297031	184291421	8000	184293031	-4000	4000	-1610
chr3	186740410	186748410	186742218	8000	186744410	-4000	4000	-2192
chr3	195859364	195867364	195864182	8000	195863364	-4000	4000	818
chr3	129273773	129281773	129275292	8000	129277773	-4000	4000	-2481
chr3	154330943	154338943	154337827	8000	154334943	-4000	4000	2884
chr3	38544057	38552057	38550521	8000	38548057	-4000	4000	2464
chr3	38692802	38700802	38698439	8000	38696802	-4000	4000	1637
chr3	51953454	51961454	51961158	8000	51957454	-4000	4000	3704
chr3	75663220	75671220	75666035	8000	75667220	-4000	4000	-1185
chr3	99795226	99803226	99795969	8000	99799226	-4000	4000	-3257
chr3	120624172	120632172	120628492	8000	120628172	-4000	4000	320
chr3	122735999	122743999	122740427	8000	122739999	-4000	4000	428
chr3	132364298	132372298	132367970	8000	132368298	-4000	4000	-328
chr3	135256467	135264467	135259112	8000	135260467	-4000	4000	-1355
chr3	137762334	137770334	137765105	8000	137766334	-4000	4000	-1229
chr3	142445007	142453007	142452170	8000	142449007	-4000	4000	3163
chr3	148739008	148747008	148741415	8000	148743008	-4000	4000	-1593
chr3	151433072	151441072	151436898	8000	151437072	-4000	4000	-174
chr3	186542067	186550067	186544375	8000	186546067	-4000	4000	-1692
chr3	194398672	194406672	194406028	8000	194402672	-4000	4000	3356
chr3	157255742	157263742	157261229	8000	157259742	-4000	4000	1487
chr3	184578408	184586408	184579913	8000	184582408	-4000	4000	-2495
chr3	184578408	184586408	184581075	8000	184582408	-4000	4000	-1333
chr3	50337110	50345110	50341628	8000	50341110	-4000	4000	518
chr3	136144917	136152917	136151900	8000	136148917	-4000	4000	2983
chr3	56617837	56625837	56619503	8000	56621837	-4000	4000	-2334
chr3	69164782	69172782	69171749	8000	69168782	-4000	4000	2967
chr3	142811922	142819922	142818112	8000	142815922	-4000	4000	2190
chr3	73378431	73386431	73383412	8000	73382431	-4000	4000	981
chr3	28321142	28329142	28324161	8000	28325142	-4000	4000	-981
chr3	190655750	190663750	190656563	8000	190659750	-4000	4000	-3187
chr3	19531642	19539642	19534175	8000	19535642	-4000	4000	-1467
chr3	75663220	75671220	75665776	8000	75667220	-4000	4000	-1444
chr3	126002357	126010357	126008866	8000	126006357	-4000	4000	2509
chr3	38003496	38011496	38007070	8000	38007496	-4000	4000	-426
chr3	184102995	184110995	184106206	8000	184106995	-4000	4000	-789
chr3	189952728	189960728	189957938	8000	189956728	-4000	4000	1210
chr3	49786732	49794732	49791948	8000	49790732	-4000	4000	1216
chr3	52829121	52837121	52833413	8000	52833121	-4000	4000	292
chr3	111972517	111980517	111975772	8000	111976517	-4000	4000	-745
chr3	48632463	48640463	48640444	8000	48636463	-4000	4000	3981
chr3	75663220	75671220	75665732	8000	75667220	-4000	4000	-1488
chr3	143120014	143128014	143121910	8000	143124014	-4000	4000	-2104
chr3	53863066	53871066	53865261	8000	53867066	-4000	4000	-1805
chr3	98791941	98799941	98799462	8000	98795941	-4000	4000	3521
chr3	195064284	195072284	195069975	8000	195068284	-4000	4000	1691
chr3	50185075	50193075	50186612	8000	50189075	-4000	4000	-2463
chr3	125979454	125987454	125982300	8000	125983454	-4000	4000	-1154
chr3	136144917	136152917	136152357	8000	136148917	-4000	4000	3440
chr3	146188335	146196335	146194443	8000	146192335	-4000	4000	2108
chr3	44656791	44664791	44659305	8000	44660791	-4000	4000	-1486
chr3	46356940	46364940	46358424	8000	46360940	-4000	4000	-2516
chr3	44719831	44727831	44721607	8000	44723831	-4000	4000	-2224
chr3	118896557	118904557	118902448	8000	118900557	-4000	4000	1891
chr3	129531344	129539344	129532625	8000	129535344	-4000	4000	-2719
chr3	138949990	138957990	138950542	8000	138953990	-4000	4000	-3448
chr3	42688544	42696544	42688701	8000	42692544	-4000	4000	-3843
chr3	108545864	108553864	108552373	8000	108549864	-4000	4000	2509
chr3	51859424	51867424	51863200	8000	51863424	-4000	4000	-224
chr3	51944867	51952867	51948640	8000	51948867	-4000	4000	-227
chr3	74258568	74266568	74264406	8000	74262568	-4000	4000	1838
chr3	123964521	123972521	123970064	8000	123968521	-4000	4000	1543
chr3	167821569	167829569	167824522	8000	167825569	-4000	4000	-1047
chr3	186785880	186793880	186790329	8000	186789880	-4000	4000	449
chr3	58168251	58176251	58168610	8000	58172251	-4000	4000	-3641
chr3	126432556	126440556	126434280	8000	126436556	-4000	4000	-2276
chr3	129083575	129091575	129091233	8000	129087575	-4000	4000	3658
chr3	112358812	112366812	112361576	8000	112362812	-4000	4000	-1236
chr3	50096045	50104045	50100156	8000	50100045	-4000	4000	111
chr3	107374635	107382635	107377427	8000	107378635	-4000	4000	-1208
chr3	165182720	165190720	165189653	8000	165186720	-4000	4000	2933
chr3	10097932	10105932	10104493	8000	10101932	-4000	4000	2561
chr3	25714944	25722944	25720045	8000	25718944	-4000	4000	1101
chr3	99795226	99803226	99795463	8000	99799226	-4000	4000	-3763
chr3	142445007	142453007	142451211	8000	142449007	-4000	4000	2204
chr3	112077269	112085269	112078803	8000	112081269	-4000	4000	-2466
chr3	197885077	197893077	197889513	8000	197889077	-4000	4000	436
chr3	183808624	183816624	183810627	8000	183812624	-4000	4000	-1997
chr3	50217486	50225486	50220331	8000	50221486	-4000	4000	-1155
chr3	130673044	130681044	130675360	8000	130677044	-4000	4000	-1684
chr3	38314575	38322575	38316384	8000	38318575	-4000	4000	-2191
chr3	48302842	48310842	48309930	8000	48306842	-4000	4000	3088
chr3	38314575	38322575	38318216	8000	38318575	-4000	4000	-359
chr3	49824601	49832601	49829727	8000	49828601	-4000	4000	1126
chr3	113011060	113019060	113011128	8000	113015060	-4000	4000	-3932
chr3	131012712	131020712	131013948	8000	131016712	-4000	4000	-2764
chr3	138648698	138656698	138656177	8000	138652698	-4000	4000	3479
chr3	3053959	3061959	3056338	8000	3057959	-4000	4000	-1621
chr3	49117114	49125114	49124703	8000	49121114	-4000	4000	3589
chr3	138119713	138127713	138124872	8000	138123713	-4000	4000	1159
chr3	40514736	40522736	40516031	8000	40518736	-4000	4000	-2705
chr3	38692802	38700802	38697926	8000	38696802	-4000	4000	1124
chr3	43075229	43083229	43080655	8000	43079229	-4000	4000	1426
chr3	48852926	48860926	48857674	8000	48856926	-4000	4000	748
chr3	51944867	51952867	51946302	8000	51948867	-4000	4000	-2565
chr3	58560117	58568117	58566708	8000	58564117	-4000	4000	2591
chr3	184035369	184043369	184038141	8000	184039369	-4000	4000	-1228
chr3	186785880	186793880	186789237	8000	186789880	-4000	4000	-643
chr3	44719831	44727831	44721749	8000	44723831	-4000	4000	-2082
chr3	186674234	186682234	186677209	8000	186678234	-4000	4000	-1025
chr3	87255404	87263404	87259911	8000	87259404	-4000	4000	507
chr3	98468924	98476924	98470198	8000	98472924	-4000	4000	-2726
chr3	165182720	165190720	165188017	8000	165186720	-4000	4000	1297
chr3	48616759	48624759	48620972	8000	48620759	-4000	4000	213
chr3	52250434	52258434	52257495	8000	52254434	-4000	4000	3061
chr3	114230631	114238631	114236668	8000	114234631	-4000	4000	2037
chr3	149158410	149166410	149162326	8000	149162410	-4000	4000	-84
chr3	52429035	52437035	52435888	8000	52433035	-4000	4000	2853
chr3	98350819	98358819	98354768	8000	98354819	-4000	4000	-51
chr3	170082732	170090732	170084367	8000	170086732	-4000	4000	-2365
chr3	149026127	149034127	149032271	8000	149030127	-4000	4000	2144
chr3	23976617	23984617	23977363	8000	23980617	-4000	4000	-3254
chr3	25714944	25722944	25720149	8000	25718944	-4000	4000	1205
chr3	120598507	120606507	120601512	8000	120602507	-4000	4000	-995
chr3	10097932	10105932	10104429	8000	10101932	-4000	4000	2497
chr3	43075229	43083229	43081243	8000	43079229	-4000	4000	2014
chr3	50096045	50104045	50100565	8000	50100045	-4000	4000	520
chr3	75663220	75671220	75665732	8000	75667220	-4000	4000	-1488
chr3	58423630	58431630	58428167	8000	58427630	-4000	4000	537
chr3	87989839	87997839	87990843	8000	87993839	-4000	4000	-2996
chr3	112811709	112819709	112815806	8000	112815709	-4000	4000	97
chr3	30722197	30730197	30728211	8000	30726197	-4000	4000	2014
chr3	101590465	101598465	101593600	8000	101594465	-4000	4000	-865
chr3	50343330	50351330	50350424	8000	50347330	-4000	4000	3094
chr3	119585945	119593945	119587858	8000	119589945	-4000	4000	-2087
chr3	151824488	151832488	151828122	8000	151828488	-4000	4000	-366
chr3	184102995	184110995	184106203	8000	184106995	-4000	4000	-792
chr3	157255742	157263742	157260964	8000	157259742	-4000	4000	1222
chr3	19531642	19539642	19534462	8000	19535642	-4000	4000	-1180
chr3	184289031	184297031	184291062	8000	184293031	-4000	4000	-1969
chr3	184289031	184297031	184292486	8000	184293031	-4000	4000	-545
chr3	8746381	8754381	8752557	8000	8750381	-4000	4000	2176
chr3	194335768	194343768	194341326	8000	194339768	-4000	4000	1558
chr3	119424949	119432949	119431922	8000	119428949	-4000	4000	2973
chr3	184238329	184246329	184238694	8000	184242329	-4000	4000	-3635
chr3	44656791	44664791	44660194	8000	44660791	-4000	4000	-597
chr3	98165774	98173774	98169388	8000	98169774	-4000	4000	-386
chr3	184190012	184198012	184191218	8000	184194012	-4000	4000	-2794
chr3	100744964	100752964	100748493	8000	100748964	-4000	4000	-471
chr3	142709664	142717664	142713262	8000	142713664	-4000	4000	-402
chr3	51944867	51952867	51947799	8000	51948867	-4000	4000	-1068
chr3	120680938	120688938	120682313	8000	120684938	-4000	4000	-2625
chr3	165182720	165190720	165188345	8000	165186720	-4000	4000	1625
chr3	157042129	157050129	157045464	8000	157046129	-4000	4000	-665
chr3	44328098	44336098	44328298	8000	44332098	-4000	4000	-3800
chr3	185186624	185194624	185193385	8000	185190624	-4000	4000	2761
chr3	405417	413417	405585	8000	409417	-4000	4000	-3832
chr3	143120014	143128014	143121583	8000	143124014	-4000	4000	-2431
chr3	119520293	119528293	119524003	8000	119524293	-4000	4000	-290
chr3	126099562	126107562	126105778	8000	126103562	-4000	4000	2216
chr3	169762921	169770921	169768076	8000	169766921	-4000	4000	1155
chr3	196502879	196510879	196508059	8000	196506879	-4000	4000	1180
chr3	3062324	3070324	3070185	8000	3066324	-4000	4000	3861
chr3	9744019	9752019	9750245	8000	9748019	-4000	4000	2226
chr3	9890349	9898349	9893131	8000	9894349	-4000	4000	-1218
chr3	12188032	12196032	12190586	8000	12192032	-4000	4000	-1446
chr3	12893043	12901043	12899337	8000	12897043	-4000	4000	2294
chr3	15663236	15671236	15670142	8000	15667236	-4000	4000	2906
chr3	17153162	17161162	17161128	8000	17157162	-4000	4000	3966
chr3	23887640	23895640	23887663	8000	23891640	-4000	4000	-3977
chr3	27711949	27719949	27717385	8000	27715949	-4000	4000	1436
chr3	32521974	32529974	32528543	8000	32525974	-4000	4000	2569
chr3	33146043	33154043	33153691	8000	33150043	-4000	4000	3648
chr3	38003496	38011496	38007810	8000	38007496	-4000	4000	314
chr3	43051871	43059871	43056368	8000	43055871	-4000	4000	497
chr3	44656791	44664791	44659146	8000	44660791	-4000	4000	-1645
chr3	44910990	44918990	44911317	8000	44914990	-4000	4000	-3673
chr3	44910990	44918990	44913699	8000	44914990	-4000	4000	-1291
chr3	45078277	45086277	45085792	8000	45082277	-4000	4000	3515
chr3	46831111	46839111	46833659	8000	46835111	-4000	4000	-1452
chr3	49011488	49019488	49012281	8000	49015488	-4000	4000	-3207
chr3	49091932	49099932	49098033	8000	49095932	-4000	4000	2101
chr3	49117114	49125114	49117813	8000	49121114	-4000	4000	-3301
chr3	50316027	50324027	50320319	8000	50320027	-4000	4000	292
chr3	50325782	50333782	50326431	8000	50329782	-4000	4000	-3351
chr3	50343330	50351330	50350739	8000	50347330	-4000	4000	3409
chr3	51859424	51867424	51861669	8000	51863424	-4000	4000	-1755
chr3	51944867	51952867	51944997	8000	51948867	-4000	4000	-3870
chr3	52250434	52258434	52256586	8000	52254434	-4000	4000	2152
chr3	52419641	52427641	52422812	8000	52423641	-4000	4000	-829
chr3	56617837	56625837	56623525	8000	56621837	-4000	4000	1688
chr3	62365681	62373681	62370001	8000	62369681	-4000	4000	320
chr3	62365681	62373681	62372113	8000	62369681	-4000	4000	2432
chr3	68541621	68549621	68544496	8000	68545621	-4000	4000	-1125
chr3	72745277	72753277	72750502	8000	72749277	-4000	4000	1225
chr3	73059337	73067337	73063698	8000	73063337	-4000	4000	361
chr3	73059337	73067337	73065060	8000	73063337	-4000	4000	1723
chr3	73059337	73067337	73065675	8000	73063337	-4000	4000	2338
chr3	73378431	73386431	73384628	8000	73382431	-4000	4000	2197
chr3	75663220	75671220	75666098	8000	75667220	-4000	4000	-1122
chr3	97940984	97948984	97943435	8000	97944984	-4000	4000	-1549
chr3	98261356	98269356	98265103	8000	98265356	-4000	4000	-253
chr3	98517133	98525133	98522921	8000	98521133	-4000	4000	1788
chr3	100691479	100699479	100694966	8000	100695479	-4000	4000	-513
chr3	101562446	101570446	101565065	8000	101566446	-4000	4000	-1381
chr3	108903792	108911792	108908079	8000	108907792	-4000	4000	287
chr3	111972517	111980517	111974630	8000	111976517	-4000	4000	-1887
chr3	112528510	112536510	112536472	8000	112532510	-4000	4000	3962
chr3	118896557	118904557	118902831	8000	118900557	-4000	4000	2274
chr3	119424949	119432949	119431971	8000	119428949	-4000	4000	3022
chr3	120160645	120168645	120167771	8000	120164645	-4000	4000	3126
chr3	126002357	126010357	126007159	8000	126006357	-4000	4000	802
chr3	126338635	126346635	126343872	8000	126342635	-4000	4000	1237
chr3	128475427	128483427	128481916	8000	128479427	-4000	4000	2489
chr3	136143894	136151894	136151278	8000	136147894	-4000	4000	3384
chr3	142803888	142811888	142804026	8000	142807888	-4000	4000	-3862
chr3	142811922	142819922	142818386	8000	142815922	-4000	4000	2464
chr3	148739008	148747008	148741785	8000	148743008	-4000	4000	-1223
chr3	148856187	148864187	148859946	8000	148860187	-4000	4000	-241
chr3	154268546	154276546	154276227	8000	154272546	-4000	4000	3681
chr3	165182720	165190720	165190099	8000	165186720	-4000	4000	3379
chr3	167235843	167243843	167242611	8000	167239843	-4000	4000	2768
chr3	169762921	169770921	169767737	8000	169766921	-4000	4000	816
chr3	169762921	169770921	169768128	8000	169766921	-4000	4000	1207
chr3	169762921	169770921	169769480	8000	169766921	-4000	4000	2559
chr3	172439291	172447291	172445442	8000	172443291	-4000	4000	2151
chr3	184386736	184394736	184388673	8000	184390736	-4000	4000	-2063
chr3	185048614	185056614	185052154	8000	185052614	-4000	4000	-460
chr3	185639130	185647130	185645609	8000	185643130	-4000	4000	2479
chr3	186674234	186682234	186677185	8000	186678234	-4000	4000	-1049
chr3	186785880	186793880	186789152	8000	186789880	-4000	4000	-728
chr3	186785880	186793880	186790157	8000	186789880	-4000	4000	277
chr3	187074553	187082553	187075705	8000	187078553	-4000	4000	-2848
chr3	187116948	187124948	187121150	8000	187120948	-4000	4000	202
chr3	190848737	190856737	190855664	8000	190852737	-4000	4000	2927
chr3	194390821	194398821	194396631	8000	194394821	-4000	4000	1810
chr3	197885077	197893077	197889486	8000	197889077	-4000	4000	409
chr3	52788068	52796068	52788287	8000	52792068	-4000	4000	-3781
chr3	136332236	136340236	136337115	8000	136336236	-4000	4000	879
chr3	186785880	186793880	186787544	8000	186789880	-4000	4000	-2336
chr3	49720294	49728294	49720530	8000	49724294	-4000	4000	-3764
chr3	113625575	113633575	113626211	8000	113629575	-4000	4000	-3364
chr3	136851888	136859888	136855371	8000	136855888	-4000	4000	-517
chr3	9890349	9898349	9890651	8000	9894349	-4000	4000	-3698
chr3	10097932	10105932	10104334	8000	10101932	-4000	4000	2402
chr3	19531642	19539642	19534457	8000	19535642	-4000	4000	-1185
chr3	113808056	113816056	113811980	8000	113812056	-4000	4000	-76
chr3	128475427	128483427	128481220	8000	128479427	-4000	4000	1793
chr3	180978753	180986753	180984641	8000	180982753	-4000	4000	1888
chr3	62365681	62373681	62371322	8000	62369681	-4000	4000	1641
chr3	141144611	141152611	141147229	8000	141148611	-4000	4000	-1382
chr3	141144611	141152611	141147230	8000	141148611	-4000	4000	-1381
chr3	57289699	57297699	57292080	8000	57293699	-4000	4000	-1619
chr3	9475240	9483240	9475742	8000	9479240	-4000	4000	-3498
chr3	138119713	138127713	138124816	8000	138123713	-4000	4000	1103
chr3	44719831	44727831	44720923	8000	44723831	-4000	4000	-2908
chr3	184056673	184064673	184059597	8000	184060673	-4000	4000	-1076
chr3	191457456	191465456	191461249	8000	191461456	-4000	4000	-207
chr3	28321142	28329142	28324081	8000	28325142	-4000	4000	-1061
chr3	38841764	38849764	38846993	8000	38845764	-4000	4000	1229
chr3	39259495	39267495	39265952	8000	39263495	-4000	4000	2457
chr3	101644889	101652889	101651040	8000	101648889	-4000	4000	2151
chr3	128615969	128623969	128620124	8000	128619969	-4000	4000	155
chr3	196502879	196510879	196503333	8000	196506879	-4000	4000	-3546
chr3	25593984	25601984	25597718	8000	25597984	-4000	4000	-266
chr3	88047944	88055944	88052256	8000	88051944	-4000	4000	312
chr3	151433072	151441072	151437835	8000	151437072	-4000	4000	763
chr3	194685037	194693037	194688381	8000	194689037	-4000	4000	-656
chr3	197505783	197513783	197512176	8000	197509783	-4000	4000	2393
chr3	69964336	69972336	69966202	8000	69968336	-4000	4000	-2134
chr3	39179210	39187210	39185553	8000	39183210	-4000	4000	2343
chr3	3053959	3061959	3056352	8000	3057959	-4000	4000	-1607
chr3	9744019	9752019	9751785	8000	9748019	-4000	4000	3766
chr3	10097932	10105932	10104176	8000	10101932	-4000	4000	2244
chr3	13812258	13820258	13819010	8000	13816258	-4000	4000	2752
chr3	19875472	19883472	19879600	8000	19879472	-4000	4000	128
chr3	20156593	20164593	20161010	8000	20160593	-4000	4000	417
chr3	33146043	33154043	33153190	8000	33150043	-4000	4000	3147
chr3	39134903	39142903	39136430	8000	39138903	-4000	4000	-2473
chr3	44719831	44727831	44721270	8000	44723831	-4000	4000	-2561
chr3	44719831	44727831	44721479	8000	44723831	-4000	4000	-2352
chr3	46356940	46364940	46357561	8000	46360940	-4000	4000	-3379
chr3	46356940	46364940	46358340	8000	46360940	-4000	4000	-2600
chr3	46511385	46519385	46518962	8000	46515385	-4000	4000	3577
chr3	48302842	48310842	48306874	8000	48306842	-4000	4000	32
chr3	48560073	48568073	48563021	8000	48564073	-4000	4000	-1052
chr3	50295890	50303890	50302788	8000	50299890	-4000	4000	2898
chr3	50337110	50345110	50342553	8000	50341110	-4000	4000	1443
chr3	51869721	51877721	51873839	8000	51873721	-4000	4000	118
chr3	51890876	51898876	51895337	8000	51894876	-4000	4000	461
chr3	52419641	52427641	52421703	8000	52423641	-4000	4000	-1938
chr3	52520495	52528495	52527670	8000	52524495	-4000	4000	3175
chr3	52690486	52698486	52697883	8000	52694486	-4000	4000	3397
chr3	57193838	57201838	57198110	8000	57197838	-4000	4000	272
chr3	57193838	57201838	57198267	8000	57197838	-4000	4000	429
chr3	62394346	62402346	62399512	8000	62398346	-4000	4000	1166
chr3	64006550	64014550	64013542	8000	64010550	-4000	4000	2992
chr3	78593239	78601239	78600180	8000	78597239	-4000	4000	2941
chr3	87255404	87263404	87259828	8000	87259404	-4000	4000	424
chr3	87989839	87997839	87990746	8000	87993839	-4000	4000	-3093
chr3	98084102	98092102	98088056	8000	98088102	-4000	4000	-46
chr3	98165774	98173774	98169577	8000	98169774	-4000	4000	-197
chr3	98261356	98269356	98264705	8000	98265356	-4000	4000	-651
chr3	100321251	100329251	100323692	8000	100325251	-4000	4000	-1559
chr3	100573444	100581444	100577059	8000	100577444	-4000	4000	-385
chr3	100744964	100752964	100748291	8000	100748964	-4000	4000	-673
chr3	101562446	101570446	101565415	8000	101566446	-4000	4000	-1031
chr3	101644889	101652889	101651548	8000	101648889	-4000	4000	2659
chr3	111972517	111980517	111974609	8000	111976517	-4000	4000	-1908
chr3	112077269	112085269	112080942	8000	112081269	-4000	4000	-327
chr3	112127004	112135004	112133110	8000	112131004	-4000	4000	2106
chr3	113943174	113951174	113945546	8000	113947174	-4000	4000	-1628
chr3	114306288	114314288	114308091	8000	114310288	-4000	4000	-2197
chr3	122408334	122416334	122409758	8000	122412334	-4000	4000	-2576
chr3	125442650	125450650	125447636	8000	125446650	-4000	4000	986
chr3	125979454	125987454	125982381	8000	125983454	-4000	4000	-1073
chr3	127194185	127202185	127196656	8000	127198185	-4000	4000	-1529
chr3	129516510	129524510	129519118	8000	129520510	-4000	4000	-1392
chr3	129643792	129651792	129651543	8000	129647792	-4000	4000	3751
chr3	133471222	133479222	133475029	8000	133475222	-4000	4000	-193
chr3	138648698	138656698	138655458	8000	138652698	-4000	4000	2760
chr3	139356497	139364497	139359333	8000	139360497	-4000	4000	-1164
chr3	148739008	148747008	148741412	8000	148743008	-4000	4000	-1596
chr3	148739008	148747008	148741535	8000	148743008	-4000	4000	-1473
chr3	149499394	149507394	149502781	8000	149503394	-4000	4000	-613
chr3	151824488	151832488	151827852	8000	151828488	-4000	4000	-636
chr3	161499942	161507942	161503713	8000	161503942	-4000	4000	-229
chr3	165182720	165190720	165187839	8000	165186720	-4000	4000	1119
chr3	165182720	165190720	165187929	8000	165186720	-4000	4000	1209
chr3	165182720	165190720	165188784	8000	165186720	-4000	4000	2064
chr3	165182720	165190720	165190489	8000	165186720	-4000	4000	3769
chr3	169833773	169841773	169840068	8000	169837773	-4000	4000	2295
chr3	172885357	172893357	172889413	8000	172889357	-4000	4000	56
chr3	178840429	178848429	178842677	8000	178844429	-4000	4000	-1752
chr3	179584407	179592407	179588925	8000	179588407	-4000	4000	518
chr3	180978753	180986753	180985955	8000	180982753	-4000	4000	3202
chr3	184578408	184586408	184581358	8000	184582408	-4000	4000	-1050
chr3	186785880	186793880	186789978	8000	186789880	-4000	4000	98
chr3	190848737	190856737	190855846	8000	190852737	-4000	4000	3109
chr3	196502879	196510879	196507956	8000	196506879	-4000	4000	1077
chr3	197038560	197046560	197044456	8000	197042560	-4000	4000	1896
chr3	197885077	197893077	197892635	8000	197889077	-4000	4000	3558
chr3	3140628	3148628	3148185	8000	3144628	-4000	4000	3557
chr3	32952349	32960349	32954023	8000	32956349	-4000	4000	-2326
chr3	48852926	48860926	48859104	8000	48856926	-4000	4000	2178
chr3	51944867	51952867	51944874	8000	51948867	-4000	4000	-3993
chr3	52704444	52712444	52711807	8000	52708444	-4000	4000	3363
chr3	112917205	112925205	112925150	8000	112921205	-4000	4000	3945
chr3	159992019	160000019	159995415	8000	159996019	-4000	4000	-604
chr3	186101668	186109668	186105853	8000	186105668	-4000	4000	185
chr3	190408138	190416138	190408311	8000	190412138	-4000	4000	-3827
chr3	190655750	190663750	190656080	8000	190659750	-4000	4000	-3670
chr3	193270789	193278789	193275141	8000	193274789	-4000	4000	352
chr3	196464783	196472783	196472315	8000	196468783	-4000	4000	3532
chr3	196464783	196472783	196472486	8000	196468783	-4000	4000	3703
chr3	149513235	149521235	149520645	8000	149517235	-4000	4000	3410
chr3	195742765	195750765	195749050	8000	195746765	-4000	4000	2285
chr3	98791941	98799941	98799187	8000	98795941	-4000	4000	3246
chr3	107374635	107382635	107378507	8000	107378635	-4000	4000	-128
chr3	49254106	49262106	49257537	8000	49258106	-4000	4000	-569
chr3	9862711	9870711	9869956	8000	9866711	-4000	4000	3245
chr3	57926003	57934003	57927859	8000	57930003	-4000	4000	-2144
chr3	73059337	73067337	73065809	8000	73063337	-4000	4000	2472
chr3	138029655	138037655	138029886	8000	138033655	-4000	4000	-3769
chr3	10097932	10105932	10099073	8000	10101932	-4000	4000	-2859
chr3	15446133	15454133	15453901	8000	15450133	-4000	4000	3768
chr3	122735999	122743999	122741037	8000	122739999	-4000	4000	1038
chr3	46356940	46364940	46358289	8000	46360940	-4000	4000	-2651
chr3	75663220	75671220	75665138	8000	75667220	-4000	4000	-2082
chr3	113011060	113019060	113013133	8000	113015060	-4000	4000	-1927
chr3	179390936	179398936	179392098	8000	179394936	-4000	4000	-2838
chr3	132554142	132562142	132559015	8000	132558142	-4000	4000	873
chr3	186854463	186862463	186854686	8000	186858463	-4000	4000	-3777
chr3	39259495	39267495	39266034	8000	39263495	-4000	4000	2539
chr3	48852926	48860926	48857683	8000	48856926	-4000	4000	757
chr3	133586261	133594261	133588183	8000	133590261	-4000	4000	-2078
chr3	75663220	75671220	75665667	8000	75667220	-4000	4000	-1553
chr3	45751449	45759449	45759048	8000	45755449	-4000	4000	3599
chr3	180598858	180606858	180602274	8000	180602858	-4000	4000	-584
chr3	185186624	185194624	185193166	8000	185190624	-4000	4000	2542
chr3	186785880	186793880	186789560	8000	186789880	-4000	4000	-320
chr3	51391867	51399867	51394616	8000	51395867	-4000	4000	-1251
chr3	49172486	49180486	49174268	8000	49176486	-4000	4000	-2218
chr3	52788068	52796068	52788242	8000	52792068	-4000	4000	-3826
chr3	194335768	194343768	194342322	8000	194339768	-4000	4000	2554
chr3	38692802	38700802	38698217	8000	38696802	-4000	4000	1415
chr3	98387631	98395631	98391397	8000	98391631	-4000	4000	-234
chr3	137762334	137770334	137764959	8000	137766334	-4000	4000	-1375
chr3	165182720	165190720	165189403	8000	165186720	-4000	4000	2683
chr3	39179210	39187210	39185398	8000	39183210	-4000	4000	2188
chr3	57193838	57201838	57198075	8000	57197838	-4000	4000	237
chr3	100691479	100699479	100695012	8000	100695479	-4000	4000	-467
chr3	5215958	5223958	5216082	8000	5219958	-4000	4000	-3876
chr3	15663236	15671236	15670503	8000	15667236	-4000	4000	3267
chr3	57926003	57934003	57927511	8000	57930003	-4000	4000	-2492
chr3	185186624	185194624	185192374	8000	185190624	-4000	4000	1750
chr3	113712458	113720458	113719158	8000	113716458	-4000	4000	2700
chr3	50325782	50333782	50331818	8000	50329782	-4000	4000	2036
chr3	49853988	49861988	49859563	8000	49857988	-4000	4000	1575
chr3	51829389	51837389	51830453	8000	51833389	-4000	4000	-2936
chr3	38003496	38011496	38010158	8000	38007496	-4000	4000	2662
chr3	27711949	27719949	27718590	8000	27715949	-4000	4000	2641
chr3	38841764	38849764	38847597	8000	38845764	-4000	4000	1833
chr3	131012712	131020712	131016454	8000	131016712	-4000	4000	-258
chr3	149365022	149373022	149370119	8000	149369022	-4000	4000	1097
chr3	149365022	149373022	149370120	8000	149369022	-4000	4000	1098
chr3	182917629	182925629	182918271	8000	182921629	-4000	4000	-3358
chr3	52690486	52698486	52690787	8000	52694486	-4000	4000	-3699
chr3	78593239	78601239	78598610	8000	78597239	-4000	4000	1371
chr3	38544057	38552057	38550846	8000	38548057	-4000	4000	2789
chr3	186785880	186793880	186789229	8000	186789880	-4000	4000	-651
chr3	138949990	138957990	138950459	8000	138953990	-4000	4000	-3531
chr3	49786732	49794732	49791771	8000	49790732	-4000	4000	1039
chr3	113438718	113446718	113445315	8000	113442718	-4000	4000	2597
chr3	17086604	17094604	17090085	8000	17090604	-4000	4000	-519
chr3	37046846	37054846	37050651	8000	37050846	-4000	4000	-195
chr3	39134903	39142903	39137372	8000	39138903	-4000	4000	-1531
chr3	48428164	48436164	48432449	8000	48432164	-4000	4000	285
chr3	93869051	93877051	93874218	8000	93873051	-4000	4000	1167
chr3	120160645	120168645	120167581	8000	120164645	-4000	4000	2936
chr3	122408334	122416334	122414473	8000	122412334	-4000	4000	2139
chr3	124901442	124909442	124908160	8000	124905442	-4000	4000	2718
chr3	126099562	126107562	126103789	8000	126103562	-4000	4000	227
chr3	142445007	142453007	142450216	8000	142449007	-4000	4000	1209
chr3	181710436	181718436	181712826	8000	181714436	-4000	4000	-1610
chr3	187694259	187702259	187698936	8000	187698259	-4000	4000	677
chr3	44733083	44741083	44734605	8000	44737083	-4000	4000	-2478
chr3	73378431	73386431	73384137	8000	73382431	-4000	4000	1706
chr3	126002357	126010357	126008859	8000	126006357	-4000	4000	2502
chr3	33492245	33500245	33498671	8000	33496245	-4000	4000	2426
chr3	39179210	39187210	39186898	8000	39183210	-4000	4000	3688
chr3	75663220	75671220	75665679	8000	75667220	-4000	4000	-1541
chr3	101320205	101328205	101327672	8000	101324205	-4000	4000	3467
chr3	146188335	146196335	146194272	8000	146192335	-4000	4000	1937
chr3	120388293	120396293	120395822	8000	120392293	-4000	4000	3529
chr3	19531642	19539642	19533559	8000	19535642	-4000	4000	-2083
chr3	180598858	180606858	180604854	8000	180602858	-4000	4000	1996
chr3	184578408	184586408	184579708	8000	184582408	-4000	4000	-2700
chr3	190424655	190432655	190429530	8000	190428655	-4000	4000	875
chr3	44719831	44727831	44721568	8000	44723831	-4000	4000	-2263
chr3	52829121	52837121	52829145	8000	52833121	-4000	4000	-3976
chr3	169785716	169793716	169793611	8000	169789716	-4000	4000	3895
chr3	194335768	194343768	194341332	8000	194339768	-4000	4000	1564
chr3	9912402	9920402	9914510	8000	9916402	-4000	4000	-1892
chr3	52899572	52907572	52905228	8000	52903572	-4000	4000	1656
chr3	196502879	196510879	196507709	8000	196506879	-4000	4000	830
chr3	44644471	44652471	44651196	8000	44648471	-4000	4000	2725
chr3	195859364	195867364	195864150	8000	195863364	-4000	4000	786
chr3	128905866	128913866	128912512	8000	128909866	-4000	4000	2646
chr3	73378431	73386431	73384795	8000	73382431	-4000	4000	2364
chr3	138490344	138498344	138494902	8000	138494344	-4000	4000	558
chr3	121627399	121635399	121633148	8000	121631399	-4000	4000	1749
chr3	25714944	25722944	25719393	8000	25718944	-4000	4000	449
chr3	178840429	178848429	178844135	8000	178844429	-4000	4000	-294
chr3	98468924	98476924	98469838	8000	98472924	-4000	4000	-3086
chr3	185186624	185194624	185192630	8000	185190624	-4000	4000	2006
chr3	186649141	186657141	186652630	8000	186653141	-4000	4000	-511
chr3	49011488	49019488	49012057	8000	49015488	-4000	4000	-3431
chr3	50217486	50225486	50218395	8000	50221486	-4000	4000	-3091
chr3	44656791	44664791	44659342	8000	44660791	-4000	4000	-1449
chr3	71767655	71775655	71772830	8000	71771655	-4000	4000	1175
chr3	180598858	180606858	180606267	8000	180602858	-4000	4000	3409
chr3	11259557	11267557	11259672	8000	11263557	-4000	4000	-3885
chr3	108954248	108962248	108958920	8000	108958248	-4000	4000	672
chr3	129643792	129651792	129651608	8000	129647792	-4000	4000	3816
chr3	151824488	151832488	151828269	8000	151828488	-4000	4000	-219
chr3	52429035	52437035	52435804	8000	52433035	-4000	4000	2769
chr3	48560073	48568073	48564153	8000	48564073	-4000	4000	80
chr3	51391867	51399867	51393748	8000	51395867	-4000	4000	-2119
chr3	46262706	46270706	46266238	8000	46266706	-4000	4000	-468
chr3	17153162	17161162	17161130	8000	17157162	-4000	4000	3968
chr3	193394967	193402967	193402861	8000	193398967	-4000	4000	3894
chr3	52690486	52698486	52690608	8000	52694486	-4000	4000	-3878
chr3	111972517	111980517	111974594	8000	111976517	-4000	4000	-1923
chr3	112528510	112536510	112534006	8000	112532510	-4000	4000	1496
chr3	184102995	184110995	184106139	8000	184106995	-4000	4000	-856
chr3	15446133	15454133	15450379	8000	15450133	-4000	4000	246
chr3	165182720	165190720	165188204	8000	165186720	-4000	4000	1484
chr3	23887640	23895640	23893248	8000	23891640	-4000	4000	1608
chr3	56617837	56625837	56623389	8000	56621837	-4000	4000	1552
chr3	98468924	98476924	98469583	8000	98472924	-4000	4000	-3341
chr3	46511385	46519385	46518848	8000	46515385	-4000	4000	3463
chr3	3062324	3070324	3070264	8000	3066324	-4000	4000	3940
chr3	48852926	48860926	48858569	8000	48856926	-4000	4000	1643
chr3	186785880	186793880	186786241	8000	186789880	-4000	4000	-3639
chr3	75663220	75671220	75664487	8000	75667220	-4000	4000	-2733
chr3	136143894	136151894	136150635	8000	136147894	-4000	4000	2741
chr3	196210222	196218222	196210662	8000	196214222	-4000	4000	-3560
chr3	44656791	44664791	44659818	8000	44660791	-4000	4000	-973
chr3	5176911	5184911	5178667	8000	5180911	-4000	4000	-2244
chr3	33146043	33154043	33153021	8000	33150043	-4000	4000	2978
chr3	151433072	151441072	151436886	8000	151437072	-4000	4000	-186
chr3	195564705	195572705	195568853	8000	195568705	-4000	4000	148
chr3	98084102	98092102	98087413	8000	98088102	-4000	4000	-689
chr3	126099562	126107562	126103741	8000	126103562	-4000	4000	179
chr3	142445007	142453007	142450232	8000	142449007	-4000	4000	1225
chr3	5215958	5223958	5216221	8000	5219958	-4000	4000	-3737
chr3	73059337	73067337	73065755	8000	73063337	-4000	4000	2418
chr3	98791941	98799941	98799451	8000	98795941	-4000	4000	3510
chr3	149734472	149742472	149741477	8000	149738472	-4000	4000	3005
chr3	125524858	125532858	125530400	8000	125528858	-4000	4000	1542
chr3	33146043	33154043	33153123	8000	33150043	-4000	4000	3080
chr3	9725908	9733908	9726697	8000	9729908	-4000	4000	-3211
chr3	13634422	13642422	13637942	8000	13638422	-4000	4000	-480
chr3	1400217	1408217	1403487	8000	1404217	-4000	4000	-730
chr3	52805009	52813009	52806937	8000	52809009	-4000	4000	-2072
chr3	143261222	143269222	143265886	8000	143265222	-4000	4000	664
chr3	122877139	122885139	122879397	8000	122881139	-4000	4000	-1742
chr3	121427431	121435431	121432305	8000	121431431	-4000	4000	874
chr3	50295890	50303890	50303036	8000	50299890	-4000	4000	3146
chr3	98261356	98269356	98265242	8000	98265356	-4000	4000	-114
chr3	121659199	121667199	121664328	8000	121663199	-4000	4000	1129
chr3	3053959	3061959	3056331	8000	3057959	-4000	4000	-1628
chr3	125524858	125532858	125530436	8000	125528858	-4000	4000	1578
chr3	143261222	143269222	143266402	8000	143265222	-4000	4000	1180
chr3	154330943	154338943	154337937	8000	154334943	-4000	4000	2994
chr3	49117114	49125114	49121999	8000	49121114	-4000	4000	885
chr3	3140628	3148628	3147453	8000	3144628	-4000	4000	2825
chr3	13812258	13820258	13819073	8000	13816258	-4000	4000	2815
chr3	33146043	33154043	33152667	8000	33150043	-4000	4000	2624
chr3	113438718	113446718	113445292	8000	113442718	-4000	4000	2574
chr3	98280070	98288070	98283123	8000	98284070	-4000	4000	-947
chr3	37046846	37054846	37050508	8000	37050846	-4000	4000	-338
chr3	98280070	98288070	98283602	8000	98284070	-4000	4000	-468
chr3	128475427	128483427	128481014	8000	128479427	-4000	4000	1587
chr3	122337969	122345969	122341549	8000	122341969	-4000	4000	-420
chr3	169762921	169770921	169769470	8000	169766921	-4000	4000	2549
chr3	73059337	73067337	73065117	8000	73063337	-4000	4000	1780
chr3	138057990	138065990	138062863	8000	138061990	-4000	4000	873
chr3	184190012	184198012	184191252	8000	184194012	-4000	4000	-2760
chr3	38139022	38147022	38141265	8000	38143022	-4000	4000	-1757
chr3	14930571	14938571	14933734	8000	14934571	-4000	4000	-837
chr3	149158410	149166410	149160163	8000	149162410	-4000	4000	-2247
chr3	36822819	36830819	36828230	8000	36826819	-4000	4000	1411
chr3	48513684	48521684	48519790	8000	48517684	-4000	4000	2106
chr3	101562446	101570446	101565721	8000	101566446	-4000	4000	-725
chr3	186785880	186793880	186787858	8000	186789880	-4000	4000	-2022
chr3	67007210	67015210	67008224	8000	67011210	-4000	4000	-2986
chr3	52210327	52218327	52214093	8000	52214327	-4000	4000	-234
chr3	98791941	98799941	98793701	8000	98795941	-4000	4000	-2240
chr3	128905866	128913866	128912516	8000	128909866	-4000	4000	2650
chr3	156535553	156543553	156543140	8000	156539553	-4000	4000	3587
chr3	160674448	160682448	160677933	8000	160678448	-4000	4000	-515
chr3	167474684	167482684	167478765	8000	167478684	-4000	4000	81
chr3	172626249	172634249	172633520	8000	172630249	-4000	4000	3271
chr3	184331358	184339358	184334749	8000	184335358	-4000	4000	-609
chr3	187368076	187376076	187368465	8000	187372076	-4000	4000	-3611
chr3	194335768	194343768	194342494	8000	194339768	-4000	4000	2726
chr3	3053959	3061959	3056210	8000	3057959	-4000	4000	-1749
chr3	69964336	69972336	69968267	8000	69968336	-4000	4000	-69
chr3	187074553	187082553	187076989	8000	187078553	-4000	4000	-1564
chr3	128615969	128623969	128622169	8000	128619969	-4000	4000	2200
chr3	1400217	1408217	1402329	8000	1404217	-4000	4000	-1888
chr3	68971217	68979217	68977755	8000	68975217	-4000	4000	2538
chr3	52250434	52258434	52256623	8000	52254434	-4000	4000	2189
chr3	98280070	98288070	98283157	8000	98284070	-4000	4000	-913
chr3	169785716	169793716	169786459	8000	169789716	-4000	4000	-3257
chr3	42688544	42696544	42691958	8000	42692544	-4000	4000	-586
chr3	136143894	136151894	136151180	8000	136147894	-4000	4000	3286
chr4	108031241	108039241	108034504	8000	108035241	-4000	4000	-737
chr4	185366185	185374185	185370811	8000	185370185	-4000	4000	626
chr4	73850483	73858483	73853894	8000	73854483	-4000	4000	-589
chr4	121031613	121039613	121036836	8000	121035613	-4000	4000	1223
chr4	174974180	174982180	174978150	8000	174978180	-4000	4000	-30
chr4	75810286	75818286	75813341	8000	75814286	-4000	4000	-945
chr4	106917802	106925802	106922078	8000	106921802	-4000	4000	276
chr4	154227742	154235742	154235356	8000	154231742	-4000	4000	3614
chr4	174974180	174982180	174976364	8000	174978180	-4000	4000	-1816
chr4	3036760	3044760	3038486	8000	3040760	-4000	4000	-2274
chr4	165037749	165045749	165040345	8000	165041749	-4000	4000	-1404
chr4	173520969	173528969	173528750	8000	173524969	-4000	4000	3781
chr4	54736783	54744783	54740364	8000	54740783	-4000	4000	-419
chr4	6880170	6888170	6882835	8000	6884170	-4000	4000	-1335
chr4	2728573	2736573	2731824	8000	2732573	-4000	4000	-749
chr4	38768238	38776238	38775087	8000	38772238	-4000	4000	2849
chr4	73417482	73425482	73419641	8000	73421482	-4000	4000	-1841
chr4	73867308	73875308	73870519	8000	73871308	-4000	4000	-789
chr4	94294535	94302535	94299469	8000	94298535	-4000	4000	934
chr4	110613423	110621423	110621202	8000	110617423	-4000	4000	3779
chr4	108031241	108039241	108034393	8000	108035241	-4000	4000	-848
chr4	89110901	89118901	89113094	8000	89114901	-4000	4000	-1807
chr4	107949461	107957461	107950353	8000	107953461	-4000	4000	-3108
chr4	185366185	185374185	185370745	8000	185370185	-4000	4000	560
chr4	188143743	188151743	188147036	8000	188147743	-4000	4000	-707
chr4	15066153	15074153	15066319	8000	15070153	-4000	4000	-3834
chr4	52862835	52870835	52865539	8000	52866835	-4000	4000	-1296
chr4	188001046	188009046	188002733	8000	188005046	-4000	4000	-2313
chr4	93826964	93834964	93829918	8000	93830964	-4000	4000	-1046
chr4	1807479	1815479	1808445	8000	1811479	-4000	4000	-3034
chr4	102881048	102889048	102887435	8000	102885048	-4000	4000	2387
chr4	146638474	146646474	146640659	8000	146642474	-4000	4000	-1815
chr4	15442167	15450167	15442850	8000	15446167	-4000	4000	-3317
chr4	109684719	109692719	109689386	8000	109688719	-4000	4000	667
chr4	40242967	40250967	40243407	8000	40246967	-4000	4000	-3560
chr4	174974180	174982180	174975625	8000	174978180	-4000	4000	-2555
chr4	121820329	121828329	121822496	8000	121824329	-4000	4000	-1833
chr4	109684719	109692719	109690897	8000	109688719	-4000	4000	2178
chr4	3435913	3443913	3439531	8000	3439913	-4000	4000	-382
chr4	73867308	73875308	73869978	8000	73871308	-4000	4000	-1330
chr4	110009766	110017766	110011416	8000	110013766	-4000	4000	-2350
chr4	155213078	155221078	155214861	8000	155217078	-4000	4000	-2217
chr4	188143743	188151743	188147078	8000	188147743	-4000	4000	-665
chr4	80959750	80967750	80963566	8000	80963750	-4000	4000	-184
chr4	112438621	112446621	112439753	8000	112442621	-4000	4000	-2868
chr4	6316578	6324578	6320688	8000	6320578	-4000	4000	110
chr4	51989652	51997652	51995047	8000	51993652	-4000	4000	1395
chr4	69291050	69299050	69294556	8000	69295050	-4000	4000	-494
chr4	182799024	182807024	182799854	8000	182803024	-4000	4000	-3170
chr4	121813021	121821021	121819430	8000	121817021	-4000	4000	2409
chr4	163319962	163327962	163326027	8000	163323962	-4000	4000	2065
chr4	56805860	56813860	56810086	8000	56809860	-4000	4000	226
chr4	56805860	56813860	56810087	8000	56809860	-4000	4000	227
chr4	55591229	55599229	55592157	8000	55595229	-4000	4000	-3072
chr4	68049198	68057198	68053492	8000	68053198	-4000	4000	294
chr4	152975671	152983671	152975965	8000	152979671	-4000	4000	-3706
chr4	122740942	122748942	122743099	8000	122744942	-4000	4000	-1843
chr4	20616561	20624561	20617472	8000	20620561	-4000	4000	-3089
chr4	79402361	79410361	79406561	8000	79406361	-4000	4000	200
chr4	188143743	188151743	188146870	8000	188147743	-4000	4000	-873
chr4	183445064	183453064	183446790	8000	183449064	-4000	4000	-2274
chr4	70478997	70486997	70481284	8000	70482997	-4000	4000	-1713
chr4	152975671	152983671	152976603	8000	152979671	-4000	4000	-3068
chr4	190020367	190028367	190027138	8000	190024367	-4000	4000	2771
chr4	165037749	165045749	165040327	8000	165041749	-4000	4000	-1422
chr4	70247474	70255474	70249489	8000	70251474	-4000	4000	-1985
chr4	10435880	10443880	10443175	8000	10439880	-4000	4000	3295
chr4	70032538	70040538	70033172	8000	70036538	-4000	4000	-3366
chr4	165339164	165347164	165340539	8000	165343164	-4000	4000	-2625
chr4	41740082	41748082	41746248	8000	41744082	-4000	4000	2166
chr4	184690963	184698963	184691706	8000	184694963	-4000	4000	-3257
chr4	188001046	188009046	188003706	8000	188005046	-4000	4000	-1340
chr4	105678627	105686627	105679254	8000	105682627	-4000	4000	-3373
chr4	87612873	87620873	87614177	8000	87616873	-4000	4000	-2696
chr4	13536830	13544830	13542289	8000	13540830	-4000	4000	1459
chr4	88704450	88712450	88708021	8000	88708450	-4000	4000	-429
chr4	122447470	122455470	122451718	8000	122451470	-4000	4000	248
chr4	134192333	134200333	134200229	8000	134196333	-4000	4000	3896
chr4	188143743	188151743	188146826	8000	188147743	-4000	4000	-917
chr4	163319962	163327962	163324343	8000	163323962	-4000	4000	381
chr4	184623696	184631696	184631065	8000	184627696	-4000	4000	3369
chr4	87979532	87987532	87982647	8000	87983532	-4000	4000	-885
chr4	117079554	117087554	117084712	8000	117083554	-4000	4000	1158
chr4	117079554	117087554	117084714	8000	117083554	-4000	4000	1160
chr4	75997275	76005275	76003518	8000	76001275	-4000	4000	2243
chr4	47589999	47597999	47595659	8000	47593999	-4000	4000	1660
chr4	117079554	117087554	117085073	8000	117083554	-4000	4000	1519
chr4	76110659	76118659	76117667	8000	76114659	-4000	4000	3008
chr4	183316777	183324777	183319758	8000	183320777	-4000	4000	-1019
chr4	121813021	121821021	121813991	8000	121817021	-4000	4000	-3030
chr4	154227742	154235742	154235710	8000	154231742	-4000	4000	3968
chr4	155213078	155221078	155213943	8000	155217078	-4000	4000	-3135
chr4	38135175	38143175	38137433	8000	38139175	-4000	4000	-1742
chr4	82479170	82487170	82485463	8000	82483170	-4000	4000	2293
chr4	159356174	159364174	159358160	8000	159360174	-4000	4000	-2014
chr4	89110901	89118901	89113753	8000	89114901	-4000	4000	-1148
chr4	121813021	121821021	121816691	8000	121817021	-4000	4000	-330
chr4	70642824	70650824	70644373	8000	70646824	-4000	4000	-2451
chr4	74093040	74101040	74099105	8000	74097040	-4000	4000	2065
chr4	127770292	127778292	127773470	8000	127774292	-4000	4000	-822
chr4	173520969	173528969	173528786	8000	173524969	-4000	4000	3817
chr4	69108987	69116987	69112771	8000	69112987	-4000	4000	-216
chr4	83257536	83265536	83264241	8000	83261536	-4000	4000	2705
chr4	70603288	70611288	70606263	8000	70607288	-4000	4000	-1025
chr4	81083370	81091370	81089801	8000	81087370	-4000	4000	2431
chr4	102247080	102255080	102253387	8000	102251080	-4000	4000	2307
chr4	122894236	122902236	122897428	8000	122898236	-4000	4000	-808
chr4	165494547	165502547	165497657	8000	165498547	-4000	4000	-890
chr4	87979532	87987532	87982877	8000	87983532	-4000	4000	-655
chr4	7961310	7969310	7967060	8000	7965310	-4000	4000	1750
chr4	70363158	70371158	70366709	8000	70367158	-4000	4000	-449
chr4	79402361	79410361	79408182	8000	79406361	-4000	4000	1821
chr4	99272369	99280369	99279476	8000	99276369	-4000	4000	3107
chr4	100181870	100189870	100187776	8000	100185870	-4000	4000	1906
chr4	110613423	110621423	110618644	8000	110617423	-4000	4000	1221
chr4	121663946	121671946	121668330	8000	121667946	-4000	4000	384
chr4	139712753	139720753	139719484	8000	139716753	-4000	4000	2731
chr4	184383729	184391729	184388819	8000	184387729	-4000	4000	1090
chr4	119291518	119299518	119292769	8000	119295518	-4000	4000	-2749
chr4	25674748	25682748	25676214	8000	25678748	-4000	4000	-2534
chr4	110613423	110621423	110618578	8000	110617423	-4000	4000	1155
chr4	16497541	16505541	16503076	8000	16501541	-4000	4000	1535
chr4	25743433	25751433	25748440	8000	25747433	-4000	4000	1007
chr4	44169903	44177903	44174183	8000	44173903	-4000	4000	280
chr4	182799024	182807024	182799727	8000	182803024	-4000	4000	-3297
chr4	118276038	118284038	118283058	8000	118280038	-4000	4000	3020
chr4	174974180	174982180	174977051	8000	174978180	-4000	4000	-1129
chr4	55423903	55431903	55425576	8000	55427903	-4000	4000	-2327
chr4	108031241	108039241	108033190	8000	108035241	-4000	4000	-2051
chr4	7961310	7969310	7967019	8000	7965310	-4000	4000	1709
chr4	87612873	87620873	87612976	8000	87616873	-4000	4000	-3897
chr4	125488932	125496932	125490865	8000	125492932	-4000	4000	-2067
chr4	186285681	186293681	186285764	8000	186289681	-4000	4000	-3917
chr4	70642824	70650824	70642926	8000	70646824	-4000	4000	-3898
chr4	174974180	174982180	174977705	8000	174978180	-4000	4000	-475
chr4	146638474	146646474	146640148	8000	146642474	-4000	4000	-2326
chr4	174486175	174494175	174491573	8000	174490175	-4000	4000	1398
chr4	105678627	105686627	105680114	8000	105682627	-4000	4000	-2513
chr4	87979532	87987532	87981541	8000	87983532	-4000	4000	-1991
chr4	25743433	25751433	25748230	8000	25747433	-4000	4000	797
chr4	15442167	15450167	15442703	8000	15446167	-4000	4000	-3464
chr4	70333116	70341116	70335874	8000	70337116	-4000	4000	-1242
chr4	44169903	44177903	44174707	8000	44173903	-4000	4000	804
chr4	151666503	151674503	151671161	8000	151670503	-4000	4000	658
chr4	118276038	118284038	118283068	8000	118280038	-4000	4000	3030
chr4	16497541	16505541	16502775	8000	16501541	-4000	4000	1234
chr4	154579128	154587128	154584303	8000	154583128	-4000	4000	1175
chr4	7961310	7969310	7966387	8000	7965310	-4000	4000	1077
chr4	38768238	38776238	38775028	8000	38772238	-4000	4000	2790
chr4	37445463	37453463	37447164	8000	37449463	-4000	4000	-2299
chr4	163319962	163327962	163325876	8000	163323962	-4000	4000	1914
chr4	102070812	102078812	102071275	8000	102074812	-4000	4000	-3537
chr4	121820329	121828329	121822607	8000	121824329	-4000	4000	-1722
chr4	41740082	41748082	41747372	8000	41744082	-4000	4000	3290
chr4	70603288	70611288	70603890	8000	70607288	-4000	4000	-3398
chr4	4859936	4867936	4862698	8000	4863936	-4000	4000	-1238
chr4	176209673	176217673	176216877	8000	176213673	-4000	4000	3204
chr4	139712753	139720753	139719522	8000	139716753	-4000	4000	2769
chr4	163467095	163475095	163471934	8000	163471095	-4000	4000	839
chr4	127895224	127903224	127898584	8000	127899224	-4000	4000	-640
chr4	51989652	51997652	51995732	8000	51993652	-4000	4000	2080
chr4	155213078	155221078	155214470	8000	155217078	-4000	4000	-2608
chr4	70478997	70486997	70481598	8000	70482997	-4000	4000	-1399
chr4	70478997	70486997	70481599	8000	70482997	-4000	4000	-1398
chr4	75561871	75569871	75564412	8000	75565871	-4000	4000	-1459
chr4	146638474	146646474	146641421	8000	146642474	-4000	4000	-1053
chr4	150253438	150261438	150257344	8000	150257438	-4000	4000	-94
chr4	89950629	89958629	89953151	8000	89954629	-4000	4000	-1478
chr4	174974180	174982180	174976688	8000	174978180	-4000	4000	-1492
chr4	117079554	117087554	117084538	8000	117083554	-4000	4000	984
chr4	117079554	117087554	117084539	8000	117083554	-4000	4000	985
chr4	185395537	185403537	185396948	8000	185399537	-4000	4000	-2589
chr4	125488932	125496932	125490272	8000	125492932	-4000	4000	-2660
chr4	46730827	46738827	46734938	8000	46734827	-4000	4000	111
chr4	121820329	121828329	121828059	8000	121824329	-4000	4000	3730
chr4	93826964	93834964	93829497	8000	93830964	-4000	4000	-1467
chr4	89110901	89118901	89113094	8000	89114901	-4000	4000	-1807
chr4	173520969	173528969	173528951	8000	173524969	-4000	4000	3982
chr4	123399760	123407760	123402465	8000	123403760	-4000	4000	-1295
chr4	47422447	47430447	47426188	8000	47426447	-4000	4000	-259
chr4	70386244	70394244	70389693	8000	70390244	-4000	4000	-551
chr4	70603288	70611288	70606420	8000	70607288	-4000	4000	-868
chr4	185395537	185403537	185396908	8000	185399537	-4000	4000	-2629
chr4	69476165	69484165	69480645	8000	69480165	-4000	4000	480
chr4	146702617	146710617	146707050	8000	146706617	-4000	4000	433
chr4	106917802	106925802	106924276	8000	106921802	-4000	4000	2474
chr4	164950446	164958446	164957172	8000	164954446	-4000	4000	2726
chr4	41740082	41748082	41744488	8000	41744082	-4000	4000	406
chr4	114674225	114682225	114676562	8000	114678225	-4000	4000	-1663
chr4	163467095	163475095	163472900	8000	163471095	-4000	4000	1805
chr4	169090259	169098259	169095286	8000	169094259	-4000	4000	1027
chr4	182799024	182807024	182802215	8000	182803024	-4000	4000	-809
chr4	185016953	185024953	185020512	8000	185020953	-4000	4000	-441
chr4	76110659	76118659	76115437	8000	76114659	-4000	4000	778
chr4	144105303	144113303	144111146	8000	144109303	-4000	4000	1843
chr4	165037749	165045749	165041006	8000	165041749	-4000	4000	-743
chr4	38768238	38776238	38775476	8000	38772238	-4000	4000	3238
chr4	169090259	169098259	169096657	8000	169094259	-4000	4000	2398
chr4	52016706	52024706	52017470	8000	52020706	-4000	4000	-3236
chr4	78540269	78548269	78540884	8000	78544269	-4000	4000	-3385
chr4	140384453	140392453	140392309	8000	140388453	-4000	4000	3856
chr4	152765354	152773354	152771014	8000	152769354	-4000	4000	1660
chr4	158706742	158714742	158709551	8000	158710742	-4000	4000	-1191
chr4	4859936	4867936	4862758	8000	4863936	-4000	4000	-1178
chr4	87332515	87340515	87337332	8000	87336515	-4000	4000	817
chr4	153702260	153710260	153704905	8000	153706260	-4000	4000	-1355
chr4	87979532	87987532	87983067	8000	87983532	-4000	4000	-465
chr4	36343511	36351511	36343815	8000	36347511	-4000	4000	-3696
chr4	154227742	154235742	154234466	8000	154231742	-4000	4000	2724
chr4	147540954	147548954	147542626	8000	147544954	-4000	4000	-2328
chr4	109536896	109544896	109539655	8000	109540896	-4000	4000	-1241
chr4	68493604	68501604	68497135	8000	68497604	-4000	4000	-469
chr4	266675	274675	272318	8000	270675	-4000	4000	1643
chr4	164950446	164958446	164957444	8000	164954446	-4000	4000	2998
chr4	48493357	48501357	48494141	8000	48497357	-4000	4000	-3216
chr4	421815	429815	426702	8000	425815	-4000	4000	887
chr4	105678627	105686627	105679776	8000	105682627	-4000	4000	-2851
chr4	47589999	47597999	47595893	8000	47593999	-4000	4000	1894
chr4	183316777	183324777	183318561	8000	183320777	-4000	4000	-2216
chr4	102790383	102798383	102797384	8000	102794383	-4000	4000	3001
chr4	174974180	174982180	174976557	8000	174978180	-4000	4000	-1623
chr4	128218931	128226931	128222451	8000	128222931	-4000	4000	-480
chr4	87612873	87620873	87616450	8000	87616873	-4000	4000	-423
chr4	121754881	121762881	121761653	8000	121758881	-4000	4000	2772
chr4	174329380	174337380	174331637	8000	174333380	-4000	4000	-1743
chr4	174974180	174982180	174977934	8000	174978180	-4000	4000	-246
chr4	3036760	3044760	3037409	8000	3040760	-4000	4000	-3351
chr4	10435880	10443880	10443592	8000	10439880	-4000	4000	3712
chr4	163467095	163475095	163472672	8000	163471095	-4000	4000	1577
chr4	73739716	73747716	73741670	8000	73743716	-4000	4000	-2046
chr4	125488932	125496932	125490873	8000	125492932	-4000	4000	-2059
chr4	70386244	70394244	70389970	8000	70390244	-4000	4000	-274
chr4	84208	92208	86681	8000	88208	-4000	4000	-1527
chr4	73500001	73508001	73500096	8000	73504001	-4000	4000	-3905
chr4	112535333	112543333	112539930	8000	112539333	-4000	4000	597
chr4	183508429	183516429	183510711	8000	183512429	-4000	4000	-1718
chr4	185395537	185403537	185399920	8000	185399537	-4000	4000	383
chr4	186583794	186591794	186588455	8000	186587794	-4000	4000	661
chr4	87808435	87816435	87811925	8000	87812435	-4000	4000	-510
chr4	182799024	182807024	182799954	8000	182803024	-4000	4000	-3070
chr4	79402361	79410361	79407009	8000	79406361	-4000	4000	648
chr4	140381728	140389728	140389155	8000	140385728	-4000	4000	3427
chr4	37445463	37453463	37446470	8000	37449463	-4000	4000	-2993
chr4	69476165	69484165	69480487	8000	69480165	-4000	4000	322
chr4	70363158	70371158	70367074	8000	70367158	-4000	4000	-84
chr4	146638474	146646474	146640364	8000	146642474	-4000	4000	-2110
chr4	40806027	40814027	40808780	8000	40810027	-4000	4000	-1247
chr4	94294535	94302535	94302174	8000	94298535	-4000	4000	3639
chr4	158120474	158128474	158127408	8000	158124474	-4000	4000	2934
chr4	154824813	154832813	154828069	8000	154828813	-4000	4000	-744
chr4	4859936	4867936	4862841	8000	4863936	-4000	4000	-1095
chr4	87842814	87850814	87846745	8000	87846814	-4000	4000	-69
chr4	165037749	165045749	165040539	8000	165041749	-4000	4000	-1210
chr4	73069376	73077376	73076946	8000	73073376	-4000	4000	3570
chr4	87612873	87620873	87613288	8000	87616873	-4000	4000	-3585
chr4	3239957	3247957	3241480	8000	3243957	-4000	4000	-2477
chr4	174974180	174982180	174976198	8000	174978180	-4000	4000	-1982
chr4	56520959	56528959	56523740	8000	56524959	-4000	4000	-1219
chr4	121663946	121671946	121668326	8000	121667946	-4000	4000	380
chr4	16497541	16505541	16502650	8000	16501541	-4000	4000	1109
chr4	27021381	27029381	27023103	8000	27025381	-4000	4000	-2278
chr4	74299099	74307099	74301755	8000	74303099	-4000	4000	-1344
chr4	26752223	26760223	26755103	8000	26756223	-4000	4000	-1120
chr4	54736783	54744783	54739954	8000	54740783	-4000	4000	-829
chr4	88439097	88447097	88442469	8000	88443097	-4000	4000	-628
chr4	186583794	186591794	186588375	8000	186587794	-4000	4000	581
chr4	8362282	8370282	8367066	8000	8366282	-4000	4000	784
chr4	10482395	10490395	10490341	8000	10486395	-4000	4000	3946
chr4	79402361	79410361	79406791	8000	79406361	-4000	4000	430
chr4	185016953	185024953	185018951	8000	185020953	-4000	4000	-2002
chr4	39283456	39291456	39288407	8000	39287456	-4000	4000	951
chr4	112535333	112543333	112539939	8000	112539333	-4000	4000	606
chr4	73069376	73077376	73076263	8000	73073376	-4000	4000	2887
chr4	99542709	99550709	99549170	8000	99546709	-4000	4000	2461
chr4	165037749	165045749	165041006	8000	165041749	-4000	4000	-743
chr4	113896284	113904284	113902814	8000	113900284	-4000	4000	2530
chr4	43026658	43034658	43030452	8000	43030658	-4000	4000	-206
chr4	39818863	39826863	39825248	8000	39822863	-4000	4000	2385
chr4	175628934	175636934	175633261	8000	175632934	-4000	4000	327
chr4	79402361	79410361	79408006	8000	79406361	-4000	4000	1645
chr4	15442167	15450167	15442596	8000	15446167	-4000	4000	-3571
chr4	69108987	69116987	69112811	8000	69112987	-4000	4000	-176
chr4	185441182	185449182	185445458	8000	185445182	-4000	4000	276
chr4	117079554	117087554	117085071	8000	117083554	-4000	4000	1517
chr4	52862835	52870835	52865433	8000	52866835	-4000	4000	-1402
chr4	68642597	68650597	68647215	8000	68646597	-4000	4000	618
chr4	121813021	121821021	121817051	8000	121817021	-4000	4000	30
chr4	185581444	185589444	185586224	8000	185585444	-4000	4000	780
chr4	161379897	161387897	161385943	8000	161383897	-4000	4000	2046
chr4	163467095	163475095	163471674	8000	163471095	-4000	4000	579
chr4	56805860	56813860	56811743	8000	56809860	-4000	4000	1883
chr4	113380221	113388221	113381607	8000	113384221	-4000	4000	-2614
chr4	125488932	125496932	125491263	8000	125492932	-4000	4000	-1669
chr4	165273812	165281812	165279458	8000	165277812	-4000	4000	1646
chr4	70603288	70611288	70606214	8000	70607288	-4000	4000	-1074
chr4	127895224	127903224	127898516	8000	127899224	-4000	4000	-708
chr4	43026658	43034658	43030438	8000	43030658	-4000	4000	-220
chr4	70333116	70341116	70335180	8000	70337116	-4000	4000	-1936
chr4	51989652	51997652	51995609	8000	51993652	-4000	4000	1957
chr4	185496660	185504660	185502281	8000	185500660	-4000	4000	1621
chr4	3764526	3772526	3767967	8000	3768526	-4000	4000	-559
chr4	20724606	20732606	20730096	8000	20728606	-4000	4000	1490
chr4	82625539	82633539	82631357	8000	82629539	-4000	4000	1818
chr4	112535333	112543333	112539493	8000	112539333	-4000	4000	160
chr4	148074762	148082762	148081429	8000	148078762	-4000	4000	2667
chr4	151666503	151674503	151671007	8000	151670503	-4000	4000	504
chr4	121663946	121671946	121669701	8000	121667946	-4000	4000	1755
chr4	157362075	157370075	157363675	8000	157366075	-4000	4000	-2400
chr4	176679538	176687538	176683968	8000	176683538	-4000	4000	430
chr4	94664227	94672227	94666442	8000	94668227	-4000	4000	-1785
chr4	68828023	68836023	68830642	8000	68832023	-4000	4000	-1381
chr4	175628934	175636934	175634232	8000	175632934	-4000	4000	1298
chr4	137514918	137522918	137521396	8000	137518918	-4000	4000	2478
chr4	125488932	125496932	125490765	8000	125492932	-4000	4000	-2167
chr4	15066153	15074153	15066475	8000	15070153	-4000	4000	-3678
chr4	87808435	87816435	87811967	8000	87812435	-4000	4000	-468
chr4	139712753	139720753	139719522	8000	139716753	-4000	4000	2769
chr4	3036760	3044760	3038374	8000	3040760	-4000	4000	-2386
chr4	421815	429815	426026	8000	425815	-4000	4000	211
chr4	41740082	41748082	41747536	8000	41744082	-4000	4000	3454
chr4	140616782	140624782	140624355	8000	140620782	-4000	4000	3573
chr4	67816876	67824876	67822194	8000	67820876	-4000	4000	1318
chr4	80200329	80208329	80202051	8000	80204329	-4000	4000	-2278
chr4	165273812	165281812	165278599	8000	165277812	-4000	4000	787
chr4	83455517	83463517	83462590	8000	83459517	-4000	4000	3073
chr4	163319962	163327962	163326533	8000	163323962	-4000	4000	2571
chr4	6880170	6888170	6880995	8000	6884170	-4000	4000	-3175
chr4	38135175	38143175	38137148	8000	38139175	-4000	4000	-2027
chr4	40242967	40250967	40243461	8000	40246967	-4000	4000	-3506
chr4	47422447	47430447	47426110	8000	47426447	-4000	4000	-337
chr4	48485526	48493526	48492851	8000	48489526	-4000	4000	3325
chr4	48493357	48501357	48494201	8000	48497357	-4000	4000	-3156
chr4	74032589	74040589	74037004	8000	74036589	-4000	4000	415
chr4	75810286	75818286	75813255	8000	75814286	-4000	4000	-1031
chr4	78540269	78548269	78540974	8000	78544269	-4000	4000	-3295
chr4	93826964	93834964	93828931	8000	93830964	-4000	4000	-2033
chr4	117079554	117087554	117084442	8000	117083554	-4000	4000	888
chr4	125488932	125496932	125490177	8000	125492932	-4000	4000	-2755
chr4	137514918	137522918	137521455	8000	137518918	-4000	4000	2537
chr4	169719673	169727673	169720014	8000	169723673	-4000	4000	-3659
chr4	173327376	173335376	173331892	8000	173331376	-4000	4000	516
chr4	185496660	185504660	185502359	8000	185500660	-4000	4000	1699
chr4	266675	274675	271224	8000	270675	-4000	4000	549
chr4	266675	274675	271736	8000	270675	-4000	4000	1061
chr4	154568807	154576807	154570653	8000	154572807	-4000	4000	-2154
chr4	7961310	7969310	7965571	8000	7965310	-4000	4000	261
chr4	54736783	54744783	54739435	8000	54740783	-4000	4000	-1348
chr4	82418565	82426565	82425598	8000	82422565	-4000	4000	3033
chr4	86819468	86827468	86825454	8000	86823468	-4000	4000	1986
chr4	119490397	119498397	119498356	8000	119494397	-4000	4000	3959
chr4	121820329	121828329	121823592	8000	121824329	-4000	4000	-737
chr4	122740942	122748942	122742394	8000	122744942	-4000	4000	-2548
chr4	146638474	146646474	146640063	8000	146642474	-4000	4000	-2411
chr4	150260435	150268435	150265033	8000	150264435	-4000	4000	598
chr4	154227742	154235742	154235290	8000	154231742	-4000	4000	3548
chr4	99944086	99952086	99949720	8000	99948086	-4000	4000	1634
chr4	37445463	37453463	37445548	8000	37449463	-4000	4000	-3915
chr4	46730827	46738827	46735147	8000	46734827	-4000	4000	320
chr4	54291272	54299272	54295128	8000	54295272	-4000	4000	-144
chr4	37445463	37453463	37445913	8000	37449463	-4000	4000	-3550
chr4	44618088	44626088	44624638	8000	44622088	-4000	4000	2550
chr4	161379897	161387897	161385877	8000	161383897	-4000	4000	1980
chr4	121031613	121039613	121036073	8000	121035613	-4000	4000	460
chr4	84208	92208	86632	8000	88208	-4000	4000	-1576
chr4	44678200	44686200	44680531	8000	44682200	-4000	4000	-1669
chr4	110009766	110017766	110011454	8000	110013766	-4000	4000	-2312
chr4	37445463	37453463	37445569	8000	37449463	-4000	4000	-3894
chr4	37445463	37453463	37446804	8000	37449463	-4000	4000	-2659
chr4	55423903	55431903	55425395	8000	55427903	-4000	4000	-2508
chr4	72144305	72152305	72147747	8000	72148305	-4000	4000	-558
chr4	76110659	76118659	76115213	8000	76114659	-4000	4000	554
chr4	87808435	87816435	87811940	8000	87812435	-4000	4000	-495
chr4	99198638	99206638	99204995	8000	99202638	-4000	4000	2357
chr4	121031613	121039613	121037640	8000	121035613	-4000	4000	2027
chr4	174974180	174982180	174975617	8000	174978180	-4000	4000	-2563
chr4	55901086	55909086	55902440	8000	55905086	-4000	4000	-2646
chr4	54291272	54299272	54295359	8000	54295272	-4000	4000	87
chr4	70200576	70208576	70203200	8000	70204576	-4000	4000	-1376
chr4	421815	429815	426385	8000	425815	-4000	4000	570
chr4	9232046	9240046	9239944	8000	9236046	-4000	4000	3898
chr4	27021381	27029381	27023470	8000	27025381	-4000	4000	-1911
chr4	38135175	38143175	38137438	8000	38139175	-4000	4000	-1737
chr4	41740082	41748082	41744734	8000	41744082	-4000	4000	652
chr4	44678200	44686200	44678667	8000	44682200	-4000	4000	-3533
chr4	69291050	69299050	69294791	8000	69295050	-4000	4000	-259
chr4	71568087	71576087	71568194	8000	71572087	-4000	4000	-3893
chr4	113380221	113388221	113382948	8000	113384221	-4000	4000	-1273
chr4	137514918	137522918	137519751	8000	137518918	-4000	4000	833
chr4	165273812	165281812	165278493	8000	165277812	-4000	4000	681
chr4	177358936	177366936	177360652	8000	177362936	-4000	4000	-2284
chr4	121754881	121762881	121761658	8000	121758881	-4000	4000	2777
chr4	421815	429815	427106	8000	425815	-4000	4000	1291
chr4	16156505	16164505	16163438	8000	16160505	-4000	4000	2933
chr4	20724606	20732606	20727380	8000	20728606	-4000	4000	-1226
chr4	37858937	37866937	37861820	8000	37862937	-4000	4000	-1117
chr4	54291272	54299272	54295225	8000	54295272	-4000	4000	-47
chr4	70642824	70650824	70643273	8000	70646824	-4000	4000	-3551
chr4	73417482	73425482	73420270	8000	73421482	-4000	4000	-1212
chr4	73850483	73858483	73854082	8000	73854483	-4000	4000	-401
chr4	112438621	112446621	112440989	8000	112442621	-4000	4000	-1632
chr4	122360167	122368167	122362272	8000	122364167	-4000	4000	-1895
chr4	143553486	143561486	143560001	8000	143557486	-4000	4000	2515
chr4	173373532	173381532	173373943	8000	173377532	-4000	4000	-3589
chr4	74384749	74392749	74388640	8000	74388749	-4000	4000	-109
chr4	78912365	78920365	78919908	8000	78916365	-4000	4000	3543
chr4	153632711	153640711	153635567	8000	153636711	-4000	4000	-1144
chr4	154568807	154576807	154570483	8000	154572807	-4000	4000	-2324
chr4	88439097	88447097	88442396	8000	88443097	-4000	4000	-701
chr4	68828023	68836023	68830629	8000	68832023	-4000	4000	-1394
chr4	68924463	68932463	68929929	8000	68928463	-4000	4000	1466
chr4	73867308	73875308	73869693	8000	73871308	-4000	4000	-1615
chr4	75855864	75863864	75860889	8000	75859864	-4000	4000	1025
chr4	112653696	112661696	112654140	8000	112657696	-4000	4000	-3556
chr4	163467095	163475095	163472087	8000	163471095	-4000	4000	992
chr4	163467095	163475095	163473290	8000	163471095	-4000	4000	2195
chr4	6316578	6324578	6323244	8000	6320578	-4000	4000	2666
chr4	110613423	110621423	110618303	8000	110617423	-4000	4000	880
chr4	108663820	108671820	108667752	8000	108667820	-4000	4000	-68
chr4	185496660	185504660	185502291	8000	185500660	-4000	4000	1631
chr4	47422447	47430447	47425881	8000	47426447	-4000	4000	-566
chr4	140616782	140624782	140622425	8000	140620782	-4000	4000	1643
chr4	184751595	184759595	184757674	8000	184755595	-4000	4000	2079
chr4	117079554	117087554	117085316	8000	117083554	-4000	4000	1762
chr4	153702260	153710260	153703595	8000	153706260	-4000	4000	-2665
chr4	95837464	95845464	95840932	8000	95841464	-4000	4000	-532
chr4	40242967	40250967	40243214	8000	40246967	-4000	4000	-3753
chr4	70200576	70208576	70202287	8000	70204576	-4000	4000	-2289
chr4	176679538	176687538	176687271	8000	176683538	-4000	4000	3733
chr4	79402361	79410361	79407874	8000	79406361	-4000	4000	1513
chr4	137514918	137522918	137521211	8000	137518918	-4000	4000	2293
chr4	20724606	20732606	20730052	8000	20728606	-4000	4000	1446
chr4	44678200	44686200	44680841	8000	44682200	-4000	4000	-1359
chr4	106917802	106925802	106924045	8000	106921802	-4000	4000	2243
chr4	16497541	16505541	16502788	8000	16501541	-4000	4000	1247
chr4	70478997	70486997	70481303	8000	70482997	-4000	4000	-1694
chr4	70247474	70255474	70249009	8000	70251474	-4000	4000	-2465
chr4	122447470	122455470	122453822	8000	122451470	-4000	4000	2352
chr4	87660361	87668361	87662931	8000	87664361	-4000	4000	-1430
chr4	154579128	154587128	154586547	8000	154583128	-4000	4000	3419
chr4	266675	274675	272406	8000	270675	-4000	4000	1731
chr4	40419267	40427267	40425954	8000	40423267	-4000	4000	2687
chr4	69942574	69950574	69944987	8000	69946574	-4000	4000	-1587
chr4	72144305	72152305	72147431	8000	72148305	-4000	4000	-874
chr4	83455517	83463517	83462331	8000	83459517	-4000	4000	2814
chr4	88721955	88729955	88728548	8000	88725955	-4000	4000	2593
chr4	118254634	118262634	118255634	8000	118258634	-4000	4000	-3000
chr4	165037749	165045749	165040437	8000	165041749	-4000	4000	-1312
chr4	17523104	17531104	17526837	8000	17527104	-4000	4000	-267
chr4	163319962	163327962	163326129	8000	163323962	-4000	4000	2167
chr4	47446787	47454787	47451625	8000	47450787	-4000	4000	838
chr4	72144305	72152305	72147705	8000	72148305	-4000	4000	-600
chr4	168183736	168191736	168187438	8000	168187736	-4000	4000	-298
chr4	421815	429815	426299	8000	425815	-4000	4000	484
chr4	42398487	42406487	42401127	8000	42402487	-4000	4000	-1360
chr4	89110901	89118901	89113707	8000	89114901	-4000	4000	-1194
chr4	56520959	56528959	56523758	8000	56524959	-4000	4000	-1201
chr4	72276969	72284969	72283247	8000	72280969	-4000	4000	2278
chr4	168183736	168191736	168184648	8000	168187736	-4000	4000	-3088
chr4	70333116	70341116	70335384	8000	70337116	-4000	4000	-1732
chr4	99866190	99874190	99868292	8000	99870190	-4000	4000	-1898
chr4	110613423	110621423	110618024	8000	110617423	-4000	4000	601
chr4	109684719	109692719	109689434	8000	109688719	-4000	4000	715
chr4	70247474	70255474	70249366	8000	70251474	-4000	4000	-2108
chr4	99198638	99206638	99204036	8000	99202638	-4000	4000	1398
chr4	152765354	152773354	152770564	8000	152769354	-4000	4000	1210
chr4	154579128	154587128	154586796	8000	154583128	-4000	4000	3668
chr4	176209673	176217673	176215560	8000	176213673	-4000	4000	1887
chr4	42398487	42406487	42401348	8000	42402487	-4000	4000	-1139
chr4	48493357	48501357	48499092	8000	48497357	-4000	4000	1735
chr4	17796655	17804655	17804107	8000	17800655	-4000	4000	3452
chr4	87842814	87850814	87846238	8000	87846814	-4000	4000	-576
chr4	3445486	3453486	3447961	8000	3449486	-4000	4000	-1525
chr4	44618088	44626088	44624666	8000	44622088	-4000	4000	2578
chr4	70333116	70341116	70336291	8000	70337116	-4000	4000	-825
chr4	154579128	154587128	154585766	8000	154583128	-4000	4000	2638
chr4	154227742	154235742	154235526	8000	154231742	-4000	4000	3784
chr4	70333116	70341116	70335880	8000	70337116	-4000	4000	-1236
chr4	16497541	16505541	16502675	8000	16501541	-4000	4000	1134
chr4	44618088	44626088	44624739	8000	44622088	-4000	4000	2651
chr4	68222653	68230653	68228775	8000	68226653	-4000	4000	2122
chr4	147668044	147676044	147673720	8000	147672044	-4000	4000	1676
chr4	41740082	41748082	41744413	8000	41744082	-4000	4000	331
chr4	76308997	76316997	76313085	8000	76312997	-4000	4000	88
chr4	154227742	154235742	154234860	8000	154231742	-4000	4000	3118
chr4	48493357	48501357	48494278	8000	48497357	-4000	4000	-3079
chr4	86819468	86827468	86823706	8000	86823468	-4000	4000	238
chr4	100181870	100189870	100187695	8000	100185870	-4000	4000	1825
chr4	163319962	163327962	163325987	8000	163323962	-4000	4000	2025
chr4	70478997	70486997	70481505	8000	70482997	-4000	4000	-1492
chr4	121813021	121821021	121816435	8000	121817021	-4000	4000	-586
chr4	69951256	69959256	69957516	8000	69955256	-4000	4000	2260
chr4	154568807	154576807	154569534	8000	154572807	-4000	4000	-3273
chr4	117079554	117087554	117084488	8000	117083554	-4000	4000	934
chr4	173520969	173528969	173528627	8000	173524969	-4000	4000	3658
chr4	67733118	67741118	67740129	8000	67737118	-4000	4000	3011
chr4	101019409	101027409	101025702	8000	101023409	-4000	4000	2293
chr4	16156505	16164505	16162441	8000	16160505	-4000	4000	1936
chr4	70642824	70650824	70644353	8000	70646824	-4000	4000	-2471
chr4	84208	92208	87066	8000	88208	-4000	4000	-1142
chr4	84208	92208	87161	8000	88208	-4000	4000	-1047
chr4	421815	429815	426410	8000	425815	-4000	4000	595
chr4	421815	429815	427062	8000	425815	-4000	4000	1247
chr4	1162932	1170932	1167616	8000	1166932	-4000	4000	684
chr4	3435913	3443913	3439607	8000	3439913	-4000	4000	-306
chr4	20616561	20624561	20618994	8000	20620561	-4000	4000	-1567
chr4	20616561	20624561	20619081	8000	20620561	-4000	4000	-1480
chr4	37445463	37453463	37446621	8000	37449463	-4000	4000	-2842
chr4	38768238	38776238	38775050	8000	38772238	-4000	4000	2812
chr4	40806027	40814027	40808986	8000	40810027	-4000	4000	-1041
chr4	48485526	48493526	48488936	8000	48489526	-4000	4000	-590
chr4	51989652	51997652	51995861	8000	51993652	-4000	4000	2209
chr4	55423903	55431903	55425442	8000	55427903	-4000	4000	-2461
chr4	69998570	70006570	69999680	8000	70002570	-4000	4000	-2890
chr4	70386244	70394244	70389717	8000	70390244	-4000	4000	-527
chr4	70642824	70650824	70644475	8000	70646824	-4000	4000	-2349
chr4	71018449	71026449	71022465	8000	71022449	-4000	4000	16
chr4	73069376	73077376	73076146	8000	73073376	-4000	4000	2770
chr4	76154737	76162737	76161484	8000	76158737	-4000	4000	2747
chr4	80200329	80208329	80202018	8000	80204329	-4000	4000	-2311
chr4	82479170	82487170	82485522	8000	82483170	-4000	4000	2352
chr4	82905973	82913973	82907784	8000	82909973	-4000	4000	-2189
chr4	83455517	83463517	83455716	8000	83459517	-4000	4000	-3801
chr4	83601875	83609875	83604814	8000	83605875	-4000	4000	-1061
chr4	104464308	104472308	104472222	8000	104468308	-4000	4000	3914
chr4	112535333	112543333	112539586	8000	112539333	-4000	4000	253
chr4	118276038	118284038	118281933	8000	118280038	-4000	4000	1895
chr4	121031613	121039613	121036546	8000	121035613	-4000	4000	933
chr4	125488932	125496932	125490289	8000	125492932	-4000	4000	-2643
chr4	127895224	127903224	127898557	8000	127899224	-4000	4000	-667
chr4	137514918	137522918	137521038	8000	137518918	-4000	4000	2120
chr4	139712753	139720753	139719787	8000	139716753	-4000	4000	3034
chr4	141729987	141737987	141732799	8000	141733987	-4000	4000	-1188
chr4	152975671	152983671	152975672	8000	152979671	-4000	4000	-3999
chr4	153776591	153784591	153781335	8000	153780591	-4000	4000	744
chr4	158706742	158714742	158710829	8000	158710742	-4000	4000	87
chr4	163319962	163327962	163326470	8000	163323962	-4000	4000	2508
chr4	163467095	163475095	163473519	8000	163471095	-4000	4000	2424
chr4	166100457	166108457	166100981	8000	166104457	-4000	4000	-3476
chr4	168924457	168932457	168926368	8000	168928457	-4000	4000	-2089
chr4	173520969	173528969	173528782	8000	173524969	-4000	4000	3813
chr4	174974180	174982180	174975570	8000	174978180	-4000	4000	-2610
chr4	177426774	177434774	177431676	8000	177430774	-4000	4000	902
chr4	185366185	185374185	185370653	8000	185370185	-4000	4000	468
chr4	48485526	48493526	48488803	8000	48489526	-4000	4000	-723
chr4	70333116	70341116	70335007	8000	70337116	-4000	4000	-2109
chr4	82479170	82487170	82485360	8000	82483170	-4000	4000	2190
chr4	146638474	146646474	146641106	8000	146642474	-4000	4000	-1368
chr4	20616561	20624561	20617131	8000	20620561	-4000	4000	-3430
chr4	153702260	153710260	153705099	8000	153706260	-4000	4000	-1161
chr4	73452174	73460174	73453859	8000	73456174	-4000	4000	-2315
chr4	99272369	99280369	99279446	8000	99276369	-4000	4000	3077
chr4	99272369	99280369	99279448	8000	99276369	-4000	4000	3079
chr4	153702260	153710260	153705109	8000	153706260	-4000	4000	-1151
chr4	173319967	173327967	173321719	8000	173323967	-4000	4000	-2248
chr4	174974180	174982180	174977165	8000	174978180	-4000	4000	-1015
chr4	93826964	93834964	93829692	8000	93830964	-4000	4000	-1272
chr4	146638474	146646474	146640335	8000	146642474	-4000	4000	-2139
chr4	87979532	87987532	87980071	8000	87983532	-4000	4000	-3461
chr4	112438621	112446621	112440970	8000	112442621	-4000	4000	-1651
chr4	51989652	51997652	51994202	8000	51993652	-4000	4000	550
chr4	266675	274675	271734	8000	270675	-4000	4000	1059
chr4	266675	274675	272048	8000	270675	-4000	4000	1373
chr4	266675	274675	272475	8000	270675	-4000	4000	1800
chr4	421815	429815	426095	8000	425815	-4000	4000	280
chr4	4263701	4271701	4267920	8000	4267701	-4000	4000	219
chr4	5744084	5752084	5745299	8000	5748084	-4000	4000	-2785
chr4	8362282	8370282	8366971	8000	8366282	-4000	4000	689
chr4	17603972	17611972	17607437	8000	17607972	-4000	4000	-535
chr4	17837199	17845199	17839781	8000	17841199	-4000	4000	-1418
chr4	17837199	17845199	17842341	8000	17841199	-4000	4000	1142
chr4	17837199	17845199	17843433	8000	17841199	-4000	4000	2234
chr4	38768238	38776238	38774887	8000	38772238	-4000	4000	2649
chr4	39447533	39455533	39454596	8000	39451533	-4000	4000	3063
chr4	40806027	40814027	40809001	8000	40810027	-4000	4000	-1026
chr4	43026658	43034658	43030452	8000	43030658	-4000	4000	-206
chr4	44678200	44686200	44680735	8000	44682200	-4000	4000	-1465
chr4	47422447	47430447	47425676	8000	47426447	-4000	4000	-771
chr4	52016706	52024706	52024016	8000	52020706	-4000	4000	3310
chr4	55552519	55560519	55556669	8000	55556519	-4000	4000	150
chr4	56962808	56970808	56968401	8000	56966808	-4000	4000	1593
chr4	67905395	67913395	67911430	8000	67909395	-4000	4000	2035
chr4	69998570	70006570	70000934	8000	70002570	-4000	4000	-1636
chr4	70231252	70239252	70233022	8000	70235252	-4000	4000	-2230
chr4	70478997	70486997	70481740	8000	70482997	-4000	4000	-1257
chr4	70642824	70650824	70644979	8000	70646824	-4000	4000	-1845
chr4	72276969	72284969	72283623	8000	72280969	-4000	4000	2654
chr4	73069376	73077376	73076167	8000	73073376	-4000	4000	2791
chr4	73739716	73747716	73742644	8000	73743716	-4000	4000	-1072
chr4	74093040	74101040	74098806	8000	74097040	-4000	4000	1766
chr4	75810286	75818286	75813381	8000	75814286	-4000	4000	-905
chr4	82814509	82822509	82818985	8000	82818509	-4000	4000	476
chr4	87612873	87620873	87613851	8000	87616873	-4000	4000	-3022
chr4	87660361	87668361	87662646	8000	87664361	-4000	4000	-1715
chr4	87842814	87850814	87845441	8000	87846814	-4000	4000	-1373
chr4	88704450	88712450	88706783	8000	88708450	-4000	4000	-1667
chr4	89110901	89118901	89112889	8000	89114901	-4000	4000	-2012
chr4	89110901	89118901	89113274	8000	89114901	-4000	4000	-1627
chr4	89110901	89118901	89114271	8000	89114901	-4000	4000	-630
chr4	95154448	95162448	95154631	8000	95158448	-4000	4000	-3817
chr4	100181870	100189870	100187735	8000	100185870	-4000	4000	1865
chr4	100181870	100189870	100187868	8000	100185870	-4000	4000	1998
chr4	101019409	101027409	101026021	8000	101023409	-4000	4000	2612
chr4	102247080	102255080	102253271	8000	102251080	-4000	4000	2191
chr4	106917802	106925802	106924526	8000	106921802	-4000	4000	2724
chr4	108043545	108051545	108048513	8000	108047545	-4000	4000	968
chr4	109868315	109876315	109870217	8000	109872315	-4000	4000	-2098
chr4	112269110	112277110	112276356	8000	112273110	-4000	4000	3246
chr4	112535333	112543333	112539503	8000	112539333	-4000	4000	170
chr4	113896284	113904284	113902692	8000	113900284	-4000	4000	2408
chr4	113896284	113904284	113903505	8000	113900284	-4000	4000	3221
chr4	114674225	114682225	114675989	8000	114678225	-4000	4000	-2236
chr4	114674225	114682225	114675990	8000	114678225	-4000	4000	-2235
chr4	121820329	121828329	121820982	8000	121824329	-4000	4000	-3347
chr4	140384453	140392453	140390682	8000	140388453	-4000	4000	2229
chr4	141729987	141737987	141733048	8000	141733987	-4000	4000	-939
chr4	146638474	146646474	146639907	8000	146642474	-4000	4000	-2567
chr4	146638474	146646474	146640572	8000	146642474	-4000	4000	-1902
chr4	152765354	152773354	152770402	8000	152769354	-4000	4000	1048
chr4	154227742	154235742	154234734	8000	154231742	-4000	4000	2992
chr4	154600134	154608134	154604223	8000	154604134	-4000	4000	89
chr4	154600134	154608134	154604960	8000	154604134	-4000	4000	826
chr4	157362075	157370075	157362920	8000	157366075	-4000	4000	-3155
chr4	158649372	158657372	158651849	8000	158653372	-4000	4000	-1523
chr4	161379897	161387897	161386062	8000	161383897	-4000	4000	2165
chr4	166100457	166108457	166101005	8000	166104457	-4000	4000	-3452
chr4	176180579	176188579	176184670	8000	176184579	-4000	4000	91
chr4	184623696	184631696	184629292	8000	184627696	-4000	4000	1596
chr4	184751595	184759595	184757685	8000	184755595	-4000	4000	2090
chr4	185395537	185403537	185399825	8000	185399537	-4000	4000	288
chr4	186285681	186293681	186286499	8000	186289681	-4000	4000	-3182
chr4	186285681	186293681	186288751	8000	186289681	-4000	4000	-930
chr4	188001046	188009046	188003226	8000	188005046	-4000	4000	-1820
chr4	48062393	48070393	48067467	8000	48066393	-4000	4000	1074
chr4	70231252	70239252	70233022	8000	70235252	-4000	4000	-2230
chr4	70642824	70650824	70644004	8000	70646824	-4000	4000	-2820
chr4	87156103	87164103	87163939	8000	87160103	-4000	4000	3836
chr4	105678627	105686627	105682954	8000	105682627	-4000	4000	327
chr4	122740942	122748942	122742981	8000	122744942	-4000	4000	-1961
chr4	165273812	165281812	165277997	8000	165277812	-4000	4000	185
chr4	41696044	41704044	41697349	8000	41700044	-4000	4000	-2695
chr4	87612873	87620873	87613028	8000	87616873	-4000	4000	-3845
chr4	109868315	109876315	109870211	8000	109872315	-4000	4000	-2104
chr4	70528743	70536743	70531036	8000	70532743	-4000	4000	-1707
chr4	71568087	71576087	71571544	8000	71572087	-4000	4000	-543
chr4	168924457	168932457	168926235	8000	168928457	-4000	4000	-2222
chr4	152765354	152773354	152769790	8000	152769354	-4000	4000	436
chr4	39481109	39489109	39481298	8000	39485109	-4000	4000	-3811
chr4	117079554	117087554	117085071	8000	117083554	-4000	4000	1517
chr4	146638474	146646474	146640684	8000	146642474	-4000	4000	-1790
chr4	83455517	83463517	83456015	8000	83459517	-4000	4000	-3502
chr4	87979532	87987532	87981578	8000	87983532	-4000	4000	-1954
chr4	87842814	87850814	87845642	8000	87846814	-4000	4000	-1172
chr4	113896284	113904284	113902496	8000	113900284	-4000	4000	2212
chr4	1162932	1170932	1167586	8000	1166932	-4000	4000	654
chr4	25116014	25124014	25123925	8000	25120014	-4000	4000	3911
chr4	121031613	121039613	121037363	8000	121035613	-4000	4000	1750
chr4	185496660	185504660	185504580	8000	185500660	-4000	4000	3920
chr4	175628934	175636934	175634843	8000	175632934	-4000	4000	1909
chr4	75936950	75944950	75940248	8000	75940950	-4000	4000	-702
chr4	86819468	86827468	86825549	8000	86823468	-4000	4000	2081
chr4	87612873	87620873	87616197	8000	87616873	-4000	4000	-676
chr4	15066153	15074153	15066207	8000	15070153	-4000	4000	-3946
chr4	183445064	183453064	183446523	8000	183449064	-4000	4000	-2541
chr4	51989652	51997652	51995642	8000	51993652	-4000	4000	1990
chr4	52016706	52024706	52017310	8000	52020706	-4000	4000	-3396
chr4	102626770	102634770	102631817	8000	102630770	-4000	4000	1047
chr4	118276038	118284038	118282114	8000	118280038	-4000	4000	2076
chr4	173037559	173045559	173040055	8000	173041559	-4000	4000	-1504
chr4	38768238	38776238	38773958	8000	38772238	-4000	4000	1720
chr4	95837464	95845464	95840833	8000	95841464	-4000	4000	-631
chr4	8303098	8311098	8304244	8000	8307098	-4000	4000	-2854
chr4	163467095	163475095	163473557	8000	163471095	-4000	4000	2462
chr4	121754881	121762881	121761565	8000	121758881	-4000	4000	2684
chr4	168924457	168932457	168925069	8000	168928457	-4000	4000	-3388
chr4	15066153	15074153	15066396	8000	15070153	-4000	4000	-3757
chr4	69108987	69116987	69112941	8000	69112987	-4000	4000	-46
chr4	69108987	69116987	69112943	8000	69112987	-4000	4000	-44
chr4	109820740	109828740	109824718	8000	109824740	-4000	4000	-22
chr4	155213078	155221078	155214773	8000	155217078	-4000	4000	-2305
chr4	75810286	75818286	75810481	8000	75814286	-4000	4000	-3805
chr4	99542709	99550709	99549220	8000	99546709	-4000	4000	2511
chr4	143992104	144000104	143997616	8000	143996104	-4000	4000	1512
chr4	164950446	164958446	164957173	8000	164954446	-4000	4000	2727
chr4	5496994	5504994	5499154	8000	5500994	-4000	4000	-1840
chr4	31142805	31150805	31143043	8000	31146805	-4000	4000	-3762
chr4	72144305	72152305	72147297	8000	72148305	-4000	4000	-1008
chr4	83455517	83463517	83461020	8000	83459517	-4000	4000	1503
chr4	87808435	87816435	87810615	8000	87812435	-4000	4000	-1820
chr4	88516998	88524998	88521770	8000	88520998	-4000	4000	772
chr4	95837464	95845464	95841237	8000	95841464	-4000	4000	-227
chr4	110613423	110621423	110618622	8000	110617423	-4000	4000	1199
chr4	152975671	152983671	152975783	8000	152979671	-4000	4000	-3888
chr4	153702260	153710260	153703676	8000	153706260	-4000	4000	-2584
chr4	153702260	153710260	153704814	8000	153706260	-4000	4000	-1446
chr4	173520969	173528969	173528906	8000	173524969	-4000	4000	3937
chr4	47589999	47597999	47591215	8000	47593999	-4000	4000	-2784
chr4	80200329	80208329	80203494	8000	80204329	-4000	4000	-835
chr4	146638474	146646474	146640356	8000	146642474	-4000	4000	-2118
chr4	70478997	70486997	70480883	8000	70482997	-4000	4000	-2114
chr4	72276969	72284969	72283640	8000	72280969	-4000	4000	2671
chr4	84208	92208	86353	8000	88208	-4000	4000	-1855
chr4	102881048	102889048	102887435	8000	102885048	-4000	4000	2387
chr4	119291518	119299518	119292351	8000	119295518	-4000	4000	-3167
chr4	125488932	125496932	125490771	8000	125492932	-4000	4000	-2161
chr4	168183736	168191736	168187471	8000	168187736	-4000	4000	-265
chr4	183316777	183324777	183319606	8000	183320777	-4000	4000	-1171
chr4	84208	92208	87307	8000	88208	-4000	4000	-901
chr4	173520969	173528969	173527029	8000	173524969	-4000	4000	2060
chr4	74093040	74101040	74097611	8000	74097040	-4000	4000	571
chr4	154227742	154235742	154235155	8000	154231742	-4000	4000	3413
chr4	1162932	1170932	1167466	8000	1166932	-4000	4000	534
chr4	48131783	48139783	48138994	8000	48135783	-4000	4000	3211
chr4	99538303	99546303	99539351	8000	99542303	-4000	4000	-2952
chr4	173520969	173528969	173528750	8000	173524969	-4000	4000	3781
chr4	174974180	174982180	174975712	8000	174978180	-4000	4000	-2468
chr4	73977074	73985074	73981141	8000	73981074	-4000	4000	67
chr4	166100457	166108457	166101022	8000	166104457	-4000	4000	-3435
chr4	421815	429815	426418	8000	425815	-4000	4000	603
chr4	38768238	38776238	38775241	8000	38772238	-4000	4000	3003
chr4	99619997	99627997	99622762	8000	99623997	-4000	4000	-1235
chr4	99944086	99952086	99950220	8000	99948086	-4000	4000	2134
chr4	3445486	3453486	3449321	8000	3449486	-4000	4000	-165
chr4	139712753	139720753	139719494	8000	139716753	-4000	4000	2741
chr4	174974180	174982180	174976162	8000	174978180	-4000	4000	-2018
chr4	51989652	51997652	51994899	8000	51993652	-4000	4000	1247
chr4	71568087	71576087	71568769	8000	71572087	-4000	4000	-3318
chr4	173319967	173327967	173322232	8000	173323967	-4000	4000	-1735
chr4	68493604	68501604	68497135	8000	68497604	-4000	4000	-469
chr4	69584417	69592417	69589596	8000	69588417	-4000	4000	1179
chr4	87612873	87620873	87613096	8000	87616873	-4000	4000	-3777
chr4	165037749	165045749	165041364	8000	165041749	-4000	4000	-385
chr4	89110901	89118901	89114472	8000	89114901	-4000	4000	-429
chr4	48493357	48501357	48494260	8000	48497357	-4000	4000	-3097
chr4	75810286	75818286	75813291	8000	75814286	-4000	4000	-995
chr4	105678627	105686627	105680038	8000	105682627	-4000	4000	-2589
chr4	163467095	163475095	163472784	8000	163471095	-4000	4000	1689
chr4	73845064	73853064	73847941	8000	73849064	-4000	4000	-1123
chr4	69942574	69950574	69944922	8000	69946574	-4000	4000	-1652
chr4	184623696	184631696	184628942	8000	184627696	-4000	4000	1246
chr4	121813021	121821021	121816806	8000	121817021	-4000	4000	-215
chr4	83455517	83463517	83456083	8000	83459517	-4000	4000	-3434
chr4	105678627	105686627	105683297	8000	105682627	-4000	4000	670
chr4	74093040	74101040	74098799	8000	74097040	-4000	4000	1759
chr4	87612873	87620873	87613288	8000	87616873	-4000	4000	-3585
chr4	89110901	89118901	89113729	8000	89114901	-4000	4000	-1172
chr4	101019409	101027409	101025862	8000	101023409	-4000	4000	2453
chr4	158649372	158657372	158651995	8000	158653372	-4000	4000	-1377
chr4	13536830	13544830	13542187	8000	13540830	-4000	4000	1357
chr4	110613423	110621423	110618490	8000	110617423	-4000	4000	1067
chr4	188143743	188151743	188147081	8000	188147743	-4000	4000	-662
chr4	112509516	112517516	112515139	8000	112513516	-4000	4000	1623
chr4	15442167	15450167	15442469	8000	15446167	-4000	4000	-3698
chr4	93826964	93834964	93829877	8000	93830964	-4000	4000	-1087
chr4	186583794	186591794	186588395	8000	186587794	-4000	4000	601
chr4	188143743	188151743	188147302	8000	188147743	-4000	4000	-441
chr4	5010586	5018586	5014986	8000	5014586	-4000	4000	400
chr4	121031613	121039613	121037198	8000	121035613	-4000	4000	1585
chr4	10435880	10443880	10443590	8000	10439880	-4000	4000	3710
chr4	40242967	40250967	40243922	8000	40246967	-4000	4000	-3045
chr4	73739716	73747716	73742593	8000	73743716	-4000	4000	-1123
chr4	17523104	17531104	17527028	8000	17527104	-4000	4000	-76
chr4	69476165	69484165	69480892	8000	69480165	-4000	4000	727
chr4	74451005	74459005	74452619	8000	74455005	-4000	4000	-2386
chr4	117079554	117087554	117085071	8000	117083554	-4000	4000	1517
chr4	117079554	117087554	117085073	8000	117083554	-4000	4000	1519
chr4	154579128	154587128	154586551	8000	154583128	-4000	4000	3423
chr4	75046115	75054115	75046303	8000	75050115	-4000	4000	-3812
chr4	15959076	15967076	15963066	8000	15963076	-4000	4000	-10
chr4	75561871	75569871	75564447	8000	75565871	-4000	4000	-1424
chr4	77948785	77956785	77952554	8000	77952785	-4000	4000	-231
chr4	77036384	77044384	77037710	8000	77040384	-4000	4000	-2674
chr4	69476165	69484165	69480828	8000	69480165	-4000	4000	663
chr4	87612873	87620873	87614822	8000	87616873	-4000	4000	-2051
chr4	98439858	98447858	98442206	8000	98443858	-4000	4000	-1652
chr4	81083370	81091370	81089590	8000	81087370	-4000	4000	2220
chr4	99538303	99546303	99540429	8000	99542303	-4000	4000	-1874
chr4	143553486	143561486	143560012	8000	143557486	-4000	4000	2526
chr4	38941739	38949739	38943586	8000	38945739	-4000	4000	-2153
chr4	110613423	110621423	110621173	8000	110617423	-4000	4000	3750
chr4	10435880	10443880	10442997	8000	10439880	-4000	4000	3117
chr4	20616561	20624561	20617065	8000	20620561	-4000	4000	-3496
chr4	39481109	39489109	39481183	8000	39485109	-4000	4000	-3926
chr4	56962808	56970808	56963616	8000	56966808	-4000	4000	-3192
chr4	72144305	72152305	72147205	8000	72148305	-4000	4000	-1100
chr4	73850483	73858483	73854084	8000	73854483	-4000	4000	-399
chr4	86819468	86827468	86825532	8000	86823468	-4000	4000	2064
chr4	99300971	99308971	99307799	8000	99304971	-4000	4000	2828
chr4	114674225	114682225	114675928	8000	114678225	-4000	4000	-2297
chr4	121324642	121332642	121329323	8000	121328642	-4000	4000	681
chr4	146638474	146646474	146640067	8000	146642474	-4000	4000	-2407
chr4	161379897	161387897	161386538	8000	161383897	-4000	4000	2641
chr4	16156505	16164505	16162447	8000	16160505	-4000	4000	1942
chr4	56805860	56813860	56810061	8000	56809860	-4000	4000	201
chr4	165273812	165281812	165278541	8000	165277812	-4000	4000	729
chr4	118276038	118284038	118279415	8000	118280038	-4000	4000	-623
chr4	145106838	145114838	145110148	8000	145110838	-4000	4000	-690
chr4	174486175	174494175	174491282	8000	174490175	-4000	4000	1107
chr4	176178818	176186818	176179569	8000	176182818	-4000	4000	-3249
chr4	17837199	17845199	17837295	8000	17841199	-4000	4000	-3904
chr4	108031241	108039241	108034296	8000	108035241	-4000	4000	-945
chr4	168183736	168191736	168187371	8000	168187736	-4000	4000	-365
chr5	55106252	55114252	55110154	8000	55110252	-4000	4000	-98
chr5	56095680	56103680	56100248	8000	56099680	-4000	4000	568
chr5	177988235	177996235	177992415	8000	177992235	-4000	4000	180
chr5	141172383	141180383	141173798	8000	141176383	-4000	4000	-2585
chr5	132186147	132194147	132193011	8000	132190147	-4000	4000	2864
chr5	141172383	141180383	141179421	8000	141176383	-4000	4000	3038
chr5	180735123	180743123	180739899	8000	180739123	-4000	4000	776
chr5	74718647	74726647	74718870	8000	74722647	-4000	4000	-3777
chr5	116439555	116447555	116446480	8000	116443555	-4000	4000	2925
chr5	58449982	58457982	58454967	8000	58453982	-4000	4000	985
chr5	139383467	139391467	139387847	8000	139387467	-4000	4000	380
chr5	141094703	141102703	141095223	8000	141098703	-4000	4000	-3480
chr5	141149287	141157287	141150682	8000	141153287	-4000	4000	-2605
chr5	150049142	150057142	150050437	8000	150053142	-4000	4000	-2705
chr5	150109839	150117839	150115873	8000	150113839	-4000	4000	2034
chr5	160389148	160397148	160394035	8000	160393148	-4000	4000	887
chr5	181232897	181240897	181239273	8000	181236897	-4000	4000	2376
chr5	141099827	141107827	141103096	8000	141103827	-4000	4000	-731
chr5	33983174	33991174	33984504	8000	33987174	-4000	4000	-2670
chr5	42795880	42803880	42799876	8000	42799880	-4000	4000	-4
chr5	95820383	95828383	95822736	8000	95824383	-4000	4000	-1647
chr5	116023619	116031619	116026282	8000	116027619	-4000	4000	-1337
chr5	132857181	132865181	132862378	8000	132861181	-4000	4000	1197
chr5	132857181	132865181	132864248	8000	132861181	-4000	4000	3067
chr5	141149287	141157287	141151624	8000	141153287	-4000	4000	-1663
chr5	141187541	141195541	141189797	8000	141191541	-4000	4000	-1744
chr5	147876726	147884726	147882171	8000	147880726	-4000	4000	1445
chr5	163515354	163523354	163517485	8000	163519354	-4000	4000	-1869
chr5	175436036	175444036	175442486	8000	175440036	-4000	4000	2450
chr5	176655054	176663054	176657515	8000	176659054	-4000	4000	-1539
chr5	161895981	161903981	161897276	8000	161899981	-4000	4000	-2705
chr5	76731770	76739770	76732478	8000	76735770	-4000	4000	-3292
chr5	150215491	150223491	150222685	8000	150219491	-4000	4000	3194
chr5	37062413	37070413	37064963	8000	37066413	-4000	4000	-1450
chr5	141008347	141016347	141012312	8000	141012347	-4000	4000	-35
chr5	151310972	151318972	151317032	8000	151314972	-4000	4000	2060
chr5	156848528	156856528	156850719	8000	156852528	-4000	4000	-1809
chr5	67165593	67173593	67166310	8000	67169593	-4000	4000	-3283
chr5	141172383	141180383	141178771	8000	141176383	-4000	4000	2388
chr5	141208571	141216571	141214860	8000	141212571	-4000	4000	2289
chr5	76831315	76839315	76832886	8000	76835315	-4000	4000	-2429
chr5	141172383	141180383	141174126	8000	141176383	-4000	4000	-2257
chr5	171857549	171865549	171863712	8000	171861549	-4000	4000	2163
chr5	33934918	33942918	33936923	8000	33938918	-4000	4000	-1995
chr5	134851133	134859133	134855288	8000	134855133	-4000	4000	155
chr5	148311922	148319922	148315764	8000	148315922	-4000	4000	-158
chr5	149350583	149358583	149351223	8000	149354583	-4000	4000	-3360
chr5	155014141	155022141	155016591	8000	155018141	-4000	4000	-1550
chr5	153986148	153994148	153993011	8000	153990148	-4000	4000	2863
chr5	141172383	141180383	141174508	8000	141176383	-4000	4000	-1875
chr5	123340890	123348890	123346301	8000	123344890	-4000	4000	1411
chr5	157676158	157684158	157679856	8000	157680158	-4000	4000	-302
chr5	157025413	157033413	157029752	8000	157029413	-4000	4000	339
chr5	181232897	181240897	181238277	8000	181236897	-4000	4000	1380
chr5	115120762	115128762	115125014	8000	115124762	-4000	4000	252
chr5	15935795	15943795	15938882	8000	15939795	-4000	4000	-913
chr5	76731770	76739770	76733203	8000	76735770	-4000	4000	-2567
chr5	141214979	141222979	141216873	8000	141218979	-4000	4000	-2106
chr5	42717878	42725878	42721624	8000	42721878	-4000	4000	-254
chr5	141199779	141207779	141200275	8000	141203779	-4000	4000	-3504
chr5	31551053	31559053	31553019	8000	31555053	-4000	4000	-2034
chr5	142150440	142158440	142152064	8000	142154440	-4000	4000	-2376
chr5	157781743	157789743	157789427	8000	157785743	-4000	4000	3684
chr5	160343754	160351754	160349777	8000	160347754	-4000	4000	2023
chr5	40755389	40763389	40760190	8000	40759389	-4000	4000	801
chr5	69226158	69234158	69229389	8000	69230158	-4000	4000	-769
chr5	140121619	140129619	140126983	8000	140125619	-4000	4000	1364
chr5	153809869	153817869	153811083	8000	153813869	-4000	4000	-2786
chr5	138088365	138096365	138091147	8000	138092365	-4000	4000	-1218
chr5	177094144	177102144	177095627	8000	177098144	-4000	4000	-2517
chr5	1221111	1229111	1221819	8000	1225111	-4000	4000	-3292
chr5	146335251	146343251	146339602	8000	146339251	-4000	4000	351
chr5	137613500	137621500	137618140	8000	137617500	-4000	4000	640
chr5	154470972	154478972	154475562	8000	154474972	-4000	4000	590
chr5	180946906	180954906	180947624	8000	180950906	-4000	4000	-3282
chr5	112842239	112850239	112843933	8000	112846239	-4000	4000	-2306
chr5	80079287	80087287	80082514	8000	80083287	-4000	4000	-773
chr5	141199779	141207779	141201858	8000	141203779	-4000	4000	-1921
chr5	109865625	109873625	109866936	8000	109869625	-4000	4000	-2689
chr5	140121619	140129619	140127559	8000	140125619	-4000	4000	1940
chr5	141094703	141102703	141096042	8000	141098703	-4000	4000	-2661
chr5	149350583	149358583	149351033	8000	149354583	-4000	4000	-3550
chr5	43276850	43284850	43277176	8000	43280850	-4000	4000	-3674
chr5	123025354	123033354	123028527	8000	123029354	-4000	4000	-827
chr5	120683332	120691332	120686685	8000	120687332	-4000	4000	-647
chr5	69206357	69214357	69209841	8000	69210357	-4000	4000	-516
chr5	177368596	177376596	177372048	8000	177372596	-4000	4000	-548
chr5	81262398	81270398	81266138	8000	81266398	-4000	4000	-260
chr5	141121623	141129623	141122542	8000	141125623	-4000	4000	-3081
chr5	141208571	141216571	141215932	8000	141212571	-4000	4000	3361
chr5	141849090	141857090	141854041	8000	141853090	-4000	4000	951
chr5	159282036	159290036	159284923	8000	159286036	-4000	4000	-1113
chr5	176876898	176884898	176881440	8000	176880898	-4000	4000	542
chr5	116439555	116447555	116446958	8000	116443555	-4000	4000	3403
chr5	83936554	83944554	83943334	8000	83940554	-4000	4000	2780
chr5	95601102	95609102	95603512	8000	95605102	-4000	4000	-1590
chr5	150704440	150712440	150711268	8000	150708440	-4000	4000	2828
chr5	180735123	180743123	180739207	8000	180739123	-4000	4000	84
chr5	53879942	53887942	53886606	8000	53883942	-4000	4000	2664
chr5	15935795	15943795	15936571	8000	15939795	-4000	4000	-3224
chr5	16447519	16455519	16453018	8000	16451519	-4000	4000	1499
chr5	24483100	24491100	24488105	8000	24487100	-4000	4000	1005
chr5	95618142	95626142	95621526	8000	95622142	-4000	4000	-616
chr5	115516908	115524908	115524670	8000	115520908	-4000	4000	3762
chr5	141208571	141216571	141209171	8000	141212571	-4000	4000	-3400
chr5	148824623	148832623	148827146	8000	148828623	-4000	4000	-1477
chr5	150896736	150904736	150898469	8000	150900736	-4000	4000	-2267
chr5	151310972	151318972	151317020	8000	151314972	-4000	4000	2048
chr5	123613045	123621045	123614967	8000	123617045	-4000	4000	-2078
chr5	176876898	176884898	176880154	8000	176880898	-4000	4000	-744
chr5	141199779	141207779	141201306	8000	141203779	-4000	4000	-2473
chr5	100582741	100590741	100586187	8000	100586741	-4000	4000	-554
chr5	115910081	115918081	115913375	8000	115914081	-4000	4000	-706
chr5	179610178	179618178	179617635	8000	179614178	-4000	4000	3457
chr5	174726896	174734896	174729474	8000	174730896	-4000	4000	-1422
chr5	180735123	180743123	180739345	8000	180739123	-4000	4000	222
chr5	60747791	60755791	60754448	8000	60751791	-4000	4000	2657
chr5	141099827	141107827	141102971	8000	141103827	-4000	4000	-856
chr5	158691916	158699916	158699098	8000	158695916	-4000	4000	3182
chr5	132857181	132865181	132864510	8000	132861181	-4000	4000	3329
chr5	141008347	141016347	141011655	8000	141012347	-4000	4000	-692
chr5	141172383	141180383	141176369	8000	141176383	-4000	4000	-14
chr5	21746673	21754673	21752075	8000	21750673	-4000	4000	1402
chr5	141176539	141184539	141183486	8000	141180539	-4000	4000	2947
chr5	26876597	26884597	26881453	8000	26880597	-4000	4000	856
chr5	73127809	73135809	73128401	8000	73131809	-4000	4000	-3408
chr5	141149287	141157287	141152381	8000	141153287	-4000	4000	-906
chr5	141208571	141216571	141211036	8000	141212571	-4000	4000	-1535
chr5	181232897	181240897	181238141	8000	181236897	-4000	4000	1244
chr5	96386333	96394333	96392726	8000	96390333	-4000	4000	2393
chr5	151657096	151665096	151662683	8000	151661096	-4000	4000	1587
chr5	130182634	130190634	130185036	8000	130186634	-4000	4000	-1598
chr5	160245083	160253083	160252727	8000	160249083	-4000	4000	3644
chr5	62577446	62585446	62580232	8000	62581446	-4000	4000	-1214
chr5	15935795	15943795	15936761	8000	15939795	-4000	4000	-3034
chr5	141149287	141157287	141157124	8000	141153287	-4000	4000	3837
chr5	132688628	132696628	132693048	8000	132692628	-4000	4000	420
chr5	141008347	141016347	141011232	8000	141012347	-4000	4000	-1115
chr5	141176539	141184539	141180422	8000	141180539	-4000	4000	-117
chr5	34901260	34909260	34908583	8000	34905260	-4000	4000	3323
chr5	97087867	97095867	97094892	8000	97091867	-4000	4000	3025
chr5	9623347	9631347	9629564	8000	9627347	-4000	4000	2217
chr5	37808677	37816677	37815807	8000	37812677	-4000	4000	3130
chr5	128185677	128193677	128186647	8000	128189677	-4000	4000	-3030
chr5	131421891	131429891	131428971	8000	131425891	-4000	4000	3080
chr5	138088365	138096365	138090692	8000	138092365	-4000	4000	-1673
chr5	141008347	141016347	141011346	8000	141012347	-4000	4000	-1001
chr5	151266440	151274440	151267341	8000	151270440	-4000	4000	-3099
chr5	157621679	157629679	157626410	8000	157625679	-4000	4000	731
chr5	171453626	171461626	171456734	8000	171457626	-4000	4000	-892
chr5	180843611	180851611	180849755	8000	180847611	-4000	4000	2144
chr5	141187541	141195541	141193897	8000	141191541	-4000	4000	2356
chr5	154813605	154821605	154814020	8000	154817605	-4000	4000	-3585
chr5	178598664	178606664	178603416	8000	178602664	-4000	4000	752
chr5	55215564	55223564	55220472	8000	55219564	-4000	4000	908
chr5	141182226	141190226	141185021	8000	141186226	-4000	4000	-1205
chr5	3597403	3605403	3601031	8000	3601403	-4000	4000	-372
chr5	26876597	26884597	26881296	8000	26880597	-4000	4000	699
chr5	179106853	179114853	179113926	8000	179110853	-4000	4000	3073
chr5	127654630	127662630	127657763	8000	127658630	-4000	4000	-867
chr5	141121623	141129623	141123379	8000	141125623	-4000	4000	-2244
chr5	95446454	95454454	95448378	8000	95450454	-4000	4000	-2076
chr5	140554268	140562268	140560315	8000	140558268	-4000	4000	2047
chr5	35875603	35883603	35876168	8000	35879603	-4000	4000	-3435
chr5	54452377	54460377	54455794	8000	54456377	-4000	4000	-583
chr5	121848833	121856833	121852119	8000	121852833	-4000	4000	-714
chr5	160424739	160432739	160427729	8000	160428739	-4000	4000	-1010
chr5	177988235	177996235	177995974	8000	177992235	-4000	4000	3739
chr5	63953874	63961874	63960723	8000	63957874	-4000	4000	2849
chr5	141187541	141195541	141188564	8000	141191541	-4000	4000	-2977
chr5	148335852	148343852	148339726	8000	148339852	-4000	4000	-126
chr5	176591974	176599974	176599311	8000	176595974	-4000	4000	3337
chr5	96386333	96394333	96393018	8000	96390333	-4000	4000	2685
chr5	80552755	80560755	80557156	8000	80556755	-4000	4000	401
chr5	141182226	141190226	141184812	8000	141186226	-4000	4000	-1414
chr5	134723909	134731909	134725019	8000	134727909	-4000	4000	-2890
chr5	160234735	160242735	160234855	8000	160238735	-4000	4000	-3880
chr5	32787724	32795724	32789246	8000	32791724	-4000	4000	-2478
chr5	141172383	141180383	141173460	8000	141176383	-4000	4000	-2923
chr5	141172383	141180383	141174813	8000	141176383	-4000	4000	-1570
chr5	150438635	150446635	150445619	8000	150442635	-4000	4000	2984
chr5	151310972	151318972	151316943	8000	151314972	-4000	4000	1971
chr5	141187541	141195541	141194874	8000	141191541	-4000	4000	3333
chr5	26876597	26884597	26880727	8000	26880597	-4000	4000	130
chr5	149367324	149375324	149368052	8000	149371324	-4000	4000	-3272
chr5	114492500	114500500	114496127	8000	114496500	-4000	4000	-373
chr5	141649401	141657401	141654360	8000	141653401	-4000	4000	959
chr5	160389148	160397148	160395105	8000	160393148	-4000	4000	1957
chr5	111492033	111500033	111499987	8000	111496033	-4000	4000	3954
chr5	141199779	141207779	141200529	8000	141203779	-4000	4000	-3250
chr5	75021346	75029346	75029266	8000	75025346	-4000	4000	3920
chr5	94699690	94707690	94707380	8000	94703690	-4000	4000	3690
chr5	154883411	154891411	154888197	8000	154887411	-4000	4000	786
chr5	138248380	138256380	138253836	8000	138252380	-4000	4000	1456
chr5	179031064	179039064	179032847	8000	179035064	-4000	4000	-2217
chr5	139840466	139848466	139847858	8000	139844466	-4000	4000	3392
chr5	141149287	141157287	141156713	8000	141153287	-4000	4000	3426
chr5	141208571	141216571	141210430	8000	141212571	-4000	4000	-2141
chr5	141121623	141129623	141124282	8000	141125623	-4000	4000	-1341
chr5	132857181	132865181	132864551	8000	132861181	-4000	4000	3370
chr5	121848833	121856833	121852147	8000	121852833	-4000	4000	-686
chr5	141134615	141142615	141136316	8000	141138615	-4000	4000	-2299
chr5	63953874	63961874	63960810	8000	63957874	-4000	4000	2936
chr5	139840466	139848466	139842341	8000	139844466	-4000	4000	-2125
chr5	114492500	114500500	114496166	8000	114496500	-4000	4000	-334
chr5	138281269	138289269	138285805	8000	138285269	-4000	4000	536
chr5	141241861	141249861	141245591	8000	141245861	-4000	4000	-270
chr5	66078546	66086546	66078962	8000	66082546	-4000	4000	-3584
chr5	73086522	73094522	73089292	8000	73090522	-4000	4000	-1230
chr5	73501667	73509667	73502501	8000	73505667	-4000	4000	-3166
chr5	78773209	78781209	78780340	8000	78777209	-4000	4000	3131
chr5	93590611	93598611	93593621	8000	93594611	-4000	4000	-990
chr5	115263190	115271190	115267869	8000	115267190	-4000	4000	679
chr5	156848528	156856528	156850621	8000	156852528	-4000	4000	-1907
chr5	156848528	156856528	156850718	8000	156852528	-4000	4000	-1810
chr5	156848528	156856528	156850951	8000	156852528	-4000	4000	-1577
chr5	163515354	163523354	163516871	8000	163519354	-4000	4000	-2483
chr5	179773283	179781283	179774274	8000	179777283	-4000	4000	-3009
chr5	138183650	138191650	138186353	8000	138187650	-4000	4000	-1297
chr5	141094703	141102703	141100645	8000	141098703	-4000	4000	1942
chr5	141094703	141102703	141101237	8000	141098703	-4000	4000	2534
chr5	146106566	146114566	146114223	8000	146110566	-4000	4000	3657
chr5	180735123	180743123	180739997	8000	180739123	-4000	4000	874
chr5	138549756	138557756	138555896	8000	138553756	-4000	4000	2140
chr5	141241861	141249861	141246863	8000	141245861	-4000	4000	1002
chr5	60747791	60755791	60752308	8000	60751791	-4000	4000	517
chr5	141134615	141142615	141137480	8000	141138615	-4000	4000	-1135
chr5	180946906	180954906	180950494	8000	180950906	-4000	4000	-412
chr5	79684246	79692246	79685856	8000	79688246	-4000	4000	-2390
chr5	141149287	141157287	141151263	8000	141153287	-4000	4000	-2024
chr5	134579230	134587230	134579738	8000	134583230	-4000	4000	-3492
chr5	141094703	141102703	141096506	8000	141098703	-4000	4000	-2197
chr5	177988235	177996235	177994243	8000	177992235	-4000	4000	2008
chr5	179610178	179618178	179616880	8000	179614178	-4000	4000	2702
chr5	26876597	26884597	26881295	8000	26880597	-4000	4000	698
chr5	181232897	181240897	181237008	8000	181236897	-4000	4000	111
chr5	141182226	141190226	141184995	8000	141186226	-4000	4000	-1231
chr5	163515354	163523354	163517556	8000	163519354	-4000	4000	-1798
chr5	7826081	7834081	7826814	8000	7830081	-4000	4000	-3267
chr5	26876597	26884597	26881214	8000	26880597	-4000	4000	617
chr5	80317842	80325842	80321780	8000	80321842	-4000	4000	-62
chr5	33464091	33472091	33467721	8000	33468091	-4000	4000	-370
chr5	148282255	148290255	148286049	8000	148286255	-4000	4000	-206
chr5	141149287	141157287	141151910	8000	141153287	-4000	4000	-1377
chr5	33934918	33942918	33937417	8000	33938918	-4000	4000	-1501
chr5	43440252	43448252	43446412	8000	43444252	-4000	4000	2160
chr5	55106252	55114252	55107794	8000	55110252	-4000	4000	-2458
chr5	123025354	123033354	123028621	8000	123029354	-4000	4000	-733
chr5	151266440	151274440	151267560	8000	151270440	-4000	4000	-2880
chr5	33934918	33942918	33936981	8000	33938918	-4000	4000	-1937
chr5	141134615	141142615	141137765	8000	141138615	-4000	4000	-850
chr5	141187541	141195541	141193773	8000	141191541	-4000	4000	2232
chr5	148171619	148179619	148174263	8000	148175619	-4000	4000	-1356
chr5	129110028	129118028	129112906	8000	129114028	-4000	4000	-1122
chr5	180735123	180743123	180739708	8000	180739123	-4000	4000	585
chr5	42795880	42803880	42800417	8000	42799880	-4000	4000	537
chr5	81309297	81317297	81312841	8000	81313297	-4000	4000	-456
chr5	141134615	141142615	141136515	8000	141138615	-4000	4000	-2100
chr5	155014141	155022141	155016422	8000	155018141	-4000	4000	-1719
chr5	32120716	32128716	32126527	8000	32124716	-4000	4000	1811
chr5	36188589	36196589	36194992	8000	36192589	-4000	4000	2403
chr5	40980643	40988643	40981394	8000	40984643	-4000	4000	-3249
chr5	143816716	143824716	143820485	8000	143820716	-4000	4000	-231
chr5	160389148	160397148	160395370	8000	160393148	-4000	4000	2222
chr5	185972	193972	192266	8000	189972	-4000	4000	2294
chr5	79796240	79804240	79799436	8000	79800240	-4000	4000	-804
chr5	151024988	151032988	151028195	8000	151028988	-4000	4000	-793
chr5	160343754	160351754	160349456	8000	160347754	-4000	4000	1702
chr5	168515301	168523301	168519108	8000	168519301	-4000	4000	-193
chr5	172205646	172213646	172211970	8000	172209646	-4000	4000	2324
chr5	88713117	88721117	88721115	8000	88717117	-4000	4000	3998
chr5	115574642	115582642	115580699	8000	115578642	-4000	4000	2057
chr5	132818141	132826141	132824034	8000	132822141	-4000	4000	1893
chr5	80552755	80560755	80559288	8000	80556755	-4000	4000	2533
chr5	134579230	134587230	134581031	8000	134583230	-4000	4000	-2199
chr5	31396494	31404494	31401506	8000	31400494	-4000	4000	1012
chr5	41726065	41734065	41731741	8000	41730065	-4000	4000	1676
chr5	94699690	94707690	94707437	8000	94703690	-4000	4000	3747
chr5	160343754	160351754	160349205	8000	160347754	-4000	4000	1451
chr5	176616082	176624082	176621276	8000	176620082	-4000	4000	1194
chr5	141149287	141157287	141150195	8000	141153287	-4000	4000	-3092
chr5	111074026	111082026	111075969	8000	111078026	-4000	4000	-2057
chr5	132746819	132754819	132751145	8000	132750819	-4000	4000	326
chr5	141199779	141207779	141200050	8000	141203779	-4000	4000	-3729
chr5	1313752	1321752	1320710	8000	1317752	-4000	4000	2958
chr5	73171143	73179143	73173839	8000	73175143	-4000	4000	-1304
chr5	141149287	141157287	141151092	8000	141153287	-4000	4000	-2195
chr5	170242233	170250233	170248542	8000	170246233	-4000	4000	2309
chr5	179106853	179114853	179113887	8000	179110853	-4000	4000	3034
chr5	185972	193972	191592	8000	189972	-4000	4000	1620
chr5	36031021	36039021	36035864	8000	36035021	-4000	4000	843
chr5	155014141	155022141	155014247	8000	155018141	-4000	4000	-3894
chr5	32787724	32795724	32789508	8000	32791724	-4000	4000	-2216
chr5	77423124	77431124	77426686	8000	77427124	-4000	4000	-438
chr5	109865625	109873625	109866956	8000	109869625	-4000	4000	-2669
chr5	141176539	141184539	141183245	8000	141180539	-4000	4000	2706
chr5	141182226	141190226	141184680	8000	141186226	-4000	4000	-1546
chr5	177593242	177601242	177593652	8000	177597242	-4000	4000	-3590
chr5	33934918	33942918	33937100	8000	33938918	-4000	4000	-1818
chr5	141176539	141184539	141182764	8000	141180539	-4000	4000	2225
chr5	141182226	141190226	141184717	8000	141186226	-4000	4000	-1509
chr5	126492494	126500494	126493211	8000	126496494	-4000	4000	-3283
chr5	160559120	160567120	160565793	8000	160563120	-4000	4000	2673
chr5	72435903	72443903	72443853	8000	72439903	-4000	4000	3950
chr5	141094703	141102703	141102368	8000	141098703	-4000	4000	3665
chr5	26876597	26884597	26881044	8000	26880597	-4000	4000	447
chr5	138135770	138143770	138140838	8000	138139770	-4000	4000	1068
chr5	140328843	140336843	140333588	8000	140332843	-4000	4000	745
chr5	141208571	141216571	141215855	8000	141212571	-4000	4000	3284
chr5	176876898	176884898	176881171	8000	176880898	-4000	4000	273
chr5	41726065	41734065	41731732	8000	41730065	-4000	4000	1667
chr5	175880021	175888021	175882344	8000	175884021	-4000	4000	-1677
chr5	24483100	24491100	24487897	8000	24487100	-4000	4000	797
chr5	663168	671168	666115	8000	667168	-4000	4000	-1053
chr5	172205646	172213646	172212030	8000	172209646	-4000	4000	2384
chr5	151096706	151104706	151103646	8000	151100706	-4000	4000	2940
chr5	43703405	43711405	43704314	8000	43707405	-4000	4000	-3091
chr5	132857181	132865181	132861809	8000	132861181	-4000	4000	628
chr5	141149287	141157287	141152490	8000	141153287	-4000	4000	-797
chr5	128185677	128193677	128187719	8000	128189677	-4000	4000	-1958
chr5	141208571	141216571	141215968	8000	141212571	-4000	4000	3397
chr5	141182226	141190226	141184903	8000	141186226	-4000	4000	-1323
chr5	141208571	141216571	141215657	8000	141212571	-4000	4000	3086
chr5	62577446	62585446	62580039	8000	62581446	-4000	4000	-1407
chr5	102229986	102237986	102236901	8000	102233986	-4000	4000	2915
chr5	141176539	141184539	141183261	8000	141180539	-4000	4000	2722
chr5	141208571	141216571	141215599	8000	141212571	-4000	4000	3028
chr5	170079382	170087382	170080235	8000	170083382	-4000	4000	-3147
chr5	38461480	38469480	38464064	8000	38465480	-4000	4000	-1416
chr5	149488982	149496982	149496813	8000	149492982	-4000	4000	3831
chr5	141094703	141102703	141097050	8000	141098703	-4000	4000	-1653
chr5	135003959	135011959	135010470	8000	135007959	-4000	4000	2511
chr5	141187541	141195541	141187586	8000	141191541	-4000	4000	-3955
chr5	141149287	141157287	141151992	8000	141153287	-4000	4000	-1295
chr5	141134615	141142615	141137012	8000	141138615	-4000	4000	-1603
chr5	141008347	141016347	141010130	8000	141012347	-4000	4000	-2217
chr5	141208571	141216571	141210038	8000	141212571	-4000	4000	-2533
chr5	23524093	23532093	23526644	8000	23528093	-4000	4000	-1449
chr5	141121623	141129623	141123660	8000	141125623	-4000	4000	-1963
chr5	149488982	149496982	149495793	8000	149492982	-4000	4000	2811
chr5	57476018	57484018	57481725	8000	57480018	-4000	4000	1707
chr5	57476018	57484018	57481727	8000	57480018	-4000	4000	1709
chr5	67165593	67173593	67165645	8000	67169593	-4000	4000	-3948
chr5	141172383	141180383	141179538	8000	141176383	-4000	4000	3155
chr5	135440226	135448226	135446905	8000	135444226	-4000	4000	2679
chr5	10675230	10683230	10681087	8000	10679230	-4000	4000	1857
chr5	76731770	76739770	76732463	8000	76735770	-4000	4000	-3307
chr5	155014141	155022141	155015988	8000	155018141	-4000	4000	-2153
chr5	139679882	139687882	139680989	8000	139683882	-4000	4000	-2893
chr5	132857181	132865181	132861571	8000	132861181	-4000	4000	390
chr5	69174245	69182245	69175064	8000	69178245	-4000	4000	-3181
chr5	136971298	136979298	136978716	8000	136975298	-4000	4000	3418
chr5	141134615	141142615	141136503	8000	141138615	-4000	4000	-2112
chr5	141208571	141216571	141214876	8000	141212571	-4000	4000	2305
chr5	141616876	141624876	141621171	8000	141620876	-4000	4000	295
chr5	32600079	32608079	32601079	8000	32604079	-4000	4000	-3000
chr5	434291	442291	434649	8000	438291	-4000	4000	-3642
chr5	161895981	161903981	161897176	8000	161899981	-4000	4000	-2805
chr5	141187541	141195541	141193670	8000	141191541	-4000	4000	2129
chr5	168515301	168523301	168516842	8000	168519301	-4000	4000	-2459
chr5	155014141	155022141	155014560	8000	155018141	-4000	4000	-3581
chr5	77687166	77695166	77693281	8000	77691166	-4000	4000	2115
chr5	174726896	174734896	174729266	8000	174730896	-4000	4000	-1630
chr5	141187541	141195541	141193103	8000	141191541	-4000	4000	1562
chr5	141172383	141180383	141179343	8000	141176383	-4000	4000	2960
chr5	141208571	141216571	141210962	8000	141212571	-4000	4000	-1609
chr5	1388794	1396794	1394555	8000	1392794	-4000	4000	1761
chr5	141182226	141190226	141184796	8000	141186226	-4000	4000	-1430
chr5	91160437	91168437	91163975	8000	91164437	-4000	4000	-462
chr5	179031064	179039064	179032856	8000	179035064	-4000	4000	-2208
chr5	141172383	141180383	141173569	8000	141176383	-4000	4000	-2814
chr5	9623347	9631347	9629615	8000	9627347	-4000	4000	2268
chr5	34828612	34836612	34832440	8000	34832612	-4000	4000	-172
chr5	35044756	35052756	35049317	8000	35048756	-4000	4000	561
chr5	36684334	36692334	36686386	8000	36688334	-4000	4000	-1948
chr5	54452377	54460377	54456153	8000	54456377	-4000	4000	-224
chr5	141208571	141216571	141210180	8000	141212571	-4000	4000	-2391
chr5	146106566	146114566	146114041	8000	146110566	-4000	4000	3475
chr5	155014141	155022141	155014681	8000	155018141	-4000	4000	-3460
chr5	180735123	180743123	180739248	8000	180739123	-4000	4000	125
chr5	130182634	130190634	130184709	8000	130186634	-4000	4000	-1925
chr5	192334	200334	195161	8000	196334	-4000	4000	-1173
chr5	31551053	31559053	31553020	8000	31555053	-4000	4000	-2033
chr5	141121623	141129623	141122543	8000	141125623	-4000	4000	-3080
chr5	179834078	179842078	179840940	8000	179838078	-4000	4000	2862
chr5	21746673	21754673	21751216	8000	21750673	-4000	4000	543
chr5	35875603	35883603	35875691	8000	35879603	-4000	4000	-3912
chr5	83936554	83944554	83943061	8000	83940554	-4000	4000	2507
chr5	96386333	96394333	96390756	8000	96390333	-4000	4000	423
chr5	138281269	138289269	138286603	8000	138285269	-4000	4000	1334
chr5	180229143	180237143	180236360	8000	180233143	-4000	4000	3217
chr5	181232897	181240897	181237279	8000	181236897	-4000	4000	382
chr5	138281269	138289269	138285781	8000	138285269	-4000	4000	512
chr5	178233476	178241476	178238556	8000	178237476	-4000	4000	1080
chr5	180843611	180851611	180849790	8000	180847611	-4000	4000	2179
chr5	141199779	141207779	141201994	8000	141203779	-4000	4000	-1785
chr5	141094703	141102703	141101204	8000	141098703	-4000	4000	2501
chr5	141214979	141222979	141216586	8000	141218979	-4000	4000	-2393
chr5	161284429	161292429	161289301	8000	161288429	-4000	4000	872
chr5	53483134	53491134	53483721	8000	53487134	-4000	4000	-3413
chr5	141172383	141180383	141179576	8000	141176383	-4000	4000	3193
chr5	83633805	83641805	83641459	8000	83637805	-4000	4000	3654
chr5	176655054	176663054	176657515	8000	176659054	-4000	4000	-1539
chr5	42717878	42725878	42719764	8000	42721878	-4000	4000	-2114
chr5	80317842	80325842	80320498	8000	80321842	-4000	4000	-1344
chr5	122071570	122079570	122075441	8000	122075570	-4000	4000	-129
chr5	24483100	24491100	24487304	8000	24487100	-4000	4000	204
chr5	141094703	141102703	141095831	8000	141098703	-4000	4000	-2872
chr5	141199779	141207779	141201562	8000	141203779	-4000	4000	-2217
chr5	40755389	40763389	40762956	8000	40759389	-4000	4000	3567
chr5	122071570	122079570	122077509	8000	122075570	-4000	4000	1939
chr5	141187541	141195541	141192784	8000	141191541	-4000	4000	1243
chr5	134851133	134859133	134855713	8000	134855133	-4000	4000	580
chr5	141121623	141129623	141122922	8000	141125623	-4000	4000	-2701
chr5	103544855	103552855	103552417	8000	103548855	-4000	4000	3562
chr5	177988235	177996235	177993031	8000	177992235	-4000	4000	796
chr5	141208571	141216571	141210695	8000	141212571	-4000	4000	-1876
chr5	141182226	141190226	141184962	8000	141186226	-4000	4000	-1264
chr5	192334	200334	195029	8000	196334	-4000	4000	-1305
chr5	58449982	58457982	58456558	8000	58453982	-4000	4000	2576
chr5	76731770	76739770	76732475	8000	76735770	-4000	4000	-3295
chr5	80552755	80560755	80558322	8000	80556755	-4000	4000	1567
chr5	93590611	93598611	93593969	8000	93594611	-4000	4000	-642
chr5	96775595	96783595	96776868	8000	96779595	-4000	4000	-2727
chr5	112842239	112850239	112843117	8000	112846239	-4000	4000	-3122
chr5	130182634	130190634	130185536	8000	130186634	-4000	4000	-1098
chr5	132857181	132865181	132864567	8000	132861181	-4000	4000	3386
chr5	138183650	138191650	138184632	8000	138187650	-4000	4000	-3018
chr5	141099827	141107827	141103073	8000	141103827	-4000	4000	-754
chr5	146509144	146517144	146510487	8000	146513144	-4000	4000	-2657
chr5	172764096	172772096	172768584	8000	172768096	-4000	4000	488
chr5	135888246	135896246	135895735	8000	135892246	-4000	4000	3489
chr5	157025413	157033413	157029813	8000	157029413	-4000	4000	400
chr5	133192455	133200455	133199271	8000	133196455	-4000	4000	2816
chr5	169600778	169608778	169601375	8000	169604778	-4000	4000	-3403
chr5	1313752	1321752	1320650	8000	1317752	-4000	4000	2898
chr5	13686328	13694328	13691962	8000	13690328	-4000	4000	1634
chr5	32106932	32114932	32109002	8000	32110932	-4000	4000	-1930
chr5	67175613	67183613	67182987	8000	67179613	-4000	4000	3374
chr5	67175613	67183613	67183453	8000	67179613	-4000	4000	3840
chr5	80552755	80560755	80559962	8000	80556755	-4000	4000	3207
chr5	103274660	103282660	103277032	8000	103278660	-4000	4000	-1628
chr5	135530282	135538282	135535513	8000	135534282	-4000	4000	1231
chr5	160389148	160397148	160394580	8000	160393148	-4000	4000	1432
chr5	180843611	180851611	180849354	8000	180847611	-4000	4000	1743
chr5	181232897	181240897	181238243	8000	181236897	-4000	4000	1346
chr5	173228109	173236109	173233087	8000	173232109	-4000	4000	978
chr5	181232897	181240897	181239078	8000	181236897	-4000	4000	2181
chr5	141172383	141180383	141175116	8000	141176383	-4000	4000	-1267
chr5	168526634	168534634	168530366	8000	168530634	-4000	4000	-268
chr5	134388108	134396108	134390882	8000	134392108	-4000	4000	-1226
chr5	160389148	160397148	160394005	8000	160393148	-4000	4000	857
chr5	161284429	161292429	161290060	8000	161288429	-4000	4000	1631
chr5	180096795	180104795	180101345	8000	180100795	-4000	4000	550
chr5	180574358	180582358	180574594	8000	180578358	-4000	4000	-3764
chr5	141094703	141102703	141095160	8000	141098703	-4000	4000	-3543
chr5	23524093	23532093	23527438	8000	23528093	-4000	4000	-655
chr5	58449982	58457982	58455311	8000	58453982	-4000	4000	1329
chr5	80317842	80325842	80320291	8000	80321842	-4000	4000	-1551
chr5	180735123	180743123	180739594	8000	180739123	-4000	4000	471
chr5	21746673	21754673	21751967	8000	21750673	-4000	4000	1294
chr5	75352345	75360345	75354535	8000	75356345	-4000	4000	-1810
chr5	102229986	102237986	102236987	8000	102233986	-4000	4000	3001
chr5	132871046	132879046	132874033	8000	132875046	-4000	4000	-1013
chr5	141241861	141249861	141246883	8000	141245861	-4000	4000	1022
chr5	151266440	151274440	151267144	8000	151270440	-4000	4000	-3296
chr5	663168	671168	665214	8000	667168	-4000	4000	-1954
chr5	6753044	6761044	6755167	8000	6757044	-4000	4000	-1877
chr5	9623347	9631347	9629276	8000	9627347	-4000	4000	1929
chr5	24483100	24491100	24487938	8000	24487100	-4000	4000	838
chr5	55215564	55223564	55220714	8000	55219564	-4000	4000	1150
chr5	57476018	57484018	57481975	8000	57480018	-4000	4000	1957
chr5	64608319	64616319	64609286	8000	64612319	-4000	4000	-3033
chr5	74718647	74726647	74726058	8000	74722647	-4000	4000	3411
chr5	77687166	77695166	77693086	8000	77691166	-4000	4000	1920
chr5	112842239	112850239	112843509	8000	112846239	-4000	4000	-2730
chr5	116439555	116447555	116444545	8000	116443555	-4000	4000	990
chr5	129110028	129118028	129113318	8000	129114028	-4000	4000	-710
chr5	141094703	141102703	141095505	8000	141098703	-4000	4000	-3198
chr5	141187541	141195541	141189572	8000	141191541	-4000	4000	-1969
chr5	141241861	141249861	141247865	8000	141245861	-4000	4000	2004
chr5	143816716	143824716	143820485	8000	143820716	-4000	4000	-231
chr5	148438836	148446836	148440524	8000	148442836	-4000	4000	-2312
chr5	148438836	148446836	148442208	8000	148442836	-4000	4000	-628
chr5	148824623	148832623	148828444	8000	148828623	-4000	4000	-179
chr5	151500092	151508092	151507445	8000	151504092	-4000	4000	3353
chr5	15935795	15943795	15936718	8000	15939795	-4000	4000	-3077
chr5	63953874	63961874	63961427	8000	63957874	-4000	4000	3553
chr5	76731770	76739770	76732786	8000	76735770	-4000	4000	-2984
chr5	141172383	141180383	141180341	8000	141176383	-4000	4000	3958
chr5	141187541	141195541	141193415	8000	141191541	-4000	4000	1874
chr5	150792734	150800734	150795592	8000	150796734	-4000	4000	-1142
chr5	95820383	95828383	95822510	8000	95824383	-4000	4000	-1873
chr5	138442969	138450969	138445334	8000	138446969	-4000	4000	-1635
chr5	151266440	151274440	151267539	8000	151270440	-4000	4000	-2901
chr5	137883851	137891851	137890482	8000	137887851	-4000	4000	2631
chr5	141187541	141195541	141188387	8000	141191541	-4000	4000	-3154
chr5	97087867	97095867	97094921	8000	97091867	-4000	4000	3054
chr5	33983174	33991174	33989265	8000	33987174	-4000	4000	2091
chr5	132871046	132879046	132875583	8000	132875046	-4000	4000	537
chr5	141094703	141102703	141101966	8000	141098703	-4000	4000	3263
chr5	78773209	78781209	78780316	8000	78777209	-4000	4000	3107
chr5	141094703	141102703	141095302	8000	141098703	-4000	4000	-3401
chr5	159153409	159161409	159158963	8000	159157409	-4000	4000	1554
chr5	21746673	21754673	21751883	8000	21750673	-4000	4000	1210
chr5	33983174	33991174	33984398	8000	33987174	-4000	4000	-2776
chr5	175436036	175444036	175441552	8000	175440036	-4000	4000	1516
chr5	171857549	171865549	171863274	8000	171861549	-4000	4000	1725
chr5	141208571	141216571	141210289	8000	141212571	-4000	4000	-2282
chr5	65583549	65591549	65590319	8000	65587549	-4000	4000	2770
chr5	79796240	79804240	79799482	8000	79800240	-4000	4000	-758
chr5	132857181	132865181	132862204	8000	132861181	-4000	4000	1023
chr5	138135770	138143770	138139948	8000	138139770	-4000	4000	178
chr5	177094144	177102144	177097386	8000	177098144	-4000	4000	-758
chr5	132688628	132696628	132693719	8000	132692628	-4000	4000	1091
chr5	141241861	141249861	141247142	8000	141245861	-4000	4000	1281
chr5	42795880	42803880	42801008	8000	42799880	-4000	4000	1128
chr5	83633805	83641805	83641458	8000	83637805	-4000	4000	3653
chr5	160343754	160351754	160349684	8000	160347754	-4000	4000	1930
chr5	19467296	19475296	19473597	8000	19471296	-4000	4000	2301
chr5	151272358	151280358	151277406	8000	151276358	-4000	4000	1048
chr5	135885770	135893770	135888032	8000	135889770	-4000	4000	-1738
chr5	96915703	96923703	96917516	8000	96919703	-4000	4000	-2187
chr5	150292343	150300343	150297811	8000	150296343	-4000	4000	1468
chr5	112842239	112850239	112844038	8000	112846239	-4000	4000	-2201
chr5	95648181	95656181	95652466	8000	95652181	-4000	4000	285
chr5	141187541	141195541	141194076	8000	141191541	-4000	4000	2535
chr5	32350350	32358350	32355897	8000	32354350	-4000	4000	1547
chr5	141172383	141180383	141179726	8000	141176383	-4000	4000	3343
chr5	147383855	147391855	147384100	8000	147387855	-4000	4000	-3755
chr5	50392192	50400192	50399286	8000	50396192	-4000	4000	3094
chr5	63953874	63961874	63961186	8000	63957874	-4000	4000	3312
chr5	100582741	100590741	100586185	8000	100586741	-4000	4000	-556
chr5	178929212	178937212	178932172	8000	178933212	-4000	4000	-1040
chr5	181155285	181163285	181155416	8000	181159285	-4000	4000	-3869
chr5	140554268	140562268	140560660	8000	140558268	-4000	4000	2392
chr5	141134615	141142615	141137480	8000	141138615	-4000	4000	-1135
chr5	172205646	172213646	172211740	8000	172209646	-4000	4000	2094
chr5	179610178	179618178	179617054	8000	179614178	-4000	4000	2876
chr5	180946906	180954906	180950233	8000	180950906	-4000	4000	-673
chr5	21746673	21754673	21752000	8000	21750673	-4000	4000	1327
chr5	32222994	32230994	32230129	8000	32226994	-4000	4000	3135
chr5	63953874	63961874	63961070	8000	63957874	-4000	4000	3196
chr5	63953874	63961874	63961576	8000	63957874	-4000	4000	3702
chr5	75677773	75685773	75677937	8000	75681773	-4000	4000	-3836
chr5	76731770	76739770	76733068	8000	76735770	-4000	4000	-2702
chr5	141094703	141102703	141095661	8000	141098703	-4000	4000	-3042
chr5	181232897	181240897	181239297	8000	181236897	-4000	4000	2400
chr5	181232897	181240897	181239577	8000	181236897	-4000	4000	2680
chr5	6367874	6375874	6374380	8000	6371874	-4000	4000	2506
chr5	115516908	115524908	115524393	8000	115520908	-4000	4000	3485
chr5	134851133	134859133	134855106	8000	134855133	-4000	4000	-27
chr5	663168	671168	665142	8000	667168	-4000	4000	-2026
chr5	32106932	32114932	32108254	8000	32110932	-4000	4000	-2678
chr5	80552755	80560755	80559740	8000	80556755	-4000	4000	2985
chr5	146077791	146085791	146084401	8000	146081791	-4000	4000	2610
chr5	42795880	42803880	42800830	8000	42799880	-4000	4000	950
chr5	138549756	138557756	138556496	8000	138553756	-4000	4000	2740
chr5	176591974	176599974	176598910	8000	176595974	-4000	4000	2936
chr5	80552755	80560755	80558474	8000	80556755	-4000	4000	1719
chr5	141199779	141207779	141201136	8000	141203779	-4000	4000	-2643
chr5	160559120	160567120	160565845	8000	160563120	-4000	4000	2725
chr5	116439555	116447555	116447254	8000	116443555	-4000	4000	3699
chr5	116439555	116447555	116447255	8000	116443555	-4000	4000	3700
chr5	141149287	141157287	141150792	8000	141153287	-4000	4000	-2495
chr5	111492033	111500033	111499957	8000	111496033	-4000	4000	3924
chr5	55252055	55260055	55256259	8000	55256055	-4000	4000	204
chr5	54542586	54550586	54543461	8000	54546586	-4000	4000	-3125
chr5	151266440	151274440	151267185	8000	151270440	-4000	4000	-3255
chr5	73440827	73448827	73446781	8000	73444827	-4000	4000	1954
chr5	141199779	141207779	141201861	8000	141203779	-4000	4000	-1918
chr5	178929212	178937212	178932014	8000	178933212	-4000	4000	-1198
chr5	116439555	116447555	116445169	8000	116443555	-4000	4000	1614
chr5	141172383	141180383	141173052	8000	141176383	-4000	4000	-3331
chr5	136059818	136067818	136060861	8000	136063818	-4000	4000	-2957
chr5	1249147	1257147	1255341	8000	1253147	-4000	4000	2194
chr5	141134615	141142615	141137696	8000	141138615	-4000	4000	-919
chr5	95446454	95454454	95448341	8000	95450454	-4000	4000	-2113
chr5	132818141	132826141	132823453	8000	132822141	-4000	4000	1312
chr5	141208571	141216571	141211186	8000	141212571	-4000	4000	-1385
chr5	116439555	116447555	116446970	8000	116443555	-4000	4000	3415
chr5	171453626	171461626	171456694	8000	171457626	-4000	4000	-932
chr5	9623347	9631347	9629847	8000	9627347	-4000	4000	2500
chr5	73501667	73509667	73503015	8000	73505667	-4000	4000	-2652
chr5	54452377	54460377	54455901	8000	54456377	-4000	4000	-476
chr5	151096706	151104706	151103654	8000	151100706	-4000	4000	2948
chr5	141241861	141249861	141245792	8000	141245861	-4000	4000	-69
chr5	141199779	141207779	141201484	8000	141203779	-4000	4000	-2295
chr5	141208571	141216571	141215757	8000	141212571	-4000	4000	3186
chr5	23524093	23532093	23527632	8000	23528093	-4000	4000	-461
chr5	23524093	23532093	23527765	8000	23528093	-4000	4000	-328
chr5	33464091	33472091	33466907	8000	33468091	-4000	4000	-1184
chr5	35044756	35052756	35047972	8000	35048756	-4000	4000	-784
chr5	37102228	37110228	37108468	8000	37106228	-4000	4000	2240
chr5	55106252	55114252	55108157	8000	55110252	-4000	4000	-2095
chr5	58449982	58457982	58455696	8000	58453982	-4000	4000	1714
chr5	61153704	61161704	61160189	8000	61157704	-4000	4000	2485
chr5	62577446	62585446	62579491	8000	62581446	-4000	4000	-1955
chr5	62577446	62585446	62580702	8000	62581446	-4000	4000	-744
chr5	70039113	70047113	70041709	8000	70043113	-4000	4000	-1404
chr5	70039113	70047113	70041954	8000	70043113	-4000	4000	-1159
chr5	75352345	75360345	75359196	8000	75356345	-4000	4000	2851
chr5	80079287	80087287	80082378	8000	80083287	-4000	4000	-909
chr5	83633805	83641805	83641576	8000	83637805	-4000	4000	3771
chr5	103025730	103033730	103028202	8000	103029730	-4000	4000	-1528
chr5	112842239	112850239	112844043	8000	112846239	-4000	4000	-2196
chr5	124632913	124640913	124639146	8000	124636913	-4000	4000	2233
chr5	132857181	132865181	132861878	8000	132861181	-4000	4000	697
chr5	135003959	135011959	135008969	8000	135007959	-4000	4000	1010
chr5	138183650	138191650	138185561	8000	138187650	-4000	4000	-2089
chr5	138549756	138557756	138556982	8000	138553756	-4000	4000	3226
chr5	140371141	140379141	140372746	8000	140375141	-4000	4000	-2395
chr5	141094703	141102703	141100456	8000	141098703	-4000	4000	1753
chr5	141121623	141129623	141123186	8000	141125623	-4000	4000	-2437
chr5	141134615	141142615	141136596	8000	141138615	-4000	4000	-2019
chr5	141172383	141180383	141178089	8000	141176383	-4000	4000	1706
chr5	141172383	141180383	141180199	8000	141176383	-4000	4000	3816
chr5	141176539	141184539	141183086	8000	141180539	-4000	4000	2547
chr5	141176539	141184539	141183244	8000	141180539	-4000	4000	2705
chr5	141208571	141216571	141214186	8000	141212571	-4000	4000	1615
chr5	143816716	143824716	143820683	8000	143820716	-4000	4000	-33
chr5	147383855	147391855	147384170	8000	147387855	-4000	4000	-3685
chr5	149488982	149496982	149496686	8000	149492982	-4000	4000	3704
chr5	152387546	152395546	152392422	8000	152391546	-4000	4000	876
chr5	153809869	153817869	153811058	8000	153813869	-4000	4000	-2811
chr5	154470972	154478972	154475830	8000	154474972	-4000	4000	858
chr5	159310780	159318780	159316772	8000	159314780	-4000	4000	1992
chr5	160389148	160397148	160393677	8000	160393148	-4000	4000	529
chr5	170079382	170087382	170081880	8000	170083382	-4000	4000	-1502
chr5	171453626	171461626	171456682	8000	171457626	-4000	4000	-944
chr5	178962433	178970433	178965174	8000	178966433	-4000	4000	-1259
chr5	178962433	178970433	178965437	8000	178966433	-4000	4000	-996
chr5	179610178	179618178	179616939	8000	179614178	-4000	4000	2761
chr5	180096795	180104795	180102117	8000	180100795	-4000	4000	1322
chr5	180946906	180954906	180947509	8000	180950906	-4000	4000	-3397
chr5	181232897	181240897	181239282	8000	181236897	-4000	4000	2385
chr5	180096795	180104795	180101463	8000	180100795	-4000	4000	668
chr5	138433028	138441028	138435764	8000	138437028	-4000	4000	-1264
chr5	174726896	174734896	174729282	8000	174730896	-4000	4000	-1614
chr5	181250077	181258077	181257355	8000	181254077	-4000	4000	3278
chr5	132391613	132399613	132392606	8000	132395613	-4000	4000	-3007
chr5	139365720	139373720	139368912	8000	139369720	-4000	4000	-808
chr5	141134615	141142615	141137261	8000	141138615	-4000	4000	-1354
chr5	155014141	155022141	155015799	8000	155018141	-4000	4000	-2342
chr5	141094703	141102703	141095447	8000	141098703	-4000	4000	-3256
chr5	55106252	55114252	55110148	8000	55110252	-4000	4000	-104
chr5	32120716	32128716	32126340	8000	32124716	-4000	4000	1624
chr5	160397641	160405641	160403141	8000	160401641	-4000	4000	1500
chr5	130182634	130190634	130184860	8000	130186634	-4000	4000	-1774
chr5	58493090	58501090	58494591	8000	58497090	-4000	4000	-2499
chr5	141208571	141216571	141209403	8000	141212571	-4000	4000	-3168
chr5	141208571	141216571	141209404	8000	141212571	-4000	4000	-3167
chr5	178233476	178241476	178239151	8000	178237476	-4000	4000	1675
chr5	62577446	62585446	62580045	8000	62581446	-4000	4000	-1401
chr5	80317842	80325842	80320131	8000	80321842	-4000	4000	-1711
chr5	140658480	140666480	140659101	8000	140662480	-4000	4000	-3379
chr5	141172383	141180383	141173516	8000	141176383	-4000	4000	-2867
chr5	135440226	135448226	135446887	8000	135444226	-4000	4000	2661
chr5	133192455	133200455	133199500	8000	133196455	-4000	4000	3045
chr5	9623347	9631347	9629869	8000	9627347	-4000	4000	2522
chr5	26876597	26884597	26881260	8000	26880597	-4000	4000	663
chr5	32106932	32114932	32108163	8000	32110932	-4000	4000	-2769
chr5	33464091	33472091	33466949	8000	33468091	-4000	4000	-1142
chr5	33519535	33527535	33527305	8000	33523535	-4000	4000	3770
chr5	34994101	35002101	34998763	8000	34998101	-4000	4000	662
chr5	36684334	36692334	36686325	8000	36688334	-4000	4000	-2009
chr5	41138116	41146116	41142751	8000	41142116	-4000	4000	635
chr5	41937743	41945743	41941249	8000	41941743	-4000	4000	-494
chr5	42717878	42725878	42718774	8000	42721878	-4000	4000	-3104
chr5	42717878	42725878	42719345	8000	42721878	-4000	4000	-2533
chr5	42795880	42803880	42800737	8000	42799880	-4000	4000	857
chr5	43276850	43284850	43280232	8000	43280850	-4000	4000	-618
chr5	43276850	43284850	43280481	8000	43280850	-4000	4000	-369
chr5	43440252	43448252	43446386	8000	43444252	-4000	4000	2134
chr5	43440252	43448252	43446533	8000	43444252	-4000	4000	2281
chr5	51390730	51398730	51391399	8000	51394730	-4000	4000	-3331
chr5	54542586	54550586	54543319	8000	54546586	-4000	4000	-3267
chr5	55030570	55038570	55031532	8000	55034570	-4000	4000	-3038
chr5	58449982	58457982	58457067	8000	58453982	-4000	4000	3085
chr5	58493090	58501090	58494807	8000	58497090	-4000	4000	-2283
chr5	60747791	60755791	60754601	8000	60751791	-4000	4000	2810
chr5	71717048	71725048	71720767	8000	71721048	-4000	4000	-281
chr5	73086522	73094522	73087699	8000	73090522	-4000	4000	-2823
chr5	75352345	75360345	75360064	8000	75356345	-4000	4000	3719
chr5	76831315	76839315	76832915	8000	76835315	-4000	4000	-2400
chr5	78481215	78489215	78488839	8000	78485215	-4000	4000	3624
chr5	80552755	80560755	80558935	8000	80556755	-4000	4000	2180
chr5	80552755	80560755	80559794	8000	80556755	-4000	4000	3039
chr5	87387931	87395931	87394407	8000	87391931	-4000	4000	2476
chr5	95601102	95609102	95603419	8000	95605102	-4000	4000	-1683
chr5	111658621	111666621	111664685	8000	111662621	-4000	4000	2064
chr5	112842239	112850239	112842262	8000	112846239	-4000	4000	-3977
chr5	112842239	112850239	112842889	8000	112846239	-4000	4000	-3350
chr5	115263190	115271190	115267886	8000	115267190	-4000	4000	696
chr5	116023619	116031619	116026052	8000	116027619	-4000	4000	-1567
chr5	123613045	123621045	123614554	8000	123617045	-4000	4000	-2491
chr5	126863714	126871714	126870624	8000	126867714	-4000	4000	2910
chr5	130182634	130190634	130185868	8000	130186634	-4000	4000	-766
chr5	132857181	132865181	132864191	8000	132861181	-4000	4000	3010
chr5	138442969	138450969	138444505	8000	138446969	-4000	4000	-2464
chr5	138549756	138557756	138555959	8000	138553756	-4000	4000	2203
chr5	140371141	140379141	140372775	8000	140375141	-4000	4000	-2366
chr5	141199779	141207779	141200516	8000	141203779	-4000	4000	-3263
chr5	141208571	141216571	141215446	8000	141212571	-4000	4000	2875
chr5	141208571	141216571	141216234	8000	141212571	-4000	4000	3663
chr5	141241861	141249861	141247095	8000	141245861	-4000	4000	1234
chr5	141635302	141643302	141641394	8000	141639302	-4000	4000	2092
chr5	147876726	147884726	147881524	8000	147880726	-4000	4000	798
chr5	148282255	148290255	148286164	8000	148286255	-4000	4000	-91
chr5	148438836	148446836	148440462	8000	148442836	-4000	4000	-2374
chr5	148824623	148832623	148827143	8000	148828623	-4000	4000	-1480
chr5	151818513	151826513	151822931	8000	151822513	-4000	4000	418
chr5	155014141	155022141	155016245	8000	155018141	-4000	4000	-1896
chr5	157621679	157629679	157626305	8000	157625679	-4000	4000	626
chr5	157781743	157789743	157789614	8000	157785743	-4000	4000	3871
chr5	163515354	163523354	163518293	8000	163519354	-4000	4000	-1061
chr5	170732632	170740632	170735939	8000	170736632	-4000	4000	-693
chr5	178929212	178937212	178932508	8000	178933212	-4000	4000	-704
chr5	178962433	178970433	178964714	8000	178966433	-4000	4000	-1719
chr5	178962433	178970433	178965531	8000	178966433	-4000	4000	-902
chr5	180946906	180954906	180950039	8000	180950906	-4000	4000	-867
chr5	181002727	181010727	181005613	8000	181006727	-4000	4000	-1114
chr5	31396494	31404494	31401487	8000	31400494	-4000	4000	993
chr5	40980643	40988643	40981394	8000	40984643	-4000	4000	-3249
chr5	74718647	74726647	74721217	8000	74722647	-4000	4000	-1430
chr5	74718647	74726647	74721541	8000	74722647	-4000	4000	-1106
chr5	83349787	83357787	83353180	8000	83353787	-4000	4000	-607
chr5	120683332	120691332	120686455	8000	120687332	-4000	4000	-877
chr5	122071570	122079570	122077118	8000	122075570	-4000	4000	1548
chr5	127041235	127049235	127047898	8000	127045235	-4000	4000	2663
chr5	138135770	138143770	138138770	8000	138139770	-4000	4000	-1000
chr5	139840466	139848466	139842326	8000	139844466	-4000	4000	-2140
chr5	141008347	141016347	141010880	8000	141012347	-4000	4000	-1467
chr5	141094703	141102703	141100488	8000	141098703	-4000	4000	1785
chr5	150292343	150300343	150297390	8000	150296343	-4000	4000	1047
chr5	180229143	180237143	180236311	8000	180233143	-4000	4000	3168
chr5	36188589	36196589	36195191	8000	36192589	-4000	4000	2602
chr5	36684334	36692334	36686454	8000	36688334	-4000	4000	-1880
chr5	43035233	43043233	43042657	8000	43039233	-4000	4000	3424
chr5	141172383	141180383	141174985	8000	141176383	-4000	4000	-1398
chr5	78481215	78489215	78488506	8000	78485215	-4000	4000	3291
chr5	10221507	10229507	10227466	8000	10225507	-4000	4000	1959
chr5	141208571	141216571	141210598	8000	141212571	-4000	4000	-1973
chr5	170242233	170250233	170248425	8000	170246233	-4000	4000	2192
chr5	132992985	133000985	132998428	8000	132996985	-4000	4000	1443
chr5	178962433	178970433	178965050	8000	178966433	-4000	4000	-1383
chr5	180229143	180237143	180236439	8000	180233143	-4000	4000	3296
chr5	141134615	141142615	141136457	8000	141138615	-4000	4000	-2158
chr5	58449982	58457982	58455588	8000	58453982	-4000	4000	1606
chr5	51390730	51398730	51391428	8000	51394730	-4000	4000	-3302
chr5	141099827	141107827	141103124	8000	141103827	-4000	4000	-703
chr5	141134615	141142615	141137766	8000	141138615	-4000	4000	-849
chr5	141187541	141195541	141193141	8000	141191541	-4000	4000	1600
chr5	1221111	1229111	1225439	8000	1225111	-4000	4000	328
chr5	148438836	148446836	148440512	8000	148442836	-4000	4000	-2324
chr5	179858066	179866066	179865838	8000	179862066	-4000	4000	3772
chr5	67165593	67173593	67166432	8000	67169593	-4000	4000	-3161
chr5	141008347	141016347	141012206	8000	141012347	-4000	4000	-141
chr5	172038079	172046079	172044953	8000	172042079	-4000	4000	2874
chr5	24483100	24491100	24487407	8000	24487100	-4000	4000	307
chr5	149488982	149496982	149495777	8000	149492982	-4000	4000	2795
chr5	172764096	172772096	172768855	8000	172768096	-4000	4000	759
chr5	141134615	141142615	141137260	8000	141138615	-4000	4000	-1355
chr5	135885770	135893770	135888284	8000	135889770	-4000	4000	-1486
chr5	141199779	141207779	141201835	8000	141203779	-4000	4000	-1944
chr5	130182634	130190634	130184334	8000	130186634	-4000	4000	-2300
chr5	33983174	33991174	33984422	8000	33987174	-4000	4000	-2752
chr5	115800733	115808733	115805216	8000	115804733	-4000	4000	483
chr5	37102228	37110228	37108448	8000	37106228	-4000	4000	2220
chr5	181057521	181065521	181059582	8000	181061521	-4000	4000	-1939
chr5	81262398	81270398	81266270	8000	81266398	-4000	4000	-128
chr5	97156867	97164867	97162790	8000	97160867	-4000	4000	1923
chr5	141121623	141129623	141122128	8000	141125623	-4000	4000	-3495
chr5	141176539	141184539	141183589	8000	141180539	-4000	4000	3050
chr5	141208571	141216571	141209699	8000	141212571	-4000	4000	-2872
chr5	155014141	155022141	155016178	8000	155018141	-4000	4000	-1963
chr5	73579380	73587380	73580122	8000	73583380	-4000	4000	-3258
chr5	102229986	102237986	102236714	8000	102233986	-4000	4000	2728
chr5	129029642	129037642	129029675	8000	129033642	-4000	4000	-3967
chr5	5316304	5324304	5318199	8000	5320304	-4000	4000	-2105
chr5	83633805	83641805	83641389	8000	83637805	-4000	4000	3584
chr5	112842239	112850239	112843589	8000	112846239	-4000	4000	-2650
chr5	163515354	163523354	163516526	8000	163519354	-4000	4000	-2828
chr5	141172383	141180383	141173265	8000	141176383	-4000	4000	-3118
chr5	102229986	102237986	102236855	8000	102233986	-4000	4000	2869
chr5	141094703	141102703	141094733	8000	141098703	-4000	4000	-3970
chr5	152387546	152395546	152392231	8000	152391546	-4000	4000	685
chr5	141199779	141207779	141200691	8000	141203779	-4000	4000	-3088
chr5	24483100	24491100	24487891	8000	24487100	-4000	4000	791
chr5	58493090	58501090	58494885	8000	58497090	-4000	4000	-2205
chr5	141199779	141207779	141201374	8000	141203779	-4000	4000	-2405
chr5	178962433	178970433	178965206	8000	178966433	-4000	4000	-1227
chr5	146335251	146343251	146339119	8000	146339251	-4000	4000	-132
chr5	64608319	64616319	64609171	8000	64612319	-4000	4000	-3148
chr5	74718647	74726647	74722497	8000	74722647	-4000	4000	-150
chr5	141094703	141102703	141096095	8000	141098703	-4000	4000	-2608
chr5	141094703	141102703	141100839	8000	141098703	-4000	4000	2136
chr5	141094703	141102703	141102193	8000	141098703	-4000	4000	3490
chr5	141172383	141180383	141173137	8000	141176383	-4000	4000	-3246
chr5	149367324	149375324	149368730	8000	149371324	-4000	4000	-2594
chr5	150896736	150904736	150898518	8000	150900736	-4000	4000	-2218
chr5	160389148	160397148	160394749	8000	160393148	-4000	4000	1601
chr5	163487941	163495941	163491358	8000	163491941	-4000	4000	-583
chr5	172764096	172772096	172769713	8000	172768096	-4000	4000	1617
chr5	176341991	176349991	176347493	8000	176345991	-4000	4000	1502
chr5	177368596	177376596	177371484	8000	177372596	-4000	4000	-1112
chr5	180946906	180954906	180950573	8000	180950906	-4000	4000	-333
chr5	138135770	138143770	138140028	8000	138139770	-4000	4000	258
chr5	141187541	141195541	141188925	8000	141191541	-4000	4000	-2616
chr5	141182226	141190226	141184693	8000	141186226	-4000	4000	-1533
chr5	65513766	65521766	65518633	8000	65517766	-4000	4000	867
chr5	43035233	43043233	43040064	8000	43039233	-4000	4000	831
chr5	132746819	132754819	132750894	8000	132750819	-4000	4000	75
chr5	141094703	141102703	141097176	8000	141098703	-4000	4000	-1527
chr5	141182226	141190226	141187336	8000	141186226	-4000	4000	1110
chr5	111074026	111082026	111076006	8000	111078026	-4000	4000	-2020
chr5	141208571	141216571	141209014	8000	141212571	-4000	4000	-3557
chr5	176876898	176884898	176881509	8000	176880898	-4000	4000	611
chr5	33983174	33991174	33989158	8000	33987174	-4000	4000	1984
chr5	141172383	141180383	141178489	8000	141176383	-4000	4000	2106
chr5	15935795	15943795	15936938	8000	15939795	-4000	4000	-2857
chr5	168260157	168268157	168262550	8000	168264157	-4000	4000	-1607
chr5	177094144	177102144	177096631	8000	177098144	-4000	4000	-1513
chr5	170105734	170113734	170108080	8000	170109734	-4000	4000	-1654
chr5	102229986	102237986	102236959	8000	102233986	-4000	4000	2973
chr5	179031064	179039064	179033709	8000	179035064	-4000	4000	-1355
chr5	141121623	141129623	141123841	8000	141125623	-4000	4000	-1782
chr5	135440226	135448226	135446689	8000	135444226	-4000	4000	2463
chr5	157737449	157745449	157739407	8000	157741449	-4000	4000	-2042
chr5	53483134	53491134	53485215	8000	53487134	-4000	4000	-1919
chr5	80317842	80325842	80321199	8000	80321842	-4000	4000	-643
chr5	180586105	180594105	180590716	8000	180590105	-4000	4000	611
chr5	51390730	51398730	51393557	8000	51394730	-4000	4000	-1173
chr5	148824623	148832623	148826919	8000	148828623	-4000	4000	-1704
chr5	136971298	136979298	136978709	8000	136975298	-4000	4000	3411
chr5	141149287	141157287	141157074	8000	141153287	-4000	4000	3787
chr5	132746819	132754819	132748356	8000	132750819	-4000	4000	-2463
chr5	138433028	138441028	138435671	8000	138437028	-4000	4000	-1357
chr5	7826081	7834081	7831895	8000	7830081	-4000	4000	1814
chr5	35810611	35818611	35814481	8000	35814611	-4000	4000	-130
chr5	141008347	141016347	141010914	8000	141012347	-4000	4000	-1433
chr5	33934918	33942918	33936581	8000	33938918	-4000	4000	-2337
chr5	141172383	141180383	141173045	8000	141176383	-4000	4000	-3338
chr5	179773283	179781283	179773976	8000	179777283	-4000	4000	-3307
chr5	58449982	58457982	58457542	8000	58453982	-4000	4000	3560
chr5	33983174	33991174	33984215	8000	33987174	-4000	4000	-2959
chr5	141208571	141216571	141210753	8000	141212571	-4000	4000	-1818
chr5	15935795	15943795	15936858	8000	15939795	-4000	4000	-2937
chr5	80552755	80560755	80559212	8000	80556755	-4000	4000	2457
chr5	178962433	178970433	178965798	8000	178966433	-4000	4000	-635
chr5	146509144	146517144	146509174	8000	146513144	-4000	4000	-3970
chr5	153809869	153817869	153811165	8000	153813869	-4000	4000	-2704
chr5	163515354	163523354	163517869	8000	163519354	-4000	4000	-1485
chr5	178180505	178188505	178186007	8000	178184505	-4000	4000	1502
chr5	41917636	41925636	41921209	8000	41921636	-4000	4000	-427
chr5	123613045	123621045	123615125	8000	123617045	-4000	4000	-1920
chr5	135530282	135538282	135535148	8000	135534282	-4000	4000	866
chr5	176876898	176884898	176877242	8000	176880898	-4000	4000	-3656
chr5	171453626	171461626	171456557	8000	171457626	-4000	4000	-1069
chr5	141094703	141102703	141102026	8000	141098703	-4000	4000	3323
chr5	141172383	141180383	141173485	8000	141176383	-4000	4000	-2898
chr5	141208571	141216571	141211267	8000	141212571	-4000	4000	-1304
chr5	123340890	123348890	123346615	8000	123344890	-4000	4000	1725
chr5	141208571	141216571	141215337	8000	141212571	-4000	4000	2766
chr5	93590611	93598611	93593897	8000	93594611	-4000	4000	-714
chr5	69440330	69448330	69441707	8000	69444330	-4000	4000	-2623
chr5	146335251	146343251	146339613	8000	146339251	-4000	4000	362
chr5	80872815	80880815	80875978	8000	80876815	-4000	4000	-837
chr5	181119122	181127122	181124841	8000	181123122	-4000	4000	1719
chr5	79368636	79376636	79376107	8000	79372636	-4000	4000	3471
chr5	141172383	141180383	141172701	8000	141176383	-4000	4000	-3682
chr5	141172383	141180383	141175240	8000	141176383	-4000	4000	-1143
chr5	55621845	55629845	55627965	8000	55625845	-4000	4000	2120
chr5	136208745	136216745	136213453	8000	136212745	-4000	4000	708
chr5	140627728	140635728	140633193	8000	140631728	-4000	4000	1465
chr5	141199779	141207779	141200737	8000	141203779	-4000	4000	-3042
chr5	134579230	134587230	134579240	8000	134583230	-4000	4000	-3990
chr5	141121623	141129623	141123638	8000	141125623	-4000	4000	-1985
chr5	141208571	141216571	141209152	8000	141212571	-4000	4000	-3419
chr5	96386333	96394333	96393342	8000	96390333	-4000	4000	3009
chr5	141208571	141216571	141214785	8000	141212571	-4000	4000	2214
chr5	32350350	32358350	32355895	8000	32354350	-4000	4000	1545
chr5	95601102	95609102	95603512	8000	95605102	-4000	4000	-1590
chr5	137883851	137891851	137889471	8000	137887851	-4000	4000	1620
chr5	141176539	141184539	141183818	8000	141180539	-4000	4000	3279
chr5	9623347	9631347	9630057	8000	9627347	-4000	4000	2710
chr5	141172383	141180383	141174393	8000	141176383	-4000	4000	-1990
chr5	95648181	95656181	95652263	8000	95652181	-4000	4000	82
chr5	133192455	133200455	133199481	8000	133196455	-4000	4000	3026
chr5	168515301	168523301	168517840	8000	168519301	-4000	4000	-1461
chr5	178929212	178937212	178932682	8000	178933212	-4000	4000	-530
chr5	134388108	134396108	134390937	8000	134392108	-4000	4000	-1171
chr5	181002727	181010727	181004758	8000	181006727	-4000	4000	-1969
chr5	135003959	135011959	135011567	8000	135007959	-4000	4000	3608
chr5	192334	200334	195038	8000	196334	-4000	4000	-1296
chr5	37102228	37110228	37108458	8000	37106228	-4000	4000	2230
chr5	43035233	43043233	43039519	8000	43039233	-4000	4000	286
chr5	57476018	57484018	57481747	8000	57480018	-4000	4000	1729
chr5	57476018	57484018	57482011	8000	57480018	-4000	4000	1993
chr5	69127069	69135069	69129522	8000	69131069	-4000	4000	-1547
chr5	73171143	73179143	73173537	8000	73175143	-4000	4000	-1606
chr5	76831315	76839315	76833354	8000	76835315	-4000	4000	-1961
chr5	132059204	132067204	132062693	8000	132063204	-4000	4000	-511
chr5	136208745	136216745	136216225	8000	136212745	-4000	4000	3480
chr5	139471533	139479533	139478401	8000	139475533	-4000	4000	2868
chr5	170810047	170818047	170812277	8000	170814047	-4000	4000	-1770
chr5	181002727	181010727	181005814	8000	181006727	-4000	4000	-913
chr5	141182226	141190226	141185154	8000	141186226	-4000	4000	-1072
chr5	116439555	116447555	116445883	8000	116443555	-4000	4000	2328
chr5	132857181	132865181	132861939	8000	132861181	-4000	4000	758
chr5	40994017	41002017	40998636	8000	40998017	-4000	4000	619
chr5	73579380	73587380	73580019	8000	73583380	-4000	4000	-3361
chr5	103025730	103033730	103029313	8000	103029730	-4000	4000	-417
chr5	141176539	141184539	141184459	8000	141180539	-4000	4000	3920
chr5	180946906	180954906	180950136	8000	180950906	-4000	4000	-770
chr5	33983174	33991174	33989452	8000	33987174	-4000	4000	2278
chr5	115263190	115271190	115267903	8000	115267190	-4000	4000	713
chr5	141172383	141180383	141177995	8000	141176383	-4000	4000	1612
chr5	57476018	57484018	57482065	8000	57480018	-4000	4000	2047
chr5	43276850	43284850	43280435	8000	43280850	-4000	4000	-415
chr6	149500495	149508495	149505422	8000	149504495	-4000	4000	927
chr6	26236793	26244793	26240436	8000	26240793	-4000	4000	-357
chr6	31826254	31834254	31829965	8000	31830254	-4000	4000	-289
chr6	33317386	33325386	33320589	8000	33321386	-4000	4000	-797
chr6	125928034	125936034	125929192	8000	125932034	-4000	4000	-2842
chr6	127284712	127292712	127287295	8000	127288712	-4000	4000	-1417
chr6	138084505	138092505	138092049	8000	138088505	-4000	4000	3544
chr6	28256958	28264958	28259819	8000	28260958	-4000	4000	-1139
chr6	35463102	35471102	35468959	8000	35467102	-4000	4000	1857
chr6	26411208	26419208	26413696	8000	26415208	-4000	4000	-1512
chr6	28427930	28435930	28434803	8000	28431930	-4000	4000	2873
chr6	35469597	35477597	35470282	8000	35473597	-4000	4000	-3315
chr6	83521704	83529704	83523925	8000	83525704	-4000	4000	-1779
chr6	3264962	3272962	3267562	8000	3268962	-4000	4000	-1400
chr6	83521704	83529704	83523586	8000	83525704	-4000	4000	-2118
chr6	26212200	26220200	26216415	8000	26216200	-4000	4000	215
chr6	168041091	168049091	168044826	8000	168045091	-4000	4000	-265
chr6	31138439	31146439	31142453	8000	31142439	-4000	4000	14
chr6	36736775	36744775	36742420	8000	36740775	-4000	4000	1645
chr6	151617193	151625193	151617949	8000	151621193	-4000	4000	-3244
chr6	7414037	7422037	7414285	8000	7418037	-4000	4000	-3752
chr6	27907185	27915185	27911821	8000	27911185	-4000	4000	636
chr6	29482697	29490697	29487207	8000	29486697	-4000	4000	510
chr6	31526219	31534219	31531101	8000	31530219	-4000	4000	882
chr6	32037153	32045153	32042301	8000	32041153	-4000	4000	1148
chr6	32124707	32132707	32129539	8000	32128707	-4000	4000	832
chr6	35775552	35783552	35777482	8000	35779552	-4000	4000	-2070
chr6	42921838	42929838	42923203	8000	42925838	-4000	4000	-2635
chr6	42959865	42967865	42966816	8000	42963865	-4000	4000	2951
chr6	52232681	52240681	52238886	8000	52236681	-4000	4000	2205
chr6	55398493	55406493	55399407	8000	55402493	-4000	4000	-3086
chr6	88062838	88070838	88066489	8000	88066838	-4000	4000	-349
chr6	118955763	118963763	118961767	8000	118959763	-4000	4000	2004
chr6	132639312	132647312	132645060	8000	132643312	-4000	4000	1748
chr6	149590873	149598873	149597166	8000	149594873	-4000	4000	2293
chr6	167968023	167976023	167969137	8000	167972023	-4000	4000	-2886
chr6	12293194	12301194	12295985	8000	12297194	-4000	4000	-1209
chr6	87081498	87089498	87086384	8000	87085498	-4000	4000	886
chr6	132567359	132575359	132570319	8000	132571359	-4000	4000	-1040
chr6	127284712	127292712	127287962	8000	127288712	-4000	4000	-750
chr6	130137449	130145449	130144415	8000	130141449	-4000	4000	2966
chr6	26016958	26024958	26020958	8000	26020958	-4000	4000	0
chr6	26027589	26035589	26031821	8000	26031589	-4000	4000	232
chr6	26027589	26035589	26033205	8000	26031589	-4000	4000	1616
chr6	109488855	109496855	109493357	8000	109492855	-4000	4000	502
chr6	132613022	132621022	132617699	8000	132617022	-4000	4000	677
chr6	159794436	159802436	159797292	8000	159798436	-4000	4000	-1144
chr6	159816704	159824704	159819050	8000	159820704	-4000	4000	-1654
chr6	114051596	114059596	114057325	8000	114055596	-4000	4000	1729
chr6	44230142	44238142	44232049	8000	44234142	-4000	4000	-2093
chr6	28229487	28237487	28233378	8000	28233487	-4000	4000	-109
chr6	35424191	35432191	35425876	8000	35428191	-4000	4000	-2315
chr6	42864558	42872558	42865545	8000	42868558	-4000	4000	-3013
chr6	152720569	152728569	152721981	8000	152724569	-4000	4000	-2588
chr6	29436977	29444977	29440199	8000	29440977	-4000	4000	-778
chr6	149945235	149953235	149946470	8000	149949235	-4000	4000	-2765
chr6	72399145	72407145	72402348	8000	72403145	-4000	4000	-797
chr6	107657306	107665306	107658455	8000	107661306	-4000	4000	-2851
chr6	33158681	33166681	33165784	8000	33162681	-4000	4000	3103
chr6	43518334	43526334	43519423	8000	43522334	-4000	4000	-2911
chr6	26195988	26203988	26197171	8000	26199988	-4000	4000	-2817
chr6	126344875	126352875	126348465	8000	126348875	-4000	4000	-410
chr6	89360616	89368616	89368017	8000	89364616	-4000	4000	3401
chr6	127704072	127712072	127709873	8000	127708072	-4000	4000	1801
chr6	134913393	134921393	134918751	8000	134917393	-4000	4000	1358
chr6	157285025	157293025	157292902	8000	157289025	-4000	4000	3877
chr6	2883270	2891270	2890006	8000	2887270	-4000	4000	2736
chr6	33405896	33413896	33406871	8000	33409896	-4000	4000	-3025
chr6	26027589	26035589	26031843	8000	26031589	-4000	4000	254
chr6	26195988	26203988	26196935	8000	26199988	-4000	4000	-3053
chr6	134165248	134173248	134170403	8000	134169248	-4000	4000	1155
chr6	89091959	89099959	89098735	8000	89095959	-4000	4000	2776
chr6	42959865	42967865	42964847	8000	42963865	-4000	4000	982
chr6	84120241	84128241	84125211	8000	84124241	-4000	4000	970
chr6	30559723	30567723	30562095	8000	30563723	-4000	4000	-1628
chr6	31941672	31949672	31946637	8000	31945672	-4000	4000	965
chr6	42177338	42185338	42178361	8000	42181338	-4000	4000	-2977
chr6	7414037	7422037	7414253	8000	7418037	-4000	4000	-3784
chr6	26630383	26638383	26637444	8000	26634383	-4000	4000	3061
chr6	116459771	116467771	116461887	8000	116463771	-4000	4000	-1884
chr6	146433601	146441601	146434348	8000	146437601	-4000	4000	-3253
chr6	27954182	27962182	27957987	8000	27958182	-4000	4000	-195
chr6	114051596	114059596	114057712	8000	114055596	-4000	4000	2116
chr6	39026792	39034792	39030371	8000	39030792	-4000	4000	-421
chr6	4060983	4068983	4068384	8000	4064983	-4000	4000	3401
chr6	13976310	13984310	13978145	8000	13980310	-4000	4000	-2165
chr6	79197245	79205245	79201871	8000	79201245	-4000	4000	626
chr6	2944159	2952159	2948971	8000	2948159	-4000	4000	812
chr6	347355	355355	350800	8000	351355	-4000	4000	-555
chr6	27810302	27818302	27814470	8000	27814302	-4000	4000	168
chr6	29827125	29835125	29829437	8000	29831125	-4000	4000	-1688
chr6	41679978	41687978	41684576	8000	41683978	-4000	4000	598
chr6	28298549	28306549	28300844	8000	28302549	-4000	4000	-1705
chr6	49964677	49972677	49968849	8000	49968677	-4000	4000	172
chr6	159774498	159782498	159779076	8000	159778498	-4000	4000	578
chr6	40387591	40395591	40392722	8000	40391591	-4000	4000	1131
chr6	42740498	42748498	42745132	8000	42744498	-4000	4000	634
chr6	99393629	99401629	99400703	8000	99397629	-4000	4000	3074
chr6	137488199	137496199	137492744	8000	137492199	-4000	4000	545
chr6	26212200	26220200	26217357	8000	26216200	-4000	4000	1157
chr6	31682962	31690962	31687711	8000	31686962	-4000	4000	749
chr6	47623263	47631263	47627036	8000	47627263	-4000	4000	-227
chr6	57051239	57059239	57053428	8000	57055239	-4000	4000	-1811
chr6	26195988	26203988	26199084	8000	26199988	-4000	4000	-904
chr6	26195988	26203988	26199771	8000	26199988	-4000	4000	-217
chr6	31805619	31813619	31809876	8000	31809619	-4000	4000	257
chr6	35745079	35753079	35748636	8000	35749079	-4000	4000	-443
chr6	98835458	98843458	98836138	8000	98839458	-4000	4000	-3320
chr6	31107223	31115223	31111943	8000	31111223	-4000	4000	720
chr6	347355	355355	348111	8000	351355	-4000	4000	-3244
chr6	7247980	7255980	7248593	8000	7251980	-4000	4000	-3387
chr6	29349749	29357749	29355545	8000	29353749	-4000	4000	1796
chr6	28320693	28328693	28326697	8000	28324693	-4000	4000	2004
chr6	35291985	35299985	35292729	8000	35295985	-4000	4000	-3256
chr6	36107236	36115236	36108746	8000	36111236	-4000	4000	-2490
chr6	26246142	26254142	26251719	8000	26250142	-4000	4000	1577
chr6	132584592	132592592	132588888	8000	132588592	-4000	4000	296
chr6	27810302	27818302	27814720	8000	27814302	-4000	4000	418
chr6	29668372	29676372	29672587	8000	29672372	-4000	4000	215
chr6	157285025	157293025	157292724	8000	157289025	-4000	4000	3699
chr6	26246142	26254142	26250391	8000	26250142	-4000	4000	249
chr6	26269412	26277412	26273044	8000	26273412	-4000	4000	-368
chr6	27907185	27915185	27911653	8000	27911185	-4000	4000	468
chr6	42740498	42748498	42745915	8000	42744498	-4000	4000	1417
chr6	133891553	133899553	133891749	8000	133895553	-4000	4000	-3804
chr6	33412453	33420453	33418261	8000	33416453	-4000	4000	1808
chr6	26223473	26231473	26225303	8000	26227473	-4000	4000	-2170
chr6	18219860	18227860	18222076	8000	18223860	-4000	4000	-1784
chr6	27810302	27818302	27814571	8000	27814302	-4000	4000	269
chr6	33412453	33420453	33416680	8000	33416453	-4000	4000	227
chr6	110095819	110103819	110101607	8000	110099819	-4000	4000	1788
chr6	110095819	110103819	110103505	8000	110099819	-4000	4000	3686
chr6	112103931	112111931	112109469	8000	112107931	-4000	4000	1538
chr6	127284712	127292712	127287064	8000	127288712	-4000	4000	-1648
chr6	26027589	26035589	26031667	8000	26031589	-4000	4000	78
chr6	132535336	132543336	132538558	8000	132539336	-4000	4000	-778
chr6	134913393	134921393	134918456	8000	134917393	-4000	4000	1063
chr6	54941099	54949099	54941110	8000	54945099	-4000	4000	-3989
chr6	10625368	10633368	10626701	8000	10629368	-4000	4000	-2667
chr6	28320693	28328693	28326194	8000	28324693	-4000	4000	1501
chr6	37328970	37336970	37331053	8000	37332970	-4000	4000	-1917
chr6	44151519	44159519	44153674	8000	44155519	-4000	4000	-1845
chr6	57166305	57174305	57172679	8000	57170305	-4000	4000	2374
chr6	127284712	127292712	127287253	8000	127288712	-4000	4000	-1459
chr6	127284712	127292712	127287599	8000	127288712	-4000	4000	-1113
chr6	150839665	150847665	150839979	8000	150843665	-4000	4000	-3686
chr6	121445727	121453727	121447227	8000	121449727	-4000	4000	-2500
chr6	26201021	26209021	26204723	8000	26205021	-4000	4000	-298
chr6	27143562	27151562	27147488	8000	27147562	-4000	4000	-74
chr6	52260014	52268014	52264556	8000	52264014	-4000	4000	542
chr6	77456924	77464924	77462684	8000	77460924	-4000	4000	1760
chr6	132613022	132621022	132617898	8000	132617022	-4000	4000	876
chr6	26027589	26035589	26031824	8000	26031589	-4000	4000	235
chr6	30147943	30155943	30153516	8000	30151943	-4000	4000	1573
chr6	99393629	99401629	99400265	8000	99397629	-4000	4000	2636
chr6	26246142	26254142	26251998	8000	26250142	-4000	4000	1856
chr6	73360171	73368171	73363604	8000	73364171	-4000	4000	-567
chr6	116748197	116756197	116752456	8000	116752197	-4000	4000	259
chr6	136191574	136199574	136191716	8000	136195574	-4000	4000	-3858
chr6	11179298	11187298	11185498	8000	11183298	-4000	4000	2200
chr6	26103412	26111412	26104250	8000	26107412	-4000	4000	-3162
chr6	27862792	27870792	27865582	8000	27866792	-4000	4000	-1210
chr6	24645979	24653979	24650911	8000	24649979	-4000	4000	932
chr6	107148562	107156562	107153667	8000	107152562	-4000	4000	1105
chr6	149072990	149080990	149073973	8000	149076990	-4000	4000	-3017
chr6	26039227	26047227	26043444	8000	26043227	-4000	4000	217
chr6	26212200	26220200	26217357	8000	26216200	-4000	4000	1157
chr6	41732711	41740711	41736858	8000	41736711	-4000	4000	147
chr6	26201021	26209021	26204865	8000	26205021	-4000	4000	-156
chr6	27867845	27875845	27873470	8000	27871845	-4000	4000	1625
chr6	30066266	30074266	30069371	8000	30070266	-4000	4000	-895
chr6	31570324	31578324	31573834	8000	31574324	-4000	4000	-490
chr6	46216736	46224736	46222161	8000	46220736	-4000	4000	1425
chr6	132549721	132557721	132553145	8000	132553721	-4000	4000	-576
chr6	26269412	26277412	26272225	8000	26273412	-4000	4000	-1187
chr6	73237314	73245314	73242161	8000	73241314	-4000	4000	847
chr6	159774498	159782498	159778572	8000	159778498	-4000	4000	74
chr6	26027589	26035589	26031709	8000	26031589	-4000	4000	120
chr6	159794436	159802436	159797436	8000	159798436	-4000	4000	-1000
chr6	157206779	157214779	157207761	8000	157210779	-4000	4000	-3018
chr6	29482697	29490697	29486895	8000	29486697	-4000	4000	198
chr6	52186638	52194638	52189387	8000	52190638	-4000	4000	-1251
chr6	73589379	73597379	73594929	8000	73593379	-4000	4000	1550
chr6	26180655	26188655	26183834	8000	26184655	-4000	4000	-821
chr6	26195988	26203988	26198861	8000	26199988	-4000	4000	-1127
chr6	34769857	34777857	34770357	8000	34773857	-4000	4000	-3500
chr6	127284712	127292712	127290202	8000	127288712	-4000	4000	1490
chr6	28990785	28998785	28998762	8000	28994785	-4000	4000	3977
chr6	26027589	26035589	26033292	8000	26031589	-4000	4000	1703
chr6	28499296	28507296	28504426	8000	28503296	-4000	4000	1130
chr6	29827125	29835125	29829531	8000	29831125	-4000	4000	-1594
chr6	7877522	7885522	7883253	8000	7881522	-4000	4000	1731
chr6	12160999	12168999	12161465	8000	12164999	-4000	4000	-3534
chr6	14132918	14140918	14133691	8000	14136918	-4000	4000	-3227
chr6	26027589	26035589	26031739	8000	26031589	-4000	4000	150
chr6	27446743	27454743	27451514	8000	27450743	-4000	4000	771
chr6	28085563	28093563	28088809	8000	28089563	-4000	4000	-754
chr6	39900877	39908877	39906380	8000	39904877	-4000	4000	1503
chr6	41679978	41687978	41685031	8000	41683978	-4000	4000	1053
chr6	109488855	109496855	109493439	8000	109492855	-4000	4000	584
chr6	125757269	125765269	125759189	8000	125761269	-4000	4000	-2080
chr6	132739870	132747870	132744298	8000	132743870	-4000	4000	428
chr6	123212339	123220339	123218709	8000	123216339	-4000	4000	2370
chr6	41346889	41354889	41350699	8000	41350889	-4000	4000	-190
chr6	49723376	49731376	49728726	8000	49727376	-4000	4000	1350
chr6	125757269	125765269	125759192	8000	125761269	-4000	4000	-2077
chr6	7247980	7255980	7248772	8000	7251980	-4000	4000	-3208
chr6	25908754	25916754	25913211	8000	25912754	-4000	4000	457
chr6	34583288	34591288	34587455	8000	34587288	-4000	4000	167
chr6	36736775	36744775	36742354	8000	36740775	-4000	4000	1579
chr6	63715980	63723980	63721659	8000	63719980	-4000	4000	1679
chr6	31805619	31813619	31810241	8000	31809619	-4000	4000	622
chr6	151360115	151368115	151366827	8000	151364115	-4000	4000	2712
chr6	166360919	166368919	166366026	8000	166364919	-4000	4000	1107
chr6	18116440	18124440	18122069	8000	18120440	-4000	4000	1629
chr6	36964141	36972141	36970067	8000	36968141	-4000	4000	1926
chr6	42740498	42748498	42744985	8000	42744498	-4000	4000	487
chr6	87012679	87020679	87015849	8000	87016679	-4000	4000	-830
chr6	109440062	109448062	109443043	8000	109444062	-4000	4000	-1019
chr6	31713919	31721919	31719001	8000	31717919	-4000	4000	1082
chr6	155253723	155261723	155254274	8000	155257723	-4000	4000	-3449
chr6	26506425	26514425	26509035	8000	26510425	-4000	4000	-1390
chr6	83853515	83861515	83857257	8000	83857515	-4000	4000	-258
chr6	132567359	132575359	132571098	8000	132571359	-4000	4000	-261
chr6	32124707	32132707	32129450	8000	32128707	-4000	4000	743
chr6	119173205	119181205	119179868	8000	119177205	-4000	4000	2663
chr6	132292055	132300055	132297284	8000	132296055	-4000	4000	1229
chr6	31682962	31690962	31687137	8000	31686962	-4000	4000	175
chr6	26449415	26457415	26452060	8000	26453415	-4000	4000	-1355
chr6	27886315	27894315	27892868	8000	27890315	-4000	4000	2553
chr6	30896156	30904156	30896811	8000	30900156	-4000	4000	-3345
chr6	17127378	17135378	17130705	8000	17131378	-4000	4000	-673
chr6	20489714	20497714	20491612	8000	20493714	-4000	4000	-2102
chr6	26212200	26220200	26217034	8000	26216200	-4000	4000	834
chr6	26246142	26254142	26251879	8000	26250142	-4000	4000	1737
chr6	27143562	27151562	27147405	8000	27147562	-4000	4000	-157
chr6	27810302	27818302	27815306	8000	27814302	-4000	4000	1004
chr6	33158681	33166681	33163156	8000	33162681	-4000	4000	475
chr6	43303134	43311134	43307715	8000	43307134	-4000	4000	581
chr6	27867845	27875845	27871965	8000	27871845	-4000	4000	120
chr6	28256958	28264958	28259967	8000	28260958	-4000	4000	-991
chr6	31138439	31146439	31138675	8000	31142439	-4000	4000	-3764
chr6	43017298	43025298	43017850	8000	43021298	-4000	4000	-3448
chr6	159268108	159276108	159271495	8000	159272108	-4000	4000	-613
chr6	31160337	31168337	31165666	8000	31164337	-4000	4000	1329
chr6	30672389	30680389	30679389	8000	30676389	-4000	4000	3000
chr6	109976720	109984720	109979133	8000	109980720	-4000	4000	-1587
chr6	53263398	53271398	53269128	8000	53267398	-4000	4000	1730
chr6	27810302	27818302	27814467	8000	27814302	-4000	4000	165
chr6	30896156	30904156	30896848	8000	30900156	-4000	4000	-3308
chr6	32944613	32952613	32949632	8000	32948613	-4000	4000	1019
chr6	35424191	35432191	35424642	8000	35428191	-4000	4000	-3549
chr6	35114071	35122071	35120509	8000	35118071	-4000	4000	2438
chr6	37025069	37033069	37027467	8000	37029069	-4000	4000	-1602
chr6	37025069	37033069	37027468	8000	37029069	-4000	4000	-1601
chr6	159816704	159824704	159820537	8000	159820704	-4000	4000	-167
chr6	132292055	132300055	132297191	8000	132296055	-4000	4000	1136
chr6	73364555	73372555	73368818	8000	73368555	-4000	4000	263
chr6	166153656	166161656	166158354	8000	166157656	-4000	4000	698
chr6	4060983	4068983	4068384	8000	4064983	-4000	4000	3401
chr6	27954182	27962182	27957386	8000	27958182	-4000	4000	-796
chr6	31761590	31769590	31766034	8000	31765590	-4000	4000	444
chr6	49781660	49789660	49786116	8000	49785660	-4000	4000	456
chr6	117706727	117714727	117707055	8000	117710727	-4000	4000	-3672
chr6	136338281	136346281	136344239	8000	136342281	-4000	4000	1958
chr6	18124311	18132311	18132140	8000	18128311	-4000	4000	3829
chr6	2782952	2790952	2785096	8000	2786952	-4000	4000	-1856
chr6	24540104	24548104	24547153	8000	24544104	-4000	4000	3049
chr6	26246142	26254142	26250277	8000	26250142	-4000	4000	135
chr6	89638498	89646498	89644171	8000	89642498	-4000	4000	1673
chr6	29436977	29444977	29440172	8000	29440977	-4000	4000	-805
chr6	151360115	151368115	151366660	8000	151364115	-4000	4000	2545
chr6	152966519	152974519	152972301	8000	152970519	-4000	4000	1782
chr6	33405896	33413896	33406862	8000	33409896	-4000	4000	-3034
chr6	46700201	46708201	46704649	8000	46704201	-4000	4000	448
chr6	16144248	16152248	16145147	8000	16148248	-4000	4000	-3101
chr6	11134733	11142733	11135230	8000	11138733	-4000	4000	-3503
chr6	57051239	57059239	57053901	8000	57055239	-4000	4000	-1338
chr6	83521704	83529704	83524401	8000	83525704	-4000	4000	-1303
chr6	139236061	139244061	139240610	8000	139240061	-4000	4000	549
chr6	165275664	165283664	165280018	8000	165279664	-4000	4000	354
chr6	26027589	26035589	26031769	8000	26031589	-4000	4000	180
chr6	39310698	39318698	39310915	8000	39314698	-4000	4000	-3783
chr6	75080326	75088326	75084715	8000	75084326	-4000	4000	389
chr6	25697783	25705783	25701480	8000	25701783	-4000	4000	-303
chr6	49781660	49789660	49786461	8000	49785660	-4000	4000	801
chr6	73409515	73417515	73413684	8000	73413515	-4000	4000	169
chr6	83194935	83202935	83195752	8000	83198935	-4000	4000	-3183
chr6	18116440	18124440	18121468	8000	18120440	-4000	4000	1028
chr6	26027589	26035589	26031745	8000	26031589	-4000	4000	156
chr6	26103412	26111412	26104016	8000	26107412	-4000	4000	-3396
chr6	26246142	26254142	26251855	8000	26250142	-4000	4000	1713
chr6	30596413	30604413	30604033	8000	30600413	-4000	4000	3620
chr6	33717662	33725662	33723135	8000	33721662	-4000	4000	1473
chr6	37025069	37033069	37025811	8000	37029069	-4000	4000	-3258
chr6	47623263	47631263	47626538	8000	47627263	-4000	4000	-725
chr6	52997279	53005279	53001844	8000	53001279	-4000	4000	565
chr6	93236020	93244020	93242465	8000	93240020	-4000	4000	2445
chr6	96614626	96622626	96615760	8000	96618626	-4000	4000	-2866
chr6	112098790	112106790	112099347	8000	112102790	-4000	4000	-3443
chr6	129572132	129580132	129580081	8000	129576132	-4000	4000	3949
chr6	136338281	136346281	136346031	8000	136342281	-4000	4000	3750
chr6	161113385	161121385	161117384	8000	161117385	-4000	4000	-1
chr6	16291549	16299549	16295073	8000	16295549	-4000	4000	-476
chr6	26246142	26254142	26250290	8000	26250142	-4000	4000	148
chr6	28256958	28264958	28259678	8000	28260958	-4000	4000	-1280
chr6	87012679	87020679	87015976	8000	87016679	-4000	4000	-703
chr6	111551381	111559381	111559249	8000	111555381	-4000	4000	3868
chr6	132765370	132773370	132772157	8000	132769370	-4000	4000	2787
chr6	155253723	155261723	155254396	8000	155257723	-4000	4000	-3327
chr6	28165594	28173594	28166761	8000	28169594	-4000	4000	-2833
chr6	32037153	32045153	32040424	8000	32041153	-4000	4000	-729
chr6	47623263	47631263	47626640	8000	47627263	-4000	4000	-623
chr6	146433601	146441601	146435193	8000	146437601	-4000	4000	-2408
chr6	31761590	31769590	31767666	8000	31765590	-4000	4000	2076
chr6	26269412	26277412	26273332	8000	26273412	-4000	4000	-80
chr6	121445727	121453727	121448662	8000	121449727	-4000	4000	-1065
chr6	18219860	18227860	18222158	8000	18223860	-4000	4000	-1702
chr6	347355	355355	351019	8000	351355	-4000	4000	-336
chr6	24701065	24709065	24706259	8000	24705065	-4000	4000	1194
chr6	49781660	49789660	49786132	8000	49785660	-4000	4000	472
chr6	33717662	33725662	33725576	8000	33721662	-4000	4000	3914
chr6	6140084	6148084	6145761	8000	6144084	-4000	4000	1677
chr6	39900877	39908877	39901861	8000	39904877	-4000	4000	-3016
chr6	99914519	99922519	99921100	8000	99918519	-4000	4000	2581
chr6	32743198	32751198	32745274	8000	32747198	-4000	4000	-1924
chr6	34533802	34541802	34534665	8000	34537802	-4000	4000	-3137
chr6	44180401	44188401	44180796	8000	44184401	-4000	4000	-3605
chr6	481154	489154	486757	8000	485154	-4000	4000	1603
chr6	27129535	27137535	27133088	8000	27133535	-4000	4000	-447
chr6	36960837	36968837	36963206	8000	36964837	-4000	4000	-1631
chr6	41154506	41162506	41158725	8000	41158506	-4000	4000	219
chr6	132567359	132575359	132570437	8000	132571359	-4000	4000	-922
chr6	99914519	99922519	99921175	8000	99918519	-4000	4000	2656
chr6	26027589	26035589	26031841	8000	26031589	-4000	4000	252
chr6	31613021	31621021	31617008	8000	31617021	-4000	4000	-13
chr6	26039227	26047227	26043263	8000	26043227	-4000	4000	36
chr6	30985903	30993903	30987621	8000	30989903	-4000	4000	-2282
chr6	155272548	155280548	155275998	8000	155276548	-4000	4000	-550
chr6	27827174	27835174	27831178	8000	27831174	-4000	4000	4
chr6	27886315	27894315	27890710	8000	27890315	-4000	4000	395
chr6	139236061	139244061	139242564	8000	139240061	-4000	4000	2503
chr6	149945235	149953235	149945373	8000	149949235	-4000	4000	-3862
chr6	49781660	49789660	49787005	8000	49785660	-4000	4000	1345
chr6	80342270	80350270	80343698	8000	80346270	-4000	4000	-2572
chr6	52260014	52268014	52264446	8000	52264014	-4000	4000	432
chr6	16291549	16299549	16295084	8000	16295549	-4000	4000	-465
chr6	28085563	28093563	28089119	8000	28089563	-4000	4000	-444
chr6	29082208	29090208	29086856	8000	29086208	-4000	4000	648
chr6	35114071	35122071	35118445	8000	35118071	-4000	4000	374
chr6	109976720	109984720	109980185	8000	109980720	-4000	4000	-535
chr6	149072990	149080990	149073994	8000	149076990	-4000	4000	-2996
chr6	27907185	27915185	27911689	8000	27911185	-4000	4000	504
chr6	134913393	134921393	134918507	8000	134917393	-4000	4000	1114
chr6	26201021	26209021	26204972	8000	26205021	-4000	4000	-49
chr6	4990717	4998717	4996226	8000	4994717	-4000	4000	1509
chr6	88062838	88070838	88064162	8000	88066838	-4000	4000	-2676
chr6	31635028	31643028	31642891	8000	31639028	-4000	4000	3863
chr6	149500495	149508495	149505492	8000	149504495	-4000	4000	997
chr6	105079332	105087332	105082213	8000	105083332	-4000	4000	-1119
chr6	11179298	11187298	11185496	8000	11183298	-4000	4000	2198
chr6	161125967	161133967	161130968	8000	161129967	-4000	4000	1001
chr6	27867845	27875845	27872322	8000	27871845	-4000	4000	477
chr6	132535336	132543336	132538383	8000	132539336	-4000	4000	-953
chr6	26103412	26111412	26108020	8000	26107412	-4000	4000	608
chr6	149945235	149953235	149946579	8000	149949235	-4000	4000	-2656
chr6	4111693	4119693	4115763	8000	4115693	-4000	4000	70
chr6	8069360	8077360	8073410	8000	8073360	-4000	4000	50
chr6	13976310	13984310	13976995	8000	13980310	-4000	4000	-3315
chr6	13976310	13984310	13977471	8000	13980310	-4000	4000	-2839
chr6	26212200	26220200	26217357	8000	26216200	-4000	4000	1157
chr6	42740498	42748498	42745835	8000	42744498	-4000	4000	1337
chr6	136921660	136929660	136924119	8000	136925660	-4000	4000	-1541
chr6	61675961	61683961	61681014	8000	61679961	-4000	4000	1053
chr6	85491791	85499791	85492039	8000	85495791	-4000	4000	-3752
chr6	114051596	114059596	114057513	8000	114055596	-4000	4000	1917
chr6	33202831	33210831	33206713	8000	33206831	-4000	4000	-118
chr6	42740498	42748498	42745590	8000	42744498	-4000	4000	1092
chr6	26212200	26220200	26217357	8000	26216200	-4000	4000	1157
chr6	27820480	27828480	27824167	8000	27824480	-4000	4000	-313
chr6	26027589	26035589	26031817	8000	26031589	-4000	4000	228
chr6	88062838	88070838	88066350	8000	88066838	-4000	4000	-488
chr6	2883270	2891270	2890305	8000	2887270	-4000	4000	3035
chr6	53263398	53271398	53269212	8000	53267398	-4000	4000	1814
chr6	99538387	99546387	99545189	8000	99542387	-4000	4000	2802
chr6	11179298	11187298	11185339	8000	11183298	-4000	4000	2041
chr6	13286446	13294446	13287067	8000	13290446	-4000	4000	-3379
chr6	25723345	25731345	25726074	8000	25727345	-4000	4000	-1271
chr6	25723345	25731345	25726164	8000	25727345	-4000	4000	-1181
chr6	27135678	27143678	27139680	8000	27139678	-4000	4000	2
chr6	28165594	28173594	28167059	8000	28169594	-4000	4000	-2535
chr6	43017298	43025298	43017696	8000	43021298	-4000	4000	-3602
chr6	52746087	52754087	52750398	8000	52750087	-4000	4000	311
chr6	63715980	63723980	63721595	8000	63719980	-4000	4000	1615
chr6	122805720	122813720	122809340	8000	122809720	-4000	4000	-380
chr6	144090884	144098884	144095248	8000	144094884	-4000	4000	364
chr6	37025069	37033069	37027694	8000	37029069	-4000	4000	-1375
chr6	39100063	39108063	39105221	8000	39104063	-4000	4000	1158
chr6	27827174	27835174	27831323	8000	27831174	-4000	4000	149
chr6	43284258	43292258	43287434	8000	43288258	-4000	4000	-824
chr6	26016958	26024958	26017540	8000	26020958	-4000	4000	-3418
chr6	46700201	46708201	46701931	8000	46704201	-4000	4000	-2270
chr6	26195988	26203988	26198880	8000	26199988	-4000	4000	-1108
chr6	26411208	26419208	26413155	8000	26415208	-4000	4000	-2053
chr6	27135678	27143678	27139581	8000	27139678	-4000	4000	-97
chr6	27810302	27818302	27815435	8000	27814302	-4000	4000	1133
chr6	7607967	7615967	7608847	8000	7611967	-4000	4000	-3120
chr6	54386142	54394142	54389824	8000	54390142	-4000	4000	-318
chr6	27886315	27894315	27892792	8000	27890315	-4000	4000	2477
chr6	29436977	29444977	29440486	8000	29440977	-4000	4000	-491
chr6	99914519	99922519	99921186	8000	99918519	-4000	4000	2667
chr6	27867845	27875845	27873404	8000	27871845	-4000	4000	1559
chr6	42959865	42967865	42966448	8000	42963865	-4000	4000	2583
chr6	87081498	87089498	87088171	8000	87085498	-4000	4000	2673
chr6	112065686	112073686	112072808	8000	112069686	-4000	4000	3122
chr6	152720569	152728569	152722122	8000	152724569	-4000	4000	-2447
chr6	152720569	152728569	152722221	8000	152724569	-4000	4000	-2348
chr6	22567666	22575666	22569587	8000	22571666	-4000	4000	-2079
chr6	29082208	29090208	29087239	8000	29086208	-4000	4000	1031
chr6	35291985	35299985	35294483	8000	35295985	-4000	4000	-1502
chr6	31713919	31721919	31717719	8000	31717919	-4000	4000	-200
chr6	43636941	43644941	43640245	8000	43640941	-4000	4000	-696
chr6	116928161	116936161	116928796	8000	116932161	-4000	4000	-3365
chr6	42740498	42748498	42745200	8000	42744498	-4000	4000	702
chr6	134165248	134173248	134170063	8000	134169248	-4000	4000	815
chr6	26212200	26220200	26217357	8000	26216200	-4000	4000	1157
chr6	26236793	26244793	26240503	8000	26240793	-4000	4000	-290
chr6	31570324	31578324	31574010	8000	31574324	-4000	4000	-314
chr6	31761590	31769590	31761616	8000	31765590	-4000	4000	-3974
chr6	27820480	27828480	27824252	8000	27824480	-4000	4000	-228
chr6	77456924	77464924	77462516	8000	77460924	-4000	4000	1592
chr6	151617193	151625193	151618366	8000	151621193	-4000	4000	-2827
chr6	347355	355355	349345	8000	351355	-4000	4000	-2010
chr6	73364555	73372555	73369757	8000	73368555	-4000	4000	1202
chr6	24540104	24548104	24547249	8000	24544104	-4000	4000	3145
chr6	29349749	29357749	29355545	8000	29353749	-4000	4000	1796
chr6	166153656	166161656	166158365	8000	166157656	-4000	4000	709
chr6	27446743	27454743	27451541	8000	27450743	-4000	4000	798
chr6	57182992	57190992	57184020	8000	57186992	-4000	4000	-2972
chr6	26016958	26024958	26020500	8000	26020958	-4000	4000	-458
chr6	26039227	26047227	26043295	8000	26043227	-4000	4000	68
chr6	26039227	26047227	26043376	8000	26043227	-4000	4000	149
chr6	26103412	26111412	26108090	8000	26107412	-4000	4000	678
chr6	27867845	27875845	27872278	8000	27871845	-4000	4000	433
chr6	31107223	31115223	31112022	8000	31111223	-4000	4000	799
chr6	42959865	42967865	42966105	8000	42963865	-4000	4000	2240
chr6	11708054	11716054	11714336	8000	11712054	-4000	4000	2282
chr6	46216736	46224736	46220824	8000	46220736	-4000	4000	88
chr6	52260014	52268014	52264504	8000	52264014	-4000	4000	490
chr6	52997279	53005279	53003921	8000	53001279	-4000	4000	2642
chr6	70212040	70220040	70217041	8000	70216040	-4000	4000	1001
chr6	55278617	55286617	55282432	8000	55282617	-4000	4000	-185
chr6	121445727	121453727	121447206	8000	121449727	-4000	4000	-2521
chr6	130137449	130145449	130144320	8000	130141449	-4000	4000	2871
chr6	83521704	83529704	83524426	8000	83525704	-4000	4000	-1278
chr6	31761590	31769590	31762466	8000	31765590	-4000	4000	-3124
chr6	109488855	109496855	109493439	8000	109492855	-4000	4000	584
chr6	116628985	116636985	116629683	8000	116632985	-4000	4000	-3302
chr6	31948087	31956087	31948433	8000	31952087	-4000	4000	-3654
chr6	33317386	33325386	33320489	8000	33321386	-4000	4000	-897
chr6	133528128	133536128	133528745	8000	133532128	-4000	4000	-3383
chr6	26246142	26254142	26250438	8000	26250142	-4000	4000	296
chr6	132613022	132621022	132617693	8000	132617022	-4000	4000	671
chr6	42959865	42967865	42965114	8000	42963865	-4000	4000	1249
chr6	3015755	3023755	3019528	8000	3019755	-4000	4000	-227
chr6	130439067	130447067	130440954	8000	130443067	-4000	4000	-2113
chr6	35291985	35299985	35293912	8000	35295985	-4000	4000	-2073
chr6	47718021	47726021	47718426	8000	47722021	-4000	4000	-3595
chr6	54386142	54394142	54389943	8000	54390142	-4000	4000	-199
chr6	96551276	96559276	96551498	8000	96555276	-4000	4000	-3778
chr6	149945235	149953235	149946567	8000	149949235	-4000	4000	-2668
chr6	1310758	1318758	1313088	8000	1314758	-4000	4000	-1670
chr6	7877522	7885522	7883239	8000	7881522	-4000	4000	1717
chr6	12293194	12301194	12296647	8000	12297194	-4000	4000	-547
chr6	42740498	42748498	42745786	8000	42744498	-4000	4000	1288
chr6	42921838	42929838	42929618	8000	42925838	-4000	4000	3780
chr6	42959865	42967865	42963643	8000	42963865	-4000	4000	-222
chr6	32513353	32521353	32517425	8000	32517353	-4000	4000	72
chr6	7582714	7590714	7585865	8000	7586714	-4000	4000	-849
chr6	36960837	36968837	36963192	8000	36964837	-4000	4000	-1645
chr6	27867845	27875845	27872240	8000	27871845	-4000	4000	395
chr6	97136754	97144754	97139454	8000	97140754	-4000	4000	-1300
chr6	27252624	27260624	27252942	8000	27256624	-4000	4000	-3682
chr6	100504194	100512194	100509308	8000	100508194	-4000	4000	1114
chr6	159816704	159824704	159818634	8000	159820704	-4000	4000	-2070
chr6	170568870	170576870	170571504	8000	170572870	-4000	4000	-1366
chr6	28256958	28264958	28260369	8000	28260958	-4000	4000	-589
chr6	34014643	34022643	34022180	8000	34018643	-4000	4000	3537
chr6	109362514	109370514	109366940	8000	109366514	-4000	4000	426
chr6	132639312	132647312	132644988	8000	132643312	-4000	4000	1676
chr6	35828966	35836966	35835188	8000	35832966	-4000	4000	2222
chr6	26374320	26382320	26376739	8000	26378320	-4000	4000	-1581
chr6	149407613	149415613	149409870	8000	149411613	-4000	4000	-1743
chr6	27803479	27811479	27807515	8000	27807479	-4000	4000	36
chr6	6650983	6658983	6654725	8000	6654983	-4000	4000	-258
chr6	347355	355355	348862	8000	351355	-4000	4000	-2493
chr6	26374320	26382320	26377193	8000	26378320	-4000	4000	-1127
chr6	29482697	29490697	29486967	8000	29486697	-4000	4000	270
chr6	29482697	29490697	29487555	8000	29486697	-4000	4000	858
chr6	31570324	31578324	31573325	8000	31574324	-4000	4000	-999
chr6	152755765	152763765	152756193	8000	152759765	-4000	4000	-3572
chr6	26212200	26220200	26216488	8000	26216200	-4000	4000	288
chr6	28085563	28093563	28089071	8000	28089563	-4000	4000	-492
chr6	28256958	28264958	28259356	8000	28260958	-4000	4000	-1602
chr6	31138439	31146439	31143081	8000	31142439	-4000	4000	642
chr6	31654298	31662298	31659841	8000	31658298	-4000	4000	1543
chr6	31805619	31813619	31811637	8000	31809619	-4000	4000	2018
chr6	33767202	33775202	33772518	8000	33771202	-4000	4000	1316
chr6	35828966	35836966	35835057	8000	35832966	-4000	4000	2091
chr6	75915537	75923537	75921679	8000	75919537	-4000	4000	2142
chr6	80342270	80350270	80343828	8000	80346270	-4000	4000	-2442
chr6	116788085	116796085	116792886	8000	116792085	-4000	4000	801
chr6	143418832	143426832	143425895	8000	143422832	-4000	4000	3063
chr6	52746087	52754087	52751636	8000	52750087	-4000	4000	1549
chr6	105153900	105161900	105161495	8000	105157900	-4000	4000	3595
chr6	105153900	105161900	105161873	8000	105157900	-4000	4000	3973
chr6	33294401	33302401	33301634	8000	33298401	-4000	4000	3233
chr6	46700201	46708201	46702134	8000	46704201	-4000	4000	-2067
chr6	84086881	84094881	84089220	8000	84090881	-4000	4000	-1661
chr6	116748197	116756197	116752496	8000	116752197	-4000	4000	299
chr6	142747469	142755469	142753122	8000	142751469	-4000	4000	1653
chr6	157206779	157214779	157206821	8000	157210779	-4000	4000	-3958
chr6	12160999	12168999	12164721	8000	12164999	-4000	4000	-278
chr6	33158681	33166681	33162756	8000	33162681	-4000	4000	75
chr6	84086881	84094881	84089361	8000	84090881	-4000	4000	-1520
chr6	114051596	114059596	114058011	8000	114055596	-4000	4000	2415
chr6	50769033	50777033	50772830	8000	50773033	-4000	4000	-203
chr6	105153900	105161900	105158377	8000	105157900	-4000	4000	477
chr6	13976310	13984310	13977692	8000	13980310	-4000	4000	-2618
chr6	28298549	28306549	28301349	8000	28302549	-4000	4000	-1200
chr6	130439067	130447067	130441218	8000	130443067	-4000	4000	-1849
chr6	37328970	37336970	37331248	8000	37332970	-4000	4000	-1722
chr6	27810302	27818302	27815152	8000	27814302	-4000	4000	850
chr6	89638498	89646498	89644180	8000	89642498	-4000	4000	1682
chr6	109976720	109984720	109980176	8000	109980720	-4000	4000	-544
chr6	29171811	29179811	29173844	8000	29175811	-4000	4000	-1967
chr6	63715980	63723980	63721651	8000	63719980	-4000	4000	1671
chr6	12160999	12168999	12163832	8000	12164999	-4000	4000	-1167
chr6	20489714	20497714	20490423	8000	20493714	-4000	4000	-3291
chr6	26180655	26188655	26183833	8000	26184655	-4000	4000	-822
chr6	26201021	26209021	26204677	8000	26205021	-4000	4000	-344
chr6	28237697	28245697	28245218	8000	28241697	-4000	4000	3521
chr6	31761590	31769590	31761942	8000	31765590	-4000	4000	-3648
chr6	35317771	35325771	35319893	8000	35321771	-4000	4000	-1878
chr6	36107236	36115236	36108451	8000	36111236	-4000	4000	-2785
chr6	39100063	39108063	39105163	8000	39104063	-4000	4000	1100
chr6	46993708	47001708	47000271	8000	46997708	-4000	4000	2563
chr6	52892639	52900639	52897846	8000	52896639	-4000	4000	1207
chr6	53122961	53130961	53128915	8000	53126961	-4000	4000	1954
chr6	89081160	89089160	89084178	8000	89085160	-4000	4000	-982
chr6	106568017	106576017	106571884	8000	106572017	-4000	4000	-133
chr6	106568017	106576017	106572024	8000	106572017	-4000	4000	7
chr6	110239940	110247940	110245971	8000	110243940	-4000	4000	2031
chr6	114051596	114059596	114057185	8000	114055596	-4000	4000	1589
chr6	114051596	114059596	114057511	8000	114055596	-4000	4000	1915
chr6	122805720	122813720	122809557	8000	122809720	-4000	4000	-163
chr6	123212339	123220339	123218717	8000	123216339	-4000	4000	2378
chr6	131580332	131588332	131587666	8000	131584332	-4000	4000	3334
chr6	149945235	149953235	149946482	8000	149949235	-4000	4000	-2753
chr6	166360919	166368919	166366857	8000	166364919	-4000	4000	1938
chr6	167312014	167320014	167315673	8000	167316014	-4000	4000	-341
chr6	27143562	27151562	27146681	8000	27147562	-4000	4000	-881
chr6	83167350	83175350	83167936	8000	83171350	-4000	4000	-3414
chr6	131279535	131287535	131281631	8000	131283535	-4000	4000	-1904
chr6	39310698	39318698	39315300	8000	39314698	-4000	4000	602
chr6	13286446	13294446	13287071	8000	13290446	-4000	4000	-3375
chr6	2883270	2891270	2890556	8000	2887270	-4000	4000	3286
chr6	3264962	3272962	3269459	8000	3268962	-4000	4000	497
chr6	4990717	4998717	4996064	8000	4994717	-4000	4000	1347
chr6	13353830	13361830	13360730	8000	13357830	-4000	4000	2900
chr6	27143562	27151562	27146802	8000	27147562	-4000	4000	-760
chr6	28165594	28173594	28166765	8000	28169594	-4000	4000	-2829
chr6	28427930	28435930	28434813	8000	28431930	-4000	4000	2883
chr6	28566535	28574535	28571856	8000	28570535	-4000	4000	1321
chr6	29482697	29490697	29486958	8000	29486697	-4000	4000	261
chr6	31264749	31272749	31269973	8000	31268749	-4000	4000	1224
chr6	31654298	31662298	31660015	8000	31658298	-4000	4000	1717
chr6	35424191	35432191	35424786	8000	35428191	-4000	4000	-3405
chr6	36107236	36115236	36109604	8000	36111236	-4000	4000	-1632
chr6	79910814	79918814	79916502	8000	79914814	-4000	4000	1688
chr6	100504194	100512194	100509415	8000	100508194	-4000	4000	1221
chr6	107061182	107069182	107066271	8000	107065182	-4000	4000	1089
chr6	149407613	149415613	149411330	8000	149411613	-4000	4000	-283
chr6	157206779	157214779	157207581	8000	157210779	-4000	4000	-3198
chr6	27803479	27811479	27807867	8000	27807479	-4000	4000	388
chr6	87081498	87089498	87086313	8000	87085498	-4000	4000	815
chr6	52787371	52795371	52794256	8000	52791371	-4000	4000	2885
chr6	42959865	42967865	42966852	8000	42963865	-4000	4000	2987
chr6	49601175	49609175	49605747	8000	49605175	-4000	4000	572
chr6	12293194	12301194	12294327	8000	12297194	-4000	4000	-2867
chr6	96211612	96219612	96212654	8000	96215612	-4000	4000	-2958
chr6	118809442	118817442	118815006	8000	118813442	-4000	4000	1564
chr6	26411208	26419208	26412520	8000	26415208	-4000	4000	-2688
chr6	41346889	41354889	41350758	8000	41350889	-4000	4000	-131
chr6	107148562	107156562	107154735	8000	107152562	-4000	4000	2173
chr6	43502556	43510556	43503393	8000	43506556	-4000	4000	-3163
chr6	43502556	43510556	43503753	8000	43506556	-4000	4000	-2803
chr6	25723345	25731345	25726359	8000	25727345	-4000	4000	-986
chr6	24782099	24790099	24784164	8000	24786099	-4000	4000	-1935
chr6	26184710	26192710	26188959	8000	26188710	-4000	4000	249
chr6	26630383	26638383	26637389	8000	26634383	-4000	4000	3006
chr6	29482697	29490697	29487201	8000	29486697	-4000	4000	504
chr6	31349872	31357872	31356694	8000	31353872	-4000	4000	2822
chr6	31761590	31769590	31767718	8000	31765590	-4000	4000	2128
chr6	33000182	33008182	33007130	8000	33004182	-4000	4000	2948
chr6	42921838	42929838	42923260	8000	42925838	-4000	4000	-2578
chr6	52827655	52835655	52831874	8000	52831655	-4000	4000	219
chr6	55749653	55757653	55755500	8000	55753653	-4000	4000	1847
chr6	57166305	57174305	57168422	8000	57170305	-4000	4000	-1883
chr6	122780074	122788074	122780350	8000	122784074	-4000	4000	-3724
chr6	158105519	158113519	158111503	8000	158109519	-4000	4000	1984
chr6	26212200	26220200	26217357	8000	26216200	-4000	4000	1157
chr6	42921838	42929838	42925505	8000	42925838	-4000	4000	-333
chr6	6650983	6658983	6654547	8000	6654983	-4000	4000	-436
chr6	17289871	17297871	17291779	8000	17293871	-4000	4000	-2092
chr6	26039227	26047227	26043342	8000	26043227	-4000	4000	115
chr6	28256958	28264958	28259516	8000	28260958	-4000	4000	-1442
chr6	31859192	31867192	31865328	8000	31863192	-4000	4000	2136
chr6	37025069	37033069	37027439	8000	37029069	-4000	4000	-1630
chr6	42740498	42748498	42745125	8000	42744498	-4000	4000	627
chr6	49426360	49434360	49431796	8000	49430360	-4000	4000	1436
chr6	110095819	110103819	110103474	8000	110099819	-4000	4000	3655
chr6	26027589	26035589	26031841	8000	26031589	-4000	4000	252
chr6	26195988	26203988	26198880	8000	26199988	-4000	4000	-1108
chr6	27862792	27870792	27865787	8000	27866792	-4000	4000	-1005
chr6	28427930	28435930	28435469	8000	28431930	-4000	4000	3539
chr6	32190843	32198843	32192832	8000	32194843	-4000	4000	-2011
chr6	33000182	33008182	33007148	8000	33004182	-4000	4000	2966
chr6	34531229	34539229	34532468	8000	34535229	-4000	4000	-2761
chr6	37171428	37179428	37175028	8000	37175428	-4000	4000	-400
chr6	39310698	39318698	39316360	8000	39314698	-4000	4000	1662
chr6	79480991	79488991	79486761	8000	79484991	-4000	4000	1770
chr6	84120241	84128241	84126432	8000	84124241	-4000	4000	2191
chr6	106664417	106672417	106666103	8000	106668417	-4000	4000	-2314
chr6	107657306	107665306	107658910	8000	107661306	-4000	4000	-2396
chr6	132292055	132300055	132297100	8000	132296055	-4000	4000	1045
chr6	132765370	132773370	132770315	8000	132769370	-4000	4000	945
chr6	146433601	146441601	146434593	8000	146437601	-4000	4000	-3008
chr6	158507828	158515828	158510269	8000	158511828	-4000	4000	-1559
chr6	159030468	159038468	159035736	8000	159034468	-4000	4000	1268
chr6	161125967	161133967	161131062	8000	161129967	-4000	4000	1095
chr6	157206779	157214779	157207532	8000	157210779	-4000	4000	-3247
chr6	12160999	12168999	12163865	8000	12164999	-4000	4000	-1134
chr6	25723345	25731345	25727222	8000	25727345	-4000	4000	-123
chr6	27862792	27870792	27865358	8000	27866792	-4000	4000	-1434
chr6	27867845	27875845	27873203	8000	27871845	-4000	4000	1358
chr6	29082208	29090208	29087213	8000	29086208	-4000	4000	1005
chr6	29482697	29490697	29487407	8000	29486697	-4000	4000	710
chr6	31264749	31272749	31269526	8000	31268749	-4000	4000	777
chr6	35291985	35299985	35293766	8000	35295985	-4000	4000	-2219
chr6	43502556	43510556	43503631	8000	43506556	-4000	4000	-2925
chr6	7247980	7255980	7248538	8000	7251980	-4000	4000	-3442
chr6	32809767	32817767	32813090	8000	32813767	-4000	4000	-677
chr6	36960837	36968837	36963356	8000	36964837	-4000	4000	-1481
chr6	167312014	167320014	167315455	8000	167316014	-4000	4000	-559
chr6	26269412	26277412	26271160	8000	26273412	-4000	4000	-2252
chr6	35424191	35432191	35426067	8000	35428191	-4000	4000	-2124
chr6	151360115	151368115	151366833	8000	151364115	-4000	4000	2718
chr6	89638498	89646498	89644101	8000	89642498	-4000	4000	1603
chr6	33568547	33576547	33573690	8000	33572547	-4000	4000	1143
chr6	13976310	13984310	13977794	8000	13980310	-4000	4000	-2516
chr6	28256958	28264958	28259401	8000	28260958	-4000	4000	-1557
chr6	83521704	83529704	83523732	8000	83525704	-4000	4000	-1972
chr6	125976244	125984244	125977865	8000	125980244	-4000	4000	-2379
chr6	158631429	158639429	158631893	8000	158635429	-4000	4000	-3536
chr6	26269412	26277412	26271347	8000	26273412	-4000	4000	-2065
chr6	32037153	32045153	32043798	8000	32041153	-4000	4000	2645
chr6	50038099	50046099	50043635	8000	50042099	-4000	4000	1536
chr6	27129535	27137535	27132415	8000	27133535	-4000	4000	-1120
chr6	26212200	26220200	26217077	8000	26216200	-4000	4000	877
chr6	27803479	27811479	27807811	8000	27807479	-4000	4000	332
chr6	27820480	27828480	27824421	8000	27824480	-4000	4000	-59
chr6	13976310	13984310	13977267	8000	13980310	-4000	4000	-3043
chr6	26246142	26254142	26246846	8000	26250142	-4000	4000	-3296
chr6	28566535	28574535	28573026	8000	28570535	-4000	4000	2491
chr6	63715980	63723980	63721164	8000	63719980	-4000	4000	1184
chr6	63715980	63723980	63721166	8000	63719980	-4000	4000	1186
chr6	27954182	27962182	27957502	8000	27958182	-4000	4000	-680
chr6	27143562	27151562	27147262	8000	27147562	-4000	4000	-300
chr6	3015755	3023755	3016945	8000	3019755	-4000	4000	-2810
chr6	33412453	33420453	33418027	8000	33416453	-4000	4000	1574
chr6	131580332	131588332	131582641	8000	131584332	-4000	4000	-1691
chr6	26195988	26203988	26197017	8000	26199988	-4000	4000	-2971
chr6	26542933	26550933	26546117	8000	26546933	-4000	4000	-816
chr6	26212200	26220200	26217357	8000	26216200	-4000	4000	1157
chr6	111551381	111559381	111559272	8000	111555381	-4000	4000	3891
chr6	116928161	116936161	116928913	8000	116932161	-4000	4000	-3248
chr6	52827655	52835655	52831961	8000	52831655	-4000	4000	306
chr6	28566535	28574535	28573644	8000	28570535	-4000	4000	3109
chr6	88605897	88613897	88612576	8000	88609897	-4000	4000	2679
chr6	61675961	61683961	61680182	8000	61679961	-4000	4000	221
chr6	159030468	159038468	159036323	8000	159034468	-4000	4000	1855
chr6	44180401	44188401	44182999	8000	44184401	-4000	4000	-1402
chr6	2782952	2790952	2785155	8000	2786952	-4000	4000	-1797
chr6	26027589	26035589	26033212	8000	26031589	-4000	4000	1623
chr6	129512566	129520566	129514501	8000	129516566	-4000	4000	-2065
chr6	27143562	27151562	27147138	8000	27147562	-4000	4000	-424
chr6	31826254	31834254	31827955	8000	31830254	-4000	4000	-2299
chr6	26223473	26231473	26225569	8000	26227473	-4000	4000	-1904
chr6	27143562	27151562	27147341	8000	27147562	-4000	4000	-221
chr6	32124707	32132707	32127118	8000	32128707	-4000	4000	-1589
chr6	117269565	117277565	117272464	8000	117273565	-4000	4000	-1101
chr6	29349749	29357749	29355668	8000	29353749	-4000	4000	1919
chr6	157941077	157949077	157944285	8000	157945077	-4000	4000	-792
chr6	31264749	31272749	31271669	8000	31268749	-4000	4000	2920
chr6	31349872	31357872	31356672	8000	31353872	-4000	4000	2800
chr6	33317386	33325386	33321348	8000	33321386	-4000	4000	-38
chr6	26506425	26514425	26508980	8000	26510425	-4000	4000	-1445
chr6	33000182	33008182	33007233	8000	33004182	-4000	4000	3051
chr6	52186638	52194638	52189166	8000	52190638	-4000	4000	-1472
chr6	89629834	89637834	89630660	8000	89633834	-4000	4000	-3174
chr6	33310406	33318406	33313353	8000	33314406	-4000	4000	-1053
chr6	39310698	39318698	39314714	8000	39314698	-4000	4000	16
chr6	121445727	121453727	121447673	8000	121449727	-4000	4000	-2054
chr6	347355	355355	350772	8000	351355	-4000	4000	-583
chr6	34280887	34288887	34288807	8000	34284887	-4000	4000	3920
chr6	87507634	87515634	87508452	8000	87511634	-4000	4000	-3182
chr6	123212339	123220339	123218444	8000	123216339	-4000	4000	2105
chr6	27129535	27137535	27133203	8000	27133535	-4000	4000	-332
chr6	30910106	30918106	30917214	8000	30914106	-4000	4000	3108
chr6	32037153	32045153	32039429	8000	32041153	-4000	4000	-1724
chr6	33317386	33325386	33321678	8000	33321386	-4000	4000	292
chr6	116628985	116636985	116630522	8000	116632985	-4000	4000	-2463
chr6	32180733	32188733	32186371	8000	32184733	-4000	4000	1638
chr6	26195988	26203988	26199090	8000	26199988	-4000	4000	-898
chr6	116628985	116636985	116629620	8000	116632985	-4000	4000	-3365
chr6	13976310	13984310	13977345	8000	13980310	-4000	4000	-2965
chr6	27886315	27894315	27893026	8000	27890315	-4000	4000	2711
chr6	28237697	28245697	28245152	8000	28241697	-4000	4000	3455
chr6	44374957	44382957	44377101	8000	44378957	-4000	4000	-1856
chr6	139236061	139244061	139243057	8000	139240061	-4000	4000	2996
chr6	347355	355355	348208	8000	351355	-4000	4000	-3147
chr6	16144248	16152248	16145084	8000	16148248	-4000	4000	-3164
chr6	26039227	26047227	26043367	8000	26043227	-4000	4000	140
chr6	28256958	28264958	28259592	8000	28260958	-4000	4000	-1366
chr6	28298549	28306549	28301225	8000	28302549	-4000	4000	-1324
chr6	96551276	96559276	96553493	8000	96555276	-4000	4000	-1783
chr6	26506425	26514425	26508925	8000	26510425	-4000	4000	-1500
chr6	27399908	27407908	27401327	8000	27403908	-4000	4000	-2581
chr6	25723345	25731345	25726294	8000	25727345	-4000	4000	-1051
chr6	28298549	28306549	28300988	8000	28302549	-4000	4000	-1561
chr6	55278617	55286617	55282311	8000	55282617	-4000	4000	-306
chr6	29941884	29949884	29943100	8000	29945884	-4000	4000	-2784
chr6	43017298	43025298	43019126	8000	43021298	-4000	4000	-2172
chr6	127284712	127292712	127290006	8000	127288712	-4000	4000	1294
chr6	142747469	142755469	142753873	8000	142751469	-4000	4000	2404
chr6	36683337	36691337	36685864	8000	36687337	-4000	4000	-1473
chr6	99538387	99546387	99543261	8000	99542387	-4000	4000	874
chr6	26027589	26035589	26031908	8000	26031589	-4000	4000	319
chr6	132567359	132575359	132571317	8000	132571359	-4000	4000	-42
chr6	57182992	57190992	57190496	8000	57186992	-4000	4000	3504
chr6	27129535	27137535	27132573	8000	27133535	-4000	4000	-962
chr6	32031418	32039418	32039174	8000	32035418	-4000	4000	3756
chr6	26103412	26111412	26107621	8000	26107412	-4000	4000	209
chr6	26269412	26277412	26271254	8000	26273412	-4000	4000	-2158
chr6	36960837	36968837	36963852	8000	36964837	-4000	4000	-985
chr6	43017298	43025298	43018892	8000	43021298	-4000	4000	-2406
chr6	72399145	72407145	72400812	8000	72403145	-4000	4000	-2333
chr6	144090884	144098884	144095588	8000	144094884	-4000	4000	704
chr6	136553046	136561046	136557812	8000	136557046	-4000	4000	766
chr6	7877522	7885522	7882986	8000	7881522	-4000	4000	1464
chr6	26230212	26238212	26234743	8000	26234212	-4000	4000	531
chr6	33294401	33302401	33301651	8000	33298401	-4000	4000	3250
chr6	30985903	30993903	30986841	8000	30989903	-4000	4000	-3062
chr6	27803479	27811479	27807897	8000	27807479	-4000	4000	418
chr6	169736109	169744109	169740225	8000	169740109	-4000	4000	116
chr6	26212200	26220200	26216304	8000	26216200	-4000	4000	104
chr6	30066266	30074266	30069309	8000	30070266	-4000	4000	-957
chr6	33790673	33798673	33794773	8000	33794673	-4000	4000	100
chr6	105079332	105087332	105082061	8000	105083332	-4000	4000	-1271
chr6	27446743	27454743	27452987	8000	27450743	-4000	4000	2244
chr6	42177338	42185338	42178809	8000	42181338	-4000	4000	-2529
chr6	73360171	73368171	73363253	8000	73364171	-4000	4000	-918
chr6	27803479	27811479	27808591	8000	27807479	-4000	4000	1112
chr6	29827125	29835125	29829446	8000	29831125	-4000	4000	-1679
chr6	132584592	132592592	132588896	8000	132588592	-4000	4000	304
chr6	29551629	29559629	29555985	8000	29555629	-4000	4000	356
chr6	52997279	53005279	53004754	8000	53001279	-4000	4000	3475
chr6	29171811	29179811	29174343	8000	29175811	-4000	4000	-1468
chr6	27954182	27962182	27957795	8000	27958182	-4000	4000	-387
chr6	36736775	36744775	36742299	8000	36740775	-4000	4000	1524
chr6	27399908	27407908	27400620	8000	27403908	-4000	4000	-3288
chr6	26212200	26220200	26217167	8000	26216200	-4000	4000	967
chr6	31264749	31272749	31271117	8000	31268749	-4000	4000	2368
chr6	4111693	4119693	4115753	8000	4115693	-4000	4000	60
chr6	12160999	12168999	12161574	8000	12164999	-4000	4000	-3425
chr6	25723345	25731345	25726116	8000	25727345	-4000	4000	-1229
chr6	26016958	26024958	26022039	8000	26020958	-4000	4000	1081
chr6	26022896	26030896	26027030	8000	26026896	-4000	4000	134
chr6	26039227	26047227	26045417	8000	26043227	-4000	4000	2190
chr6	26195988	26203988	26196916	8000	26199988	-4000	4000	-3072
chr6	26201021	26209021	26204842	8000	26205021	-4000	4000	-179
chr6	26246142	26254142	26250287	8000	26250142	-4000	4000	145
chr6	26246142	26254142	26251879	8000	26250142	-4000	4000	1737
chr6	27143562	27151562	27147225	8000	27147562	-4000	4000	-337
chr6	27803479	27811479	27810226	8000	27807479	-4000	4000	2747
chr6	27810302	27818302	27814343	8000	27814302	-4000	4000	41
chr6	27820480	27828480	27824468	8000	27824480	-4000	4000	-12
chr6	27827174	27835174	27831217	8000	27831174	-4000	4000	43
chr6	27886315	27894315	27893616	8000	27890315	-4000	4000	3301
chr6	28085563	28093563	28092740	8000	28089563	-4000	4000	3177
chr6	29171811	29179811	29173994	8000	29175811	-4000	4000	-1817
chr6	29482697	29490697	29487220	8000	29486697	-4000	4000	523
chr6	33717662	33725662	33722905	8000	33721662	-4000	4000	1243
chr6	36960837	36968837	36961448	8000	36964837	-4000	4000	-3389
chr6	36960837	36968837	36961945	8000	36964837	-4000	4000	-2892
chr6	36960837	36968837	36962992	8000	36964837	-4000	4000	-1845
chr6	37025069	37033069	37028017	8000	37029069	-4000	4000	-1052
chr6	42202807	42210807	42208075	8000	42206807	-4000	4000	1268
chr6	42864558	42872558	42865000	8000	42868558	-4000	4000	-3558
chr6	44230142	44238142	44232914	8000	44234142	-4000	4000	-1228
chr6	57182992	57190992	57183985	8000	57186992	-4000	4000	-3007
chr6	87012679	87020679	87016145	8000	87016679	-4000	4000	-534
chr6	106568017	106576017	106571836	8000	106572017	-4000	4000	-181
chr6	112065686	112073686	112068342	8000	112069686	-4000	4000	-1344
chr6	118955763	118963763	118960074	8000	118959763	-4000	4000	311
chr6	122805720	122813720	122809345	8000	122809720	-4000	4000	-375
chr6	131580332	131588332	131587608	8000	131584332	-4000	4000	3276
chr6	132639312	132647312	132645083	8000	132643312	-4000	4000	1771
chr6	136338281	136346281	136345913	8000	136342281	-4000	4000	3632
chr6	137488199	137496199	137493701	8000	137492199	-4000	4000	1502
chr6	155253723	155261723	155256786	8000	155257723	-4000	4000	-937
chr6	158095176	158103176	158096148	8000	158099176	-4000	4000	-3028
chr6	158760876	158768876	158763310	8000	158764876	-4000	4000	-1566
chr6	159030468	159038468	159035928	8000	159034468	-4000	4000	1460
chr6	159030468	159038468	159036768	8000	159034468	-4000	4000	2300
chr6	159816704	159824704	159819002	8000	159820704	-4000	4000	-1702
chr6	159816704	159824704	159819269	8000	159820704	-4000	4000	-1435
chr6	160448577	160456577	160453652	8000	160452577	-4000	4000	1075
chr6	132639312	132647312	132645048	8000	132643312	-4000	4000	1736
chr6	18116440	18124440	18122023	8000	18120440	-4000	4000	1583
chr6	27907185	27915185	27911610	8000	27911185	-4000	4000	425
chr6	39900877	39908877	39901349	8000	39904877	-4000	4000	-3528
chr6	26236793	26244793	26240571	8000	26240793	-4000	4000	-222
chr6	26094343	26102343	26096707	8000	26098343	-4000	4000	-1636
chr6	36601600	36609600	36603515	8000	36605600	-4000	4000	-2085
chr6	132567359	132575359	132571239	8000	132571359	-4000	4000	-120
chr6	160448577	160456577	160453618	8000	160452577	-4000	4000	1041
chr6	347355	355355	350668	8000	351355	-4000	4000	-687
chr6	83853515	83861515	83859848	8000	83857515	-4000	4000	2333
chr6	52232681	52240681	52238911	8000	52236681	-4000	4000	2230
chr6	27954182	27962182	27957336	8000	27958182	-4000	4000	-846
chr6	28566535	28574535	28573403	8000	28570535	-4000	4000	2868
chr6	132535336	132543336	132538497	8000	132539336	-4000	4000	-839
chr6	151360115	151368115	151366302	8000	151364115	-4000	4000	2187
chr6	149407613	149415613	149410440	8000	149411613	-4000	4000	-1173
chr6	158507828	158515828	158511605	8000	158511828	-4000	4000	-223
chr6	17607719	17615719	17608217	8000	17611719	-4000	4000	-3502
chr6	33000182	33008182	33007331	8000	33004182	-4000	4000	3149
chr6	57182992	57190992	57190144	8000	57186992	-4000	4000	3152
chr6	25697783	25705783	25701256	8000	25701783	-4000	4000	-527
chr6	152720569	152728569	152722166	8000	152724569	-4000	4000	-2403
chr6	157206779	157214779	157206803	8000	157210779	-4000	4000	-3976
chr6	167312014	167320014	167315532	8000	167316014	-4000	4000	-482
chr6	4060983	4068983	4068702	8000	4064983	-4000	4000	3719
chr6	6650983	6658983	6654849	8000	6654983	-4000	4000	-134
chr6	10705782	10713782	10707456	8000	10709782	-4000	4000	-2326
chr6	10926423	10934423	10927251	8000	10930423	-4000	4000	-3172
chr6	11708054	11716054	11714424	8000	11712054	-4000	4000	2370
chr6	13286446	13294446	13287071	8000	13290446	-4000	4000	-3375
chr6	13617498	13625498	13620328	8000	13621498	-4000	4000	-1170
chr6	13976310	13984310	13976979	8000	13980310	-4000	4000	-3331
chr6	20095684	20103684	20102167	8000	20099684	-4000	4000	2483
chr6	20489714	20497714	20490210	8000	20493714	-4000	4000	-3504
chr6	21228404	21236404	21231162	8000	21232404	-4000	4000	-1242
chr6	24540104	24548104	24547160	8000	24544104	-4000	4000	3056
chr6	25723345	25731345	25727082	8000	25727345	-4000	4000	-263
chr6	25777199	25785199	25779196	8000	25781199	-4000	4000	-2003
chr6	26094343	26102343	26094425	8000	26098343	-4000	4000	-3918
chr6	26212200	26220200	26216280	8000	26216200	-4000	4000	80
chr6	26212200	26220200	26216430	8000	26216200	-4000	4000	230
chr6	27252624	27260624	27255034	8000	27256624	-4000	4000	-1590
chr6	28499296	28507296	28505718	8000	28503296	-4000	4000	2422
chr6	29436977	29444977	29440063	8000	29440977	-4000	4000	-914
chr6	33317386	33325386	33318781	8000	33321386	-4000	4000	-2605
chr6	33449689	33457689	33456654	8000	33453689	-4000	4000	2965
chr6	33568547	33576547	33575912	8000	33572547	-4000	4000	3365
chr6	34280887	34288887	34288887	8000	34284887	-4000	4000	4000
chr6	35317771	35325771	35319889	8000	35321771	-4000	4000	-1882
chr6	36311761	36319761	36319393	8000	36315761	-4000	4000	3632
chr6	39900877	39908877	39901304	8000	39904877	-4000	4000	-3573
chr6	40387591	40395591	40392054	8000	40391591	-4000	4000	463
chr6	41154506	41162506	41161456	8000	41158506	-4000	4000	2950
chr6	41185749	41193749	41192832	8000	41189749	-4000	4000	3083
chr6	46216736	46224736	46223123	8000	46220736	-4000	4000	2387
chr6	50038099	50046099	50043739	8000	50042099	-4000	4000	1640
chr6	52232681	52240681	52236897	8000	52236681	-4000	4000	216
chr6	53122961	53130961	53128250	8000	53126961	-4000	4000	1289
chr6	53122961	53130961	53128344	8000	53126961	-4000	4000	1383
chr6	54941099	54949099	54941336	8000	54945099	-4000	4000	-3763
chr6	55749653	55757653	55755554	8000	55753653	-4000	4000	1901
chr6	57166305	57174305	57168526	8000	57170305	-4000	4000	-1779
chr6	75714281	75722281	75715394	8000	75718281	-4000	4000	-2887
chr6	83167350	83175350	83168072	8000	83171350	-4000	4000	-3278
chr6	83521704	83529704	83524629	8000	83525704	-4000	4000	-1075
chr6	87081498	87089498	87085568	8000	87085498	-4000	4000	70
chr6	96614626	96622626	96615668	8000	96618626	-4000	4000	-2958
chr6	100504194	100512194	100509317	8000	100508194	-4000	4000	1123
chr6	105153900	105161900	105161769	8000	105157900	-4000	4000	3869
chr6	107047586	107055586	107051268	8000	107051586	-4000	4000	-318
chr6	108184805	108192805	108187603	8000	108188805	-4000	4000	-1202
chr6	109488855	109496855	109495380	8000	109492855	-4000	4000	2525
chr6	114051596	114059596	114057529	8000	114055596	-4000	4000	1933
chr6	116628985	116636985	116630528	8000	116632985	-4000	4000	-2457
chr6	116628985	116636985	116632596	8000	116632985	-4000	4000	-389
chr6	116748197	116756197	116752592	8000	116752197	-4000	4000	395
chr6	121445727	121453727	121447395	8000	121449727	-4000	4000	-2332
chr6	121445727	121453727	121447803	8000	121449727	-4000	4000	-1924
chr6	127284712	127292712	127286821	8000	127288712	-4000	4000	-1891
chr6	127587820	127595820	127590223	8000	127591820	-4000	4000	-1597
chr6	127964785	127972785	127970242	8000	127968785	-4000	4000	1457
chr6	130439067	130447067	130441083	8000	130443067	-4000	4000	-1984
chr6	131580332	131588332	131583374	8000	131584332	-4000	4000	-958
chr6	132613022	132621022	132617161	8000	132617022	-4000	4000	139
chr6	132613022	132621022	132617996	8000	132617022	-4000	4000	974
chr6	132639312	132647312	132645602	8000	132643312	-4000	4000	2290
chr6	132739870	132747870	132744342	8000	132743870	-4000	4000	472
chr6	132813564	132821564	132816984	8000	132817564	-4000	4000	-580
chr6	137488199	137496199	137493688	8000	137492199	-4000	4000	1489
chr6	138789319	138797319	138792879	8000	138793319	-4000	4000	-440
chr6	139236061	139244061	139243224	8000	139240061	-4000	4000	3163
chr6	143490812	143498812	143495840	8000	143494812	-4000	4000	1028
chr6	149654153	149662153	149662127	8000	149658153	-4000	4000	3974
chr6	150839665	150847665	150840530	8000	150843665	-4000	4000	-3135
chr6	152720569	152728569	152722125	8000	152724569	-4000	4000	-2444
chr6	157206779	157214779	157207157	8000	157210779	-4000	4000	-3622
chr6	157285025	157293025	157292987	8000	157289025	-4000	4000	3962
chr6	158195344	158203344	158197376	8000	158199344	-4000	4000	-1968
chr6	169736109	169744109	169740152	8000	169740109	-4000	4000	43
chr6	17611035	17619035	17616685	8000	17615035	-4000	4000	1650
chr6	28256958	28264958	28260448	8000	28260958	-4000	4000	-510
chr6	31160337	31168337	31166025	8000	31164337	-4000	4000	1688
chr6	41346889	41354889	41350797	8000	41350889	-4000	4000	-92
chr6	42177338	42185338	42184760	8000	42181338	-4000	4000	3422
chr6	151360115	151368115	151366437	8000	151364115	-4000	4000	2322
chr6	155253723	155261723	155257069	8000	155257723	-4000	4000	-654
chr6	27143562	27151562	27146837	8000	27147562	-4000	4000	-725
chr6	75080326	75088326	75086404	8000	75084326	-4000	4000	2078
chr6	149654153	149662153	149661691	8000	149658153	-4000	4000	3538
chr6	26212200	26220200	26217357	8000	26216200	-4000	4000	1157
chr6	154155828	154163828	154160017	8000	154159828	-4000	4000	189
chr6	42177338	42185338	42179312	8000	42181338	-4000	4000	-2026
chr6	26201021	26209021	26204984	8000	26205021	-4000	4000	-37
chr6	118313676	118321676	118314085	8000	118317676	-4000	4000	-3591
chr6	31349872	31357872	31355208	8000	31353872	-4000	4000	1336
chr6	34531229	34539229	34531728	8000	34535229	-4000	4000	-3501
chr6	49964677	49972677	49968804	8000	49968677	-4000	4000	127
chr6	170568870	170576870	170569647	8000	170572870	-4000	4000	-3223
chr6	26195988	26203988	26199787	8000	26199988	-4000	4000	-201
chr6	27886315	27894315	27893732	8000	27890315	-4000	4000	3417
chr6	52232681	52240681	52236930	8000	52236681	-4000	4000	249
chr6	169699902	169707902	169704024	8000	169703902	-4000	4000	122
chr6	152117687	152125687	152122622	8000	152121687	-4000	4000	935
chr6	26027589	26035589	26031841	8000	26031589	-4000	4000	252
chr6	26542933	26550933	26545519	8000	26546933	-4000	4000	-1414
chr6	28298549	28306549	28301422	8000	28302549	-4000	4000	-1127
chr6	37328970	37336970	37331686	8000	37332970	-4000	4000	-1284
chr6	107657306	107665306	107659035	8000	107661306	-4000	4000	-2271
chr6	109362514	109370514	109366990	8000	109366514	-4000	4000	476
chr6	33158681	33166681	33166512	8000	33162681	-4000	4000	3831
chr6	130439067	130447067	130441477	8000	130443067	-4000	4000	-1590
chr6	149969715	149977715	149970111	8000	149973715	-4000	4000	-3604
chr6	158095176	158103176	158095806	8000	158099176	-4000	4000	-3370
chr6	26039227	26047227	26045498	8000	26043227	-4000	4000	2271
chr6	11179298	11187298	11185274	8000	11183298	-4000	4000	1976
chr6	29082208	29090208	29086325	8000	29086208	-4000	4000	117
chr6	30649119	30657119	30652678	8000	30653119	-4000	4000	-441
chr6	79910814	79918814	79916186	8000	79914814	-4000	4000	1372
chr6	18116440	18124440	18121630	8000	18120440	-4000	4000	1190
chr6	160448577	160456577	160454180	8000	160452577	-4000	4000	1603
chr6	167312014	167320014	167315297	8000	167316014	-4000	4000	-717
chr6	347355	355355	350830	8000	351355	-4000	4000	-525
chr6	138900070	138908070	138900945	8000	138904070	-4000	4000	-3125
chr6	85491791	85499791	85493913	8000	85495791	-4000	4000	-1878
chr6	166405364	166413364	166411686	8000	166409364	-4000	4000	2322
chr6	89081160	89089160	89084378	8000	89085160	-4000	4000	-782
chr6	26246142	26254142	26250433	8000	26250142	-4000	4000	291
chr6	50038099	50046099	50043667	8000	50042099	-4000	4000	1568
chr6	96885315	96893315	96891070	8000	96889315	-4000	4000	1755
chr6	161343417	161351417	161350003	8000	161347417	-4000	4000	2586
chr6	10625368	10633368	10626841	8000	10629368	-4000	4000	-2527
chr6	26094343	26102343	26094395	8000	26098343	-4000	4000	-3948
chr6	57051239	57059239	57054491	8000	57055239	-4000	4000	-748
chr6	99538387	99546387	99543432	8000	99542387	-4000	4000	1045
chr6	106568017	106576017	106568750	8000	106572017	-4000	4000	-3267
chr6	106568017	106576017	106568751	8000	106572017	-4000	4000	-3266
chr6	152720569	152728569	152721880	8000	152724569	-4000	4000	-2689
chr6	56453987	56461987	56459142	8000	56457987	-4000	4000	1155
chr6	56453987	56461987	56459229	8000	56457987	-4000	4000	1242
chr6	84120241	84128241	84126387	8000	84124241	-4000	4000	2146
chr6	96551276	96559276	96553350	8000	96555276	-4000	4000	-1926
chr6	116928161	116936161	116931372	8000	116932161	-4000	4000	-789
chr6	27143562	27151562	27147470	8000	27147562	-4000	4000	-92
chr6	43177506	43185506	43184511	8000	43181506	-4000	4000	3005
chr6	95605470	95613470	95605798	8000	95609470	-4000	4000	-3672
chr6	32190843	32198843	32191498	8000	32194843	-4000	4000	-3345
chr6	49956249	49964249	49960423	8000	49960249	-4000	4000	174
chr6	7877522	7885522	7880310	8000	7881522	-4000	4000	-1212
chr6	35789675	35797675	35797238	8000	35793675	-4000	4000	3563
chr6	89250464	89258464	89257921	8000	89254464	-4000	4000	3457
chr6	49964677	49972677	49969620	8000	49968677	-4000	4000	943
chr6	96885315	96893315	96891324	8000	96889315	-4000	4000	2009
chr6	28499296	28507296	28504247	8000	28503296	-4000	4000	951
chr6	36386551	36394551	36387566	8000	36390551	-4000	4000	-2985
chr6	43301538	43309538	43302331	8000	43305538	-4000	4000	-3207
chr6	43301538	43309538	43302332	8000	43305538	-4000	4000	-3206
chr6	26027589	26035589	26031751	8000	26031589	-4000	4000	162
chr6	27129535	27137535	27133383	8000	27133535	-4000	4000	-152
chr6	27862792	27870792	27865668	8000	27866792	-4000	4000	-1124
chr6	29082208	29090208	29087288	8000	29086208	-4000	4000	1080
chr6	31584895	31592895	31587308	8000	31588895	-4000	4000	-1587
chr6	31713919	31721919	31720182	8000	31717919	-4000	4000	2263
chr6	39310698	39318698	39316876	8000	39314698	-4000	4000	2178
chr6	53920125	53928125	53922649	8000	53924125	-4000	4000	-1476
chr6	85500776	85508776	85507258	8000	85504776	-4000	4000	2482
chr6	87012679	87020679	87015945	8000	87016679	-4000	4000	-734
chr6	97136754	97144754	97139481	8000	97140754	-4000	4000	-1273
chr6	132535336	132543336	132538487	8000	132539336	-4000	4000	-849
chr6	137488199	137496199	137493850	8000	137492199	-4000	4000	1651
chr6	5993999	6001999	5998799	8000	5997999	-4000	4000	800
chr6	27867845	27875845	27871866	8000	27871845	-4000	4000	21
chr6	26212200	26220200	26217357	8000	26216200	-4000	4000	1157
chr6	27446743	27454743	27451562	8000	27450743	-4000	4000	819
chr6	136191574	136199574	136191845	8000	136195574	-4000	4000	-3729
chr6	29436977	29444977	29440648	8000	29440977	-4000	4000	-329
chr6	15518807	15526807	15524402	8000	15522807	-4000	4000	1595
chr6	26022896	26030896	26027096	8000	26026896	-4000	4000	200
chr6	28237697	28245697	28245602	8000	28241697	-4000	4000	3905
chr6	42959865	42967865	42966378	8000	42963865	-4000	4000	2513
chr6	158105519	158113519	158111311	8000	158109519	-4000	4000	1792
chr6	16144248	16152248	16146808	8000	16148248	-4000	4000	-1440
chr6	35463102	35471102	35468429	8000	35467102	-4000	4000	1327
chr6	125757269	125765269	125759426	8000	125761269	-4000	4000	-1843
chr6	116928161	116936161	116931723	8000	116932161	-4000	4000	-438
chr6	136995971	137003971	137001801	8000	136999971	-4000	4000	1830
chr6	28298549	28306549	28302095	8000	28302549	-4000	4000	-454
chr6	32180733	32188733	32186460	8000	32184733	-4000	4000	1727
chr6	55278617	55286617	55280432	8000	55282617	-4000	4000	-2185
chr6	26212200	26220200	26217139	8000	26216200	-4000	4000	939
chr6	32389339	32397339	32394882	8000	32393339	-4000	4000	1543
chr6	26449415	26457415	26451867	8000	26453415	-4000	4000	-1548
chr6	31859192	31867192	31860136	8000	31863192	-4000	4000	-3056
chr6	33405896	33413896	33406393	8000	33409896	-4000	4000	-3503
chr6	106568017	106576017	106568716	8000	106572017	-4000	4000	-3301
chr6	127284712	127292712	127287319	8000	127288712	-4000	4000	-1393
chr6	13976310	13984310	13977852	8000	13980310	-4000	4000	-2458
chr6	26201021	26209021	26204794	8000	26205021	-4000	4000	-227
chr6	28566535	28574535	28573146	8000	28570535	-4000	4000	2611
chr6	72399145	72407145	72400676	8000	72403145	-4000	4000	-2469
chr6	116459771	116467771	116463607	8000	116463771	-4000	4000	-164
chr6	136995971	137003971	137002056	8000	136999971	-4000	4000	2085
chr6	26195988	26203988	26199067	8000	26199988	-4000	4000	-921
chr6	26236793	26244793	26240622	8000	26240793	-4000	4000	-171
chr6	85491791	85499791	85492170	8000	85495791	-4000	4000	-3621
chr6	134165248	134173248	134171661	8000	134169248	-4000	4000	2413
chr6	87663453	87671453	87665811	8000	87667453	-4000	4000	-1642
chr6	32574769	32582769	32579049	8000	32578769	-4000	4000	280
chr6	33158681	33166681	33164464	8000	33162681	-4000	4000	1783
chr6	28237697	28245697	28245250	8000	28241697	-4000	4000	3553
chr6	73360171	73368171	73362871	8000	73364171	-4000	4000	-1300
chr6	138084505	138092505	138092164	8000	138088505	-4000	4000	3659
chr6	107148562	107156562	107154441	8000	107152562	-4000	4000	1879
chr6	149654153	149662153	149661749	8000	149658153	-4000	4000	3596
chr6	57182992	57190992	57190454	8000	57186992	-4000	4000	3462
chr6	27886315	27894315	27893024	8000	27890315	-4000	4000	2709
chr6	77456924	77464924	77462600	8000	77460924	-4000	4000	1676
chr6	12160999	12168999	12163649	8000	12164999	-4000	4000	-1350
chr6	3264962	3272962	3267652	8000	3268962	-4000	4000	-1310
chr6	26223473	26231473	26225580	8000	26227473	-4000	4000	-1893
chr6	31722714	31730714	31723649	8000	31726714	-4000	4000	-3065
chr6	35745079	35753079	35747307	8000	35749079	-4000	4000	-1772
chr6	158760876	158768876	158763509	8000	158764876	-4000	4000	-1367
chr6	26103412	26111412	26104007	8000	26107412	-4000	4000	-3405
chr6	124821640	124829640	124824976	8000	124825640	-4000	4000	-664
chr6	144187939	144195939	144188119	8000	144191939	-4000	4000	-3820
chr6	37390734	37398734	37391262	8000	37394734	-4000	4000	-3472
chr6	27446743	27454743	27452211	8000	27450743	-4000	4000	1468
chr6	27810302	27818302	27814609	8000	27814302	-4000	4000	307
chr6	132584592	132592592	132589161	8000	132588592	-4000	4000	569
chr6	13976310	13984310	13979065	8000	13980310	-4000	4000	-1245
chr6	155253723	155261723	155254713	8000	155257723	-4000	4000	-3010
chr6	36228790	36236790	36230483	8000	36232790	-4000	4000	-2307
chr6	89161565	89169565	89161872	8000	89165565	-4000	4000	-3693
chr6	130137449	130145449	130145403	8000	130141449	-4000	4000	3954
chr6	14132918	14140918	14135320	8000	14136918	-4000	4000	-1598
chr6	30066266	30074266	30068342	8000	30070266	-4000	4000	-1924
chr6	34280887	34288887	34288843	8000	34284887	-4000	4000	3956
chr6	99914519	99922519	99920896	8000	99918519	-4000	4000	2377
chr6	26180655	26188655	26183836	8000	26184655	-4000	4000	-819
chr6	170531120	170539120	170535316	8000	170535120	-4000	4000	196
chr6	31264749	31272749	31271424	8000	31268749	-4000	4000	2675
chr6	17289871	17297871	17292063	8000	17293871	-4000	4000	-1808
chr6	55278617	55286617	55282503	8000	55282617	-4000	4000	-114
chr6	15518807	15526807	15524442	8000	15522807	-4000	4000	1635
chr6	33568547	33576547	33573822	8000	33572547	-4000	4000	1275
chr6	132613022	132621022	132618014	8000	132617022	-4000	4000	992
chr6	36960837	36968837	36963357	8000	36964837	-4000	4000	-1480
chr6	41650244	41658244	41653793	8000	41654244	-4000	4000	-451
chr6	52232681	52240681	52236745	8000	52236681	-4000	4000	64
chr6	29668372	29676372	29673306	8000	29672372	-4000	4000	934
chr6	83853515	83861515	83859733	8000	83857515	-4000	4000	2218
chr6	35114071	35122071	35118291	8000	35118071	-4000	4000	220
chr6	117314211	117322211	117321308	8000	117318211	-4000	4000	3097
chr6	132549721	132557721	132553486	8000	132553721	-4000	4000	-235
chr6	132567359	132575359	132570712	8000	132571359	-4000	4000	-647
chr6	36601600	36609600	36602859	8000	36605600	-4000	4000	-2741
chr6	70212040	70220040	70216925	8000	70216040	-4000	4000	885
chr6	30649119	30657119	30655259	8000	30653119	-4000	4000	2140
chr6	42921838	42929838	42924255	8000	42925838	-4000	4000	-1583
chr6	160448577	160456577	160453513	8000	160452577	-4000	4000	936
chr6	123212339	123220339	123218710	8000	123216339	-4000	4000	2371
chr6	109976720	109984720	109979627	8000	109980720	-4000	4000	-1093
chr6	26411208	26419208	26412742	8000	26415208	-4000	4000	-2466
chr6	3015755	3023755	3019529	8000	3019755	-4000	4000	-226
chr6	84120241	84128241	84124935	8000	84124241	-4000	4000	694
chr6	150246392	150254392	150249150	8000	150250392	-4000	4000	-1242
chr6	72399145	72407145	72400511	8000	72403145	-4000	4000	-2634
chr6	95605470	95613470	95606181	8000	95609470	-4000	4000	-3289
chr6	52260014	52268014	52264723	8000	52264014	-4000	4000	709
chr6	57051239	57059239	57054339	8000	57055239	-4000	4000	-900
chr6	73360171	73368171	73362681	8000	73364171	-4000	4000	-1490
chr6	108207222	108215222	108211833	8000	108211222	-4000	4000	611
chr6	26374320	26382320	26376639	8000	26378320	-4000	4000	-1681
chr6	13976310	13984310	13979972	8000	13980310	-4000	4000	-338
chr6	111656332	111664332	111661350	8000	111660332	-4000	4000	1018
chr6	33449689	33457689	33456347	8000	33453689	-4000	4000	2658
chr6	46993708	47001708	47000174	8000	46997708	-4000	4000	2466
chr6	26180655	26188655	26183817	8000	26184655	-4000	4000	-838
chr6	44180401	44188401	44184027	8000	44184401	-4000	4000	-374
chr6	157206779	157214779	157206929	8000	157210779	-4000	4000	-3850
chr6	73194853	73202853	73195089	8000	73198853	-4000	4000	-3764
chr6	26180655	26188655	26184169	8000	26184655	-4000	4000	-486
chr6	27803479	27811479	27808542	8000	27807479	-4000	4000	1063
chr6	18219860	18227860	18225437	8000	18223860	-4000	4000	1577
chr6	12160999	12168999	12164252	8000	12164999	-4000	4000	-747
chr6	39295001	39303001	39300459	8000	39299001	-4000	4000	1458
chr6	110095819	110103819	110101726	8000	110099819	-4000	4000	1907
chr6	32944613	32952613	32950463	8000	32948613	-4000	4000	1850
chr6	131580332	131588332	131587798	8000	131584332	-4000	4000	3466
chr6	24701065	24709065	24706137	8000	24705065	-4000	4000	1072
chr6	29482697	29490697	29487270	8000	29486697	-4000	4000	573
chr6	29482697	29490697	29487416	8000	29486697	-4000	4000	719
chr6	46835778	46843778	46839091	8000	46839778	-4000	4000	-687
chr6	49781660	49789660	49787275	8000	49785660	-4000	4000	1615
chr6	54941099	54949099	54941625	8000	54945099	-4000	4000	-3474
chr6	99365401	99373401	99369712	8000	99369401	-4000	4000	311
chr6	114051596	114059596	114057845	8000	114055596	-4000	4000	2249
chr6	122805720	122813720	122809482	8000	122809720	-4000	4000	-238
chr6	10625368	10633368	10626660	8000	10629368	-4000	4000	-2708
chr6	105153900	105161900	105161527	8000	105157900	-4000	4000	3627
chr6	144849034	144857034	144851067	8000	144853034	-4000	4000	-1967
chr6	39900877	39908877	39901455	8000	39904877	-4000	4000	-3422
chr6	30642823	30650823	30644482	8000	30646823	-4000	4000	-2341
chr6	36309955	36317955	36317310	8000	36313955	-4000	4000	3355
chr6	26269412	26277412	26270991	8000	26273412	-4000	4000	-2421
chr6	52232681	52240681	52236945	8000	52236681	-4000	4000	264
chr6	99393629	99401629	99394146	8000	99397629	-4000	4000	-3483
chr6	30985903	30993903	30986757	8000	30989903	-4000	4000	-3146
chr6	160448577	160456577	160453656	8000	160452577	-4000	4000	1079
chr6	26269412	26277412	26273059	8000	26273412	-4000	4000	-353
chr6	89161565	89169565	89161859	8000	89165565	-4000	4000	-3706
chr6	137879312	137887312	137880141	8000	137883312	-4000	4000	-3171
chr6	43071095	43079095	43074681	8000	43075095	-4000	4000	-414
chr6	53263398	53271398	53269028	8000	53267398	-4000	4000	1630
chr6	27867845	27875845	27873256	8000	27871845	-4000	4000	1411
chr6	35463102	35471102	35468429	8000	35467102	-4000	4000	1327
chr6	109440062	109448062	109443834	8000	109444062	-4000	4000	-228
chr6	4111693	4119693	4115929	8000	4115693	-4000	4000	236
chr6	30896156	30904156	30896822	8000	30900156	-4000	4000	-3334
chr6	47227532	47235532	47234808	8000	47231532	-4000	4000	3276
chr6	53493341	53501341	53498638	8000	53497341	-4000	4000	1297
chr6	130137449	130145449	130145385	8000	130141449	-4000	4000	3936
chr6	36386551	36394551	36391740	8000	36390551	-4000	4000	1189
chr6	77456924	77464924	77462870	8000	77460924	-4000	4000	1946
chr6	160154718	160162718	160158653	8000	160158718	-4000	4000	-65
chr6	27820480	27828480	27824322	8000	27824480	-4000	4000	-158
chr6	38150624	38158624	38152464	8000	38154624	-4000	4000	-2160
chr6	49524078	49532078	49526701	8000	49528078	-4000	4000	-1377
chr6	43301538	43309538	43301640	8000	43305538	-4000	4000	-3898
chr6	149912878	149920878	149918197	8000	149916878	-4000	4000	1319
chr6	15518807	15526807	15522922	8000	15522807	-4000	4000	115
chr6	22567666	22575666	22569774	8000	22571666	-4000	4000	-1892
chr6	26027589	26035589	26031728	8000	26031589	-4000	4000	139
chr6	26039227	26047227	26043441	8000	26043227	-4000	4000	214
chr6	26103412	26111412	26107621	8000	26107412	-4000	4000	209
chr6	26195988	26203988	26199867	8000	26199988	-4000	4000	-121
chr6	26212200	26220200	26217081	8000	26216200	-4000	4000	881
chr6	27803479	27811479	27808438	8000	27807479	-4000	4000	959
chr6	28566535	28574535	28572915	8000	28570535	-4000	4000	2380
chr6	30922459	30930459	30924491	8000	30926459	-4000	4000	-1968
chr6	31761590	31769590	31762484	8000	31765590	-4000	4000	-3106
chr6	31941672	31949672	31946545	8000	31945672	-4000	4000	873
chr6	32190843	32198843	32198486	8000	32194843	-4000	4000	3643
chr6	35317771	35325771	35319655	8000	35321771	-4000	4000	-2116
chr6	40387591	40395591	40392862	8000	40391591	-4000	4000	1271
chr6	42864558	42872558	42864815	8000	42868558	-4000	4000	-3743
chr6	57166305	57174305	57168586	8000	57170305	-4000	4000	-1719
chr6	77456924	77464924	77462892	8000	77460924	-4000	4000	1968
chr6	99611578	99619578	99613052	8000	99615578	-4000	4000	-2526
chr6	109976720	109984720	109980276	8000	109980720	-4000	4000	-444
chr6	116628985	116636985	116632340	8000	116632985	-4000	4000	-645
chr6	132613022	132621022	132617570	8000	132617022	-4000	4000	548
chr6	150839665	150847665	150840782	8000	150843665	-4000	4000	-2883
chr6	26195988	26203988	26196945	8000	26199988	-4000	4000	-3043
chr6	89922528	89930528	89928879	8000	89926528	-4000	4000	2351
chr6	122429119	122437119	122432426	8000	122433119	-4000	4000	-693
chr6	46142688	46150688	46143588	8000	46146688	-4000	4000	-3100
chr6	87670860	87678860	87675476	8000	87674860	-4000	4000	616
chr6	30985903	30993903	30986574	8000	30989903	-4000	4000	-3329
chr6	27143562	27151562	27146792	8000	27147562	-4000	4000	-770
chr6	4111693	4119693	4115904	8000	4115693	-4000	4000	211
chr6	26027589	26035589	26031887	8000	26031589	-4000	4000	298
chr6	26212200	26220200	26216362	8000	26216200	-4000	4000	162
chr6	26390874	26398874	26392742	8000	26394874	-4000	4000	-2132
chr6	31793396	31801396	31795206	8000	31797396	-4000	4000	-2190
chr6	31859192	31867192	31860604	8000	31863192	-4000	4000	-2588
chr6	33317386	33325386	33321448	8000	33321386	-4000	4000	62
chr6	33717662	33725662	33723156	8000	33721662	-4000	4000	1494
chr6	35789675	35797675	35795147	8000	35793675	-4000	4000	1472
chr6	105153900	105161900	105159752	8000	105157900	-4000	4000	1852
chr6	105153900	105161900	105161834	8000	105157900	-4000	4000	3934
chr6	106568017	106576017	106568489	8000	106572017	-4000	4000	-3528
chr6	117269565	117277565	117272549	8000	117273565	-4000	4000	-1016
chr6	133528128	133536128	133529204	8000	133532128	-4000	4000	-2924
chr6	121445727	121453727	121447797	8000	121449727	-4000	4000	-1930
chr6	132765370	132773370	132770183	8000	132769370	-4000	4000	813
chr6	42885925	42893925	42886069	8000	42889925	-4000	4000	-3856
chr6	170531120	170539120	170537235	8000	170535120	-4000	4000	2115
chr7	122990704	122998704	122994804	8000	122994704	-4000	4000	100
chr7	135644757	135652757	135648416	8000	135648757	-4000	4000	-341
chr7	73432120	73440120	73434841	8000	73436120	-4000	4000	-1279
chr7	48923454	48931454	48925007	8000	48927454	-4000	4000	-2447
chr7	141832300	141840300	141837998	8000	141836300	-4000	4000	1698
chr7	53032925	53040925	53036147	8000	53036925	-4000	4000	-778
chr7	87829568	87837568	87836191	8000	87833568	-4000	4000	2623
chr7	106244298	106252298	106251003	8000	106248298	-4000	4000	2705
chr7	98210624	98218624	98218028	8000	98214624	-4000	4000	3404
chr7	28821894	28829894	28825552	8000	28825894	-4000	4000	-342
chr7	150475393	150483393	150477700	8000	150479393	-4000	4000	-1693
chr7	15196317	15204317	15201188	8000	15200317	-4000	4000	871
chr7	74792150	74800150	74797957	8000	74796150	-4000	4000	1807
chr7	14141049	14149049	14148367	8000	14145049	-4000	4000	3318
chr7	73861890	73869890	73865318	8000	73865890	-4000	4000	-572
chr7	144004793	144012793	144004845	8000	144008793	-4000	4000	-3948
chr7	25130692	25138692	25136543	8000	25134692	-4000	4000	1851
chr7	25220570	25228570	25225076	8000	25224570	-4000	4000	506
chr7	142867094	142875094	142871653	8000	142871094	-4000	4000	559
chr7	74792150	74800150	74797945	8000	74796150	-4000	4000	1795
chr7	93095513	93103513	93101990	8000	93099513	-4000	4000	2477
chr7	93095513	93103513	93102685	8000	93099513	-4000	4000	3172
chr7	93907265	93915265	93911026	8000	93911265	-4000	4000	-239
chr7	99644194	99652194	99650190	8000	99648194	-4000	4000	1996
chr7	100396096	100404096	100401160	8000	100400096	-4000	4000	1064
chr7	130502238	130510238	130506540	8000	130506238	-4000	4000	302
chr7	143474796	143482796	143478098	8000	143478796	-4000	4000	-698
chr7	151048756	151056756	151051844	8000	151052756	-4000	4000	-912
chr7	26209607	26217607	26211751	8000	26213607	-4000	4000	-1856
chr7	93095513	93103513	93103145	8000	93099513	-4000	4000	3632
chr7	100155244	100163244	100160663	8000	100159244	-4000	4000	1419
chr7	100597117	100605117	100600661	8000	100601117	-4000	4000	-456
chr7	122990704	122998704	122995599	8000	122994704	-4000	4000	895
chr7	144106539	144114539	144110245	8000	144110539	-4000	4000	-294
chr7	150689641	150697641	150692524	8000	150693641	-4000	4000	-1117
chr7	4265000	4273000	4268818	8000	4269000	-4000	4000	-182
chr7	26370383	26378383	26371957	8000	26374383	-4000	4000	-2426
chr7	39606320	39614320	39610131	8000	39610320	-4000	4000	-189
chr7	15196317	15204317	15201155	8000	15200317	-4000	4000	838
chr7	27521442	27529442	27526125	8000	27525442	-4000	4000	683
chr7	44006124	44014124	44007200	8000	44010124	-4000	4000	-2924
chr7	152118340	152126340	152118642	8000	152122340	-4000	4000	-3698
chr7	23197011	23205011	23200183	8000	23201011	-4000	4000	-828
chr7	92108176	92116176	92108522	8000	92112176	-4000	4000	-3654
chr7	38379704	38387704	38384829	8000	38383704	-4000	4000	1125
chr7	100611384	100619384	100615194	8000	100615384	-4000	4000	-190
chr7	8748961	8756961	8751027	8000	8752961	-4000	4000	-1934
chr7	150940961	150948961	150948458	8000	150944961	-4000	4000	3497
chr7	89334528	89342528	89335529	8000	89338528	-4000	4000	-2999
chr7	140019749	140027749	140024615	8000	140023749	-4000	4000	866
chr7	31704455	31712455	31707414	8000	31708455	-4000	4000	-1041
chr7	20778279	20786279	20784695	8000	20782279	-4000	4000	2416
chr7	101191007	101199007	101196060	8000	101195007	-4000	4000	1053
chr7	95355872	95363872	95360109	8000	95359872	-4000	4000	237
chr7	31747179	31755179	31753086	8000	31751179	-4000	4000	1907
chr7	101191007	101199007	101198292	8000	101195007	-4000	4000	3285
chr7	20778279	20786279	20784662	8000	20782279	-4000	4000	2383
chr7	48923454	48931454	48925877	8000	48927454	-4000	4000	-1577
chr7	6018247	6026247	6024578	8000	6022247	-4000	4000	2331
chr7	84991553	84999553	84999496	8000	84995553	-4000	4000	3943
chr7	123109531	123117531	123117513	8000	123113531	-4000	4000	3982
chr7	1743946	1751946	1746986	8000	1747946	-4000	4000	-960
chr7	1743946	1751946	1746987	8000	1747946	-4000	4000	-959
chr7	84991553	84999553	84999439	8000	84995553	-4000	4000	3886
chr7	100459359	100467359	100463966	8000	100463359	-4000	4000	607
chr7	113872777	113880777	113878040	8000	113876777	-4000	4000	1263
chr7	73861890	73869890	73865598	8000	73865890	-4000	4000	-292
chr7	122058036	122066036	122061234	8000	122062036	-4000	4000	-802
chr7	74401935	74409935	74403932	8000	74405935	-4000	4000	-2003
chr7	113872777	113880777	113879151	8000	113876777	-4000	4000	2374
chr7	23197011	23205011	23200344	8000	23201011	-4000	4000	-667
chr7	112815147	112823147	112819313	8000	112819147	-4000	4000	166
chr7	37947936	37955936	37950414	8000	37951936	-4000	4000	-1522
chr7	71709600	71717600	71710836	8000	71713600	-4000	4000	-2764
chr7	99752960	99760960	99760864	8000	99756960	-4000	4000	3904
chr7	113872777	113880777	113879652	8000	113876777	-4000	4000	2875
chr7	113872777	113880777	113879956	8000	113876777	-4000	4000	3179
chr7	106244298	106252298	106251003	8000	106248298	-4000	4000	2705
chr7	149179042	149187042	149181143	8000	149183042	-4000	4000	-1899
chr7	113872777	113880777	113880027	8000	113876777	-4000	4000	3250
chr7	73861890	73869890	73865806	8000	73865890	-4000	4000	-84
chr7	26183137	26191137	26185839	8000	26187137	-4000	4000	-1298
chr7	48923454	48931454	48925160	8000	48927454	-4000	4000	-2294
chr7	142102747	142110747	142103414	8000	142106747	-4000	4000	-3333
chr7	142867094	142875094	142873534	8000	142871094	-4000	4000	2440
chr7	44822791	44830791	44829919	8000	44826791	-4000	4000	3128
chr7	32864172	32872172	32868565	8000	32868172	-4000	4000	393
chr7	108570850	108578850	108571890	8000	108574850	-4000	4000	-2960
chr7	150475393	150483393	150477309	8000	150479393	-4000	4000	-2084
chr7	6157564	6165564	6164814	8000	6161564	-4000	4000	3250
chr7	31333465	31341465	31339038	8000	31337465	-4000	4000	1573
chr7	100155244	100163244	100160115	8000	100159244	-4000	4000	871
chr7	143932186	143940186	143936003	8000	143936186	-4000	4000	-183
chr7	130014287	130022287	130018598	8000	130018287	-4000	4000	311
chr7	150689641	150697641	150693081	8000	150693641	-4000	4000	-560
chr7	64262931	64270931	64266189	8000	64266931	-4000	4000	-742
chr7	132780870	132788870	132785520	8000	132784870	-4000	4000	650
chr7	4901989	4909989	4909977	8000	4905989	-4000	4000	3988
chr7	100639097	100647097	100646801	8000	100643097	-4000	4000	3704
chr7	97016396	97024396	97021016	8000	97020396	-4000	4000	620
chr7	97016396	97024396	97022271	8000	97020396	-4000	4000	1875
chr7	24792540	24800540	24800014	8000	24796540	-4000	4000	3474
chr7	123660290	123668290	123662289	8000	123664290	-4000	4000	-2001
chr7	142867094	142875094	142870311	8000	142871094	-4000	4000	-783
chr7	18022770	18030770	18027637	8000	18026770	-4000	4000	867
chr7	53032925	53040925	53036419	8000	53036925	-4000	4000	-506
chr7	93126056	93134056	93133751	8000	93130056	-4000	4000	3695
chr7	75500316	75508316	75503126	8000	75504316	-4000	4000	-1190
chr7	1743946	1751946	1746101	8000	1747946	-4000	4000	-1845
chr7	30630033	30638033	30632383	8000	30634033	-4000	4000	-1650
chr7	64829681	64837681	64831628	8000	64833681	-4000	4000	-2053
chr7	100155244	100163244	100160031	8000	100159244	-4000	4000	787
chr7	143049282	143057282	143053257	8000	143053282	-4000	4000	-25
chr7	143932186	143940186	143935640	8000	143936186	-4000	4000	-546
chr7	100060033	100068033	100064799	8000	100064033	-4000	4000	766
chr7	44213150	44221150	44220181	8000	44217150	-4000	4000	3031
chr7	38718974	38726974	38726906	8000	38722974	-4000	4000	3932
chr7	87829568	87837568	87836188	8000	87833568	-4000	4000	2620
chr7	55429737	55437737	55431341	8000	55433737	-4000	4000	-2396
chr7	77046391	77054391	77052981	8000	77050391	-4000	4000	2590
chr7	1743946	1751946	1745863	8000	1747946	-4000	4000	-2083
chr7	6157564	6165564	6164843	8000	6161564	-4000	4000	3279
chr7	15607212	15615212	15612466	8000	15611212	-4000	4000	1254
chr7	44139213	44147213	44145765	8000	44143213	-4000	4000	2552
chr7	74792150	74800150	74798257	8000	74796150	-4000	4000	2107
chr7	76512522	76520522	76515155	8000	76516522	-4000	4000	-1367
chr7	95355872	95363872	95363801	8000	95359872	-4000	4000	3929
chr7	107197372	107205372	107200197	8000	107201372	-4000	4000	-1175
chr7	121293442	121301442	121295702	8000	121297442	-4000	4000	-1740
chr7	123873481	123881481	123877274	8000	123877481	-4000	4000	-207
chr7	149760182	149768182	149764795	8000	149764182	-4000	4000	613
chr7	112477017	112485017	112484924	8000	112481017	-4000	4000	3907
chr7	5302790	5310790	5308941	8000	5306790	-4000	4000	2151
chr7	142867094	142875094	142870970	8000	142871094	-4000	4000	-124
chr7	4901989	4909989	4907307	8000	4905989	-4000	4000	1318
chr7	48104736	48112736	48107488	8000	48108736	-4000	4000	-1248
chr7	97007040	97015040	97007699	8000	97011040	-4000	4000	-3341
chr7	143751089	143759089	143757077	8000	143755089	-4000	4000	1988
chr7	142218324	142226324	142220970	8000	142222324	-4000	4000	-1354
chr7	150940961	150948961	150945462	8000	150944961	-4000	4000	501
chr7	151374449	151382449	151377097	8000	151378449	-4000	4000	-1352
chr7	23271108	23279108	23273530	8000	23275108	-4000	4000	-1578
chr7	142936868	142944868	142944394	8000	142940868	-4000	4000	3526
chr7	37947936	37955936	37950221	8000	37951936	-4000	4000	-1715
chr7	74401935	74409935	74403853	8000	74405935	-4000	4000	-2082
chr7	124472955	124480955	124476711	8000	124476955	-4000	4000	-244
chr7	90160829	90168829	90160993	8000	90164829	-4000	4000	-3836
chr7	101191007	101199007	101195927	8000	101195007	-4000	4000	920
chr7	150621375	150629375	150627753	8000	150625375	-4000	4000	2378
chr7	144393240	144401240	144400265	8000	144397240	-4000	4000	3025
chr7	74792150	74800150	74796874	8000	74796150	-4000	4000	724
chr7	99962720	99970720	99968235	8000	99966720	-4000	4000	1515
chr7	112815147	112823147	112822256	8000	112819147	-4000	4000	3109
chr7	152015929	152023929	152019661	8000	152019929	-4000	4000	-268
chr7	102809230	102817230	102813466	8000	102813230	-4000	4000	236
chr7	64829681	64837681	64832362	8000	64833681	-4000	4000	-1319
chr7	100639097	100647097	100640975	8000	100643097	-4000	4000	-2122
chr7	93357123	93365123	93358751	8000	93361123	-4000	4000	-2372
chr7	142248143	142256143	142255630	8000	142252143	-4000	4000	3487
chr7	73861890	73869890	73865172	8000	73865890	-4000	4000	-718
chr7	19715315	19723315	19722096	8000	19719315	-4000	4000	2781
chr7	27096354	27104354	27100847	8000	27100354	-4000	4000	493
chr7	64926981	64934981	64927809	8000	64930981	-4000	4000	-3172
chr7	1233326	1241326	1235864	8000	1237326	-4000	4000	-1462
chr7	6684433	6692433	6691094	8000	6688433	-4000	4000	2661
chr7	80738538	80746538	80744994	8000	80742538	-4000	4000	2456
chr7	100396096	100404096	100401892	8000	100400096	-4000	4000	1796
chr7	130384114	130392114	130385903	8000	130388114	-4000	4000	-2211
chr7	150787285	150795285	150793188	8000	150791285	-4000	4000	1903
chr7	53032925	53040925	53035791	8000	53036925	-4000	4000	-1134
chr7	36320152	36328152	36326836	8000	36324152	-4000	4000	2684
chr7	103467381	103475381	103472618	8000	103471381	-4000	4000	1237
chr7	84991553	84999553	84999496	8000	84995553	-4000	4000	3943
chr7	123635481	123643481	123637423	8000	123639481	-4000	4000	-2058
chr7	95355872	95363872	95362386	8000	95359872	-4000	4000	2514
chr7	143751089	143759089	143756485	8000	143755089	-4000	4000	1396
chr7	107761467	107769467	107767595	8000	107765467	-4000	4000	2128
chr7	95292415	95300415	95298807	8000	95296415	-4000	4000	2392
chr7	150621375	150629375	150628198	8000	150625375	-4000	4000	2823
chr7	151010588	151018588	151014230	8000	151014588	-4000	4000	-358
chr7	134062589	134070589	134064404	8000	134066589	-4000	4000	-2185
chr7	54567080	54575080	54569149	8000	54571080	-4000	4000	-1931
chr7	48923454	48931454	48925208	8000	48927454	-4000	4000	-2246
chr7	48923454	48931454	48925547	8000	48927454	-4000	4000	-1907
chr7	25130692	25138692	25136109	8000	25134692	-4000	4000	1417
chr7	27149716	27157716	27155127	8000	27153716	-4000	4000	1411
chr7	104122341	104130341	104126739	8000	104126341	-4000	4000	398
chr7	92464380	92472380	92470317	8000	92468380	-4000	4000	1937
chr7	150689641	150697641	150692409	8000	150693641	-4000	4000	-1232
chr7	6620290	6628290	6621798	8000	6624290	-4000	4000	-2492
chr7	16702523	16710523	16704632	8000	16706523	-4000	4000	-1891
chr7	75145817	75153817	75148436	8000	75149817	-4000	4000	-1381
chr7	140019749	140027749	140020245	8000	140023749	-4000	4000	-3504
chr7	4265000	4273000	4268578	8000	4269000	-4000	4000	-422
chr7	84991553	84999553	84999533	8000	84995553	-4000	4000	3980
chr7	56059989	56067989	56063092	8000	56063989	-4000	4000	-897
chr7	123660290	123668290	123663032	8000	123664290	-4000	4000	-1258
chr7	151552124	151560124	151556419	8000	151556124	-4000	4000	295
chr7	127606292	127614292	127613829	8000	127610292	-4000	4000	3537
chr7	114689772	114697772	114690852	8000	114693772	-4000	4000	-2920
chr7	120746337	120754337	120749529	8000	120750337	-4000	4000	-808
chr7	149098784	149106784	149104740	8000	149102784	-4000	4000	1956
chr7	149098784	149106784	149105188	8000	149102784	-4000	4000	2404
chr7	6620290	6628290	6621604	8000	6624290	-4000	4000	-2686
chr7	99872958	99880958	99876296	8000	99876958	-4000	4000	-662
chr7	113872777	113880777	113877592	8000	113876777	-4000	4000	815
chr7	158627169	158635169	158631497	8000	158631169	-4000	4000	328
chr7	142867094	142875094	142867766	8000	142871094	-4000	4000	-3328
chr7	139039515	139047515	139047350	8000	139043515	-4000	4000	3835
chr7	150334317	150342317	150337313	8000	150338317	-4000	4000	-1004
chr7	105106704	105114704	105113458	8000	105110704	-4000	4000	2754
chr7	19140782	19148782	19145320	8000	19144782	-4000	4000	538
chr7	48923454	48931454	48924911	8000	48927454	-4000	4000	-2543
chr7	124472955	124480955	124476376	8000	124476955	-4000	4000	-579
chr7	99872958	99880958	99876574	8000	99876958	-4000	4000	-384
chr7	123660290	123668290	123663842	8000	123664290	-4000	4000	-448
chr7	27088993	27096993	27095724	8000	27092993	-4000	4000	2731
chr7	33010130	33018130	33014674	8000	33014130	-4000	4000	544
chr7	98625869	98633869	98628497	8000	98629869	-4000	4000	-1372
chr7	43803342	43811342	43807236	8000	43807342	-4000	4000	-106
chr7	27189503	27197503	27196970	8000	27193503	-4000	4000	3467
chr7	100597117	100605117	100603943	8000	100601117	-4000	4000	2826
chr7	144127188	144135188	144129157	8000	144131188	-4000	4000	-2031
chr7	23640708	23648708	23643622	8000	23644708	-4000	4000	-1086
chr7	108143623	108151623	108148573	8000	108147623	-4000	4000	950
chr7	106032432	106040432	106032806	8000	106036432	-4000	4000	-3626
chr7	545197	553197	550475	8000	549197	-4000	4000	1278
chr7	1148071	1156071	1152947	8000	1152071	-4000	4000	876
chr7	64707577	64715577	64708623	8000	64711577	-4000	4000	-2954
chr7	75500316	75508316	75501384	8000	75504316	-4000	4000	-2932
chr7	77779022	77787022	77779550	8000	77783022	-4000	4000	-3472
chr7	95579499	95587499	95583856	8000	95583499	-4000	4000	357
chr7	105106704	105114704	105107503	8000	105110704	-4000	4000	-3201
chr7	128855274	128863274	128856609	8000	128859274	-4000	4000	-2665
chr7	57113676	57121676	57119968	8000	57117676	-4000	4000	2292
chr7	72947440	72955440	72949912	8000	72951440	-4000	4000	-1528
chr7	1233326	1241326	1233633	8000	1237326	-4000	4000	-3693
chr7	57469559	57477559	57470415	8000	57473559	-4000	4000	-3144
chr7	107757667	107765667	107759436	8000	107761667	-4000	4000	-2231
chr7	120783320	120791320	120787979	8000	120787320	-4000	4000	659
chr7	151043782	151051782	151049344	8000	151047782	-4000	4000	1562
chr7	38379704	38387704	38384591	8000	38383704	-4000	4000	887
chr7	101054859	101062859	101058031	8000	101058859	-4000	4000	-828
chr7	150569953	150577953	150572617	8000	150573953	-4000	4000	-1336
chr7	6684433	6692433	6691191	8000	6688433	-4000	4000	2758
chr7	27102184	27110184	27108450	8000	27106184	-4000	4000	2266
chr7	149760182	149768182	149766229	8000	149764182	-4000	4000	2047
chr7	92464380	92472380	92468892	8000	92468380	-4000	4000	512
chr7	102809230	102817230	102813261	8000	102813230	-4000	4000	31
chr7	102809230	102817230	102813343	8000	102813230	-4000	4000	113
chr7	31333465	31341465	31339141	8000	31337465	-4000	4000	1676
chr7	31333465	31341465	31339285	8000	31337465	-4000	4000	1820
chr7	143219079	143227079	143222214	8000	143223079	-4000	4000	-865
chr7	144094953	144102953	144096016	8000	144098953	-4000	4000	-2937
chr7	23173914	23181914	23174270	8000	23177914	-4000	4000	-3644
chr7	50586063	50594063	50593073	8000	50590063	-4000	4000	3010
chr7	122990704	122998704	122994995	8000	122994704	-4000	4000	291
chr7	48104736	48112736	48108314	8000	48108736	-4000	4000	-422
chr7	95579499	95587499	95587494	8000	95583499	-4000	4000	3995
chr7	100088728	100096728	100089641	8000	100092728	-4000	4000	-3087
chr7	150334317	150342317	150336861	8000	150338317	-4000	4000	-1456
chr7	150689641	150697641	150692852	8000	150693641	-4000	4000	-789
chr7	150689641	150697641	150692853	8000	150693641	-4000	4000	-788
chr7	128855274	128863274	128855311	8000	128859274	-4000	4000	-3963
chr7	100396096	100404096	100401212	8000	100400096	-4000	4000	1116
chr7	129209545	129217545	129211014	8000	129213545	-4000	4000	-2531
chr7	101014939	101022939	101018635	8000	101018939	-4000	4000	-304
chr7	102469168	102477168	102476241	8000	102473168	-4000	4000	3073
chr7	107761467	107769467	107767581	8000	107765467	-4000	4000	2114
chr7	87499017	87507017	87505924	8000	87503017	-4000	4000	2907
chr7	139039515	139047515	139047253	8000	139043515	-4000	4000	3738
chr7	100060033	100068033	100064813	8000	100064033	-4000	4000	780
chr7	36848906	36856906	36855336	8000	36852906	-4000	4000	2430
chr7	6157564	6165564	6164713	8000	6161564	-4000	4000	3149
chr7	6157564	6165564	6165002	8000	6161564	-4000	4000	3438
chr7	22808628	22816628	22813156	8000	22812628	-4000	4000	528
chr7	73861890	73869890	73865262	8000	73865890	-4000	4000	-628
chr7	129209545	129217545	129211004	8000	129213545	-4000	4000	-2541
chr7	130502238	130510238	130506586	8000	130506238	-4000	4000	348
chr7	143474796	143482796	143478580	8000	143478796	-4000	4000	-216
chr7	152015929	152023929	152019701	8000	152019929	-4000	4000	-228
chr7	93907265	93915265	93909648	8000	93911265	-4000	4000	-1617
chr7	70789506	70797506	70792837	8000	70793506	-4000	4000	-669
chr7	72947440	72955440	72949654	8000	72951440	-4000	4000	-1786
chr7	27088993	27096993	27095330	8000	27092993	-4000	4000	2337
chr7	44210294	44218294	44211054	8000	44214294	-4000	4000	-3240
chr7	6684433	6692433	6691156	8000	6688433	-4000	4000	2723
chr7	144182080	144190080	144187713	8000	144186080	-4000	4000	1633
chr7	93095513	93103513	93103429	8000	93099513	-4000	4000	3916
chr7	154890285	154898285	154892812	8000	154894285	-4000	4000	-1473
chr7	128950180	128958180	128955070	8000	128954180	-4000	4000	890
chr7	23173914	23181914	23174382	8000	23177914	-4000	4000	-3532
chr7	143135739	143143739	143139597	8000	143139739	-4000	4000	-142
chr7	143751089	143759089	143756494	8000	143755089	-4000	4000	1405
chr7	150517073	150525073	150520818	8000	150521073	-4000	4000	-255
chr7	144262674	144270674	144268312	8000	144266674	-4000	4000	1638
chr7	12326885	12334885	12333505	8000	12330885	-4000	4000	2620
chr7	124739885	124747885	124746970	8000	124743885	-4000	4000	3085
chr7	128346325	128354325	128350903	8000	128350325	-4000	4000	578
chr7	53032925	53040925	53036530	8000	53036925	-4000	4000	-395
chr7	90234137	90242137	90236969	8000	90238137	-4000	4000	-1168
chr7	129484399	129492399	129485734	8000	129488399	-4000	4000	-2665
chr7	4265000	4273000	4268677	8000	4269000	-4000	4000	-323
chr7	71709600	71717600	71710862	8000	71713600	-4000	4000	-2738
chr7	26183137	26191137	26184664	8000	26187137	-4000	4000	-2473
chr7	35198430	35206430	35202642	8000	35202430	-4000	4000	212
chr7	31333465	31341465	31338553	8000	31337465	-4000	4000	1088
chr7	44006124	44014124	44007742	8000	44010124	-4000	4000	-2382
chr7	90160829	90168829	90164786	8000	90164829	-4000	4000	-43
chr7	105106704	105114704	105109172	8000	105110704	-4000	4000	-1532
chr7	21510822	21518822	21511254	8000	21514822	-4000	4000	-3568
chr7	44508535	44516535	44515822	8000	44512535	-4000	4000	3287
chr7	122990704	122998704	122994953	8000	122994704	-4000	4000	249
chr7	124739885	124747885	124747267	8000	124743885	-4000	4000	3382
chr7	30420527	30428527	30425384	8000	30424527	-4000	4000	857
chr7	90160829	90168829	90161262	8000	90164829	-4000	4000	-3567
chr7	144106539	144114539	144109752	8000	144110539	-4000	4000	-787
chr7	35198430	35206430	35202690	8000	35202430	-4000	4000	260
chr7	100611384	100619384	100613267	8000	100615384	-4000	4000	-2117
chr7	48923454	48931454	48924975	8000	48927454	-4000	4000	-2479
chr7	75145817	75153817	75148707	8000	75149817	-4000	4000	-1110
chr7	149468696	149476696	149473957	8000	149472696	-4000	4000	1261
chr7	8748961	8756961	8752445	8000	8752961	-4000	4000	-516
chr7	27149716	27157716	27152722	8000	27153716	-4000	4000	-994
chr7	151043782	151051782	151048985	8000	151047782	-4000	4000	1203
chr7	18022770	18030770	18027659	8000	18026770	-4000	4000	889
chr7	120783320	120791320	120788855	8000	120787320	-4000	4000	1535
chr7	123873481	123881481	123876790	8000	123877481	-4000	4000	-691
chr7	8109184	8117184	8113995	8000	8113184	-4000	4000	811
chr7	26183137	26191137	26184647	8000	26187137	-4000	4000	-2490
chr7	130726697	130734697	130732961	8000	130730697	-4000	4000	2264
chr7	124026921	124034921	124032773	8000	124030921	-4000	4000	1852
chr7	137870979	137878979	137876060	8000	137874979	-4000	4000	1081
chr7	100869454	100877454	100870636	8000	100873454	-4000	4000	-2818
chr7	70789506	70797506	70790705	8000	70793506	-4000	4000	-2801
chr7	142867094	142875094	142873464	8000	142871094	-4000	4000	2370
chr7	150689641	150697641	150692746	8000	150693641	-4000	4000	-895
chr7	7604932	7612932	7606042	8000	7608932	-4000	4000	-2890
chr7	93126056	93134056	93132140	8000	93130056	-4000	4000	2084
chr7	28949358	28957358	28953881	8000	28953358	-4000	4000	523
chr7	103467381	103475381	103472864	8000	103471381	-4000	4000	1483
chr7	141652728	141660728	141652972	8000	141656728	-4000	4000	-3756
chr7	42905273	42913273	42910716	8000	42909273	-4000	4000	1443
chr7	152118340	152126340	152118881	8000	152122340	-4000	4000	-3459
chr7	31333465	31341465	31339045	8000	31337465	-4000	4000	1580
chr7	101166496	101174496	101174428	8000	101170496	-4000	4000	3932
chr7	114689772	114697772	114689825	8000	114693772	-4000	4000	-3947
chr7	150857504	150865504	150857506	8000	150861504	-4000	4000	-3998
chr7	75806825	75814825	75813338	8000	75810825	-4000	4000	2513
chr7	142867208	142875208	142875147	8000	142871208	-4000	4000	3939
chr7	89334528	89342528	89335619	8000	89338528	-4000	4000	-2909
chr7	93095513	93103513	93101249	8000	93099513	-4000	4000	1736
chr7	24792540	24800540	24800154	8000	24796540	-4000	4000	3614
chr7	150334317	150342317	150337987	8000	150338317	-4000	4000	-330
chr7	116557179	116565179	116559136	8000	116561179	-4000	4000	-2043
chr7	130384114	130392114	130387858	8000	130388114	-4000	4000	-256
chr7	142904101	142912101	142908627	8000	142908101	-4000	4000	526
chr7	64829681	64837681	64831680	8000	64833681	-4000	4000	-2001
chr7	100597117	100605117	100600800	8000	100601117	-4000	4000	-317
chr7	138702294	138710294	138709754	8000	138706294	-4000	4000	3460
chr7	129209545	129217545	129210977	8000	129213545	-4000	4000	-2568
chr7	23173914	23181914	23174107	8000	23177914	-4000	4000	-3807
chr7	23173914	23181914	23174108	8000	23177914	-4000	4000	-3806
chr7	31333465	31341465	31338307	8000	31337465	-4000	4000	842
chr7	73861890	73869890	73865250	8000	73865890	-4000	4000	-640
chr7	8748961	8756961	8751597	8000	8752961	-4000	4000	-1364
chr7	93095513	93103513	93102521	8000	93099513	-4000	4000	3008
chr7	141727271	141735271	141727342	8000	141731271	-4000	4000	-3929
chr7	141832300	141840300	141838068	8000	141836300	-4000	4000	1768
chr7	8748961	8756961	8751520	8000	8752961	-4000	4000	-1441
chr7	27149716	27157716	27155060	8000	27153716	-4000	4000	1344
chr7	27102184	27110184	27107868	8000	27106184	-4000	4000	1684
chr7	256772	264772	259819	8000	260772	-4000	4000	-953
chr7	102475976	102483976	102478861	8000	102479976	-4000	4000	-1115
chr7	102578523	102586523	102581345	8000	102582523	-4000	4000	-1178
chr7	151043782	151051782	151048946	8000	151047782	-4000	4000	1164
chr7	27177157	27185157	27182904	8000	27181157	-4000	4000	1747
chr7	44139213	44147213	44145565	8000	44143213	-4000	4000	2352
chr7	86872906	86880906	86880389	8000	86876906	-4000	4000	3483
chr7	93126056	93134056	93133885	8000	93130056	-4000	4000	3829
chr7	98842488	98850488	98847891	8000	98846488	-4000	4000	1403
chr7	122314411	122322411	122320176	8000	122318411	-4000	4000	1765
chr7	129209545	129217545	129212448	8000	129213545	-4000	4000	-1097
chr7	140998610	141006610	141006293	8000	141002610	-4000	4000	3683
chr7	144182080	144190080	144188143	8000	144186080	-4000	4000	2063
chr7	148416998	148424998	148420873	8000	148420998	-4000	4000	-125
chr7	26183137	26191137	26184851	8000	26187137	-4000	4000	-2286
chr7	100088728	100096728	100089315	8000	100092728	-4000	4000	-3413
chr7	140019749	140027749	140024519	8000	140023749	-4000	4000	770
chr7	142663718	142671718	142671199	8000	142667718	-4000	4000	3481
chr7	150517073	150525073	150519997	8000	150521073	-4000	4000	-1076
chr7	32481338	32489338	32489301	8000	32485338	-4000	4000	3963
chr7	127606292	127614292	127613778	8000	127610292	-4000	4000	3486
chr7	14141049	14149049	14148318	8000	14145049	-4000	4000	3269
chr7	36508941	36516941	36513189	8000	36512941	-4000	4000	248
chr7	77636069	77644069	77639506	8000	77640069	-4000	4000	-563
chr7	97847677	97855677	97854642	8000	97851677	-4000	4000	2965
chr7	101191007	101199007	101195962	8000	101195007	-4000	4000	955
chr7	95579499	95587499	95587071	8000	95583499	-4000	4000	3572
chr7	144393240	144401240	144400234	8000	144397240	-4000	4000	2994
chr7	144094953	144102953	144095537	8000	144098953	-4000	4000	-3416
chr7	112477017	112485017	112484851	8000	112481017	-4000	4000	3834
chr7	112815147	112823147	112822083	8000	112819147	-4000	4000	2936
chr7	29563293	29571293	29566457	8000	29567293	-4000	4000	-836
chr7	48923454	48931454	48924887	8000	48927454	-4000	4000	-2567
chr7	18022770	18030770	18027324	8000	18026770	-4000	4000	554
chr7	75412786	75420786	75414942	8000	75416786	-4000	4000	-1844
chr7	113872777	113880777	113877723	8000	113876777	-4000	4000	946
chr7	129126793	129134793	129127226	8000	129130793	-4000	4000	-3567
chr7	27177157	27185157	27182664	8000	27181157	-4000	4000	1507
chr7	64515878	64523878	64520875	8000	64519878	-4000	4000	997
chr7	70789506	70797506	70790407	8000	70793506	-4000	4000	-3099
chr7	93095513	93103513	93102890	8000	93099513	-4000	4000	3377
chr7	122314411	122322411	122320078	8000	122318411	-4000	4000	1667
chr7	144071870	144079870	144074795	8000	144075870	-4000	4000	-1075
chr7	149251606	149259606	149253740	8000	149255606	-4000	4000	-1866
chr7	101135247	101143247	101137068	8000	101139247	-4000	4000	-2179
chr7	48104736	48112736	48108247	8000	48108736	-4000	4000	-489
chr7	4793055	4801055	4799237	8000	4797055	-4000	4000	2182
chr7	6684433	6692433	6691718	8000	6688433	-4000	4000	3285
chr7	31333465	31341465	31337482	8000	31337465	-4000	4000	17
chr7	44139213	44147213	44145090	8000	44143213	-4000	4000	1877
chr7	74785315	74793315	74788610	8000	74789315	-4000	4000	-705
chr7	77325533	77333533	77326329	8000	77329533	-4000	4000	-3204
chr7	78013055	78021055	78017677	8000	78017055	-4000	4000	622
chr7	100124495	100132495	100128120	8000	100128495	-4000	4000	-375
chr7	100568228	100576228	100575608	8000	100572228	-4000	4000	3380
chr7	100793797	100801797	100797739	8000	100797797	-4000	4000	-58
chr7	101135247	101143247	101138060	8000	101139247	-4000	4000	-1187
chr7	105106704	105114704	105107778	8000	105110704	-4000	4000	-2926
chr7	113074331	113082331	113082098	8000	113078331	-4000	4000	3767
chr7	115015917	115023917	115016071	8000	115019917	-4000	4000	-3846
chr7	129426211	129434211	129427519	8000	129430211	-4000	4000	-2692
chr7	129753082	129761082	129755940	8000	129757082	-4000	4000	-1142
chr7	130389771	130397771	130397705	8000	130393771	-4000	4000	3934
chr7	132780870	132788870	132785651	8000	132784870	-4000	4000	781
chr7	157413439	157421439	157416114	8000	157417439	-4000	4000	-1325
chr7	151043782	151051782	151049069	8000	151047782	-4000	4000	1287
chr7	1743946	1751946	1745284	8000	1747946	-4000	4000	-2662
chr7	44872299	44880299	44879451	8000	44876299	-4000	4000	3152
chr7	150940961	150948961	150947677	8000	150944961	-4000	4000	2716
chr7	97016396	97024396	97020715	8000	97020396	-4000	4000	319
chr7	100396096	100404096	100400030	8000	100400096	-4000	4000	-66
chr7	143022200	143030200	143026856	8000	143026200	-4000	4000	656
chr7	101135247	101143247	101138220	8000	101139247	-4000	4000	-1027
chr7	124472955	124480955	124476433	8000	124476955	-4000	4000	-522
chr7	73432120	73440120	73435976	8000	73436120	-4000	4000	-144
chr7	30888081	30896081	30892076	8000	30892081	-4000	4000	-5
chr7	142867094	142875094	142868716	8000	142871094	-4000	4000	-2378
chr7	142867094	142875094	142868718	8000	142871094	-4000	4000	-2376
chr7	25220570	25228570	25225052	8000	25224570	-4000	4000	482
chr7	31333465	31341465	31339201	8000	31337465	-4000	4000	1736
chr7	93907265	93915265	93910763	8000	93911265	-4000	4000	-502
chr7	102805225	102813225	102808449	8000	102809225	-4000	4000	-776
chr7	108143623	108151623	108150733	8000	108147623	-4000	4000	3110
chr7	121293442	121301442	121295613	8000	121297442	-4000	4000	-1829
chr7	89334528	89342528	89335903	8000	89338528	-4000	4000	-2625
chr7	150517073	150525073	150520232	8000	150521073	-4000	4000	-841
chr7	16780536	16788536	16783976	8000	16784536	-4000	4000	-560
chr7	25130692	25138692	25136248	8000	25134692	-4000	4000	1556
chr7	26209607	26217607	26212333	8000	26213607	-4000	4000	-1274
chr7	27096354	27104354	27102120	8000	27100354	-4000	4000	1766
chr7	54748250	54756250	54752412	8000	54752250	-4000	4000	162
chr7	80738538	80746538	80744925	8000	80742538	-4000	4000	2387
chr7	102809230	102817230	102813392	8000	102813230	-4000	4000	162
chr7	108570850	108578850	108573526	8000	108574850	-4000	4000	-1324
chr7	113872777	113880777	113879051	8000	113876777	-4000	4000	2274
chr7	137870979	137878979	137876025	8000	137874979	-4000	4000	1046
chr7	144094953	144102953	144095328	8000	144098953	-4000	4000	-3625
chr7	150394630	150402630	150396680	8000	150398630	-4000	4000	-1950
chr7	150689641	150697641	150692990	8000	150693641	-4000	4000	-651
chr7	151043782	151051782	151048959	8000	151047782	-4000	4000	1177
chr7	152118340	152126340	152121589	8000	152122340	-4000	4000	-751
chr7	155083392	155091392	155084601	8000	155087392	-4000	4000	-2791
chr7	155777485	155785485	155777613	8000	155781485	-4000	4000	-3872
chr7	158726995	158734995	158734111	8000	158730995	-4000	4000	3116
chr7	142867094	142875094	142869820	8000	142871094	-4000	4000	-1274
chr7	144127188	144135188	144129830	8000	144131188	-4000	4000	-1358
chr7	56059989	56067989	56064361	8000	56063989	-4000	4000	372
chr7	76283288	76291288	76283594	8000	76287288	-4000	4000	-3694
chr7	135922760	135930760	135926875	8000	135926760	-4000	4000	115
chr7	122990704	122998704	122994783	8000	122994704	-4000	4000	79
chr7	23306209	23314209	23312370	8000	23310209	-4000	4000	2161
chr7	130384114	130392114	130385882	8000	130388114	-4000	4000	-2232
chr7	150857504	150865504	150858005	8000	150861504	-4000	4000	-3499
chr7	44508535	44516535	44513338	8000	44512535	-4000	4000	803
chr7	143440409	143448409	143444304	8000	143444409	-4000	4000	-105
chr7	44508535	44516535	44516176	8000	44512535	-4000	4000	3641
chr7	70789506	70797506	70790895	8000	70793506	-4000	4000	-2611
chr7	128088609	128096609	128091875	8000	128092609	-4000	4000	-734
chr7	143751089	143759089	143756561	8000	143755089	-4000	4000	1472
chr7	6684433	6692433	6692257	8000	6688433	-4000	4000	3824
chr7	149098784	149106784	149104841	8000	149102784	-4000	4000	2057
chr7	92483020	92491020	92489769	8000	92487020	-4000	4000	2749
chr7	120746337	120754337	120747709	8000	120750337	-4000	4000	-2628
chr7	74792150	74800150	74796975	8000	74796150	-4000	4000	825
chr7	75145817	75153817	75148984	8000	75149817	-4000	4000	-833
chr7	44958662	44966662	44965004	8000	44962662	-4000	4000	2342
chr7	144262674	144270674	144267117	8000	144266674	-4000	4000	443
chr7	2902142	2910142	2906721	8000	2906142	-4000	4000	579
chr7	25130692	25138692	25136587	8000	25134692	-4000	4000	1895
chr7	992986	1000986	997747	8000	996986	-4000	4000	761
chr7	121293442	121301442	121295465	8000	121297442	-4000	4000	-1977
chr7	126434598	126442598	126439126	8000	126438598	-4000	4000	528
chr7	144182080	144190080	144186993	8000	144186080	-4000	4000	913
chr7	43803342	43811342	43807081	8000	43807342	-4000	4000	-261
chr7	99046831	99054831	99047710	8000	99050831	-4000	4000	-3121
chr7	91206590	91214590	91209626	8000	91210590	-4000	4000	-964
chr7	28949358	28957358	28957281	8000	28953358	-4000	4000	3923
chr7	143303696	143311696	143305173	8000	143307696	-4000	4000	-2523
chr7	57113676	57121676	57119862	8000	57117676	-4000	4000	2186
chr7	156969176	156977176	156969567	8000	156973176	-4000	4000	-3609
chr7	128088609	128096609	128091876	8000	128092609	-4000	4000	-733
chr7	19140782	19148782	19145038	8000	19144782	-4000	4000	256
chr7	26370383	26378383	26372553	8000	26374383	-4000	4000	-1830
chr7	89334528	89342528	89336307	8000	89338528	-4000	4000	-2221
chr7	15607212	15615212	15611561	8000	15611212	-4000	4000	349
chr7	137870979	137878979	137875348	8000	137874979	-4000	4000	369
chr7	149098784	149106784	149105007	8000	149102784	-4000	4000	2223
chr7	150569953	150577953	150569962	8000	150573953	-4000	4000	-3991
chr7	65397136	65405136	65399915	8000	65401136	-4000	4000	-1221
chr7	122058036	122066036	122058882	8000	122062036	-4000	4000	-3154
chr7	23173914	23181914	23174040	8000	23177914	-4000	4000	-3874
chr7	105561120	105569120	105565450	8000	105565120	-4000	4000	330
chr7	135179839	135187839	135186104	8000	135183839	-4000	4000	2265
chr7	30493077	30501077	30496918	8000	30497077	-4000	4000	-159
chr7	30493077	30501077	30497139	8000	30497077	-4000	4000	62
chr7	95355872	95363872	95363814	8000	95359872	-4000	4000	3942
chr7	6684433	6692433	6691277	8000	6688433	-4000	4000	2844
chr7	21897839	21905839	21904238	8000	21901839	-4000	4000	2399
chr7	26183137	26191137	26185468	8000	26187137	-4000	4000	-1669
chr7	32481338	32489338	32487152	8000	32485338	-4000	4000	1814
chr7	97980684	97988684	97987082	8000	97984684	-4000	4000	2398
chr7	106086505	106094505	106093021	8000	106090505	-4000	4000	2516
chr7	149468696	149476696	149475235	8000	149472696	-4000	4000	2539
chr7	92108176	92116176	92113448	8000	92112176	-4000	4000	1272
chr7	30630033	30638033	30633739	8000	30634033	-4000	4000	-294
chr7	159024175	159032175	159030740	8000	159028175	-4000	4000	2565
chr7	6795365	6803365	6796753	8000	6799365	-4000	4000	-2612
chr7	73298516	73306516	73300570	8000	73302516	-4000	4000	-1946
chr7	93095513	93103513	93103264	8000	93099513	-4000	4000	3751
chr7	112815147	112823147	112821833	8000	112819147	-4000	4000	2686
chr7	151043782	151051782	151049073	8000	151047782	-4000	4000	1291
chr7	1233326	1241326	1233651	8000	1237326	-4000	4000	-3675
chr7	1233326	1241326	1233652	8000	1237326	-4000	4000	-3674
chr7	73308536	73316536	73313147	8000	73312536	-4000	4000	611
chr7	44508535	44516535	44513539	8000	44512535	-4000	4000	1004
chr7	99046831	99054831	99050946	8000	99050831	-4000	4000	115
chr7	97847677	97855677	97852458	8000	97851677	-4000	4000	781
chr7	77325533	77333533	77329477	8000	77329533	-4000	4000	-56
chr7	8748961	8756961	8751312	8000	8752961	-4000	4000	-1649
chr7	97016396	97024396	97022226	8000	97020396	-4000	4000	1830
chr7	27102184	27110184	27108388	8000	27106184	-4000	4000	2204
chr7	64707577	64715577	64707848	8000	64711577	-4000	4000	-3729
chr7	140019749	140027749	140026215	8000	140023749	-4000	4000	2466
chr7	31747179	31755179	31753086	8000	31751179	-4000	4000	1907
chr7	44006124	44014124	44007648	8000	44010124	-4000	4000	-2476
chr7	70789506	70797506	70790880	8000	70793506	-4000	4000	-2626
chr7	77789728	77797728	77794300	8000	77793728	-4000	4000	572
chr7	135162215	135170215	135168936	8000	135166215	-4000	4000	2721
chr7	100060033	100068033	100064622	8000	100064033	-4000	4000	589
chr7	143386289	143394289	143394236	8000	143390289	-4000	4000	3947
chr7	93420486	93428486	93426216	8000	93424486	-4000	4000	1730
chr7	108019548	108027548	108023840	8000	108023548	-4000	4000	292
chr7	15607212	15615212	15611469	8000	15611212	-4000	4000	257
chr7	143386289	143394289	143388800	8000	143390289	-4000	4000	-1489
chr7	128855274	128863274	128856846	8000	128859274	-4000	4000	-2428
chr7	23173914	23181914	23174528	8000	23177914	-4000	4000	-3386
chr7	95292415	95300415	95298939	8000	95296415	-4000	4000	2524
chr7	5302790	5310790	5308189	8000	5306790	-4000	4000	1399
chr7	43803342	43811342	43803727	8000	43807342	-4000	4000	-3615
chr7	55951239	55959239	55955016	8000	55955239	-4000	4000	-223
chr7	121344878	121352878	121350432	8000	121348878	-4000	4000	1554
chr7	93126056	93134056	93131521	8000	93130056	-4000	4000	1465
chr7	142867094	142875094	142870877	8000	142871094	-4000	4000	-217
chr7	150569953	150577953	150572458	8000	150573953	-4000	4000	-1495
chr7	15607212	15615212	15612508	8000	15611212	-4000	4000	1296
chr7	37947936	37955936	37949012	8000	37951936	-4000	4000	-2924
chr7	73432120	73440120	73435545	8000	73436120	-4000	4000	-575
chr7	892435	900435	893813	8000	896435	-4000	4000	-2622
chr7	5921550	5929550	5925806	8000	5925550	-4000	4000	256
chr7	5966925	5974925	5973537	8000	5970925	-4000	4000	2612
chr7	6620290	6628290	6621274	8000	6624290	-4000	4000	-3016
chr7	27149716	27157716	27156601	8000	27153716	-4000	4000	2885
chr7	27177157	27185157	27182696	8000	27181157	-4000	4000	1539
chr7	33010130	33018130	33015819	8000	33014130	-4000	4000	1689
chr7	33090797	33098797	33097275	8000	33094797	-4000	4000	2478
chr7	36297538	36305538	36299191	8000	36301538	-4000	4000	-2347
chr7	44134864	44142864	44140739	8000	44138864	-4000	4000	1875
chr7	64707577	64715577	64707883	8000	64711577	-4000	4000	-3694
chr7	64829681	64837681	64832697	8000	64833681	-4000	4000	-984
chr7	65397136	65405136	65399280	8000	65401136	-4000	4000	-1856
chr7	73298516	73306516	73304970	8000	73302516	-4000	4000	2454
chr7	75145817	75153817	75147936	8000	75149817	-4000	4000	-1881
chr7	75145817	75153817	75148219	8000	75149817	-4000	4000	-1598
chr7	81695010	81703010	81702512	8000	81699010	-4000	4000	3502
chr7	89334528	89342528	89335312	8000	89338528	-4000	4000	-3216
chr7	90160829	90168829	90164671	8000	90164829	-4000	4000	-158
chr7	92108176	92116176	92108564	8000	92112176	-4000	4000	-3612
chr7	93126056	93134056	93133100	8000	93130056	-4000	4000	3044
chr7	93126056	93134056	93134024	8000	93130056	-4000	4000	3968
chr7	97847677	97855677	97853062	8000	97851677	-4000	4000	1385
chr7	99412739	99420739	99416258	8000	99416739	-4000	4000	-481
chr7	100318196	100326196	100320816	8000	100322196	-4000	4000	-1380
chr7	100604175	100612175	100607803	8000	100608175	-4000	4000	-372
chr7	106904980	106912980	106905400	8000	106908980	-4000	4000	-3580
chr7	107197372	107205372	107201226	8000	107201372	-4000	4000	-146
chr7	113872777	113880777	113879588	8000	113876777	-4000	4000	2811
chr7	135644757	135652757	135648628	8000	135648757	-4000	4000	-129
chr7	143135739	143143739	143139715	8000	143139739	-4000	4000	-24
chr7	143386289	143394289	143393849	8000	143390289	-4000	4000	3560
chr7	149251606	149259606	149253569	8000	149255606	-4000	4000	-2037
chr7	150475393	150483393	150477893	8000	150479393	-4000	4000	-1500
chr7	150569953	150577953	150572458	8000	150573953	-4000	4000	-1495
chr7	150857504	150865504	150861108	8000	150861504	-4000	4000	-396
chr7	151043782	151051782	151049095	8000	151047782	-4000	4000	1313
chr7	151043782	151051782	151050226	8000	151047782	-4000	4000	2444
chr7	152118340	152126340	152118655	8000	152122340	-4000	4000	-3685
chr7	152118340	152126340	152121587	8000	152122340	-4000	4000	-753
chr7	90307063	90315063	90310078	8000	90311063	-4000	4000	-985
chr7	26183137	26191137	26184623	8000	26187137	-4000	4000	-2514
chr7	135644757	135652757	135648712	8000	135648757	-4000	4000	-45
chr7	57113676	57121676	57120612	8000	57117676	-4000	4000	2936
chr7	112758377	112766377	112766014	8000	112762377	-4000	4000	3637
chr7	141832300	141840300	141838040	8000	141836300	-4000	4000	1740
chr7	28821894	28829894	28824769	8000	28825894	-4000	4000	-1125
chr7	124026921	124034921	124032158	8000	124030921	-4000	4000	1237
chr7	158726995	158734995	158731897	8000	158730995	-4000	4000	902
chr7	74792150	74800150	74797050	8000	74796150	-4000	4000	900
chr7	142867094	142875094	142873465	8000	142871094	-4000	4000	2371
chr7	106244298	106252298	106251003	8000	106248298	-4000	4000	2705
chr7	105561120	105569120	105565356	8000	105565120	-4000	4000	236
chr7	143751089	143759089	143756831	8000	143755089	-4000	4000	1742
chr7	150746033	150754033	150749840	8000	150750033	-4000	4000	-193
chr7	42905273	42913273	42910813	8000	42909273	-4000	4000	1540
chr7	93184534	93192534	93188853	8000	93188534	-4000	4000	319
chr7	5229840	5237840	5231953	8000	5233840	-4000	4000	-1887
chr7	39704120	39712120	39708003	8000	39708120	-4000	4000	-117
chr7	142904101	142912101	142908496	8000	142908101	-4000	4000	395
chr7	135162215	135170215	135167894	8000	135166215	-4000	4000	1679
chr7	1743946	1751946	1744884	8000	1747946	-4000	4000	-3062
chr7	11165623	11173623	11169498	8000	11169623	-4000	4000	-125
chr7	27159535	27167535	27164938	8000	27163535	-4000	4000	1403
chr7	27177157	27185157	27182885	8000	27181157	-4000	4000	1728
chr7	31333465	31341465	31338616	8000	31337465	-4000	4000	1151
chr7	36297538	36305538	36299141	8000	36301538	-4000	4000	-2397
chr7	48923454	48931454	48925480	8000	48927454	-4000	4000	-1974
chr7	50586063	50594063	50592936	8000	50590063	-4000	4000	2873
chr7	55429737	55437737	55431307	8000	55433737	-4000	4000	-2430
chr7	57113676	57121676	57120420	8000	57117676	-4000	4000	2744
chr7	64262931	64270931	64266253	8000	64266931	-4000	4000	-678
chr7	64515878	64523878	64521786	8000	64519878	-4000	4000	1908
chr7	64707577	64715577	64708859	8000	64711577	-4000	4000	-2718
chr7	64926981	64934981	64928719	8000	64930981	-4000	4000	-2262
chr7	65397136	65405136	65398467	8000	65401136	-4000	4000	-2669
chr7	87397696	87405696	87398553	8000	87401696	-4000	4000	-3143
chr7	87397696	87405696	87402054	8000	87401696	-4000	4000	358
chr7	88201115	88209115	88208556	8000	88205115	-4000	4000	3441
chr7	92483020	92491020	92487271	8000	92487020	-4000	4000	251
chr7	93095513	93103513	93101852	8000	93099513	-4000	4000	2339
chr7	93126056	93134056	93132479	8000	93130056	-4000	4000	2423
chr7	93420486	93428486	93426502	8000	93424486	-4000	4000	2016
chr7	100060033	100068033	100064369	8000	100064033	-4000	4000	336
chr7	100165606	100173606	100167070	8000	100169606	-4000	4000	-2536
chr7	100396096	100404096	100401957	8000	100400096	-4000	4000	1861
chr7	101135247	101143247	101137534	8000	101139247	-4000	4000	-1713
chr7	104904561	104912561	104906249	8000	104908561	-4000	4000	-2312
chr7	105561120	105569120	105565246	8000	105565120	-4000	4000	126
chr7	105600772	105608772	105607609	8000	105604772	-4000	4000	2837
chr7	108143623	108151623	108150069	8000	108147623	-4000	4000	2446
chr7	108570850	108578850	108573042	8000	108574850	-4000	4000	-1808
chr7	113872777	113880777	113879315	8000	113876777	-4000	4000	2538
chr7	121293442	121301442	121295563	8000	121297442	-4000	4000	-1879
chr7	122990704	122998704	122995468	8000	122994704	-4000	4000	764
chr7	130726697	130734697	130733404	8000	130730697	-4000	4000	2707
chr7	134260591	134268591	134264027	8000	134264591	-4000	4000	-564
chr7	142936868	142944868	142941216	8000	142940868	-4000	4000	348
chr7	143049282	143057282	143052637	8000	143053282	-4000	4000	-645
chr7	143219079	143227079	143222332	8000	143223079	-4000	4000	-747
chr7	143751089	143759089	143756341	8000	143755089	-4000	4000	1252
chr7	143751089	143759089	143756638	8000	143755089	-4000	4000	1549
chr7	144094953	144102953	144095707	8000	144098953	-4000	4000	-3246
chr7	144447941	144455941	144453499	8000	144451941	-4000	4000	1558
chr7	151010588	151018588	151016706	8000	151014588	-4000	4000	2118
chr7	23699249	23707249	23702338	8000	23703249	-4000	4000	-911
chr7	25130692	25138692	25136024	8000	25134692	-4000	4000	1332
chr7	103467381	103475381	103472843	8000	103471381	-4000	4000	1462
chr7	107197372	107205372	107200162	8000	107201372	-4000	4000	-1210
chr7	150475393	150483393	150477734	8000	150479393	-4000	4000	-1659
chr7	151374449	151382449	151377154	8000	151378449	-4000	4000	-1295
chr7	26183137	26191137	26184905	8000	26187137	-4000	4000	-2232
chr7	97177763	97185763	97181017	8000	97181763	-4000	4000	-746
chr7	24694355	24702355	24699165	8000	24698355	-4000	4000	810
chr7	27149716	27157716	27156661	8000	27153716	-4000	4000	2945
chr7	120746337	120754337	120747795	8000	120750337	-4000	4000	-2542
chr7	149760182	149768182	149764803	8000	149764182	-4000	4000	621
chr7	141832300	141840300	141837189	8000	141836300	-4000	4000	889
chr7	4901989	4909989	4907384	8000	4905989	-4000	4000	1395
chr7	116794377	116802377	116795989	8000	116798377	-4000	4000	-2388
chr7	47983148	47991148	47987235	8000	47987148	-4000	4000	87
chr7	27177157	27185157	27184815	8000	27181157	-4000	4000	3658
chr7	15607212	15615212	15611581	8000	15611212	-4000	4000	369
chr7	143386289	143394289	143388844	8000	143390289	-4000	4000	-1445
chr7	97980684	97988684	97984884	8000	97984684	-4000	4000	200
chr7	107713809	107721809	107715430	8000	107717809	-4000	4000	-2379
chr7	135179839	135187839	135187074	8000	135183839	-4000	4000	3235
chr7	100604175	100612175	100605759	8000	100608175	-4000	4000	-2416
chr7	142248143	142256143	142252170	8000	142252143	-4000	4000	27
chr7	143303696	143311696	143303878	8000	143307696	-4000	4000	-3818
chr7	150857504	150865504	150857957	8000	150861504	-4000	4000	-3547
chr7	94427227	94435227	94427632	8000	94431227	-4000	4000	-3595
chr7	75765533	75773533	75769624	8000	75769533	-4000	4000	91
chr7	149098784	149106784	149104123	8000	149102784	-4000	4000	1339
chr7	149098784	149106784	149105219	8000	149102784	-4000	4000	2435
chr7	93126056	93134056	93132742	8000	93130056	-4000	4000	2686
chr7	141787367	141795367	141790497	8000	141791367	-4000	4000	-870
chr7	77953503	77961503	77955073	8000	77957503	-4000	4000	-2430
chr7	5882363	5890363	5886095	8000	5886363	-4000	4000	-268
chr7	19715315	19723315	19722072	8000	19719315	-4000	4000	2757
chr7	21897839	21905839	21899994	8000	21901839	-4000	4000	-1845
chr7	72955485	72963485	72960203	8000	72959485	-4000	4000	718
chr7	75765533	75773533	75771981	8000	75769533	-4000	4000	2448
chr7	97847677	97855677	97853183	8000	97851677	-4000	4000	1506
chr7	101555024	101563024	101557488	8000	101559024	-4000	4000	-1536
chr7	121337104	121345104	121339219	8000	121341104	-4000	4000	-1885
chr7	142663718	142671718	142670986	8000	142667718	-4000	4000	3268
chr7	143022200	143030200	143026971	8000	143026200	-4000	4000	771
chr7	144393240	144401240	144400260	8000	144397240	-4000	4000	3020
chr7	149098784	149106784	149103777	8000	149102784	-4000	4000	993
chr7	151043782	151051782	151049277	8000	151047782	-4000	4000	1495
chr7	100719700	100727700	100723052	8000	100723700	-4000	4000	-648
chr7	33002930	33010930	33005343	8000	33006930	-4000	4000	-1587
chr7	84991553	84999553	84999500	8000	84995553	-4000	4000	3947
chr7	134260591	134268591	134263881	8000	134264591	-4000	4000	-710
chr7	93095513	93103513	93102630	8000	93099513	-4000	4000	3117
chr7	72955485	72963485	72960135	8000	72959485	-4000	4000	650
chr7	99644194	99652194	99648312	8000	99648194	-4000	4000	118
chr7	112815147	112823147	112820321	8000	112819147	-4000	4000	1174
chr7	23306209	23314209	23309516	8000	23310209	-4000	4000	-693
chr7	57113676	57121676	57121054	8000	57117676	-4000	4000	3378
chr7	57469559	57477559	57469660	8000	57473559	-4000	4000	-3899
chr7	149760182	149768182	149764858	8000	149764182	-4000	4000	676
chr7	64829681	64837681	64832139	8000	64833681	-4000	4000	-1542
chr7	93126056	93134056	93131435	8000	93130056	-4000	4000	1379
chr7	107197372	107205372	107201439	8000	107201372	-4000	4000	67
chr7	1743946	1751946	1747100	8000	1747946	-4000	4000	-846
chr7	116557179	116565179	116559279	8000	116561179	-4000	4000	-1900
chr7	132780870	132788870	132785651	8000	132784870	-4000	4000	781
chr7	141832300	141840300	141836304	8000	141836300	-4000	4000	4
chr7	106244298	106252298	106250901	8000	106248298	-4000	4000	2603
chr7	112339934	112347934	112342594	8000	112343934	-4000	4000	-1340
chr7	56059989	56067989	56062757	8000	56063989	-4000	4000	-1232
chr7	129209545	129217545	129212389	8000	129213545	-4000	4000	-1156
chr7	21897839	21905839	21901191	8000	21901839	-4000	4000	-648
chr7	64515878	64523878	64522264	8000	64519878	-4000	4000	2386
chr7	150517073	150525073	150520942	8000	150521073	-4000	4000	-131
chr7	256772	264772	258679	8000	260772	-4000	4000	-2093
chr7	140998610	141006610	141006449	8000	141002610	-4000	4000	3839
chr7	33002930	33010930	33005279	8000	33006930	-4000	4000	-1651
chr7	73432120	73440120	73434746	8000	73436120	-4000	4000	-1374
chr7	149098784	149106784	149103540	8000	149102784	-4000	4000	756
chr7	73668112	73676112	73670054	8000	73672112	-4000	4000	-2058
chr7	149098784	149106784	149104137	8000	149102784	-4000	4000	1353
chr7	34152427	34160427	34153191	8000	34156427	-4000	4000	-3236
chr7	36508941	36516941	36513251	8000	36512941	-4000	4000	310
chr7	66807189	66815189	66809456	8000	66811189	-4000	4000	-1733
chr7	143049282	143057282	143052685	8000	143053282	-4000	4000	-597
chr7	26183137	26191137	26184926	8000	26187137	-4000	4000	-2211
chr7	26183137	26191137	26185013	8000	26187137	-4000	4000	-2124
chr7	124818386	124826386	124823889	8000	124822386	-4000	4000	1503
chr7	108019548	108027548	108023952	8000	108023548	-4000	4000	404
chr7	45072469	45080469	45074274	8000	45076469	-4000	4000	-2195
chr7	142248143	142256143	142252491	8000	142252143	-4000	4000	348
chr7	97007040	97015040	97009891	8000	97011040	-4000	4000	-1149
chr7	100151944	100159944	100159786	8000	100155944	-4000	4000	3842
chr7	105106704	105114704	105111970	8000	105110704	-4000	4000	1266
chr7	73298516	73306516	73305081	8000	73302516	-4000	4000	2565
chr7	26183137	26191137	26186021	8000	26187137	-4000	4000	-1116
chr7	26183137	26191137	26186023	8000	26187137	-4000	4000	-1114
chr7	149098784	149106784	149104498	8000	149102784	-4000	4000	1714
chr7	84991553	84999553	84999416	8000	84995553	-4000	4000	3863
chr7	19140782	19148782	19145516	8000	19144782	-4000	4000	734
chr7	149468696	149476696	149474190	8000	149472696	-4000	4000	1494
chr7	98625869	98633869	98629491	8000	98629869	-4000	4000	-378
chr7	99872958	99880958	99876483	8000	99876958	-4000	4000	-475
chr7	27102184	27110184	27108443	8000	27106184	-4000	4000	2259
chr7	99628408	99636408	99629897	8000	99632408	-4000	4000	-2511
chr7	51012212	51020212	51017503	8000	51016212	-4000	4000	1291
chr7	26370383	26378383	26372523	8000	26374383	-4000	4000	-1860
chr7	127606292	127614292	127611132	8000	127610292	-4000	4000	840
chr7	151374449	151382449	151377268	8000	151378449	-4000	4000	-1181
chr7	122990704	122998704	122994793	8000	122994704	-4000	4000	89
chr7	25130692	25138692	25135854	8000	25134692	-4000	4000	1162
chr7	100102876	100110876	100105258	8000	100106876	-4000	4000	-1618
chr7	27096354	27104354	27100803	8000	27100354	-4000	4000	449
chr7	149098784	149106784	149104724	8000	149102784	-4000	4000	1940
chr7	101191007	101199007	101198733	8000	101195007	-4000	4000	3726
chr7	150621375	150629375	150628294	8000	150625375	-4000	4000	2919
chr7	27088993	27096993	27095331	8000	27092993	-4000	4000	2338
chr7	44110680	44118680	44110738	8000	44114680	-4000	4000	-3942
chr7	144106539	144114539	144110195	8000	144110539	-4000	4000	-344
chr7	21897839	21905839	21903096	8000	21901839	-4000	4000	1257
chr7	101555024	101563024	101557458	8000	101559024	-4000	4000	-1566
chr7	19140782	19148782	19145084	8000	19144782	-4000	4000	302
chr7	76605986	76613986	76610207	8000	76609986	-4000	4000	221
chr7	107197372	107205372	107201206	8000	107201372	-4000	4000	-166
chr7	138114305	138122305	138116737	8000	138118305	-4000	4000	-1568
chr7	23197011	23205011	23200764	8000	23201011	-4000	4000	-247
chr7	56059989	56067989	56060917	8000	56063989	-4000	4000	-3072
chr7	143349400	143357400	143357006	8000	143353400	-4000	4000	3606
chr7	100604175	100612175	100607647	8000	100608175	-4000	4000	-528
chr7	97007040	97015040	97009959	8000	97011040	-4000	4000	-1081
chr7	87397696	87405696	87402063	8000	87401696	-4000	4000	367
chr7	94427227	94435227	94428441	8000	94431227	-4000	4000	-2786
chr7	144393240	144401240	144399032	8000	144397240	-4000	4000	1792
chr7	19140782	19148782	19145162	8000	19144782	-4000	4000	380
chr7	24287862	24295862	24291664	8000	24291862	-4000	4000	-198
chr7	149098784	149106784	149103663	8000	149102784	-4000	4000	879
chr7	93126056	93134056	93133539	8000	93130056	-4000	4000	3483
chr7	4901989	4909989	4907501	8000	4905989	-4000	4000	1512
chr7	93095513	93103513	93102102	8000	93099513	-4000	4000	2589
chr7	106244298	106252298	106251003	8000	106248298	-4000	4000	2705
chr7	100616416	100624416	100620832	8000	100620416	-4000	4000	416
chr7	6684433	6692433	6692205	8000	6688433	-4000	4000	3772
chr7	43803342	43811342	43807048	8000	43807342	-4000	4000	-294
chr7	97016396	97024396	97020626	8000	97020396	-4000	4000	230
chr7	28949358	28957358	28957356	8000	28953358	-4000	4000	3998
chr7	150475393	150483393	150477840	8000	150479393	-4000	4000	-1553
chr7	6325411	6333411	6330324	8000	6329411	-4000	4000	913
chr7	44139213	44147213	44145135	8000	44143213	-4000	4000	1922
chr7	56059989	56067989	56060318	8000	56063989	-4000	4000	-3671
chr7	66954551	66962551	66955577	8000	66958551	-4000	4000	-2974
chr7	100597117	100605117	100603910	8000	100601117	-4000	4000	2793
chr7	129753082	129761082	129755346	8000	129757082	-4000	4000	-1736
chr7	142867094	142875094	142868619	8000	142871094	-4000	4000	-2475
chr7	150689641	150697641	150693012	8000	150693641	-4000	4000	-629
chr7	155306235	155314235	155308475	8000	155310235	-4000	4000	-1760
chr7	129126793	129134793	129127663	8000	129130793	-4000	4000	-3130
chr7	75806825	75814825	75813320	8000	75810825	-4000	4000	2495
chr7	16787811	16795811	16794967	8000	16791811	-4000	4000	3156
chr7	57113676	57121676	57119945	8000	57117676	-4000	4000	2269
chr7	74193122	74201122	74196396	8000	74197122	-4000	4000	-726
chr7	97016396	97024396	97024269	8000	97020396	-4000	4000	3873
chr7	102475976	102483976	102478840	8000	102479976	-4000	4000	-1136
chr7	142936868	142944868	142939738	8000	142940868	-4000	4000	-1130
chr7	155460831	155468831	155462660	8000	155464831	-4000	4000	-2171
chr7	93907265	93915265	93910785	8000	93911265	-4000	4000	-480
chr7	128855274	128863274	128856634	8000	128859274	-4000	4000	-2640
chr7	113872777	113880777	113877717	8000	113876777	-4000	4000	940
chr7	152015929	152023929	152019775	8000	152019929	-4000	4000	-154
chr7	152118340	152126340	152121815	8000	152122340	-4000	4000	-525
chr8	10602349	10610349	10609094	8000	10606349	-4000	4000	2745
chr8	85477493	85485493	85480750	8000	85481493	-4000	4000	-743
chr8	66624487	66632487	66630477	8000	66628487	-4000	4000	1990
chr8	22044809	22052809	22046182	8000	22048809	-4000	4000	-2627
chr8	30674066	30682066	30679512	8000	30678066	-4000	4000	1446
chr8	100129351	100137351	100133759	8000	100133351	-4000	4000	408
chr8	144136851	144144851	144139267	8000	144140851	-4000	4000	-1584
chr8	144389242	144397242	144393893	8000	144393242	-4000	4000	651
chr8	144445582	144453582	144452384	8000	144449582	-4000	4000	2802
chr8	11756002	11764002	11759948	8000	11760002	-4000	4000	-54
chr8	129744196	129752196	129748586	8000	129748196	-4000	4000	390
chr8	144136851	144144851	144139228	8000	144140851	-4000	4000	-1623
chr8	22600150	22608150	22607244	8000	22604150	-4000	4000	3094
chr8	42832674	42840674	42838059	8000	42836674	-4000	4000	1385
chr8	63208786	63216786	63209731	8000	63212786	-4000	4000	-3055
chr8	73044123	73052123	73046315	8000	73048123	-4000	4000	-1808
chr8	81689631	81697631	81694541	8000	81693631	-4000	4000	910
chr8	102822111	102830111	102829857	8000	102826111	-4000	4000	3746
chr8	142780882	142788882	142785278	8000	142784882	-4000	4000	396
chr8	144389242	144397242	144393315	8000	144393242	-4000	4000	73
chr8	144768224	144776224	144774578	8000	144772224	-4000	4000	2354
chr8	76976258	76984258	76983275	8000	76980258	-4000	4000	3017
chr8	79758371	79766371	79765319	8000	79762371	-4000	4000	2948
chr8	142912506	142920506	142915070	8000	142916506	-4000	4000	-1436
chr8	72934349	72942349	72936241	8000	72938349	-4000	4000	-2108
chr8	87866747	87874747	87873014	8000	87870747	-4000	4000	2267
chr8	109561996	109569996	109564895	8000	109565996	-4000	4000	-1101
chr8	48913598	48921598	48921404	8000	48917598	-4000	4000	3806
chr8	87866747	87874747	87873859	8000	87870747	-4000	4000	3112
chr8	92879532	92887532	92886670	8000	92883532	-4000	4000	3138
chr8	94245253	94253253	94250268	8000	94249253	-4000	4000	1015
chr8	100255278	100263278	100259909	8000	100259278	-4000	4000	631
chr8	144768224	144776224	144773837	8000	144772224	-4000	4000	1613
chr8	144768224	144776224	144774094	8000	144772224	-4000	4000	1870
chr8	109569978	109577978	109575206	8000	109573978	-4000	4000	1228
chr8	133130903	133138903	133133498	8000	133134903	-4000	4000	-1405
chr8	26654178	26662178	26658129	8000	26658178	-4000	4000	-49
chr8	81520981	81528981	81525082	8000	81524981	-4000	4000	101
chr8	133233175	133241175	133238568	8000	133237175	-4000	4000	1393
chr8	73044123	73052123	73046309	8000	73048123	-4000	4000	-1814
chr8	119553086	119561086	119557528	8000	119557086	-4000	4000	442
chr8	81436326	81444326	81443356	8000	81440326	-4000	4000	3030
chr8	58579508	58587508	58580542	8000	58583508	-4000	4000	-2966
chr8	76863281	76871281	76864481	8000	76867281	-4000	4000	-2800
chr8	2931353	2939353	2938686	8000	2935353	-4000	4000	3333
chr8	143973153	143981153	143975285	8000	143977153	-4000	4000	-1868
chr8	120046918	120054918	120049601	8000	120050918	-4000	4000	-1317
chr8	121608116	121616116	121614604	8000	121612116	-4000	4000	2488
chr8	71193433	71201433	71199174	8000	71197433	-4000	4000	1741
chr8	78671743	78679743	78678605	8000	78675743	-4000	4000	2862
chr8	105800539	105808539	105804339	8000	105804539	-4000	4000	-200
chr8	86210063	86218063	86217695	8000	86214063	-4000	4000	3632
chr8	95152685	95160685	95154403	8000	95156685	-4000	4000	-2282
chr8	105800539	105808539	105802782	8000	105804539	-4000	4000	-1757
chr8	40012397	40020397	40015256	8000	40016397	-4000	4000	-1141
chr8	81689631	81697631	81694053	8000	81693631	-4000	4000	422
chr8	121608116	121616116	121614151	8000	121612116	-4000	4000	2035
chr8	133233175	133241175	133238908	8000	133237175	-4000	4000	1733
chr8	71837560	71845560	71843765	8000	71841560	-4000	4000	2205
chr8	144716907	144724907	144722586	8000	144720907	-4000	4000	1679
chr8	22002585	22010585	22005032	8000	22006585	-4000	4000	-1553
chr8	76976258	76984258	76983673	8000	76980258	-4000	4000	3415
chr8	23571463	23579463	23572303	8000	23575463	-4000	4000	-3160
chr8	80963810	80971810	80970324	8000	80967810	-4000	4000	2514
chr8	141428454	141436454	141433913	8000	141432454	-4000	4000	1459
chr8	118919557	118927557	118924112	8000	118923557	-4000	4000	555
chr8	142912506	142920506	142912660	8000	142916506	-4000	4000	-3846
chr8	104485231	104493231	104490884	8000	104489231	-4000	4000	1653
chr8	12178096	12186096	12182523	8000	12182096	-4000	4000	427
chr8	144257927	144265927	144258845	8000	144261927	-4000	4000	-3082
chr8	20140855	20148855	20145681	8000	20144855	-4000	4000	826
chr8	67169511	67177511	67175346	8000	67173511	-4000	4000	1835
chr8	23571463	23579463	23573918	8000	23575463	-4000	4000	-1545
chr8	36932125	36940125	36935742	8000	36936125	-4000	4000	-383
chr8	144047266	144055266	144055173	8000	144051266	-4000	4000	3907
chr8	123206079	123214079	123209685	8000	123210079	-4000	4000	-394
chr8	52939734	52947734	52940190	8000	52943734	-4000	4000	-3544
chr8	70105782	70113782	70113621	8000	70109782	-4000	4000	3839
chr8	72934349	72942349	72937239	8000	72938349	-4000	4000	-1110
chr8	79758371	79766371	79765215	8000	79762371	-4000	4000	2844
chr8	94877746	94885746	94881713	8000	94881746	-4000	4000	-33
chr8	100150003	100158003	100153475	8000	100154003	-4000	4000	-528
chr8	133233175	133241175	133239036	8000	133237175	-4000	4000	1861
chr8	142701127	142709127	142703007	8000	142705127	-4000	4000	-2120
chr8	144445582	144453582	144452528	8000	144449582	-4000	4000	2946
chr8	47974160	47982160	47975822	8000	47978160	-4000	4000	-2338
chr8	10602349	10610349	10607555	8000	10606349	-4000	4000	1206
chr8	24402013	24410013	24405403	8000	24406013	-4000	4000	-610
chr8	66558175	66566175	66564641	8000	66562175	-4000	4000	2466
chr8	87866747	87874747	87873675	8000	87870747	-4000	4000	2928
chr8	93727527	93735527	93728301	8000	93731527	-4000	4000	-3226
chr8	144768224	144776224	144773975	8000	144772224	-4000	4000	1751
chr8	144926358	144934358	144931336	8000	144930358	-4000	4000	978
chr8	27455391	27463391	27463312	8000	27459391	-4000	4000	3921
chr8	96607790	96615790	96610706	8000	96611790	-4000	4000	-1084
chr8	144047266	144055266	144052219	8000	144051266	-4000	4000	953
chr8	72934349	72942349	72936120	8000	72938349	-4000	4000	-2229
chr8	129744196	129752196	129750569	8000	129748196	-4000	4000	2373
chr8	144768224	144776224	144774442	8000	144772224	-4000	4000	2218
chr8	10892045	10900045	10898037	8000	10896045	-4000	4000	1992
chr8	74851029	74859029	74852999	8000	74855029	-4000	4000	-2030
chr8	127416066	127424066	127416235	8000	127420066	-4000	4000	-3831
chr8	10602349	10610349	10609250	8000	10606349	-4000	4000	2901
chr8	38265704	38273704	38267219	8000	38269704	-4000	4000	-2485
chr8	42170718	42178718	42176012	8000	42174718	-4000	4000	1294
chr8	105800539	105808539	105801495	8000	105804539	-4000	4000	-3044
chr8	18025948	18033948	18027710	8000	18029948	-4000	4000	-2238
chr8	54144514	54152514	54147587	8000	54148514	-4000	4000	-927
chr8	93922068	93930068	93922684	8000	93926068	-4000	4000	-3384
chr8	142912506	142920506	142914847	8000	142916506	-4000	4000	-1659
chr8	85445040	85453040	85446267	8000	85449040	-4000	4000	-2773
chr8	95152685	95160685	95154548	8000	95156685	-4000	4000	-2137
chr8	91394155	91402155	91397507	8000	91398155	-4000	4000	-648
chr8	38209301	38217301	38210028	8000	38213301	-4000	4000	-3273
chr8	129744196	129752196	129750542	8000	129748196	-4000	4000	2346
chr8	121608116	121616116	121614483	8000	121612116	-4000	4000	2367
chr8	142912506	142920506	142917195	8000	142916506	-4000	4000	689
chr8	109569978	109577978	109575471	8000	109573978	-4000	4000	1493
chr8	89923888	89931888	89924867	8000	89927888	-4000	4000	-3021
chr8	94367960	94375960	94372381	8000	94371960	-4000	4000	421
chr8	22142830	22150830	22148847	8000	22146830	-4000	4000	2017
chr8	18397218	18405218	18400099	8000	18401218	-4000	4000	-1119
chr8	105800539	105808539	105803625	8000	105804539	-4000	4000	-914
chr8	24402013	24410013	24402044	8000	24406013	-4000	4000	-3969
chr8	58579508	58587508	58586001	8000	58583508	-4000	4000	2493
chr8	67169511	67177511	67175367	8000	67173511	-4000	4000	1856
chr8	127416066	127424066	127416870	8000	127420066	-4000	4000	-3196
chr8	105800539	105808539	105802180	8000	105804539	-4000	4000	-2359
chr8	27455391	27463391	27458350	8000	27459391	-4000	4000	-1041
chr8	138126023	138134023	138132512	8000	138130023	-4000	4000	2489
chr8	26368680	26376680	26370139	8000	26372680	-4000	4000	-2541
chr8	89923888	89931888	89926397	8000	89927888	-4000	4000	-1491
chr8	23697740	23705740	23702737	8000	23701740	-4000	4000	997
chr8	96607790	96615790	96608401	8000	96611790	-4000	4000	-3389
chr8	10602349	10610349	10608710	8000	10606349	-4000	4000	2361
chr8	10602349	10610349	10608790	8000	10606349	-4000	4000	2441
chr8	56214809	56222809	56217469	8000	56218809	-4000	4000	-1340
chr8	10424891	10432891	10428264	8000	10428891	-4000	4000	-627
chr8	124116061	124124061	124119609	8000	124120061	-4000	4000	-452
chr8	41507095	41515095	41509741	8000	41511095	-4000	4000	-1354
chr8	76863281	76871281	76865936	8000	76867281	-4000	4000	-1345
chr8	40526590	40534590	40532174	8000	40530590	-4000	4000	1584
chr8	56108942	56116942	56113565	8000	56112942	-4000	4000	623
chr8	58801412	58809412	58805547	8000	58805412	-4000	4000	135
chr8	117172714	117180714	117176405	8000	117176714	-4000	4000	-309
chr8	19400161	19408161	19405982	8000	19404161	-4000	4000	1821
chr8	142912506	142920506	142912693	8000	142916506	-4000	4000	-3813
chr8	96235398	96243398	96235510	8000	96239398	-4000	4000	-3888
chr8	138126023	138134023	138132710	8000	138130023	-4000	4000	2687
chr8	60619644	60627644	60620675	8000	60623644	-4000	4000	-2969
chr8	39924790	39932790	39927959	8000	39928790	-4000	4000	-831
chr8	85142080	85150080	85145451	8000	85146080	-4000	4000	-629
chr8	85142080	85150080	85145766	8000	85146080	-4000	4000	-314
chr8	106755483	106763483	106761130	8000	106759483	-4000	4000	1647
chr8	6804517	6812517	6811406	8000	6808517	-4000	4000	2889
chr8	12178096	12186096	12185352	8000	12182096	-4000	4000	3256
chr8	72934349	72942349	72937348	8000	72938349	-4000	4000	-1001
chr8	123222189	123230189	123226485	8000	123226189	-4000	4000	296
chr8	78601267	78609267	78601827	8000	78605267	-4000	4000	-3440
chr8	98098344	98106344	98102548	8000	98102344	-4000	4000	204
chr8	54144514	54152514	54147618	8000	54148514	-4000	4000	-896
chr8	41649220	41657220	41654171	8000	41653220	-4000	4000	951
chr8	69656915	69664915	69659203	8000	69660915	-4000	4000	-1712
chr8	144445582	144453582	144450421	8000	144449582	-4000	4000	839
chr8	17118642	17126642	17120730	8000	17122642	-4000	4000	-1912
chr8	10602349	10610349	10609775	8000	10606349	-4000	4000	3426
chr8	26501636	26509636	26507702	8000	26505636	-4000	4000	2066
chr8	26654178	26662178	26658005	8000	26658178	-4000	4000	-173
chr8	27592917	27600917	27598601	8000	27596917	-4000	4000	1684
chr8	81280777	81288777	81284623	8000	81284777	-4000	4000	-154
chr8	95152685	95160685	95155692	8000	95156685	-4000	4000	-993
chr8	116940487	116948487	116942659	8000	116944487	-4000	4000	-1828
chr8	124975389	124983389	124977681	8000	124979389	-4000	4000	-1708
chr8	144716907	144724907	144722318	8000	144720907	-4000	4000	1411
chr8	76863281	76871281	76864333	8000	76867281	-4000	4000	-2948
chr8	87866747	87874747	87872714	8000	87870747	-4000	4000	1967
chr8	97849013	97857013	97851484	8000	97853013	-4000	4000	-1529
chr8	141203166	141211166	141207249	8000	141207166	-4000	4000	83
chr8	72015917	72023917	72022932	8000	72019917	-4000	4000	3015
chr8	144257927	144265927	144264520	8000	144261927	-4000	4000	2593
chr8	105800539	105808539	105803286	8000	105804539	-4000	4000	-1253
chr8	144716907	144724907	144722031	8000	144720907	-4000	4000	1124
chr8	81474419	81482419	81478829	8000	81478419	-4000	4000	410
chr8	144257927	144265927	144260791	8000	144261927	-4000	4000	-1136
chr8	47974160	47982160	47974904	8000	47978160	-4000	4000	-3256
chr8	10602349	10610349	10610269	8000	10606349	-4000	4000	3920
chr8	124484485	124492485	124486355	8000	124488485	-4000	4000	-2130
chr8	37930340	37938340	37935077	8000	37934340	-4000	4000	737
chr8	96235398	96243398	96235604	8000	96239398	-4000	4000	-3794
chr8	109569978	109577978	109574837	8000	109573978	-4000	4000	859
chr8	109569978	109577978	109574970	8000	109573978	-4000	4000	992
chr8	24915098	24923098	24917299	8000	24919098	-4000	4000	-1799
chr8	71193433	71201433	71199321	8000	71197433	-4000	4000	1888
chr8	76976258	76984258	76983104	8000	76980258	-4000	4000	2846
chr8	58579508	58587508	58579653	8000	58583508	-4000	4000	-3855
chr8	144926358	144934358	144930717	8000	144930358	-4000	4000	359
chr8	39924790	39932790	39928071	8000	39928790	-4000	4000	-719
chr8	40012397	40020397	40015368	8000	40016397	-4000	4000	-1029
chr8	87866747	87874747	87872992	8000	87870747	-4000	4000	2245
chr8	74025079	74033079	74026796	8000	74029079	-4000	4000	-2283
chr8	20140855	20148855	20147678	8000	20144855	-4000	4000	2823
chr8	109569978	109577978	109575823	8000	109573978	-4000	4000	1845
chr8	69656915	69664915	69658543	8000	69660915	-4000	4000	-2372
chr8	119829976	119837976	119832707	8000	119833976	-4000	4000	-1269
chr8	38140076	38148076	38144357	8000	38144076	-4000	4000	281
chr8	90989802	90997802	90995526	8000	90993802	-4000	4000	1724
chr8	106755483	106763483	106761001	8000	106759483	-4000	4000	1518
chr8	11417476	11425476	11424462	8000	11421476	-4000	4000	2986
chr8	104485231	104493231	104491357	8000	104489231	-4000	4000	2126
chr8	22078527	22086527	22081168	8000	22082527	-4000	4000	-1359
chr8	102200502	102208502	102207912	8000	102204502	-4000	4000	3410
chr8	73978783	73986783	73981434	8000	73982783	-4000	4000	-1349
chr8	485803	493803	492323	8000	489803	-4000	4000	2520
chr8	10602349	10610349	10608288	8000	10606349	-4000	4000	1939
chr8	124484485	124492485	124487906	8000	124488485	-4000	4000	-579
chr8	20242165	20250165	20249958	8000	20246165	-4000	4000	3793
chr8	28344287	28352287	28350068	8000	28348287	-4000	4000	1781
chr8	69656915	69664915	69658548	8000	69660915	-4000	4000	-2367
chr8	89787064	89795064	89790129	8000	89791064	-4000	4000	-935
chr8	123148153	123156153	123151809	8000	123152153	-4000	4000	-344
chr8	143153914	143161914	143158428	8000	143157914	-4000	4000	514
chr8	85477493	85485493	85480827	8000	85481493	-4000	4000	-666
chr8	24915098	24923098	24917353	8000	24919098	-4000	4000	-1745
chr8	119420434	119428434	119423404	8000	119424434	-4000	4000	-1030
chr8	119420434	119428434	119423405	8000	119424434	-4000	4000	-1029
chr8	98155835	98163835	98156063	8000	98159835	-4000	4000	-3772
chr8	6931820	6939820	6936796	8000	6935820	-4000	4000	976
chr8	42832674	42840674	42838229	8000	42836674	-4000	4000	1555
chr8	96138333	96146333	96142608	8000	96142333	-4000	4000	275
chr8	8779354	8787354	8786011	8000	8783354	-4000	4000	2657
chr8	86210063	86218063	86214407	8000	86214063	-4000	4000	344
chr8	94483689	94491689	94490070	8000	94487689	-4000	4000	2381
chr8	93727527	93735527	93728355	8000	93731527	-4000	4000	-3172
chr8	21904873	21912873	21912303	8000	21908873	-4000	4000	3430
chr8	124116061	124124061	124119816	8000	124120061	-4000	4000	-245
chr8	118919557	118927557	118924627	8000	118923557	-4000	4000	1070
chr8	105800539	105808539	105802148	8000	105804539	-4000	4000	-2391
chr8	72934349	72942349	72937048	8000	72938349	-4000	4000	-1301
chr8	42370063	42378063	42376982	8000	42374063	-4000	4000	2919
chr8	58486178	58494178	58491476	8000	58490178	-4000	4000	1298
chr8	109569978	109577978	109577881	8000	109573978	-4000	4000	3903
chr8	141352470	141360470	141357853	8000	141356470	-4000	4000	1383
chr8	16988181	16996181	16992935	8000	16992181	-4000	4000	754
chr8	81474419	81482419	81480446	8000	81478419	-4000	4000	2027
chr8	118919557	118927557	118926608	8000	118923557	-4000	4000	3051
chr8	42170718	42178718	42175890	8000	42174718	-4000	4000	1172
chr8	141352470	141360470	141357696	8000	141356470	-4000	4000	1226
chr8	100129351	100137351	100133911	8000	100133351	-4000	4000	560
chr8	30059003	30067003	30066838	8000	30063003	-4000	4000	3835
chr8	72934349	72942349	72936132	8000	72938349	-4000	4000	-2217
chr8	142912506	142920506	142913429	8000	142916506	-4000	4000	-3077
chr8	87866747	87874747	87873431	8000	87870747	-4000	4000	2684
chr8	6757503	6765503	6758386	8000	6761503	-4000	4000	-3117
chr8	52106838	52114838	52111796	8000	52110838	-4000	4000	958
chr8	56156909	56164909	56162763	8000	56160909	-4000	4000	1854
chr8	24946955	24954955	24954196	8000	24950955	-4000	4000	3241
chr8	11560599	11568599	11561441	8000	11564599	-4000	4000	-3158
chr8	102822111	102830111	102829318	8000	102826111	-4000	4000	3207
chr8	38396215	38404215	38400946	8000	38400215	-4000	4000	731
chr8	95152685	95160685	95154314	8000	95156685	-4000	4000	-2371
chr8	124975389	124983389	124976418	8000	124979389	-4000	4000	-2971
chr8	142701127	142709127	142703262	8000	142705127	-4000	4000	-1865
chr8	10602349	10610349	10607520	8000	10606349	-4000	4000	1171
chr8	73044123	73052123	73045990	8000	73048123	-4000	4000	-2133
chr8	106748694	106756694	106750824	8000	106752694	-4000	4000	-1870
chr8	40012397	40020397	40013637	8000	40016397	-4000	4000	-2760
chr8	21904873	21912873	21909248	8000	21908873	-4000	4000	375
chr8	105800539	105808539	105801664	8000	105804539	-4000	4000	-2875
chr8	117536262	117544262	117539931	8000	117540262	-4000	4000	-331
chr8	25503911	25511911	25507535	8000	25507911	-4000	4000	-376
chr8	100255278	100263278	100259924	8000	100259278	-4000	4000	646
chr8	30173208	30181208	30180530	8000	30177208	-4000	4000	3322
chr8	39101445	39109445	39103652	8000	39105445	-4000	4000	-1793
chr8	93922068	93930068	93922862	8000	93926068	-4000	4000	-3206
chr8	93922068	93930068	93922864	8000	93926068	-4000	4000	-3204
chr8	73978783	73986783	73978873	8000	73982783	-4000	4000	-3910
chr8	23571463	23579463	23574797	8000	23575463	-4000	4000	-666
chr8	72934349	72942349	72936936	8000	72938349	-4000	4000	-1413
chr8	100150003	100158003	100153461	8000	100154003	-4000	4000	-542
chr8	109117565	109125565	109119411	8000	109121565	-4000	4000	-2154
chr8	116638130	116646130	116644876	8000	116642130	-4000	4000	2746
chr8	100255278	100263278	100258497	8000	100259278	-4000	4000	-781
chr8	78671743	78679743	78675857	8000	78675743	-4000	4000	114
chr8	52618458	52626458	52623704	8000	52622458	-4000	4000	1246
chr8	86549977	86557977	86556168	8000	86553977	-4000	4000	2191
chr8	109236919	109244919	109242978	8000	109240919	-4000	4000	2059
chr8	35792550	35800550	35793699	8000	35796550	-4000	4000	-2851
chr8	24946955	24954955	24952898	8000	24950955	-4000	4000	1943
chr8	98155835	98163835	98156158	8000	98159835	-4000	4000	-3677
chr8	8700096	8708096	8703633	8000	8704096	-4000	4000	-463
chr8	67169511	67177511	67175470	8000	67173511	-4000	4000	1959
chr8	71193433	71201433	71198770	8000	71197433	-4000	4000	1337
chr8	73044123	73052123	73045992	8000	73048123	-4000	4000	-2131
chr8	130048104	130056104	130054442	8000	130052104	-4000	4000	2338
chr8	22002585	22010585	22005024	8000	22006585	-4000	4000	-1561
chr8	23674697	23682697	23681335	8000	23678697	-4000	4000	2638
chr8	109236919	109244919	109243118	8000	109240919	-4000	4000	2199
chr8	130776301	130784301	130780429	8000	130780301	-4000	4000	128
chr8	40151310	40159310	40154596	8000	40155310	-4000	4000	-714
chr8	40151310	40159310	40154837	8000	40155310	-4000	4000	-473
chr8	142912506	142920506	142912574	8000	142916506	-4000	4000	-3932
chr8	21904873	21912873	21909727	8000	21908873	-4000	4000	854
chr8	67418038	67426038	67422356	8000	67422038	-4000	4000	318
chr8	65598458	65606458	65604326	8000	65602458	-4000	4000	1868
chr8	109117565	109125565	109119494	8000	109121565	-4000	4000	-2071
chr8	73321281	73329281	73323075	8000	73325281	-4000	4000	-2206
chr8	19963259	19971259	19967231	8000	19967259	-4000	4000	-28
chr8	141191808	141199808	141192649	8000	141195808	-4000	4000	-3159
chr8	58579508	58587508	58585714	8000	58583508	-4000	4000	2206
chr8	144047266	144055266	144052866	8000	144051266	-4000	4000	1600
chr8	6866592	6874592	6870682	8000	6870592	-4000	4000	90
chr8	18219689	18227689	18222516	8000	18223689	-4000	4000	-1173
chr8	22537142	22545142	22540906	8000	22541142	-4000	4000	-236
chr8	25503911	25511911	25507120	8000	25507911	-4000	4000	-791
chr8	25503911	25511911	25507495	8000	25507911	-4000	4000	-416
chr8	27808640	27816640	27810287	8000	27812640	-4000	4000	-2353
chr8	38209301	38217301	38210058	8000	38213301	-4000	4000	-3243
chr8	72934349	72942349	72937322	8000	72938349	-4000	4000	-1027
chr8	90054608	90062608	90060682	8000	90058608	-4000	4000	2074
chr8	93922068	93930068	93922900	8000	93926068	-4000	4000	-3168
chr8	94245253	94253253	94253071	8000	94249253	-4000	4000	3818
chr8	94483689	94491689	94488605	8000	94487689	-4000	4000	916
chr8	118919557	118927557	118924356	8000	118923557	-4000	4000	799
chr8	70105782	70113782	70113211	8000	70109782	-4000	4000	3429
chr8	81436326	81444326	81442283	8000	81440326	-4000	4000	1957
chr8	101665726	101673726	101669500	8000	101669726	-4000	4000	-226
chr8	130776301	130784301	130780746	8000	130780301	-4000	4000	445
chr8	27541564	27549564	27544541	8000	27545564	-4000	4000	-1023
chr8	11417476	11425476	11424030	8000	11421476	-4000	4000	2554
chr8	12132435	12140435	12137651	8000	12136435	-4000	4000	1216
chr8	92879532	92887532	92884951	8000	92883532	-4000	4000	1419
chr8	96138333	96146333	96142803	8000	96142333	-4000	4000	470
chr8	105800539	105808539	105802948	8000	105804539	-4000	4000	-1591
chr8	94877746	94885746	94881626	8000	94881746	-4000	4000	-120
chr8	96138333	96146333	96143570	8000	96142333	-4000	4000	1237
chr8	121608116	121616116	121614549	8000	121612116	-4000	4000	2433
chr8	162086	170086	166434	8000	166086	-4000	4000	348
chr8	144926358	144934358	144931011	8000	144930358	-4000	4000	653
chr8	6804517	6812517	6811845	8000	6808517	-4000	4000	3328
chr8	7892716	7900716	7894701	8000	7896716	-4000	4000	-2015
chr8	81454253	81462253	81459220	8000	81458253	-4000	4000	967
chr8	109561996	109569996	109564436	8000	109565996	-4000	4000	-1560
chr8	121608116	121616116	121614969	8000	121612116	-4000	4000	2853
chr8	66558175	66566175	66564621	8000	66562175	-4000	4000	2446
chr8	27592917	27600917	27599986	8000	27596917	-4000	4000	3069
chr8	56108942	56116942	56113550	8000	56112942	-4000	4000	608
chr8	144768224	144776224	144773873	8000	144772224	-4000	4000	1649
chr8	11838524	11846524	11845166	8000	11842524	-4000	4000	2642
chr8	12420411	12428411	12424881	8000	12424411	-4000	4000	470
chr8	13079361	13087361	13083682	8000	13083361	-4000	4000	321
chr8	13079361	13087361	13084129	8000	13083361	-4000	4000	768
chr8	17220966	17228966	17221542	8000	17224966	-4000	4000	-3424
chr8	28344287	28352287	28349165	8000	28348287	-4000	4000	878
chr8	41649220	41657220	41654263	8000	41653220	-4000	4000	1043
chr8	67169511	67177511	67172553	8000	67173511	-4000	4000	-958
chr8	80030745	80038745	80037235	8000	80034745	-4000	4000	2490
chr8	84917844	84925844	84921056	8000	84921844	-4000	4000	-788
chr8	90955393	90963393	90958964	8000	90959393	-4000	4000	-429
chr8	94703466	94711466	94706187	8000	94707466	-4000	4000	-1279
chr8	119104455	119112455	119106138	8000	119108455	-4000	4000	-2317
chr8	121608116	121616116	121614753	8000	121612116	-4000	4000	2637
chr8	132844807	132852807	132847108	8000	132848807	-4000	4000	-1699
chr8	144257927	144265927	144260693	8000	144261927	-4000	4000	-1234
chr8	144257927	144265927	144260694	8000	144261927	-4000	4000	-1233
chr8	109341954	109349954	109343662	8000	109345954	-4000	4000	-2292
chr8	123206079	123214079	123209524	8000	123210079	-4000	4000	-555
chr8	21904873	21912873	21910786	8000	21908873	-4000	4000	1913
chr8	22142830	22150830	22148755	8000	22146830	-4000	4000	1925
chr8	33587330	33595330	33593708	8000	33591330	-4000	4000	2378
chr8	38969912	38977912	38975077	8000	38973912	-4000	4000	1165
chr8	81652914	81660914	81659444	8000	81656914	-4000	4000	2530
chr8	87866747	87874747	87873385	8000	87870747	-4000	4000	2638
chr8	124975389	124983389	124977237	8000	124979389	-4000	4000	-2152
chr8	124975389	124983389	124977450	8000	124979389	-4000	4000	-1939
chr8	142780882	142788882	142786468	8000	142784882	-4000	4000	1586
chr8	144768224	144776224	144773636	8000	144772224	-4000	4000	1412
chr8	144843509	144851509	144850737	8000	144847509	-4000	4000	3228
chr8	52618458	52626458	52622897	8000	52622458	-4000	4000	439
chr8	98948104	98956104	98950861	8000	98952104	-4000	4000	-1243
chr8	11838524	11846524	11845748	8000	11842524	-4000	4000	3224
chr8	142912506	142920506	142915174	8000	142916506	-4000	4000	-1332
chr8	97849013	97857013	97851462	8000	97853013	-4000	4000	-1551
chr8	96332995	96340995	96334400	8000	96336995	-4000	4000	-2595
chr8	56296005	56304005	56301554	8000	56300005	-4000	4000	1549
chr8	87866747	87874747	87873609	8000	87870747	-4000	4000	2862
chr8	118919557	118927557	118926552	8000	118923557	-4000	4000	2995
chr8	130048104	130056104	130054625	8000	130052104	-4000	4000	2521
chr8	47974160	47982160	47974748	8000	47978160	-4000	4000	-3412
chr8	81454253	81462253	81459181	8000	81458253	-4000	4000	928
chr8	71193433	71201433	71198577	8000	71197433	-4000	4000	1144
chr8	144807169	144815169	144809986	8000	144811169	-4000	4000	-1183
chr8	6931820	6939820	6936093	8000	6935820	-4000	4000	273
chr8	93922068	93930068	93922186	8000	93926068	-4000	4000	-3882
chr8	102644784	102652784	102650093	8000	102648784	-4000	4000	1309
chr8	90617995	90625995	90625047	8000	90621995	-4000	4000	3052
chr8	22002585	22010585	22004026	8000	22006585	-4000	4000	-2559
chr8	96138333	96146333	96144493	8000	96142333	-4000	4000	2160
chr8	94483689	94491689	94488757	8000	94487689	-4000	4000	1068
chr8	73978783	73986783	73981202	8000	73982783	-4000	4000	-1581
chr8	16103878	16111878	16110112	8000	16107878	-4000	4000	2234
chr8	37840896	37848896	37843681	8000	37844896	-4000	4000	-1215
chr8	41925479	41933479	41931953	8000	41929479	-4000	4000	2474
chr8	41257962	41265962	41265178	8000	41261962	-4000	4000	3216
chr8	144843509	144851509	144850658	8000	144847509	-4000	4000	3149
chr8	84917844	84925844	84920908	8000	84921844	-4000	4000	-936
chr8	105800539	105808539	105802580	8000	105804539	-4000	4000	-1959
chr8	37775768	37783768	37775935	8000	37779768	-4000	4000	-3833
chr8	144445582	144453582	144450541	8000	144449582	-4000	4000	959
chr8	42401937	42409937	42402126	8000	42405937	-4000	4000	-3811
chr8	26501636	26509636	26508440	8000	26505636	-4000	4000	2804
chr8	108485196	108493196	108486548	8000	108489196	-4000	4000	-2648
chr8	127416066	127424066	127416804	8000	127420066	-4000	4000	-3262
chr8	56156909	56164909	56162843	8000	56160909	-4000	4000	1934
chr8	90989802	90997802	90995502	8000	90993802	-4000	4000	1700
chr8	98185826	98193826	98193411	8000	98189826	-4000	4000	3585
chr8	75562834	75570834	75564007	8000	75566834	-4000	4000	-2827
chr8	21904873	21912873	21909248	8000	21908873	-4000	4000	375
chr8	23837929	23845929	23844631	8000	23841929	-4000	4000	2702
chr8	10892045	10900045	10898156	8000	10896045	-4000	4000	2111
chr8	11969937	11977937	11973968	8000	11973937	-4000	4000	31
chr8	13079361	13087361	13085754	8000	13083361	-4000	4000	2393
chr8	73978783	73986783	73981187	8000	73982783	-4000	4000	-1596
chr8	102557018	102565018	102560591	8000	102561018	-4000	4000	-427
chr8	144257927	144265927	144264255	8000	144261927	-4000	4000	2328
chr8	124975389	124983389	124977253	8000	124979389	-4000	4000	-2136
chr8	132009642	132017642	132010863	8000	132013642	-4000	4000	-2779
chr8	22600150	22608150	22607312	8000	22604150	-4000	4000	3162
chr8	144926358	144934358	144931449	8000	144930358	-4000	4000	1091
chr8	20140855	20148855	20145682	8000	20144855	-4000	4000	827
chr8	37930340	37938340	37937362	8000	37934340	-4000	4000	3022
chr8	96332995	96340995	96333565	8000	96336995	-4000	4000	-3430
chr8	112218928	112226928	112224898	8000	112222928	-4000	4000	1970
chr8	81436326	81444326	81443427	8000	81440326	-4000	4000	3101
chr8	2931353	2939353	2938553	8000	2935353	-4000	4000	3200
chr8	42367808	42375808	42371601	8000	42371808	-4000	4000	-207
chr8	40151310	40159310	40154987	8000	40155310	-4000	4000	-323
chr8	56214809	56222809	56217405	8000	56218809	-4000	4000	-1404
chr8	42367808	42375808	42374762	8000	42371808	-4000	4000	2954
chr8	144716907	144724907	144722867	8000	144720907	-4000	4000	1960
chr8	23292279	23300279	23297944	8000	23296279	-4000	4000	1665
chr8	22002585	22010585	22005181	8000	22006585	-4000	4000	-1404
chr8	42748620	42756620	42756137	8000	42752620	-4000	4000	3517
chr8	70569218	70577218	70574005	8000	70573218	-4000	4000	787
chr8	87866747	87874747	87872987	8000	87870747	-4000	4000	2240
chr8	104485231	104493231	104491307	8000	104489231	-4000	4000	2076
chr8	109569978	109577978	109575817	8000	109573978	-4000	4000	1839
chr8	10892045	10900045	10898569	8000	10896045	-4000	4000	2524
chr8	130776301	130784301	130780848	8000	130780301	-4000	4000	547
chr8	81689631	81697631	81693896	8000	81693631	-4000	4000	265
chr8	43198855	43206855	43199492	8000	43202855	-4000	4000	-3363
chr8	124975389	124983389	124977021	8000	124979389	-4000	4000	-2368
chr8	6804517	6812517	6811403	8000	6808517	-4000	4000	2886
chr8	93922068	93930068	93925022	8000	93926068	-4000	4000	-1046
chr8	10892045	10900045	10897931	8000	10896045	-4000	4000	1886
chr8	22100911	22108911	22107958	8000	22104911	-4000	4000	3047
chr8	29329064	29337064	29337030	8000	29333064	-4000	4000	3966
chr8	41257962	41265962	41265320	8000	41261962	-4000	4000	3358
chr8	42367808	42375808	42369937	8000	42371808	-4000	4000	-1871
chr8	42367808	42375808	42374197	8000	42371808	-4000	4000	2389
chr8	51813575	51821575	51820259	8000	51817575	-4000	4000	2684
chr8	63208786	63216786	63209884	8000	63212786	-4000	4000	-2902
chr8	64579627	64587627	64581594	8000	64583627	-4000	4000	-2033
chr8	73060543	73068543	73067454	8000	73064543	-4000	4000	2911
chr8	79758371	79766371	79765266	8000	79762371	-4000	4000	2895
chr8	85280073	85288073	85281422	8000	85284073	-4000	4000	-2651
chr8	89923888	89931888	89924773	8000	89927888	-4000	4000	-3115
chr8	93727527	93735527	93728405	8000	93731527	-4000	4000	-3122
chr8	94483689	94491689	94488600	8000	94487689	-4000	4000	911
chr8	100129351	100137351	100133805	8000	100133351	-4000	4000	454
chr8	102644784	102652784	102651801	8000	102648784	-4000	4000	3017
chr8	106755483	106763483	106761182	8000	106759483	-4000	4000	1699
chr8	107895316	107903316	107901165	8000	107899316	-4000	4000	1849
chr8	109236919	109244919	109243207	8000	109240919	-4000	4000	2288
chr8	124484485	124492485	124485862	8000	124488485	-4000	4000	-2623
chr8	124484485	124492485	124486099	8000	124488485	-4000	4000	-2386
chr8	141191808	141199808	141194099	8000	141195808	-4000	4000	-1709
chr8	98948104	98956104	98949091	8000	98952104	-4000	4000	-3013
chr8	53221724	53229724	53229587	8000	53225724	-4000	4000	3863
chr8	129835593	129843593	129842157	8000	129839593	-4000	4000	2564
chr8	38209301	38217301	38210283	8000	38213301	-4000	4000	-3018
chr8	104485231	104493231	104490618	8000	104489231	-4000	4000	1387
chr8	10892045	10900045	10898107	8000	10896045	-4000	4000	2062
chr8	42748620	42756620	42756400	8000	42752620	-4000	4000	3780
chr8	38140076	38148076	38145262	8000	38144076	-4000	4000	1186
chr8	76863281	76871281	76864172	8000	76867281	-4000	4000	-3109
chr8	127416066	127424066	127416805	8000	127420066	-4000	4000	-3261
chr8	42832674	42840674	42837700	8000	42836674	-4000	4000	1026
chr8	121608116	121616116	121614103	8000	121612116	-4000	4000	1987
chr8	142912506	142920506	142917193	8000	142916506	-4000	4000	687
chr8	102644784	102652784	102651798	8000	102648784	-4000	4000	3014
chr8	138126023	138134023	138132515	8000	138130023	-4000	4000	2492
chr8	118919557	118927557	118924358	8000	118923557	-4000	4000	801
chr8	95240913	95248913	95247470	8000	95244913	-4000	4000	2557
chr8	42167673	42175673	42169521	8000	42171673	-4000	4000	-2152
chr8	112218928	112226928	112224924	8000	112222928	-4000	4000	1996
chr8	130776301	130784301	130780698	8000	130780301	-4000	4000	397
chr8	25423847	25431847	25428524	8000	25427847	-4000	4000	677
chr8	16988181	16996181	16993150	8000	16992181	-4000	4000	969
chr8	22215703	22223703	22221712	8000	22219703	-4000	4000	2009
chr8	23016133	23024133	23022710	8000	23020133	-4000	4000	2577
chr8	23292279	23300279	23293306	8000	23296279	-4000	4000	-2973
chr8	24402013	24410013	24405506	8000	24406013	-4000	4000	-507
chr8	24915098	24923098	24917060	8000	24919098	-4000	4000	-2038
chr8	24946955	24954955	24952611	8000	24950955	-4000	4000	1656
chr8	26501636	26509636	26507614	8000	26505636	-4000	4000	1978
chr8	26501636	26509636	26508751	8000	26505636	-4000	4000	3115
chr8	27231308	27239308	27236893	8000	27235308	-4000	4000	1585
chr8	27455391	27463391	27458452	8000	27459391	-4000	4000	-939
chr8	27808640	27816640	27810391	8000	27812640	-4000	4000	-2249
chr8	28344287	28352287	28349175	8000	28348287	-4000	4000	888
chr8	30173208	30181208	30175118	8000	30177208	-4000	4000	-2090
chr8	30574318	30582318	30578995	8000	30578318	-4000	4000	677
chr8	30991802	30999802	30996583	8000	30995802	-4000	4000	781
chr8	33587330	33595330	33593555	8000	33591330	-4000	4000	2225
chr8	40526590	40534590	40531987	8000	40530590	-4000	4000	1397
chr8	42367808	42375808	42375770	8000	42371808	-4000	4000	3962
chr8	42733407	42741407	42736813	8000	42737407	-4000	4000	-594
chr8	58447501	58455501	58447655	8000	58451501	-4000	4000	-3846
chr8	63208786	63216786	63209777	8000	63212786	-4000	4000	-3009
chr8	73321281	73329281	73322993	8000	73325281	-4000	4000	-2288
chr8	81436326	81444326	81443258	8000	81440326	-4000	4000	2932
chr8	81520981	81528981	81527064	8000	81524981	-4000	4000	2083
chr8	81795581	81803581	81801416	8000	81799581	-4000	4000	1835
chr8	86210063	86218063	86217716	8000	86214063	-4000	4000	3653
chr8	89923888	89931888	89925111	8000	89927888	-4000	4000	-2777
chr8	90617995	90625995	90625822	8000	90621995	-4000	4000	3827
chr8	93922068	93930068	93923639	8000	93926068	-4000	4000	-2429
chr8	95152685	95160685	95154790	8000	95156685	-4000	4000	-1895
chr8	98098344	98106344	98106000	8000	98102344	-4000	4000	3656
chr8	102200502	102208502	102208220	8000	102204502	-4000	4000	3718
chr8	102644784	102652784	102651781	8000	102648784	-4000	4000	2997
chr8	116638130	116646130	116644945	8000	116642130	-4000	4000	2815
chr8	116841934	116849934	116847632	8000	116845934	-4000	4000	1698
chr8	119420434	119428434	119423148	8000	119424434	-4000	4000	-1286
chr8	121608116	121616116	121614433	8000	121612116	-4000	4000	2317
chr8	124484485	124492485	124487423	8000	124488485	-4000	4000	-1062
chr8	124546784	124554784	124547026	8000	124550784	-4000	4000	-3758
chr8	127416066	127424066	127417090	8000	127420066	-4000	4000	-2976
chr8	129835593	129843593	129842031	8000	129839593	-4000	4000	2438
chr8	142780882	142788882	142785596	8000	142784882	-4000	4000	714
chr8	142912506	142920506	142914308	8000	142916506	-4000	4000	-2198
chr8	143829583	143837583	143837481	8000	143833583	-4000	4000	3898
chr8	144716907	144724907	144723184	8000	144720907	-4000	4000	2277
chr8	144768224	144776224	144773596	8000	144772224	-4000	4000	1372
chr8	38209301	38217301	38210234	8000	38213301	-4000	4000	-3067
chr8	47974160	47982160	47974912	8000	47978160	-4000	4000	-3248
chr8	48913598	48921598	48918905	8000	48917598	-4000	4000	1307
chr8	85213158	85221158	85215068	8000	85217158	-4000	4000	-2090
chr8	94877746	94885746	94881451	8000	94881746	-4000	4000	-295
chr8	30059003	30067003	30063871	8000	30063003	-4000	4000	868
chr8	79758371	79766371	79765290	8000	79762371	-4000	4000	2919
chr8	56156909	56164909	56164750	8000	56160909	-4000	4000	3841
chr8	105800539	105808539	105802911	8000	105804539	-4000	4000	-1628
chr8	42167673	42175673	42168988	8000	42171673	-4000	4000	-2685
chr8	100912523	100920523	100918747	8000	100916523	-4000	4000	2224
chr8	133130903	133138903	133133489	8000	133134903	-4000	4000	-1414
chr8	144716907	144724907	144723086	8000	144720907	-4000	4000	2179
chr8	33587330	33595330	33593677	8000	33591330	-4000	4000	2347
chr8	40526590	40534590	40532213	8000	40530590	-4000	4000	1623
chr8	123640442	123648442	123646011	8000	123644442	-4000	4000	1569
chr8	89923888	89931888	89924548	8000	89927888	-4000	4000	-3340
chr8	52939734	52947734	52940234	8000	52943734	-4000	4000	-3500
chr8	19392218	19400218	19394854	8000	19396218	-4000	4000	-1364
chr8	40012397	40020397	40015283	8000	40016397	-4000	4000	-1114
chr8	53221724	53229724	53229685	8000	53225724	-4000	4000	3961
chr8	87866747	87874747	87872983	8000	87870747	-4000	4000	2236
chr8	109569978	109577978	109575648	8000	109573978	-4000	4000	1670
chr8	41649220	41657220	41654179	8000	41653220	-4000	4000	959
chr8	144047266	144055266	144053329	8000	144051266	-4000	4000	2063
chr8	87866747	87874747	87873263	8000	87870747	-4000	4000	2516
chr8	105800539	105808539	105803158	8000	105804539	-4000	4000	-1381
chr8	23111536	23119536	23115611	8000	23115536	-4000	4000	75
chr8	10892045	10900045	10898240	8000	10896045	-4000	4000	2195
chr8	21904873	21912873	21910692	8000	21908873	-4000	4000	1819
chr8	144716907	144724907	144723196	8000	144720907	-4000	4000	2289
chr8	116940487	116948487	116942748	8000	116944487	-4000	4000	-1739
chr8	42748620	42756620	42756316	8000	42752620	-4000	4000	3696
chr8	103378989	103386989	103382802	8000	103382989	-4000	4000	-187
chr8	10602349	10610349	10607133	8000	10606349	-4000	4000	784
chr8	96138333	96146333	96144782	8000	96142333	-4000	4000	2449
chr8	23016133	23024133	23018786	8000	23020133	-4000	4000	-1347
chr8	98948104	98956104	98951523	8000	98952104	-4000	4000	-581
chr8	72934349	72942349	72936047	8000	72938349	-4000	4000	-2302
chr8	66172376	66180376	66174683	8000	66176376	-4000	4000	-1693
chr8	85445040	85453040	85445174	8000	85449040	-4000	4000	-3866
chr8	24402013	24410013	24405385	8000	24406013	-4000	4000	-628
chr8	42832674	42840674	42838316	8000	42836674	-4000	4000	1642
chr8	23016133	23024133	23022964	8000	23020133	-4000	4000	2831
chr8	10602349	10610349	10610307	8000	10606349	-4000	4000	3958
chr8	23674697	23682697	23681388	8000	23678697	-4000	4000	2691
chr8	27541564	27549564	27544622	8000	27545564	-4000	4000	-942
chr8	76863281	76871281	76863424	8000	76867281	-4000	4000	-3857
chr8	129744196	129752196	129748328	8000	129748196	-4000	4000	132
chr8	144716907	144724907	144721978	8000	144720907	-4000	4000	1071
chr8	40151310	40159310	40153637	8000	40155310	-4000	4000	-1673
chr8	91394155	91402155	91394251	8000	91398155	-4000	4000	-3904
chr8	81689631	81697631	81694314	8000	81693631	-4000	4000	683
chr8	27541564	27549564	27544504	8000	27545564	-4000	4000	-1060
chr8	485803	493803	492559	8000	489803	-4000	4000	2756
chr8	6804517	6812517	6811377	8000	6808517	-4000	4000	2860
chr8	30991802	30999802	30996434	8000	30995802	-4000	4000	632
chr8	56108942	56116942	56113721	8000	56112942	-4000	4000	779
chr8	86150225	86158225	86152824	8000	86154225	-4000	4000	-1401
chr8	66856472	66864472	66860017	8000	66860472	-4000	4000	-455
chr8	76863281	76871281	76863662	8000	76867281	-4000	4000	-3619
chr8	10424891	10432891	10428153	8000	10428891	-4000	4000	-738
chr8	115404496	115412496	115411275	8000	115408496	-4000	4000	2779
chr8	70047651	70055651	70052233	8000	70051651	-4000	4000	582
chr8	27808640	27816640	27811123	8000	27812640	-4000	4000	-1517
chr8	73416369	73424369	73421393	8000	73420369	-4000	4000	1024
chr8	105800539	105808539	105802309	8000	105804539	-4000	4000	-2230
chr8	141352470	141360470	141357026	8000	141356470	-4000	4000	556
chr8	81689631	81697631	81694280	8000	81693631	-4000	4000	649
chr8	94703466	94711466	94705947	8000	94707466	-4000	4000	-1519
chr8	104485231	104493231	104490077	8000	104489231	-4000	4000	846
chr8	126548443	126556443	126553384	8000	126552443	-4000	4000	941
chr8	26501636	26509636	26507945	8000	26505636	-4000	4000	2309
chr8	27865883	27873883	27871950	8000	27869883	-4000	4000	2067
chr8	61497645	61505645	61503366	8000	61501645	-4000	4000	1721
chr8	123676794	123684794	123681350	8000	123680794	-4000	4000	556
chr8	76863281	76871281	76865993	8000	76867281	-4000	4000	-1288
chr8	109569978	109577978	109575568	8000	109573978	-4000	4000	1590
chr8	86474420	86482420	86477307	8000	86478420	-4000	4000	-1113
chr8	144047266	144055266	144052873	8000	144051266	-4000	4000	1607
chr8	49072093	49080093	49075417	8000	49076093	-4000	4000	-676
chr8	76976258	76984258	76983855	8000	76980258	-4000	4000	3597
chr8	87866747	87874747	87873212	8000	87870747	-4000	4000	2465
chr8	26501636	26509636	26508150	8000	26505636	-4000	4000	2514
chr8	10602349	10610349	10607794	8000	10606349	-4000	4000	1445
chr8	33587330	33595330	33592208	8000	33591330	-4000	4000	878
chr8	24915098	24923098	24917614	8000	24919098	-4000	4000	-1484
chr8	30574318	30582318	30578623	8000	30578318	-4000	4000	305
chr8	72934349	72942349	72936047	8000	72938349	-4000	4000	-2302
chr8	23258000	23266000	23258819	8000	23262000	-4000	4000	-3181
chr8	69656915	69664915	69659510	8000	69660915	-4000	4000	-1405
chr8	102644784	102652784	102651395	8000	102648784	-4000	4000	2611
chr8	102644784	102652784	102651890	8000	102648784	-4000	4000	3106
chr8	85280073	85288073	85281300	8000	85284073	-4000	4000	-2773
chr8	86549977	86557977	86556285	8000	86553977	-4000	4000	2308
chr8	107245482	107253482	107251775	8000	107249482	-4000	4000	2293
chr8	72934349	72942349	72937786	8000	72938349	-4000	4000	-563
chr8	55822445	55830445	55824695	8000	55826445	-4000	4000	-1750
chr8	142912506	142920506	142913310	8000	142916506	-4000	4000	-3196
chr8	87866747	87874747	87873256	8000	87870747	-4000	4000	2509
chr8	94483689	94491689	94488731	8000	94487689	-4000	4000	1042
chr8	144716907	144724907	144722429	8000	144720907	-4000	4000	1522
chr8	104485231	104493231	104491205	8000	104489231	-4000	4000	1974
chr8	49072093	49080093	49075285	8000	49076093	-4000	4000	-808
chr8	144926358	144934358	144932237	8000	144930358	-4000	4000	1879
chr8	87866747	87874747	87873746	8000	87870747	-4000	4000	2999
chr8	25837725	25845725	25844570	8000	25841725	-4000	4000	2845
chr8	23697740	23705740	23702842	8000	23701740	-4000	4000	1102
chr8	73416369	73424369	73420106	8000	73420369	-4000	4000	-263
chr8	94703466	94711466	94706067	8000	94707466	-4000	4000	-1399
chr8	120369573	120377573	120370501	8000	120373573	-4000	4000	-3072
chr8	56108942	56116942	56113223	8000	56112942	-4000	4000	281
chr8	73321281	73329281	73323037	8000	73325281	-4000	4000	-2244
chr8	85280073	85288073	85281422	8000	85284073	-4000	4000	-2651
chr8	109569978	109577978	109577918	8000	109573978	-4000	4000	3940
chr8	124975389	124983389	124977465	8000	124979389	-4000	4000	-1924
chr8	12717906	12725906	12722224	8000	12721906	-4000	4000	318
chr8	52939734	52947734	52940880	8000	52943734	-4000	4000	-2854
chr8	10721399	10729399	10726080	8000	10725399	-4000	4000	681
chr8	19963259	19971259	19965395	8000	19967259	-4000	4000	-1864
chr8	90617995	90625995	90625805	8000	90621995	-4000	4000	3810
chr8	118919557	118927557	118924538	8000	118923557	-4000	4000	981
chr8	105800539	105808539	105801340	8000	105804539	-4000	4000	-3199
chr8	20242165	20250165	20246245	8000	20246165	-4000	4000	80
chr8	53962552	53970552	53967128	8000	53966552	-4000	4000	576
chr8	72934349	72942349	72937308	8000	72938349	-4000	4000	-1041
chr8	71837560	71845560	71842695	8000	71841560	-4000	4000	1135
chr8	142912506	142920506	142912674	8000	142916506	-4000	4000	-3832
chr8	98948104	98956104	98949288	8000	98952104	-4000	4000	-2816
chr8	10721399	10729399	10725965	8000	10725399	-4000	4000	566
chr8	17292794	17300794	17300109	8000	17296794	-4000	4000	3315
chr8	18219689	18227689	18223057	8000	18223689	-4000	4000	-632
chr8	28344287	28352287	28348536	8000	28348287	-4000	4000	249
chr8	28344287	28352287	28348682	8000	28348287	-4000	4000	395
chr8	31172138	31180138	31173103	8000	31176138	-4000	4000	-3035
chr8	49072093	49080093	49075283	8000	49076093	-4000	4000	-810
chr8	50792692	50800692	50792763	8000	50796692	-4000	4000	-3929
chr8	105800539	105808539	105803478	8000	105804539	-4000	4000	-1061
chr8	124484485	124492485	124486072	8000	124488485	-4000	4000	-2413
chr8	70569218	70577218	70574618	8000	70573218	-4000	4000	1400
chr8	25503911	25511911	25507397	8000	25507911	-4000	4000	-514
chr8	58486178	58494178	58492485	8000	58490178	-4000	4000	2307
chr8	120369573	120377573	120371320	8000	120373573	-4000	4000	-2253
chr8	53221724	53229724	53229171	8000	53225724	-4000	4000	3447
chr8	52939734	52947734	52940773	8000	52943734	-4000	4000	-2961
chr8	96332995	96340995	96334101	8000	96336995	-4000	4000	-2894
chr8	144926358	144934358	144931611	8000	144930358	-4000	4000	1253
chr8	42832674	42840674	42837943	8000	42836674	-4000	4000	1269
chr9	2716469	2724469	2717849	8000	2720469	-4000	4000	-2620
chr9	32785201	32793201	32786436	8000	32789201	-4000	4000	-2765
chr9	104522253	104530253	104526758	8000	104526253	-4000	4000	505
chr9	127219166	127227166	127219775	8000	127223166	-4000	4000	-3391
chr9	127219166	127227166	127220085	8000	127223166	-4000	4000	-3081
chr9	127219166	127227166	127220998	8000	127223166	-4000	4000	-2168
chr9	27944078	27952078	27950325	8000	27948078	-4000	4000	2247
chr9	70222972	70230972	70226457	8000	70226972	-4000	4000	-515
chr9	27226174	27234174	27228231	8000	27230174	-4000	4000	-1943
chr9	27944078	27952078	27950143	8000	27948078	-4000	4000	2065
chr9	93316572	93324572	93320374	8000	93320572	-4000	4000	-198
chr9	104522253	104530253	104526684	8000	104526253	-4000	4000	431
chr9	130898438	130906438	130904258	8000	130902438	-4000	4000	1820
chr9	133094121	133102121	133101732	8000	133098121	-4000	4000	3611
chr9	34660163	34668163	34660533	8000	34664163	-4000	4000	-3630
chr9	34660163	34668163	34660534	8000	34664163	-4000	4000	-3629
chr9	461259	469259	464280	8000	465259	-4000	4000	-979
chr9	20991955	20999955	20995577	8000	20995955	-4000	4000	-378
chr9	21161637	21169637	21166205	8000	21165637	-4000	4000	568
chr9	21197469	21205469	21201727	8000	21201469	-4000	4000	258
chr9	65734784	65742784	65737154	8000	65738784	-4000	4000	-1630
chr9	74976790	74984790	74983581	8000	74980790	-4000	4000	2791
chr9	88125305	88133305	88132493	8000	88129305	-4000	4000	3188
chr9	101321135	101329135	101324207	8000	101325135	-4000	4000	-928
chr9	104756120	104764120	104759345	8000	104760120	-4000	4000	-775
chr9	122391703	122399703	122392248	8000	122395703	-4000	4000	-3455
chr9	124938608	124946608	124938767	8000	124942608	-4000	4000	-3841
chr9	129086438	129094438	129086711	8000	129090438	-4000	4000	-3727
chr9	133067861	133075861	133071051	8000	133071861	-4000	4000	-810
chr9	133510586	133518586	133514776	8000	133514586	-4000	4000	190
chr9	35953108	35961108	35957987	8000	35957108	-4000	4000	879
chr9	35100112	35108112	35105205	8000	35104112	-4000	4000	1093
chr9	81946093	81954093	81949702	8000	81950093	-4000	4000	-391
chr9	37434102	37442102	37441981	8000	37438102	-4000	4000	3879
chr9	65730041	65738041	65733028	8000	65734041	-4000	4000	-1013
chr9	14733152	14741152	14737585	8000	14737152	-4000	4000	433
chr9	127389660	127397660	127390732	8000	127393660	-4000	4000	-2928
chr9	122563117	122571117	122568038	8000	122567117	-4000	4000	921
chr9	136202333	136210333	136208494	8000	136206333	-4000	4000	2161
chr9	35069835	35077835	35077302	8000	35073835	-4000	4000	3467
chr9	81991253	81999253	81993432	8000	81995253	-4000	4000	-1821
chr9	122472958	122480958	122477152	8000	122476958	-4000	4000	194
chr9	110869263	110877263	110875610	8000	110873263	-4000	4000	2347
chr9	12819060	12827060	12821545	8000	12823060	-4000	4000	-1515
chr9	987732	995732	990144	8000	991732	-4000	4000	-1588
chr9	34630722	34638722	34635780	8000	34634722	-4000	4000	1058
chr9	104691462	104699462	104694848	8000	104695462	-4000	4000	-614
chr9	122522358	122530358	122526561	8000	122526358	-4000	4000	203
chr9	97852717	97860717	97856102	8000	97856717	-4000	4000	-615
chr9	34362666	34370666	34369978	8000	34366666	-4000	4000	3312
chr9	120596811	120604811	120602528	8000	120600811	-4000	4000	1717
chr9	88125305	88133305	88129538	8000	88129305	-4000	4000	233
chr9	122911566	122919566	122919296	8000	122915566	-4000	4000	3730
chr9	135619648	135627648	135624030	8000	135623648	-4000	4000	382
chr9	133573081	133581081	133580182	8000	133577081	-4000	4000	3101
chr9	74718495	74726495	74724732	8000	74722495	-4000	4000	2237
chr9	21300326	21308326	21304987	8000	21304326	-4000	4000	661
chr9	81946093	81954093	81947672	8000	81950093	-4000	4000	-2421
chr9	42185887	42193887	42186336	8000	42189887	-4000	4000	-3551
chr9	34547432	34555432	34552059	8000	34551432	-4000	4000	627
chr9	94105856	94113856	94107878	8000	94109856	-4000	4000	-1978
chr9	10475	18475	12799	8000	14475	-4000	4000	-1676
chr9	14077843	14085843	14085080	8000	14081843	-4000	4000	3237
chr9	100573636	100581636	100577044	8000	100577636	-4000	4000	-592
chr9	136734167	136742167	136739951	8000	136738167	-4000	4000	1784
chr9	88125305	88133305	88132106	8000	88129305	-4000	4000	2801
chr9	6528467	6536467	6534748	8000	6532467	-4000	4000	2281
chr9	95095054	95103054	95101654	8000	95099054	-4000	4000	2600
chr9	101416560	101424560	101421891	8000	101420560	-4000	4000	1331
chr9	133067861	133075861	133071806	8000	133071861	-4000	4000	-55
chr9	122522358	122530358	122526943	8000	122526358	-4000	4000	585
chr9	84000074	84008074	84002708	8000	84004074	-4000	4000	-1366
chr9	6327891	6335891	6330045	8000	6331891	-4000	4000	-1846
chr9	21380255	21388255	21384883	8000	21384255	-4000	4000	628
chr9	83655968	83663968	83661938	8000	83659968	-4000	4000	1970
chr9	132257356	132265356	132264017	8000	132261356	-4000	4000	2661
chr9	36167334	36175334	36170438	8000	36171334	-4000	4000	-896
chr9	66982304	66990304	66987247	8000	66986304	-4000	4000	943
chr9	84000074	84008074	84001686	8000	84004074	-4000	4000	-2388
chr9	94314198	94322198	94320217	8000	94318198	-4000	4000	2019
chr9	113290009	113298009	113297796	8000	113294009	-4000	4000	3787
chr9	122746783	122754783	122750436	8000	122750783	-4000	4000	-347
chr9	34617074	34625074	34623973	8000	34621074	-4000	4000	2899
chr9	12819060	12827060	12821545	8000	12823060	-4000	4000	-1515
chr9	6528467	6536467	6532874	8000	6532467	-4000	4000	407
chr9	27944078	27952078	27950485	8000	27948078	-4000	4000	2407
chr9	104522253	104530253	104526329	8000	104526253	-4000	4000	76
chr9	114056127	114064127	114061491	8000	114060127	-4000	4000	1364
chr9	5466566	5474566	5466805	8000	5470566	-4000	4000	-3761
chr9	88474694	88482694	88475166	8000	88478694	-4000	4000	-3528
chr9	89001155	89009155	89001470	8000	89005155	-4000	4000	-3685
chr9	128497292	128505292	128500226	8000	128501292	-4000	4000	-1066
chr9	96486241	96494241	96490014	8000	96490241	-4000	4000	-227
chr9	2716469	2724469	2717879	8000	2720469	-4000	4000	-2590
chr9	32625454	32633454	32633085	8000	32629454	-4000	4000	3631
chr9	33795231	33803231	33798610	8000	33799231	-4000	4000	-621
chr9	35677992	35685992	35679333	8000	35681992	-4000	4000	-2659
chr9	81991253	81999253	81992837	8000	81995253	-4000	4000	-2416
chr9	87727469	87735469	87729675	8000	87731469	-4000	4000	-1794
chr9	88125305	88133305	88130776	8000	88129305	-4000	4000	1471
chr9	96812269	96820269	96819075	8000	96816269	-4000	4000	2806
chr9	133067861	133075861	133071202	8000	133071861	-4000	4000	-659
chr9	136734167	136742167	136739411	8000	136738167	-4000	4000	1244
chr9	104501222	104509222	104504764	8000	104505222	-4000	4000	-458
chr9	104531749	104539749	104536257	8000	104535749	-4000	4000	508
chr9	104566130	104574130	104570101	8000	104570130	-4000	4000	-29
chr9	108850588	108858588	108855031	8000	108854588	-4000	4000	443
chr9	35041986	35049986	35043033	8000	35045986	-4000	4000	-2953
chr9	97900489	97908489	97904764	8000	97904489	-4000	4000	275
chr9	21325665	21333665	21333117	8000	21329665	-4000	4000	3452
chr9	34617074	34625074	34623466	8000	34621074	-4000	4000	2392
chr9	65278101	65286101	65283967	8000	65282101	-4000	4000	1866
chr9	65734784	65742784	65737556	8000	65738784	-4000	4000	-1228
chr9	35041986	35049986	35043845	8000	35045986	-4000	4000	-2141
chr9	72896671	72904671	72901212	8000	72900671	-4000	4000	541
chr9	81930998	81938998	81932710	8000	81934998	-4000	4000	-2288
chr9	81930998	81938998	81932933	8000	81934998	-4000	4000	-2065
chr9	88474694	88482694	88475099	8000	88478694	-4000	4000	-3595
chr9	6327891	6335891	6329975	8000	6331891	-4000	4000	-1916
chr9	742105	750105	742357	8000	746105	-4000	4000	-3748
chr9	6007025	6015025	6013135	8000	6011025	-4000	4000	2110
chr9	81991253	81999253	81992872	8000	81995253	-4000	4000	-2381
chr9	18906950	18914950	18908547	8000	18910950	-4000	4000	-2403
chr9	35069835	35077835	35076500	8000	35073835	-4000	4000	2665
chr9	104594457	104602457	104598785	8000	104598457	-4000	4000	328
chr9	21136632	21144632	21141049	8000	21140632	-4000	4000	417
chr9	21223243	21231243	21227651	8000	21227243	-4000	4000	408
chr9	21223243	21231243	21228015	8000	21227243	-4000	4000	772
chr9	33437156	33445156	33442640	8000	33441156	-4000	4000	1484
chr9	94314198	94322198	94320414	8000	94318198	-4000	4000	2216
chr9	108850588	108858588	108854892	8000	108854588	-4000	4000	304
chr9	126881878	126889878	126885008	8000	126885878	-4000	4000	-870
chr9	6253983	6261983	6256323	8000	6257983	-4000	4000	-1660
chr9	84000074	84008074	84001749	8000	84004074	-4000	4000	-2325
chr9	133510586	133518586	133515602	8000	133514586	-4000	4000	1016
chr9	5295864	5303864	5300362	8000	5299864	-4000	4000	498
chr9	32625454	32633454	32631140	8000	32629454	-4000	4000	1686
chr9	32625454	32633454	32632015	8000	32629454	-4000	4000	2561
chr9	35100112	35108112	35105709	8000	35104112	-4000	4000	1597
chr9	35677992	35685992	35679915	8000	35681992	-4000	4000	-2077
chr9	81946093	81954093	81947903	8000	81950093	-4000	4000	-2190
chr9	81991253	81999253	81993325	8000	81995253	-4000	4000	-1928
chr9	87884903	87892903	87888072	8000	87888903	-4000	4000	-831
chr9	87884903	87892903	87888623	8000	87888903	-4000	4000	-280
chr9	89001155	89009155	89002226	8000	89005155	-4000	4000	-2929
chr9	93675587	93683587	93677643	8000	93679587	-4000	4000	-1944
chr9	94314198	94322198	94318707	8000	94318198	-4000	4000	509
chr9	95438980	95446980	95446962	8000	95442980	-4000	4000	3982
chr9	101469170	101477170	101476060	8000	101473170	-4000	4000	2890
chr9	108862898	108870898	108863299	8000	108866898	-4000	4000	-3599
chr9	112468405	112476405	112470537	8000	112472405	-4000	4000	-1868
chr9	127931099	127939099	127935693	8000	127935099	-4000	4000	594
chr9	123100866	123108866	123101589	8000	123104866	-4000	4000	-3277
chr9	21235002	21243002	21239925	8000	21239002	-4000	4000	923
chr9	37584413	37592413	37588670	8000	37588413	-4000	4000	257
chr9	81991253	81999253	81994501	8000	81995253	-4000	4000	-752
chr9	34994900	35002900	34996384	8000	34998900	-4000	4000	-2516
chr9	8310246	8318246	8317504	8000	8314246	-4000	4000	3258
chr9	21073104	21081104	21077757	8000	21077104	-4000	4000	653
chr9	99862891	99870891	99863724	8000	99866891	-4000	4000	-3167
chr9	100573636	100581636	100576750	8000	100577636	-4000	4000	-886
chr9	37354149	37362149	37354801	8000	37358149	-4000	4000	-3348
chr9	87884903	87892903	87888136	8000	87888903	-4000	4000	-767
chr9	21235002	21243002	21239902	8000	21239002	-4000	4000	900
chr9	34617074	34625074	34622416	8000	34621074	-4000	4000	1342
chr9	108850588	108858588	108855972	8000	108854588	-4000	4000	1384
chr9	742105	750105	742314	8000	746105	-4000	4000	-3791
chr9	61192280	61200280	61192549	8000	61196280	-4000	4000	-3731
chr9	41122435	41130435	41127246	8000	41126435	-4000	4000	811
chr9	127734317	127742317	127738459	8000	127738317	-4000	4000	142
chr9	32625454	32633454	32631494	8000	32629454	-4000	4000	2040
chr9	35654875	35662875	35662259	8000	35658875	-4000	4000	3384
chr9	81991253	81999253	81993342	8000	81995253	-4000	4000	-1911
chr9	137080539	137088539	137088284	8000	137084539	-4000	4000	3745
chr9	99212425	99220425	99218138	8000	99216425	-4000	4000	1713
chr9	126503041	126511041	126503210	8000	126507041	-4000	4000	-3831
chr9	32625454	32633454	32633085	8000	32629454	-4000	4000	3631
chr9	10475	18475	16035	8000	14475	-4000	4000	1560
chr9	23686104	23694104	23692329	8000	23690104	-4000	4000	2225
chr9	91405045	91413045	91409995	8000	91409045	-4000	4000	950
chr9	74976790	74984790	74983708	8000	74980790	-4000	4000	2918
chr9	22451740	22459740	22451852	8000	22455740	-4000	4000	-3888
chr9	19049141	19057141	19050616	8000	19053141	-4000	4000	-2525
chr9	32625454	32633454	32633235	8000	32629454	-4000	4000	3781
chr9	122563117	122571117	122567572	8000	122567117	-4000	4000	455
chr9	122611682	122619682	122614962	8000	122615682	-4000	4000	-720
chr9	110299476	110307476	110303631	8000	110303476	-4000	4000	155
chr9	39357962	39365962	39360985	8000	39361962	-4000	4000	-977
chr9	35041986	35049986	35044017	8000	35045986	-4000	4000	-1969
chr9	35692948	35700948	35700201	8000	35696948	-4000	4000	3253
chr9	39357962	39365962	39358744	8000	39361962	-4000	4000	-3218
chr9	122672104	122680104	122675941	8000	122676104	-4000	4000	-163
chr9	135491181	135499181	135495432	8000	135495181	-4000	4000	251
chr9	135491181	135499181	135495315	8000	135495181	-4000	4000	134
chr9	127810327	127818327	127813458	8000	127814327	-4000	4000	-869
chr9	136981435	136989435	136985277	8000	136985435	-4000	4000	-158
chr9	77419079	77427079	77425716	8000	77423079	-4000	4000	2637
chr9	10475	18475	14653	8000	14475	-4000	4000	178
chr9	12819060	12827060	12821876	8000	12823060	-4000	4000	-1184
chr9	16405503	16413503	16412159	8000	16409503	-4000	4000	2656
chr9	32625454	32633454	32631328	8000	32629454	-4000	4000	1874
chr9	93675587	93683587	93678060	8000	93679587	-4000	4000	-1527
chr9	122507743	122515743	122511356	8000	122511743	-4000	4000	-387
chr9	126834210	126842210	126838011	8000	126838210	-4000	4000	-199
chr9	81991253	81999253	81991554	8000	81995253	-4000	4000	-3699
chr9	104501222	104509222	104504560	8000	104505222	-4000	4000	-662
chr9	111682171	111690171	111686731	8000	111686171	-4000	4000	560
chr9	121781530	121789530	121782399	8000	121785530	-4000	4000	-3131
chr9	131254076	131262076	131261076	8000	131258076	-4000	4000	3000
chr9	122391703	122399703	122392366	8000	122395703	-4000	4000	-3337
chr9	36332396	36340396	36339344	8000	36336396	-4000	4000	2948
chr9	93675587	93683587	93677625	8000	93679587	-4000	4000	-1962
chr9	61192280	61200280	61193138	8000	61196280	-4000	4000	-3142
chr9	987732	995732	990838	8000	991732	-4000	4000	-894
chr9	81991253	81999253	81993812	8000	81995253	-4000	4000	-1441
chr9	69008504	69016504	69013892	8000	69012504	-4000	4000	1388
chr9	32625454	32633454	32630249	8000	32629454	-4000	4000	795
chr9	97922791	97930791	97927426	8000	97926791	-4000	4000	635
chr9	21182694	21190694	21187339	8000	21186694	-4000	4000	645
chr9	35677992	35685992	35682117	8000	35681992	-4000	4000	125
chr9	5330930	5338930	5335559	8000	5334930	-4000	4000	629
chr9	42185887	42193887	42186033	8000	42189887	-4000	4000	-3854
chr9	41122435	41130435	41127360	8000	41126435	-4000	4000	925
chr9	65278101	65286101	65283354	8000	65282101	-4000	4000	1253
chr9	116419112	116427112	116426003	8000	116423112	-4000	4000	2891
chr9	87884903	87892903	87886515	8000	87888903	-4000	4000	-2388
chr9	14715724	14723724	14719821	8000	14719724	-4000	4000	97
chr9	27944078	27952078	27950446	8000	27948078	-4000	4000	2368
chr9	36167334	36175334	36170530	8000	36171334	-4000	4000	-804
chr9	83735425	83743425	83742532	8000	83739425	-4000	4000	3107
chr9	94599133	94607133	94605535	8000	94603133	-4000	4000	2402
chr9	98284109	98292109	98290606	8000	98288109	-4000	4000	2497
chr9	81991253	81999253	81992724	8000	81995253	-4000	4000	-2529
chr9	27944078	27952078	27949371	8000	27948078	-4000	4000	1293
chr9	90605832	90613832	90613611	8000	90609832	-4000	4000	3779
chr9	68296035	68304035	68302973	8000	68300035	-4000	4000	2938
chr9	81579683	81587683	81584168	8000	81583683	-4000	4000	485
chr9	93675587	93683587	93677704	8000	93679587	-4000	4000	-1883
chr9	77419079	77427079	77425630	8000	77423079	-4000	4000	2551
chr9	104522253	104530253	104526888	8000	104526253	-4000	4000	635
chr9	113290009	113298009	113291643	8000	113294009	-4000	4000	-2366
chr9	132240526	132248526	132241019	8000	132244526	-4000	4000	-3507
chr9	136202333	136210333	136209165	8000	136206333	-4000	4000	2832
chr9	8310246	8318246	8317484	8000	8314246	-4000	4000	3238
chr9	6007025	6015025	6013905	8000	6011025	-4000	4000	2880
chr9	114330156	114338156	114330542	8000	114334156	-4000	4000	-3614
chr9	34994900	35002900	34996747	8000	34998900	-4000	4000	-2153
chr9	135545969	135553969	135547945	8000	135549969	-4000	4000	-2024
chr9	87704634	87712634	87707245	8000	87708634	-4000	4000	-1389
chr9	120811496	120819496	120818066	8000	120815496	-4000	4000	2570
chr9	6007025	6015025	6012355	8000	6011025	-4000	4000	1330
chr9	104600671	104608671	104605014	8000	104604671	-4000	4000	343
chr9	21363424	21371424	21367944	8000	21367424	-4000	4000	520
chr9	94314198	94322198	94318847	8000	94318198	-4000	4000	649
chr9	101406660	101414660	101408381	8000	101410660	-4000	4000	-2279
chr9	104531749	104539749	104536346	8000	104535749	-4000	4000	597
chr9	122785895	122793895	122789275	8000	122789895	-4000	4000	-620
chr9	6007025	6015025	6012280	8000	6011025	-4000	4000	1255
chr9	83934311	83942311	83939406	8000	83938311	-4000	4000	1095
chr9	18906950	18914950	18908593	8000	18910950	-4000	4000	-2357
chr9	114330156	114338156	114331826	8000	114334156	-4000	4000	-2330
chr9	136192250	136200250	136196678	8000	136196250	-4000	4000	428
chr9	32625454	32633454	32631331	8000	32629454	-4000	4000	1877
chr9	99862891	99870891	99864431	8000	99866891	-4000	4000	-2460
chr9	98195011	98203011	98200350	8000	98199011	-4000	4000	1339
chr9	81991253	81999253	81992611	8000	81995253	-4000	4000	-2642
chr9	105659124	105667124	105662478	8000	105663124	-4000	4000	-646
chr9	117038	125038	121439	8000	121038	-4000	4000	401
chr9	22451740	22459740	22451753	8000	22455740	-4000	4000	-3987
chr9	35605982	35613982	35612975	8000	35609982	-4000	4000	2993
chr9	136734167	136742167	136740989	8000	136738167	-4000	4000	2822
chr9	35865463	35873463	35870178	8000	35869463	-4000	4000	715
chr9	94314198	94322198	94320502	8000	94318198	-4000	4000	2304
chr9	104613248	104621248	104617394	8000	104617248	-4000	4000	146
chr9	110299476	110307476	110304507	8000	110303476	-4000	4000	1031
chr9	35645295	35653295	35649947	8000	35649295	-4000	4000	652
chr9	104531749	104539749	104535966	8000	104535749	-4000	4000	217
chr9	128725786	128733786	128731389	8000	128729786	-4000	4000	1603
chr9	40262845	40270845	40265460	8000	40266845	-4000	4000	-1385
chr9	128149453	128157453	128149514	8000	128153453	-4000	4000	-3939
chr9	133571519	133579519	133573984	8000	133575519	-4000	4000	-1535
chr9	35645295	35653295	35650932	8000	35649295	-4000	4000	1637
chr9	95438980	95446980	95443649	8000	95442980	-4000	4000	669
chr9	101406660	101414660	101409527	8000	101410660	-4000	4000	-1133
chr9	94599133	94607133	94603475	8000	94603133	-4000	4000	342
chr9	68527061	68535061	68529666	8000	68531061	-4000	4000	-1395
chr9	107009634	107017634	107010957	8000	107013634	-4000	4000	-2677
chr9	87884903	87892903	87887746	8000	87888903	-4000	4000	-1157
chr9	81991253	81999253	81993269	8000	81995253	-4000	4000	-1984
chr9	8310246	8318246	8317921	8000	8314246	-4000	4000	3675
chr9	35677992	35685992	35685145	8000	35681992	-4000	4000	3153
chr9	131254076	131262076	131261120	8000	131258076	-4000	4000	3044
chr9	37434102	37442102	37441775	8000	37438102	-4000	4000	3673
chr9	92707363	92715363	92713485	8000	92711363	-4000	4000	2122
chr9	96635577	96643577	96641758	8000	96639577	-4000	4000	2181
chr9	21380255	21388255	21385236	8000	21384255	-4000	4000	981
chr9	21223243	21231243	21228029	8000	21227243	-4000	4000	786
chr9	21380255	21388255	21384862	8000	21384255	-4000	4000	607
chr9	89001155	89009155	89001720	8000	89005155	-4000	4000	-3435
chr9	107009634	107017634	107011013	8000	107013634	-4000	4000	-2621
chr9	104566130	104574130	104569972	8000	104570130	-4000	4000	-158
chr9	122611682	122619682	122615331	8000	122615682	-4000	4000	-351
chr9	131119152	131127152	131125632	8000	131123152	-4000	4000	2480
chr9	110299476	110307476	110304512	8000	110303476	-4000	4000	1036
chr9	130497274	130505274	130501169	8000	130501274	-4000	4000	-105
chr9	14715724	14723724	14720006	8000	14719724	-4000	4000	282
chr9	21363424	21371424	21367849	8000	21367424	-4000	4000	425
chr9	122624579	122632579	122628839	8000	122628579	-4000	4000	260
chr9	81946093	81954093	81948029	8000	81950093	-4000	4000	-2064
chr9	21363424	21371424	21367502	8000	21367424	-4000	4000	78
chr9	122198577	122206577	122199961	8000	122202577	-4000	4000	-2616
chr9	69008504	69016504	69013789	8000	69012504	-4000	4000	1285
chr9	6007025	6015025	6013396	8000	6011025	-4000	4000	2371
chr9	34660163	34668163	34661487	8000	34664163	-4000	4000	-2676
chr9	34719053	34727053	34723332	8000	34723053	-4000	4000	279
chr9	89001155	89009155	89001845	8000	89005155	-4000	4000	-3310
chr9	21161637	21169637	21166407	8000	21165637	-4000	4000	770
chr9	91405045	91413045	91410270	8000	91409045	-4000	4000	1225
chr9	107480852	107488852	107487067	8000	107484852	-4000	4000	2215
chr9	122720925	122728925	122724262	8000	122724925	-4000	4000	-663
chr9	111666229	111674229	111666856	8000	111670229	-4000	4000	-3373
chr9	127712002	127720002	127716197	8000	127716002	-4000	4000	195
chr9	21073104	21081104	21077644	8000	21077104	-4000	4000	540
chr9	81930998	81938998	81933102	8000	81934998	-4000	4000	-1896
chr9	98284109	98292109	98290707	8000	98288109	-4000	4000	2598
chr9	19370281	19378281	19371865	8000	19374281	-4000	4000	-2416
chr9	98284109	98292109	98290506	8000	98288109	-4000	4000	2397
chr9	35865463	35873463	35870124	8000	35869463	-4000	4000	661
chr9	5295864	5303864	5300414	8000	5299864	-4000	4000	550
chr9	21182694	21190694	21186956	8000	21186694	-4000	4000	262
chr9	34719053	34727053	34723406	8000	34723053	-4000	4000	353
chr9	66982304	66990304	66987458	8000	66986304	-4000	4000	1154
chr9	69902227	69910227	69906067	8000	69906227	-4000	4000	-160
chr9	108862898	108870898	108863093	8000	108866898	-4000	4000	-3805
chr9	114056127	114064127	114061506	8000	114060127	-4000	4000	1379
chr9	122551173	122559173	122553271	8000	122555173	-4000	4000	-1902
chr9	134883523	134891523	134885282	8000	134887523	-4000	4000	-2241
chr9	135804487	135812487	135811131	8000	135808487	-4000	4000	2644
chr9	121334987	121342987	121341206	8000	121338987	-4000	4000	2219
chr9	122507743	122515743	122511718	8000	122511743	-4000	4000	-25
chr9	21073104	21081104	21077515	8000	21077104	-4000	4000	411
chr9	35100112	35108112	35105150	8000	35104112	-4000	4000	1038
chr9	35645295	35653295	35650371	8000	35649295	-4000	4000	1076
chr9	35865463	35873463	35869721	8000	35869463	-4000	4000	258
chr9	101469170	101477170	101476023	8000	101473170	-4000	4000	2853
chr9	122720925	122728925	122724469	8000	122724925	-4000	4000	-456
chr9	127712002	127720002	127717012	8000	127716002	-4000	4000	1010
chr9	69008504	69016504	69013395	8000	69012504	-4000	4000	891
chr9	104613248	104621248	104617401	8000	104617248	-4000	4000	153
chr9	136750386	136758386	136754464	8000	136754386	-4000	4000	78
chr9	33437156	33445156	33443284	8000	33441156	-4000	4000	2128
chr9	6007025	6015025	6014816	8000	6011025	-4000	4000	3791
chr9	81991253	81999253	81994212	8000	81995253	-4000	4000	-1041
chr9	131090473	131098473	131091886	8000	131094473	-4000	4000	-2587
chr9	132257356	132265356	132264705	8000	132261356	-4000	4000	3349
chr9	108850588	108858588	108855251	8000	108854588	-4000	4000	663
chr9	128357470	128365470	128360378	8000	128361470	-4000	4000	-1092
chr9	21202181	21210181	21207103	8000	21206181	-4000	4000	922
chr9	23686104	23694104	23690828	8000	23690104	-4000	4000	724
chr9	122785895	122793895	122789003	8000	122789895	-4000	4000	-892
chr9	35805732	35813732	35813389	8000	35809732	-4000	4000	3657
chr9	135522540	135530540	135524862	8000	135526540	-4000	4000	-1678
chr9	35677992	35685992	35685482	8000	35681992	-4000	4000	3490
chr9	99862891	99870891	99863904	8000	99866891	-4000	4000	-2987
chr9	6327891	6335891	6331219	8000	6331891	-4000	4000	-672
chr9	21476839	21484839	21481400	8000	21480839	-4000	4000	561
chr9	34705005	34713005	34710099	8000	34709005	-4000	4000	1094
chr9	96486241	96494241	96490075	8000	96490241	-4000	4000	-166
chr9	96812269	96820269	96818112	8000	96816269	-4000	4000	1843
chr9	114642422	114650422	114643193	8000	114646422	-4000	4000	-3229
chr9	116419112	116427112	116425502	8000	116423112	-4000	4000	2390
chr9	127810327	127818327	127813369	8000	127814327	-4000	4000	-958
chr9	133347426	133355426	133354944	8000	133351426	-4000	4000	3518
chr9	125142573	125150573	125149521	8000	125146573	-4000	4000	2948
chr9	122472958	122480958	122477893	8000	122476958	-4000	4000	935
chr9	101469170	101477170	101476059	8000	101473170	-4000	4000	2889
chr9	742105	750105	742283	8000	746105	-4000	4000	-3822
chr9	2189624	2197624	2193411	8000	2193624	-4000	4000	-213
chr9	2716469	2724469	2718729	8000	2720469	-4000	4000	-1740
chr9	21202181	21210181	21206845	8000	21206181	-4000	4000	664
chr9	23686104	23694104	23691624	8000	23690104	-4000	4000	1520
chr9	32625454	32633454	32631260	8000	32629454	-4000	4000	1806
chr9	66982304	66990304	66988475	8000	66986304	-4000	4000	2171
chr9	72347413	72355413	72354465	8000	72351413	-4000	4000	3052
chr9	86940362	86948362	86946075	8000	86944362	-4000	4000	1713
chr9	86940362	86948362	86946924	8000	86944362	-4000	4000	2562
chr9	90605832	90613832	90610372	8000	90609832	-4000	4000	540
chr9	101469170	101477170	101476398	8000	101473170	-4000	4000	3228
chr9	101565352	101573352	101570405	8000	101569352	-4000	4000	1053
chr9	114056127	114064127	114061176	8000	114060127	-4000	4000	1049
chr9	122785895	122793895	122789668	8000	122789895	-4000	4000	-227
chr9	122904056	122912056	122911535	8000	122908056	-4000	4000	3479
chr9	124474589	124482589	124476690	8000	124478589	-4000	4000	-1899
chr9	126834210	126842210	126836326	8000	126838210	-4000	4000	-1884
chr9	128692400	128700400	128695697	8000	128696400	-4000	4000	-703
chr9	128692400	128700400	128696339	8000	128696400	-4000	4000	-61
chr9	132887348	132895348	132888494	8000	132891348	-4000	4000	-2854
chr9	125230853	125238853	125234078	8000	125234853	-4000	4000	-775
chr9	104756120	104764120	104759347	8000	104760120	-4000	4000	-773
chr9	61192280	61200280	61192474	8000	61196280	-4000	4000	-3806
chr9	12706285	12714285	12708043	8000	12710285	-4000	4000	-2242
chr9	34719053	34727053	34723921	8000	34723053	-4000	4000	868
chr9	133655329	133663329	133657238	8000	133659329	-4000	4000	-2091
chr9	122746783	122754783	122750665	8000	122750783	-4000	4000	-118
chr9	19370281	19378281	19372167	8000	19374281	-4000	4000	-2114
chr9	19448505	19456505	19450627	8000	19452505	-4000	4000	-1878
chr9	21223243	21231243	21227496	8000	21227243	-4000	4000	253
chr9	21223243	21231243	21227708	8000	21227243	-4000	4000	465
chr9	21300326	21308326	21304749	8000	21304326	-4000	4000	423
chr9	21345835	21353835	21350380	8000	21349835	-4000	4000	545
chr9	21406185	21414185	21409747	8000	21410185	-4000	4000	-438
chr9	33437156	33445156	33443641	8000	33441156	-4000	4000	2485
chr9	35100112	35108112	35108038	8000	35104112	-4000	4000	3926
chr9	81991253	81999253	81993859	8000	81995253	-4000	4000	-1394
chr9	83655968	83663968	83663877	8000	83659968	-4000	4000	3909
chr9	93675587	93683587	93677790	8000	93679587	-4000	4000	-1797
chr9	94314198	94322198	94321156	8000	94318198	-4000	4000	2958
chr9	97025677	97033677	97032979	8000	97029677	-4000	4000	3302
chr9	100298175	100306175	100300593	8000	100302175	-4000	4000	-1582
chr9	125230853	125238853	125237017	8000	125234853	-4000	4000	2164
chr9	133201277	133209277	133208543	8000	133205277	-4000	4000	3266
chr9	69008504	69016504	69013946	8000	69012504	-4000	4000	1442
chr9	33379179	33387179	33385520	8000	33383179	-4000	4000	2341
chr9	35084688	35092688	35089541	8000	35088688	-4000	4000	853
chr9	91405045	91413045	91410459	8000	91409045	-4000	4000	1414
chr9	94314198	94322198	94318685	8000	94318198	-4000	4000	487
chr9	16405503	16413503	16412233	8000	16409503	-4000	4000	2730
chr9	21363424	21371424	21367457	8000	21367424	-4000	4000	33
chr9	32785201	32793201	32787357	8000	32789201	-4000	4000	-1844
chr9	34082387	34090387	34088357	8000	34086387	-4000	4000	1970
chr9	35041986	35049986	35042873	8000	35045986	-4000	4000	-3113
chr9	35041986	35049986	35043270	8000	35045986	-4000	4000	-2716
chr9	35041986	35049986	35043368	8000	35045986	-4000	4000	-2618
chr9	35041986	35049986	35045606	8000	35045986	-4000	4000	-380
chr9	35401338	35409338	35403907	8000	35405338	-4000	4000	-1431
chr9	35654875	35662875	35661844	8000	35658875	-4000	4000	2969
chr9	35953108	35961108	35957374	8000	35957108	-4000	4000	266
chr9	36167334	36175334	36169688	8000	36171334	-4000	4000	-1646
chr9	42185887	42193887	42188966	8000	42189887	-4000	4000	-921
chr9	66982304	66990304	66988244	8000	66986304	-4000	4000	1940
chr9	81946093	81954093	81947578	8000	81950093	-4000	4000	-2515
chr9	97492125	97500125	97495857	8000	97496125	-4000	4000	-268
chr9	99862891	99870891	99866694	8000	99866891	-4000	4000	-197
chr9	122904056	122912056	122905272	8000	122908056	-4000	4000	-2784
chr9	137249483	137257483	137252513	8000	137253483	-4000	4000	-970
chr9	35903136	35911136	35906379	8000	35907136	-4000	4000	-757
chr9	128105245	128113245	128107034	8000	128109245	-4000	4000	-2211
chr9	35692948	35700948	35697746	8000	35696948	-4000	4000	798
chr9	36167334	36175334	36170595	8000	36171334	-4000	4000	-739
chr9	65734784	65742784	65737408	8000	65738784	-4000	4000	-1376
chr9	83964083	83972083	83969363	8000	83968083	-4000	4000	1280
chr9	107480852	107488852	107485690	8000	107484852	-4000	4000	838
chr9	122522358	122530358	122526652	8000	122526358	-4000	4000	294
chr9	111323229	111331229	111327789	8000	111327229	-4000	4000	560
chr9	123100866	123108866	123103147	8000	123104866	-4000	4000	-1719
chr9	21073104	21081104	21077626	8000	21077104	-4000	4000	522
chr9	21202181	21210181	21206601	8000	21206181	-4000	4000	420
chr9	100573636	100581636	100578141	8000	100577636	-4000	4000	505
chr9	35041986	35049986	35043980	8000	35045986	-4000	4000	-2006
chr9	70380604	70388604	70386611	8000	70384604	-4000	4000	2007
chr9	113290009	113298009	113297917	8000	113294009	-4000	4000	3908
chr9	99862891	99870891	99864242	8000	99866891	-4000	4000	-2649
chr9	35401338	35409338	35403595	8000	35405338	-4000	4000	-1743
chr9	114056127	114064127	114062733	8000	114060127	-4000	4000	2606
chr9	122904056	122912056	122910682	8000	122908056	-4000	4000	2626
chr9	122198577	122206577	122199952	8000	122202577	-4000	4000	-2625
chr9	86260546	86268546	86265776	8000	86264546	-4000	4000	1230
chr9	104600671	104608671	104605328	8000	104604671	-4000	4000	657
chr9	77016953	77024953	77020049	8000	77020953	-4000	4000	-904
chr9	32625454	32633454	32632817	8000	32629454	-4000	4000	3363
chr9	34516988	34524988	34520904	8000	34520988	-4000	4000	-84
chr9	125230853	125238853	125232606	8000	125234853	-4000	4000	-2247
chr9	32625454	32633454	32632678	8000	32629454	-4000	4000	3224
chr9	83964083	83972083	83969396	8000	83968083	-4000	4000	1313
chr9	81946093	81954093	81947599	8000	81950093	-4000	4000	-2494
chr9	108850588	108858588	108855667	8000	108854588	-4000	4000	1079
chr9	98846081	98854081	98848980	8000	98850081	-4000	4000	-1101
chr9	130634352	130642352	130638098	8000	130638352	-4000	4000	-254
chr9	21202181	21210181	21206600	8000	21206181	-4000	4000	419
chr9	93032236	93040236	93032808	8000	93036236	-4000	4000	-3428
chr9	122516082	122524082	122519531	8000	122520082	-4000	4000	-551
chr9	64409142	64417142	64412066	8000	64413142	-4000	4000	-1076
chr9	101416560	101424560	101421861	8000	101420560	-4000	4000	1301
chr9	21073104	21081104	21077876	8000	21077104	-4000	4000	772
chr9	122522358	122530358	122526562	8000	122526358	-4000	4000	204
chr9	27944078	27952078	27948863	8000	27948078	-4000	4000	785
chr9	88125305	88133305	88131077	8000	88129305	-4000	4000	1772
chr9	121328843	121336843	121332632	8000	121332843	-4000	4000	-211
chr9	131254076	131262076	131261177	8000	131258076	-4000	4000	3101
chr9	5772557	5780557	5772602	8000	5776557	-4000	4000	-3955
chr9	14715724	14723724	14722328	8000	14719724	-4000	4000	2604
chr9	35645295	35653295	35650903	8000	35649295	-4000	4000	1608
chr9	68527061	68535061	68529592	8000	68531061	-4000	4000	-1469
chr9	128388016	128396016	128389440	8000	128392016	-4000	4000	-2576
chr9	128388016	128396016	128389441	8000	128392016	-4000	4000	-2575
chr9	32450769	32458769	32457351	8000	32454769	-4000	4000	2582
chr9	81579683	81587683	81584294	8000	81583683	-4000	4000	611
chr9	127810327	127818327	127813528	8000	127814327	-4000	4000	-799
chr9	104566130	104574130	104569805	8000	104570130	-4000	4000	-325
chr9	114308511	114316511	114309450	8000	114312511	-4000	4000	-3061
chr9	21223243	21231243	21227805	8000	21227243	-4000	4000	562
chr9	35677992	35685992	35685271	8000	35681992	-4000	4000	3279
chr9	89001155	89009155	89001994	8000	89005155	-4000	4000	-3161
chr9	128941530	128949530	128946020	8000	128945530	-4000	4000	490
chr9	6327891	6335891	6330991	8000	6331891	-4000	4000	-900
chr9	21476839	21484839	21481514	8000	21480839	-4000	4000	675
chr9	113425690	113433690	113428954	8000	113429690	-4000	4000	-736
chr9	34719053	34727053	34726879	8000	34723053	-4000	4000	3826
chr9	135562955	135570955	135564247	8000	135566955	-4000	4000	-2708
chr9	104594457	104602457	104598509	8000	104598457	-4000	4000	52
chr9	68296035	68304035	68303913	8000	68300035	-4000	4000	3878
chr9	128941530	128949530	128946577	8000	128945530	-4000	4000	1047
chr9	90605832	90613832	90613712	8000	90609832	-4000	4000	3880
chr9	3820127	3828127	3824142	8000	3824127	-4000	4000	15
chr9	32625454	32633454	32630538	8000	32629454	-4000	4000	1084
chr9	68296035	68304035	68303897	8000	68300035	-4000	4000	3862
chr9	120948335	120956335	120952772	8000	120952335	-4000	4000	437
chr9	129068082	129076082	129069083	8000	129072082	-4000	4000	-2999
chr9	98116975	98124975	98124836	8000	98120975	-4000	4000	3861
chr9	84000074	84008074	84003000	8000	84004074	-4000	4000	-1074
chr9	128149453	128157453	128151692	8000	128153453	-4000	4000	-1761
chr9	127712002	127720002	127716022	8000	127716002	-4000	4000	20
chr9	99150192	99158192	99150518	8000	99154192	-4000	4000	-3674
chr9	15460066	15468066	15465640	8000	15464066	-4000	4000	1574
chr9	38567358	38575358	38571742	8000	38571358	-4000	4000	384
chr9	21212373	21220373	21217073	8000	21216373	-4000	4000	700
chr9	100584389	100592389	100586129	8000	100588389	-4000	4000	-2260
chr9	104613248	104621248	104617803	8000	104617248	-4000	4000	555
chr9	125230853	125238853	125236526	8000	125234853	-4000	4000	1673
chr9	1053552	1061552	1057000	8000	1057552	-4000	4000	-552
chr9	6327891	6335891	6330070	8000	6331891	-4000	4000	-1821
chr9	14715724	14723724	14722629	8000	14719724	-4000	4000	2905
chr9	21073104	21081104	21077166	8000	21077104	-4000	4000	62
chr9	21212373	21220373	21217192	8000	21216373	-4000	4000	819
chr9	21223243	21231243	21227956	8000	21227243	-4000	4000	713
chr9	21223243	21231243	21228098	8000	21227243	-4000	4000	855
chr9	27226174	27234174	27228266	8000	27230174	-4000	4000	-1908
chr9	32625454	32633454	32632777	8000	32629454	-4000	4000	3323
chr9	33035907	33043907	33037107	8000	33039907	-4000	4000	-2800
chr9	34719053	34727053	34724773	8000	34723053	-4000	4000	1720
chr9	34994900	35002900	34996651	8000	34998900	-4000	4000	-2249
chr9	35041986	35049986	35044907	8000	35045986	-4000	4000	-1079
chr9	35069835	35077835	35074435	8000	35073835	-4000	4000	600
chr9	35654875	35662875	35662540	8000	35658875	-4000	4000	3665
chr9	36167334	36175334	36169866	8000	36171334	-4000	4000	-1468
chr9	37434102	37442102	37441307	8000	37438102	-4000	4000	3205
chr9	42185887	42193887	42189204	8000	42189887	-4000	4000	-683
chr9	68532580	68540580	68537416	8000	68536580	-4000	4000	836
chr9	69008504	69016504	69013998	8000	69012504	-4000	4000	1494
chr9	72047376	72055376	72052225	8000	72051376	-4000	4000	849
chr9	81579683	81587683	81584047	8000	81583683	-4000	4000	364
chr9	81991253	81999253	81991982	8000	81995253	-4000	4000	-3271
chr9	84000074	84008074	84002664	8000	84004074	-4000	4000	-1410
chr9	87884903	87892903	87886424	8000	87888903	-4000	4000	-2479
chr9	88125305	88133305	88132621	8000	88129305	-4000	4000	3316
chr9	89001155	89009155	89001383	8000	89005155	-4000	4000	-3772
chr9	92293358	92301358	92299970	8000	92297358	-4000	4000	2612
chr9	94105856	94113856	94107959	8000	94109856	-4000	4000	-1897
chr9	94314198	94322198	94318809	8000	94318198	-4000	4000	611
chr9	96812269	96820269	96817963	8000	96816269	-4000	4000	1694
chr9	99066792	99074792	99069811	8000	99070792	-4000	4000	-981
chr9	104600671	104608671	104604912	8000	104604671	-4000	4000	241
chr9	104613248	104621248	104618180	8000	104617248	-4000	4000	932
chr9	104691462	104699462	104694557	8000	104695462	-4000	4000	-905
chr9	104691462	104699462	104695211	8000	104695462	-4000	4000	-251
chr9	108850588	108858588	108855819	8000	108854588	-4000	4000	1231
chr9	111323229	111331229	111327643	8000	111327229	-4000	4000	414
chr9	113425690	113433690	113429263	8000	113429690	-4000	4000	-427
chr9	122472958	122480958	122477117	8000	122476958	-4000	4000	159
chr9	127443674	127451674	127444036	8000	127447674	-4000	4000	-3638
chr9	127443674	127451674	127444142	8000	127447674	-4000	4000	-3532
chr9	127712002	127720002	127715567	8000	127716002	-4000	4000	-435
chr9	127712002	127720002	127716217	8000	127716002	-4000	4000	215
chr9	127734317	127742317	127738817	8000	127738317	-4000	4000	500
chr9	131119152	131127152	131125642	8000	131123152	-4000	4000	2490
chr9	132257356	132265356	132264611	8000	132261356	-4000	4000	3255
chr9	133201277	133209277	133206381	8000	133205277	-4000	4000	1104
chr9	135545969	135553969	135546777	8000	135549969	-4000	4000	-3192
chr9	135791508	135799508	135792089	8000	135795508	-4000	4000	-3419
chr9	137027241	137035241	137028876	8000	137031241	-4000	4000	-2365
chr9	113290009	113298009	113291633	8000	113294009	-4000	4000	-2376
chr9	34516988	34524988	34521804	8000	34520988	-4000	4000	816
chr9	35605982	35613982	35608982	8000	35609982	-4000	4000	-1000
chr9	135491181	135499181	135498582	8000	135495181	-4000	4000	3401
chr9	39357962	39365962	39361723	8000	39361962	-4000	4000	-239
chr9	84000074	84008074	84002356	8000	84004074	-4000	4000	-1718
chr9	122611682	122619682	122615552	8000	122615682	-4000	4000	-130
chr9	81930998	81938998	81933078	8000	81934998	-4000	4000	-1920
chr9	5295864	5303864	5300346	8000	5299864	-4000	4000	482
chr9	81991253	81999253	81994440	8000	81995253	-4000	4000	-813
chr9	99212425	99220425	99218333	8000	99216425	-4000	4000	1908
chr9	122911566	122919566	122918712	8000	122915566	-4000	4000	3146
chr9	4705556	4713556	4713072	8000	4709556	-4000	4000	3516
chr9	32625454	32633454	32632177	8000	32629454	-4000	4000	2723
chr9	34547432	34555432	34552696	8000	34551432	-4000	4000	1264
chr9	35805732	35813732	35811638	8000	35809732	-4000	4000	1906
chr9	21476839	21484839	21481119	8000	21480839	-4000	4000	280
chr9	104566130	104574130	104569991	8000	104570130	-4000	4000	-139
chr9	101469170	101477170	101475788	8000	101473170	-4000	4000	2618
chr9	121173729	121181729	121181489	8000	121177729	-4000	4000	3760
chr9	104566130	104574130	104570103	8000	104570130	-4000	4000	-27
chr9	104566130	104574130	104570104	8000	104570130	-4000	4000	-26
chr9	1053552	1061552	1056030	8000	1057552	-4000	4000	-1522
chr9	1053552	1061552	1056555	8000	1057552	-4000	4000	-997
chr9	6007025	6015025	6013269	8000	6011025	-4000	4000	2244
chr9	6007025	6015025	6013702	8000	6011025	-4000	4000	2677
chr9	6253983	6261983	6254512	8000	6257983	-4000	4000	-3471
chr9	13101706	13109706	13109042	8000	13105706	-4000	4000	3336
chr9	21437316	21445316	21440442	8000	21441316	-4000	4000	-874
chr9	21437316	21445316	21441212	8000	21441316	-4000	4000	-104
chr9	27944078	27952078	27949967	8000	27948078	-4000	4000	1889
chr9	32625454	32633454	32632168	8000	32629454	-4000	4000	2714
chr9	34375019	34383019	34381420	8000	34379019	-4000	4000	2401
chr9	34660163	34668163	34662040	8000	34664163	-4000	4000	-2123
chr9	34685570	34693570	34689965	8000	34689570	-4000	4000	395
chr9	34705005	34713005	34709126	8000	34709005	-4000	4000	121
chr9	35645295	35653295	35650834	8000	35649295	-4000	4000	1539
chr9	35677992	35685992	35685749	8000	35681992	-4000	4000	3757
chr9	36159913	36167913	36162560	8000	36163913	-4000	4000	-1353
chr9	37434102	37442102	37441805	8000	37438102	-4000	4000	3703
chr9	64409142	64417142	64411219	8000	64413142	-4000	4000	-1923
chr9	65734784	65742784	65737227	8000	65738784	-4000	4000	-1557
chr9	69008504	69016504	69008649	8000	69012504	-4000	4000	-3855
chr9	78326093	78334093	78328098	8000	78330093	-4000	4000	-1995
chr9	81946093	81954093	81947865	8000	81950093	-4000	4000	-2228
chr9	81946093	81954093	81948029	8000	81950093	-4000	4000	-2064
chr9	81991253	81999253	81992261	8000	81995253	-4000	4000	-2992
chr9	81991253	81999253	81993267	8000	81995253	-4000	4000	-1986
chr9	81991253	81999253	81995143	8000	81995253	-4000	4000	-110
chr9	83735425	83743425	83739514	8000	83739425	-4000	4000	89
chr9	86260546	86268546	86265901	8000	86264546	-4000	4000	1355
chr9	88125305	88133305	88130168	8000	88129305	-4000	4000	863
chr9	91405045	91413045	91409448	8000	91409045	-4000	4000	403
chr9	95095054	95103054	95101720	8000	95099054	-4000	4000	2666
chr9	100573636	100581636	100576612	8000	100577636	-4000	4000	-1024
chr9	100584389	100592389	100586170	8000	100588389	-4000	4000	-2219
chr9	101406660	101414660	101408911	8000	101410660	-4000	4000	-1749
chr9	101406660	101414660	101409354	8000	101410660	-4000	4000	-1306
chr9	101469170	101477170	101476141	8000	101473170	-4000	4000	2971
chr9	111323229	111331229	111327757	8000	111327229	-4000	4000	528
chr9	111323229	111331229	111328355	8000	111327229	-4000	4000	1126
chr9	114330156	114338156	114331652	8000	114334156	-4000	4000	-2504
chr9	115015575	115023575	115020972	8000	115019575	-4000	4000	1397
chr9	122624579	122632579	122629227	8000	122628579	-4000	4000	648
chr9	122672104	122680104	122675180	8000	122676104	-4000	4000	-924
chr9	127443674	127451674	127444046	8000	127447674	-4000	4000	-3628
chr9	132257356	132265356	132264880	8000	132261356	-4000	4000	3524
chr9	132371548	132379548	132375903	8000	132375548	-4000	4000	355
chr9	33278070	33286070	33280964	8000	33282070	-4000	4000	-1106
chr9	75143265	75151265	75146962	8000	75147265	-4000	4000	-303
chr9	92840182	92848182	92847226	8000	92844182	-4000	4000	3044
chr9	104501222	104509222	104504546	8000	104505222	-4000	4000	-676
chr9	33437156	33445156	33442728	8000	33441156	-4000	4000	1572
chr9	81930998	81938998	81933076	8000	81934998	-4000	4000	-1922
chr9	4705556	4713556	4712874	8000	4709556	-4000	4000	3318
chr9	132588997	132596997	132589984	8000	132592997	-4000	4000	-3013
chr9	14715724	14723724	14722338	8000	14719724	-4000	4000	2614
chr9	110869263	110877263	110875489	8000	110873263	-4000	4000	2226
chr9	27944078	27952078	27950417	8000	27948078	-4000	4000	2339
chr9	35041986	35049986	35043677	8000	35045986	-4000	4000	-2309
chr9	108862898	108870898	108863049	8000	108866898	-4000	4000	-3849
chr9	127712002	127720002	127712205	8000	127716002	-4000	4000	-3797
chr9	133659560	133667560	133666922	8000	133663560	-4000	4000	3362
chr9	35677992	35685992	35683162	8000	35681992	-4000	4000	1170
chr9	91405045	91413045	91409358	8000	91409045	-4000	4000	313
chr9	104600671	104608671	104605322	8000	104604671	-4000	4000	651
chr9	133659560	133667560	133666828	8000	133663560	-4000	4000	3268
chr9	35605982	35613982	35607512	8000	35609982	-4000	4000	-2470
chr9	127692027	127700027	127692374	8000	127696027	-4000	4000	-3653
chr9	27944078	27952078	27950345	8000	27948078	-4000	4000	2267
chr9	84000074	84008074	84002049	8000	84004074	-4000	4000	-2025
chr9	113290009	113298009	113290911	8000	113294009	-4000	4000	-3098
chr9	125142573	125150573	125149689	8000	125146573	-4000	4000	3116
chr9	89001155	89009155	89002838	8000	89005155	-4000	4000	-2317
chr9	122746783	122754783	122750215	8000	122750783	-4000	4000	-568
chr9	69008504	69016504	69013883	8000	69012504	-4000	4000	1379
chr9	99226615	99234615	99230421	8000	99230615	-4000	4000	-194
chr9	33437156	33445156	33442379	8000	33441156	-4000	4000	1223
chr9	122522358	122530358	122526616	8000	122526358	-4000	4000	258
chr9	114322479	114330479	114323691	8000	114326479	-4000	4000	-2788
chr9	6007025	6015025	6012961	8000	6011025	-4000	4000	1936
chr9	21197469	21205469	21202188	8000	21201469	-4000	4000	719
chr9	32625454	32633454	32631173	8000	32629454	-4000	4000	1719
chr9	101565352	101573352	101573241	8000	101569352	-4000	4000	3889
chr9	101559344	101567344	101561144	8000	101563344	-4000	4000	-2200
chr9	33916399	33924399	33917123	8000	33920399	-4000	4000	-3276
chr9	137578081	137586081	137583161	8000	137582081	-4000	4000	1080
chr9	81991253	81999253	81992192	8000	81995253	-4000	4000	-3061
chr9	5295864	5303864	5300144	8000	5299864	-4000	4000	280
chr9	21406185	21414185	21409273	8000	21410185	-4000	4000	-912
chr9	35677992	35685992	35684278	8000	35681992	-4000	4000	2286
chr9	35732866	35740866	35740055	8000	35736866	-4000	4000	3189
chr9	36167334	36175334	36169594	8000	36171334	-4000	4000	-1740
chr9	39357962	39365962	39360190	8000	39361962	-4000	4000	-1772
chr9	42185887	42193887	42189635	8000	42189887	-4000	4000	-252
chr9	87727469	87735469	87729702	8000	87731469	-4000	4000	-1767
chr9	93081133	93089133	93084839	8000	93085133	-4000	4000	-294
chr9	101383633	101391633	101390578	8000	101387633	-4000	4000	2945
chr9	113425690	113433690	113429176	8000	113429690	-4000	4000	-514
chr9	128105245	128113245	128107174	8000	128109245	-4000	4000	-2071
chr9	128941530	128949530	128945662	8000	128945530	-4000	4000	132
chr9	132721578	132729578	132725738	8000	132725578	-4000	4000	160
chr9	98195011	98203011	98199513	8000	98199011	-4000	4000	502
chr9	136750386	136758386	136757058	8000	136754386	-4000	4000	2672
chr9	81946093	81954093	81949899	8000	81950093	-4000	4000	-194
chr9	87962441	87970441	87969809	8000	87966441	-4000	4000	3368
chr9	104566130	104574130	104569378	8000	104570130	-4000	4000	-752
chr9	4705556	4713556	4713067	8000	4709556	-4000	4000	3511
chr9	21161637	21169637	21166062	8000	21165637	-4000	4000	425
chr9	42185887	42193887	42188956	8000	42189887	-4000	4000	-931
chr9	93675587	93683587	93677712	8000	93679587	-4000	4000	-1875
chr9	128941530	128949530	128945673	8000	128945530	-4000	4000	143
chr9	127734317	127742317	127739776	8000	127738317	-4000	4000	1459
chr9	77016953	77024953	77019698	8000	77020953	-4000	4000	-1255
chr9	32625454	32633454	32631816	8000	32629454	-4000	4000	2362
chr9	70380604	70388604	70385586	8000	70384604	-4000	4000	982
chr9	101383633	101391633	101390846	8000	101387633	-4000	4000	3213
chr9	81991253	81999253	81992897	8000	81995253	-4000	4000	-2356
chr9	89312703	89320703	89319707	8000	89316703	-4000	4000	3004
chr9	33437156	33445156	33442429	8000	33441156	-4000	4000	1273
chr9	124029301	124037301	124032556	8000	124033301	-4000	4000	-745
chr9	987732	995732	991183	8000	991732	-4000	4000	-549
chr9	128149453	128157453	128150443	8000	128153453	-4000	4000	-3010
chr9	104522253	104530253	104526850	8000	104526253	-4000	4000	597
chr9	81930998	81938998	81933055	8000	81934998	-4000	4000	-1943
chr9	137080539	137088539	137088328	8000	137084539	-4000	4000	3789
chr9	21235002	21243002	21239567	8000	21239002	-4000	4000	565
chr9	34339711	34347711	34343330	8000	34343711	-4000	4000	-381
chr9	133094121	133102121	133101693	8000	133098121	-4000	4000	3572
chr9	133757894	133765894	133763976	8000	133761894	-4000	4000	2082
chr9	19448505	19456505	19450515	8000	19452505	-4000	4000	-1990
chr9	21212373	21220373	21216923	8000	21216373	-4000	4000	550
chr9	122563117	122571117	122567707	8000	122567117	-4000	4000	590
chr9	5231304	5239304	5233728	8000	5235304	-4000	4000	-1576
chr9	21380255	21388255	21385029	8000	21384255	-4000	4000	774
chr9	27944078	27952078	27950283	8000	27948078	-4000	4000	2205
chr9	65734784	65742784	65737143	8000	65738784	-4000	4000	-1641
chr9	125963377	125971377	125966858	8000	125967377	-4000	4000	-519
chr9	94314198	94322198	94320429	8000	94318198	-4000	4000	2231
chr9	35084688	35092688	35088748	8000	35088688	-4000	4000	60
chr9	89001155	89009155	89002275	8000	89005155	-4000	4000	-2880
chr9	122522358	122530358	122526919	8000	122526358	-4000	4000	561
chr9	17793124	17801124	17795654	8000	17797124	-4000	4000	-1470
chr9	132887348	132895348	132889733	8000	132891348	-4000	4000	-1615
chr9	21363424	21371424	21367457	8000	21367424	-4000	4000	33
chr9	21161637	21169637	21166508	8000	21165637	-4000	4000	871
chr9	21197469	21205469	21201827	8000	21201469	-4000	4000	358
chr9	36159913	36167913	36162466	8000	36163913	-4000	4000	-1447
chr9	17499923	17507923	17502603	8000	17503923	-4000	4000	-1320
chr9	33379179	33387179	33386977	8000	33383179	-4000	4000	3798
chr9	34660163	34668163	34662020	8000	34664163	-4000	4000	-2143
chr9	110239810	110247810	110244183	8000	110243810	-4000	4000	373
chr9	27944078	27952078	27949806	8000	27948078	-4000	4000	1728
chr9	114322479	114330479	114329980	8000	114326479	-4000	4000	3501
chr9	87704634	87712634	87706999	8000	87708634	-4000	4000	-1635
chr9	137455952	137463952	137462308	8000	137459952	-4000	4000	2356
chr9	21182694	21190694	21186889	8000	21186694	-4000	4000	195
chr9	39357962	39365962	39358850	8000	39361962	-4000	4000	-3112
chr9	105659124	105667124	105662908	8000	105663124	-4000	4000	-216
chr9	107480852	107488852	107485316	8000	107484852	-4000	4000	464
chr9	128149453	128157453	128150579	8000	128153453	-4000	4000	-2874
chr9	5295864	5303864	5300176	8000	5299864	-4000	4000	312
chr9	14715724	14723724	14719982	8000	14719724	-4000	4000	258
chr9	14715724	14723724	14720355	8000	14719724	-4000	4000	631
chr9	35677992	35685992	35685032	8000	35681992	-4000	4000	3040
chr9	35645295	35653295	35650903	8000	35649295	-4000	4000	1608
chr9	35084688	35092688	35089514	8000	35088688	-4000	4000	826
chr9	122746783	122754783	122750116	8000	122750783	-4000	4000	-667
chr9	99212425	99220425	99218047	8000	99216425	-4000	4000	1622
chr9	108862898	108870898	108863517	8000	108866898	-4000	4000	-3381
chr9	107480852	107488852	107485355	8000	107484852	-4000	4000	503
chr9	27944078	27952078	27949220	8000	27948078	-4000	4000	1142
chr9	35041986	35049986	35044470	8000	35045986	-4000	4000	-1516
chr9	122794389	122802389	122800271	8000	122798389	-4000	4000	1882
chr9	39357962	39365962	39361276	8000	39361962	-4000	4000	-686
chr9	133455402	133463402	133456640	8000	133459402	-4000	4000	-2762
chr9	21437316	21445316	21441025	8000	21441316	-4000	4000	-291
chr9	34705005	34713005	34709560	8000	34709005	-4000	4000	555
chr9	68527061	68535061	68529748	8000	68531061	-4000	4000	-1313
chr9	81930998	81938998	81933145	8000	81934998	-4000	4000	-1853
chr9	987732	995732	990339	8000	991732	-4000	4000	-1393
chr9	5330930	5338930	5335409	8000	5334930	-4000	4000	479
chr9	112877671	112885671	112879717	8000	112881671	-4000	4000	-1954
chr9	27944078	27952078	27950340	8000	27948078	-4000	4000	2262
chr9	100573636	100581636	100576957	8000	100577636	-4000	4000	-679
chr9	122904056	122912056	122911010	8000	122908056	-4000	4000	2954
chr9	122904056	122912056	122911694	8000	122908056	-4000	4000	3638
chr9	128941530	128949530	128946342	8000	128945530	-4000	4000	812
chr9	35865463	35873463	35870159	8000	35869463	-4000	4000	696
chr9	132887348	132895348	132889817	8000	132891348	-4000	4000	-1531
chr9	101469170	101477170	101476593	8000	101473170	-4000	4000	3423
chr9	21380255	21388255	21385065	8000	21384255	-4000	4000	810
chr9	121328843	121336843	121332611	8000	121332843	-4000	4000	-232
chr9	39357962	39365962	39361521	8000	39361962	-4000	4000	-441
chr9	96812269	96820269	96817955	8000	96816269	-4000	4000	1686
chr9	19370281	19378281	19371905	8000	19374281	-4000	4000	-2376
chr9	114308511	114316511	114309262	8000	114312511	-4000	4000	-3249
chr9	6327891	6335891	6330015	8000	6331891	-4000	4000	-1876
chr9	6503054	6511054	6506202	8000	6507054	-4000	4000	-852
chr9	108862898	108870898	108863339	8000	108866898	-4000	4000	-3559
chr9	128941530	128949530	128949234	8000	128945530	-4000	4000	3704
chr9	133571519	133579519	133573879	8000	133575519	-4000	4000	-1640
chr9	122507743	122515743	122511314	8000	122511743	-4000	4000	-429
chr9	107480852	107488852	107487067	8000	107484852	-4000	4000	2215
chr9	5772557	5780557	5772697	8000	5776557	-4000	4000	-3860
chr9	12706285	12714285	12709118	8000	12710285	-4000	4000	-1167
chr9	23686104	23694104	23692711	8000	23690104	-4000	4000	2607
chr9	35605982	35613982	35607474	8000	35609982	-4000	4000	-2508
chr9	35805732	35813732	35809220	8000	35809732	-4000	4000	-512
chr9	89001155	89009155	89001528	8000	89005155	-4000	4000	-3627
chr9	89001155	89009155	89001797	8000	89005155	-4000	4000	-3358
chr9	93316572	93324572	93318575	8000	93320572	-4000	4000	-1997
chr9	98195011	98203011	98200305	8000	98199011	-4000	4000	1294
chr9	116419112	116427112	116425995	8000	116423112	-4000	4000	2883
chr9	121781530	121789530	121783685	8000	121785530	-4000	4000	-1845
chr9	122198577	122206577	122200028	8000	122202577	-4000	4000	-2549
chr9	122472958	122480958	122477822	8000	122476958	-4000	4000	864
chr9	122785895	122793895	122789482	8000	122789895	-4000	4000	-413
chr9	122904056	122912056	122911099	8000	122908056	-4000	4000	3043
chr9	125230853	125238853	125236962	8000	125234853	-4000	4000	2109
chr9	127443674	127451674	127444109	8000	127447674	-4000	4000	-3565
chr9	90605832	90613832	90613611	8000	90609832	-4000	4000	3779
chr9	110168512	110176512	110169099	8000	110172512	-4000	4000	-3413
chr9	35100112	35108112	35107631	8000	35104112	-4000	4000	3519
chr9	1053552	1061552	1057202	8000	1057552	-4000	4000	-350
chr9	34719053	34727053	34725694	8000	34723053	-4000	4000	2641
chr9	84000074	84008074	84003344	8000	84004074	-4000	4000	-730
chr9	122911566	122919566	122918610	8000	122915566	-4000	4000	3044
chr9	122911566	122919566	122918776	8000	122915566	-4000	4000	3210
chr9	130883675	130891675	130886882	8000	130887675	-4000	4000	-793
chr9	101469170	101477170	101476352	8000	101473170	-4000	4000	3182
chr9	94554720	94562720	94558905	8000	94558720	-4000	4000	185
chr9	135928969	135936969	135933377	8000	135932969	-4000	4000	408
chr10	93952062	93960062	93959221	8000	93956062	-4000	4000	3159
chr10	79611455	79619455	79612415	8000	79615455	-4000	4000	-3040
chr10	100482646	100490646	100487655	8000	100486646	-4000	4000	1009
chr10	50007654	50015654	50009704	8000	50011654	-4000	4000	-1950
chr10	80267820	80275820	80274530	8000	80271820	-4000	4000	2710
chr10	17907164	17915164	17910989	8000	17911164	-4000	4000	-175
chr10	113584714	113592714	113588837	8000	113588714	-4000	4000	123
chr10	63163221	63171221	63168533	8000	63167221	-4000	4000	1312
chr10	68690487	68698487	68691241	8000	68694487	-4000	4000	-3246
chr10	104027286	104035286	104033245	8000	104031286	-4000	4000	1959
chr10	110602048	110610048	110604260	8000	110606048	-4000	4000	-1788
chr10	43190535	43198535	43195783	8000	43194535	-4000	4000	1248
chr10	91280337	91288337	91281578	8000	91284337	-4000	4000	-2759
chr10	270190	278190	277445	8000	274190	-4000	4000	3255
chr10	5103686	5111686	5107565	8000	5107686	-4000	4000	-121
chr10	7555270	7563270	7563258	8000	7559270	-4000	4000	3988
chr10	11456510	11464510	11463091	8000	11460510	-4000	4000	2581
chr10	17585032	17593032	17590265	8000	17589032	-4000	4000	1233
chr10	68891432	68899432	68892872	8000	68895432	-4000	4000	-2560
chr10	70758441	70766441	70760855	8000	70762441	-4000	4000	-1586
chr10	73670287	73678287	73674821	8000	73674287	-4000	4000	534
chr10	122993513	123001513	122994040	8000	122997513	-4000	4000	-3473
chr10	68891432	68899432	68892865	8000	68895432	-4000	4000	-2567
chr10	49730641	49738641	49738237	8000	49734641	-4000	4000	3596
chr10	113584714	113592714	113589695	8000	113588714	-4000	4000	981
chr10	7555270	7563270	7562799	8000	7559270	-4000	4000	3529
chr10	69100805	69108805	69104326	8000	69104805	-4000	4000	-479
chr10	70427936	70435936	70432730	8000	70431936	-4000	4000	794
chr10	28619112	28627112	28619549	8000	28623112	-4000	4000	-3563
chr10	122510907	122518907	122514213	8000	122514907	-4000	4000	-694
chr10	88602976	88610976	88605645	8000	88606976	-4000	4000	-1331
chr10	15207643	15215643	15213346	8000	15211643	-4000	4000	1703
chr10	1128384	1136384	1130289	8000	1132384	-4000	4000	-2095
chr10	85595552	85603552	85602482	8000	85599552	-4000	4000	2930
chr10	122428354	122436354	122429885	8000	122432354	-4000	4000	-2469
chr10	68690487	68698487	68693269	8000	68694487	-4000	4000	-1218
chr10	129831233	129839233	129837883	8000	129835233	-4000	4000	2650
chr10	15071475	15079475	15078423	8000	15075475	-4000	4000	2948
chr10	62092944	62100944	62093034	8000	62096944	-4000	4000	-3910
chr10	31801398	31809398	31808654	8000	31805398	-4000	4000	3256
chr10	100825944	100833944	100829007	8000	100829944	-4000	4000	-937
chr10	91624442	91632442	91630103	8000	91628442	-4000	4000	1661
chr10	59646764	59654764	59652931	8000	59650764	-4000	4000	2167
chr10	32263751	32271751	32269079	8000	32267751	-4000	4000	1328
chr10	117206299	117214299	117209534	8000	117210299	-4000	4000	-765
chr10	70593348	70601348	70598113	8000	70597348	-4000	4000	765
chr10	93952062	93960062	93959969	8000	93956062	-4000	4000	3907
chr10	100479744	100487744	100482431	8000	100483744	-4000	4000	-1313
chr10	133619895	133627895	133626676	8000	133623895	-4000	4000	2781
chr10	8012631	8020631	8013793	8000	8016631	-4000	4000	-2838
chr10	24844614	24852614	24849794	8000	24848614	-4000	4000	1180
chr10	43479181	43487181	43482442	8000	43483181	-4000	4000	-739
chr10	79512440	79520440	79513976	8000	79516440	-4000	4000	-2464
chr10	6006689	6014689	6012779	8000	6010689	-4000	4000	2090
chr10	15071475	15079475	15078465	8000	15075475	-4000	4000	2990
chr10	119567802	119575802	119575751	8000	119571802	-4000	4000	3949
chr10	101821974	101829974	101829188	8000	101825974	-4000	4000	3214
chr10	110286730	110294730	110294184	8000	110290730	-4000	4000	3454
chr10	42888	50888	47147	8000	46888	-4000	4000	259
chr10	47309577	47317577	47312700	8000	47313577	-4000	4000	-877
chr10	88674814	88682814	88678740	8000	88678814	-4000	4000	-74
chr10	99606522	99614522	99611046	8000	99610522	-4000	4000	524
chr10	122639736	122647736	122643214	8000	122643736	-4000	4000	-522
chr10	60790852	60798852	60793927	8000	60794852	-4000	4000	-925
chr10	111076907	111084907	111079139	8000	111080907	-4000	4000	-1768
chr10	116659696	116667696	116664104	8000	116663696	-4000	4000	408
chr10	87747512	87755512	87754508	8000	87751512	-4000	4000	2996
chr10	123135423	123143423	123137378	8000	123139423	-4000	4000	-2045
chr10	68690487	68698487	68692198	8000	68694487	-4000	4000	-2289
chr10	45999742	46007742	46003431	8000	46003742	-4000	4000	-311
chr10	47497854	47505854	47503229	8000	47501854	-4000	4000	1375
chr10	73670287	73678287	73675366	8000	73674287	-4000	4000	1079
chr10	13207110	13215110	13209286	8000	13211110	-4000	4000	-1824
chr10	73640881	73648881	73648469	8000	73644881	-4000	4000	3588
chr10	15069853	15077853	15073161	8000	15073853	-4000	4000	-692
chr10	5389101	5397101	5395458	8000	5393101	-4000	4000	2357
chr10	5522771	5530771	5525160	8000	5526771	-4000	4000	-1611
chr10	5761223	5769223	5766069	8000	5765223	-4000	4000	846
chr10	7555270	7563270	7563064	8000	7559270	-4000	4000	3794
chr10	43613904	43621904	43617243	8000	43617904	-4000	4000	-661
chr10	50007654	50015654	50009994	8000	50011654	-4000	4000	-1660
chr10	70427936	70435936	70435629	8000	70431936	-4000	4000	3693
chr10	73640881	73648881	73648778	8000	73644881	-4000	4000	3897
chr10	101766109	101774109	101770481	8000	101770109	-4000	4000	372
chr10	1035152	1043152	1041207	8000	1039152	-4000	4000	2055
chr10	102102489	102110489	102108153	8000	102106489	-4000	4000	1664
chr10	17907164	17915164	17907605	8000	17911164	-4000	4000	-3559
chr10	31525814	31533814	31527059	8000	31529814	-4000	4000	-2755
chr10	45788964	45796964	45792264	8000	45792964	-4000	4000	-700
chr10	50129509	50137509	50130930	8000	50133509	-4000	4000	-2579
chr10	85595552	85603552	85602429	8000	85599552	-4000	4000	2877
chr10	88602976	88610976	88606691	8000	88606976	-4000	4000	-285
chr10	97579884	97587884	97583693	8000	97583884	-4000	4000	-191
chr10	101766109	101774109	101770388	8000	101770109	-4000	4000	279
chr10	102830516	102838516	102837211	8000	102834516	-4000	4000	2695
chr10	117124521	117132521	117132219	8000	117128521	-4000	4000	3698
chr10	127873841	127881841	127878313	8000	127877841	-4000	4000	472
chr10	49730641	49738641	49738012	8000	49734641	-4000	4000	3371
chr10	38356098	38364098	38363573	8000	38360098	-4000	4000	3475
chr10	79551852	79559852	79558952	8000	79555852	-4000	4000	3100
chr10	25598229	25606229	25598866	8000	25602229	-4000	4000	-3363
chr10	5370692	5378692	5373766	8000	5374692	-4000	4000	-926
chr10	124980317	124988317	124987271	8000	124984317	-4000	4000	2954
chr10	73640881	73648881	73647854	8000	73644881	-4000	4000	2973
chr10	100146094	100154094	100152290	8000	100150094	-4000	4000	2196
chr10	49323492	49331492	49324129	8000	49327492	-4000	4000	-3363
chr10	116877477	116885477	116885399	8000	116881477	-4000	4000	3922
chr10	5522771	5530771	5525176	8000	5526771	-4000	4000	-1595
chr10	49323492	49331492	49327115	8000	49327492	-4000	4000	-377
chr10	103385065	103393065	103385469	8000	103389065	-4000	4000	-3596
chr10	116473957	116481957	116476655	8000	116477957	-4000	4000	-1302
chr10	49323492	49331492	49324515	8000	49327492	-4000	4000	-2977
chr10	133549901	133557901	133556759	8000	133553901	-4000	4000	2858
chr10	5389101	5397101	5394423	8000	5393101	-4000	4000	1322
chr10	42888	50888	48649	8000	46888	-4000	4000	1761
chr10	100269280	100277280	100275109	8000	100273280	-4000	4000	1829
chr10	23034523	23042523	23037329	8000	23038523	-4000	4000	-1194
chr10	68337107	68345107	68337459	8000	68341107	-4000	4000	-3648
chr10	132804392	132812392	132810967	8000	132808392	-4000	4000	2575
chr10	15069853	15077853	15073243	8000	15073853	-4000	4000	-610
chr10	45001326	45009326	45003746	8000	45005326	-4000	4000	-1580
chr10	24579609	24587609	24585027	8000	24583609	-4000	4000	1418
chr10	17907164	17915164	17910664	8000	17911164	-4000	4000	-500
chr10	22325542	22333542	22329407	8000	22329542	-4000	4000	-135
chr10	60865438	60873438	60869519	8000	60869438	-4000	4000	81
chr10	15207643	15215643	15212825	8000	15211643	-4000	4000	1182
chr10	101553321	101561321	101553655	8000	101557321	-4000	4000	-3666
chr10	47353881	47361881	47355375	8000	47357881	-4000	4000	-2506
chr10	11456510	11464510	11462370	8000	11460510	-4000	4000	1860
chr10	97861000	97869000	97865491	8000	97865000	-4000	4000	491
chr10	133549901	133557901	133555506	8000	133553901	-4000	4000	1605
chr10	11456510	11464510	11462875	8000	11460510	-4000	4000	2365
chr10	113584714	113592714	113589020	8000	113588714	-4000	4000	306
chr10	116667192	116675192	116674935	8000	116671192	-4000	4000	3743
chr10	49127154	49135154	49132150	8000	49131154	-4000	4000	996
chr10	133519558	133527558	133527489	8000	133523558	-4000	4000	3931
chr10	5634867	5642867	5639121	8000	5638867	-4000	4000	254
chr10	49323492	49331492	49325876	8000	49327492	-4000	4000	-1616
chr10	47309577	47317577	47309932	8000	47313577	-4000	4000	-3645
chr10	25598229	25606229	25598248	8000	25602229	-4000	4000	-3981
chr10	91510829	91518829	91514176	8000	91514829	-4000	4000	-653
chr10	59784747	59792747	59792500	8000	59788747	-4000	4000	3753
chr10	79512440	79520440	79513127	8000	79516440	-4000	4000	-3313
chr10	122693709	122701709	122698207	8000	122697709	-4000	4000	498
chr10	102102489	102110489	102110022	8000	102106489	-4000	4000	3533
chr10	42888	50888	47164	8000	46888	-4000	4000	276
chr10	5522771	5530771	5525487	8000	5526771	-4000	4000	-1284
chr10	102146333	102154333	102148642	8000	102150333	-4000	4000	-1691
chr10	63151031	63159031	63153649	8000	63155031	-4000	4000	-1382
chr10	133127675	133135675	133129327	8000	133131675	-4000	4000	-2348
chr10	17907164	17915164	17910518	8000	17911164	-4000	4000	-646
chr10	116667192	116675192	116672844	8000	116671192	-4000	4000	1652
chr10	67917899	67925899	67925086	8000	67921899	-4000	4000	3187
chr10	88775626	88783626	88778199	8000	88779626	-4000	4000	-1427
chr10	23190245	23198245	23193947	8000	23194245	-4000	4000	-298
chr10	127873841	127881841	127878163	8000	127877841	-4000	4000	322
chr10	47323588	47331588	47325503	8000	47327588	-4000	4000	-2085
chr10	68690487	68698487	68691535	8000	68694487	-4000	4000	-2952
chr10	96589315	96597315	96595419	8000	96593315	-4000	4000	2104
chr10	126008381	126016381	126009409	8000	126012381	-4000	4000	-2972
chr10	270190	278190	277415	8000	274190	-4000	4000	3225
chr10	37945573	37953573	37952518	8000	37949573	-4000	4000	2945
chr10	102830516	102838516	102830766	8000	102834516	-4000	4000	-3750
chr10	121474332	121482332	121479872	8000	121478332	-4000	4000	1540
chr10	124832667	124840667	124834726	8000	124836667	-4000	4000	-1941
chr10	1128384	1136384	1130048	8000	1132384	-4000	4000	-2336
chr10	43613904	43621904	43616980	8000	43617904	-4000	4000	-924
chr10	45001326	45009326	45003951	8000	45005326	-4000	4000	-1375
chr10	90908096	90916096	90912908	8000	90912096	-4000	4000	812
chr10	91510829	91518829	91512725	8000	91514829	-4000	4000	-2104
chr10	102102489	102110489	102107748	8000	102106489	-4000	4000	1259
chr10	127737183	127745183	127738601	8000	127741183	-4000	4000	-2582
chr10	44991891	44999891	44991911	8000	44995891	-4000	4000	-3980
chr10	119825147	119833147	119827368	8000	119829147	-4000	4000	-1779
chr10	125760143	125768143	125767633	8000	125764143	-4000	4000	3490
chr10	47309577	47317577	47310597	8000	47313577	-4000	4000	-2980
chr10	104027286	104035286	104034157	8000	104031286	-4000	4000	2871
chr10	131088391	131096391	131092533	8000	131092391	-4000	4000	142
chr10	45298298	45306298	45304074	8000	45302298	-4000	4000	1776
chr10	1035152	1043152	1041377	8000	1039152	-4000	4000	2225
chr10	6423143	6431143	6430899	8000	6427143	-4000	4000	3756
chr10	15207643	15215643	15213982	8000	15211643	-4000	4000	2339
chr10	21739630	21747630	21742182	8000	21743630	-4000	4000	-1448
chr10	24579609	24587609	24585731	8000	24583609	-4000	4000	2122
chr10	93073885	93081885	93075211	8000	93077885	-4000	4000	-2674
chr10	100479744	100487744	100479955	8000	100483744	-4000	4000	-3789
chr10	73913496	73921496	73915291	8000	73917496	-4000	4000	-2205
chr10	85595552	85603552	85602586	8000	85599552	-4000	4000	3034
chr10	73419579	73427579	73425116	8000	73423579	-4000	4000	1537
chr10	75033472	75041472	75038057	8000	75037472	-4000	4000	585
chr10	100965458	100973458	100973236	8000	100969458	-4000	4000	3778
chr10	13273796	13281796	13278306	8000	13277796	-4000	4000	510
chr10	122693709	122701709	122697853	8000	122697709	-4000	4000	144
chr10	24579609	24587609	24585902	8000	24583609	-4000	4000	2293
chr10	93073885	93081885	93076558	8000	93077885	-4000	4000	-1327
chr10	22325542	22333542	22327614	8000	22329542	-4000	4000	-1928
chr10	73913496	73921496	73916451	8000	73917496	-4000	4000	-1045
chr10	103385065	103393065	103387677	8000	103389065	-4000	4000	-1388
chr10	117545546	117553546	117548439	8000	117549546	-4000	4000	-1107
chr10	14514557	14522557	14521986	8000	14518557	-4000	4000	3429
chr10	56353227	56361227	56360373	8000	56357227	-4000	4000	3146
chr10	67914390	67922390	67916519	8000	67918390	-4000	4000	-1871
chr10	72883694	72891694	72885901	8000	72887694	-4000	4000	-1793
chr10	94986091	94994091	94986105	8000	94990091	-4000	4000	-3986
chr10	62807996	62815996	62813365	8000	62811996	-4000	4000	1369
chr10	124832667	124840667	124834855	8000	124836667	-4000	4000	-1812
chr10	12165961	12173961	12173796	8000	12169961	-4000	4000	3835
chr10	93662010	93670010	93663067	8000	93666010	-4000	4000	-2943
chr10	92027437	92035437	92028940	8000	92031437	-4000	4000	-2497
chr10	116659696	116667696	116664817	8000	116663696	-4000	4000	1121
chr10	47497854	47505854	47502517	8000	47501854	-4000	4000	663
chr10	87549461	87557461	87552470	8000	87553461	-4000	4000	-991
chr10	5522771	5530771	5525262	8000	5526771	-4000	4000	-1509
chr10	15207643	15215643	15212194	8000	15211643	-4000	4000	551
chr10	95307771	95315771	95312142	8000	95311771	-4000	4000	371
chr10	73371101	73379101	73376157	8000	73375101	-4000	4000	1056
chr10	5389101	5397101	5394327	8000	5393101	-4000	4000	1226
chr10	99390330	99398330	99390342	8000	99394330	-4000	4000	-3988
chr10	117206299	117214299	117209831	8000	117210299	-4000	4000	-468
chr10	125760143	125768143	125763526	8000	125764143	-4000	4000	-617
chr10	100961134	100969134	100963122	8000	100965134	-4000	4000	-2012
chr10	15774170	15782170	15778828	8000	15778170	-4000	4000	658
chr10	87743705	87751705	87745919	8000	87747705	-4000	4000	-1786
chr10	109860766	109868766	109865077	8000	109864766	-4000	4000	311
chr10	113830725	113838725	113837085	8000	113834725	-4000	4000	2360
chr10	30607779	30615779	30611959	8000	30611779	-4000	4000	180
chr10	116473957	116481957	116476713	8000	116477957	-4000	4000	-1244
chr10	89417605	89425605	89418624	8000	89421605	-4000	4000	-2981
chr10	103449240	103457240	103455643	8000	103453240	-4000	4000	2403
chr10	73627612	73635612	73632024	8000	73631612	-4000	4000	412
chr10	101766109	101774109	101770551	8000	101770109	-4000	4000	442
chr10	92691647	92699647	92692724	8000	92695647	-4000	4000	-2923
chr10	62807996	62815996	62814271	8000	62811996	-4000	4000	2275
chr10	17907164	17915164	17910664	8000	17911164	-4000	4000	-500
chr10	45001326	45009326	45003781	8000	45005326	-4000	4000	-1545
chr10	68690487	68698487	68690832	8000	68694487	-4000	4000	-3655
chr10	72009558	72017558	72009796	8000	72013558	-4000	4000	-3762
chr10	117545546	117553546	117548384	8000	117549546	-4000	4000	-1162
chr10	15069853	15077853	15073238	8000	15073853	-4000	4000	-615
chr10	45821594	45829594	45827193	8000	45825594	-4000	4000	1599
chr10	95224928	95232928	95228901	8000	95228928	-4000	4000	-27
chr10	102146333	102154333	102148693	8000	102150333	-4000	4000	-1640
chr10	62807996	62815996	62813739	8000	62811996	-4000	4000	1743
chr10	35634247	35642247	35641169	8000	35638247	-4000	4000	2922
chr10	69503666	69511666	69506139	8000	69507666	-4000	4000	-1527
chr10	91624442	91632442	91629914	8000	91628442	-4000	4000	1472
chr10	42830937	42838937	42830939	8000	42834937	-4000	4000	-3998
chr10	13313428	13321428	13318858	8000	13317428	-4000	4000	1430
chr10	62807996	62815996	62813424	8000	62811996	-4000	4000	1428
chr10	103468804	103476804	103473537	8000	103472804	-4000	4000	733
chr10	68942847	68950847	68946494	8000	68946847	-4000	4000	-353
chr10	102226186	102234186	102229004	8000	102230186	-4000	4000	-1182
chr10	70108282	70116282	70109092	8000	70112282	-4000	4000	-3190
chr10	73003217	73011217	73007980	8000	73007217	-4000	4000	763
chr10	122909111	122917111	122912951	8000	122913111	-4000	4000	-160
chr10	43372335	43380335	43373650	8000	43376335	-4000	4000	-2685
chr10	11868277	11876277	11869457	8000	11872277	-4000	4000	-2820
chr10	27164135	27172135	27171061	8000	27168135	-4000	4000	2926
chr10	45001326	45009326	45004447	8000	45005326	-4000	4000	-879
chr10	73808501	73816501	73812774	8000	73812501	-4000	4000	273
chr10	103385065	103393065	103388204	8000	103389065	-4000	4000	-861
chr10	103385065	103393065	103388436	8000	103389065	-4000	4000	-629
chr10	73240504	73248504	73243503	8000	73244504	-4000	4000	-1001
chr10	73913496	73921496	73914787	8000	73917496	-4000	4000	-2709
chr10	52761380	52769380	52768268	8000	52765380	-4000	4000	2888
chr10	84215621	84223621	84222257	8000	84219621	-4000	4000	2636
chr10	94986091	94994091	94988927	8000	94990091	-4000	4000	-1164
chr10	79611455	79619455	79613962	8000	79615455	-4000	4000	-1493
chr10	70593348	70601348	70600771	8000	70597348	-4000	4000	3423
chr10	69567698	69575698	69573000	8000	69571698	-4000	4000	1302
chr10	116605175	116613175	116609091	8000	116609175	-4000	4000	-84
chr10	47361496	47369496	47368256	8000	47365496	-4000	4000	2760
chr10	31525814	31533814	31526891	8000	31529814	-4000	4000	-2923
chr10	59646764	59654764	59652733	8000	59650764	-4000	4000	1969
chr10	102226186	102234186	102230230	8000	102230186	-4000	4000	44
chr10	45611500	45619500	45616059	8000	45615500	-4000	4000	559
chr10	102226186	102234186	102226488	8000	102230186	-4000	4000	-3698
chr10	102669731	102677731	102676776	8000	102673731	-4000	4000	3045
chr10	4844062	4852062	4847210	8000	4848062	-4000	4000	-852
chr10	27668874	27676874	27675068	8000	27672874	-4000	4000	2194
chr10	27668874	27676874	27675070	8000	27672874	-4000	4000	2196
chr10	45298298	45306298	45303768	8000	45302298	-4000	4000	1470
chr10	46457099	46465099	46462654	8000	46461099	-4000	4000	1555
chr10	62092944	62100944	62093255	8000	62096944	-4000	4000	-3689
chr10	70593348	70601348	70598935	8000	70597348	-4000	4000	1587
chr10	100479744	100487744	100479912	8000	100483744	-4000	4000	-3832
chr10	101821974	101829974	101827365	8000	101825974	-4000	4000	1391
chr10	103385065	103393065	103388348	8000	103389065	-4000	4000	-717
chr10	104263459	104271459	104267320	8000	104267459	-4000	4000	-139
chr10	105261242	105269242	105263559	8000	105265242	-4000	4000	-1683
chr10	110507533	110515533	110510069	8000	110511533	-4000	4000	-1464
chr10	113584714	113592714	113592211	8000	113588714	-4000	4000	3497
chr10	113584714	113592714	113592212	8000	113588714	-4000	4000	3498
chr10	3133718	3141718	3134508	8000	3137718	-4000	4000	-3210
chr10	17907164	17915164	17910352	8000	17911164	-4000	4000	-812
chr10	27164135	27172135	27170634	8000	27168135	-4000	4000	2499
chr10	47497854	47505854	47502746	8000	47501854	-4000	4000	892
chr10	48149088	48157088	48157074	8000	48153088	-4000	4000	3986
chr10	92042692	92050692	92049803	8000	92046692	-4000	4000	3111
chr10	101780443	101788443	101786074	8000	101784443	-4000	4000	1631
chr10	104122385	104130385	104125681	8000	104126385	-4000	4000	-704
chr10	95224928	95232928	95228923	8000	95228928	-4000	4000	-5
chr10	31525814	31533814	31526818	8000	31529814	-4000	4000	-2996
chr10	45001326	45009326	45003758	8000	45005326	-4000	4000	-1568
chr10	72883694	72891694	72886125	8000	72887694	-4000	4000	-1569
chr10	80267820	80275820	80275183	8000	80271820	-4000	4000	3363
chr10	11456510	11464510	11463032	8000	11460510	-4000	4000	2522
chr10	49323492	49331492	49324265	8000	49327492	-4000	4000	-3227
chr10	49730641	49738641	49738049	8000	49734641	-4000	4000	3408
chr10	79512440	79520440	79514130	8000	79516440	-4000	4000	-2310
chr10	69629596	69637596	69633058	8000	69633596	-4000	4000	-538
chr10	70427936	70435936	70435786	8000	70431936	-4000	4000	3850
chr10	1035152	1043152	1042634	8000	1039152	-4000	4000	3482
chr10	21752548	21760548	21756708	8000	21756548	-4000	4000	160
chr10	45001326	45009326	45003486	8000	45005326	-4000	4000	-1840
chr10	68226595	68234595	68231345	8000	68230595	-4000	4000	750
chr10	69397884	69405884	69398646	8000	69401884	-4000	4000	-3238
chr10	89417605	89425605	89418633	8000	89421605	-4000	4000	-2972
chr10	97429444	97437444	97430500	8000	97433444	-4000	4000	-2944
chr10	113726907	113734907	113729480	8000	113730907	-4000	4000	-1427
chr10	117206299	117214299	117209907	8000	117210299	-4000	4000	-392
chr10	122693709	122701709	122699643	8000	122697709	-4000	4000	1934
chr10	270190	278190	277452	8000	274190	-4000	4000	3262
chr10	35604935	35612935	35607720	8000	35608935	-4000	4000	-1215
chr10	270190	278190	276920	8000	274190	-4000	4000	2730
chr10	4844062	4852062	4847529	8000	4848062	-4000	4000	-533
chr10	7555270	7563270	7559781	8000	7559270	-4000	4000	511
chr10	11868277	11876277	11870841	8000	11872277	-4000	4000	-1436
chr10	13313428	13321428	13318879	8000	13317428	-4000	4000	1451
chr10	15207643	15215643	15211818	8000	15211643	-4000	4000	175
chr10	15207643	15215643	15212223	8000	15211643	-4000	4000	580
chr10	16509745	16517745	16512809	8000	16513745	-4000	4000	-936
chr10	20775973	20783973	20783574	8000	20779973	-4000	4000	3601
chr10	25598229	25606229	25598688	8000	25602229	-4000	4000	-3541
chr10	37228567	37236567	37231530	8000	37232567	-4000	4000	-1037
chr10	47309577	47317577	47310650	8000	47313577	-4000	4000	-2927
chr10	94986091	94994091	94989033	8000	94990091	-4000	4000	-1058
chr10	100961134	100969134	100965126	8000	100965134	-4000	4000	-8
chr10	101222994	101230994	101227771	8000	101226994	-4000	4000	777
chr10	102226186	102234186	102230492	8000	102230186	-4000	4000	306
chr10	102226186	102234186	102230671	8000	102230186	-4000	4000	485
chr10	102226186	102234186	102230872	8000	102230186	-4000	4000	686
chr10	102226186	102234186	102231024	8000	102230186	-4000	4000	838
chr10	102629535	102637535	102630275	8000	102633535	-4000	4000	-3260
chr10	111076907	111084907	111079475	8000	111080907	-4000	4000	-1432
chr10	119029670	119037670	119034038	8000	119033670	-4000	4000	368
chr10	11916022	11924022	11921303	8000	11920022	-4000	4000	1281
chr10	53798771	53806771	53806745	8000	53802771	-4000	4000	3974
chr10	70294970	70302970	70301460	8000	70298970	-4000	4000	2490
chr10	73640881	73648881	73645037	8000	73644881	-4000	4000	156
chr10	103449240	103457240	103455553	8000	103453240	-4000	4000	2313
chr10	68690487	68698487	68691891	8000	68694487	-4000	4000	-2596
chr10	29453338	29461338	29457813	8000	29457338	-4000	4000	475
chr10	46998488	47006488	47001044	8000	47002488	-4000	4000	-1444
chr10	13434484	13442484	13439240	8000	13438484	-4000	4000	756
chr10	37945573	37953573	37952516	8000	37949573	-4000	4000	2943
chr10	58366751	58374751	58368825	8000	58370751	-4000	4000	-1926
chr10	98379565	98387565	98383625	8000	98383565	-4000	4000	60
chr10	45999742	46007742	46005722	8000	46003742	-4000	4000	1980
chr10	70593348	70601348	70598568	8000	70597348	-4000	4000	1220
chr10	73627612	73635612	73634482	8000	73631612	-4000	4000	2870
chr10	73244843	73252843	73251800	8000	73248843	-4000	4000	2957
chr10	33173492	33181492	33180260	8000	33177492	-4000	4000	2768
chr10	49706261	49714261	49708621	8000	49710261	-4000	4000	-1640
chr10	126008381	126016381	126008450	8000	126012381	-4000	4000	-3931
chr10	12246589	12254589	12249675	8000	12250589	-4000	4000	-914
chr10	17233593	17241593	17236369	8000	17237593	-4000	4000	-1224
chr10	91510829	91518829	91512426	8000	91514829	-4000	4000	-2403
chr10	15207643	15215643	15213283	8000	15211643	-4000	4000	1640
chr10	122926901	122934901	122932588	8000	122930901	-4000	4000	1687
chr10	49127154	49135154	49133834	8000	49131154	-4000	4000	2680
chr10	24579609	24587609	24584832	8000	24583609	-4000	4000	1223
chr10	27668874	27676874	27675306	8000	27672874	-4000	4000	2432
chr10	113779429	113787429	113780617	8000	113783429	-4000	4000	-2812
chr10	31801398	31809398	31807127	8000	31805398	-4000	4000	1729
chr10	80642560	80650560	80646306	8000	80646560	-4000	4000	-254
chr10	60790852	60798852	60792178	8000	60794852	-4000	4000	-2674
chr10	87020730	87028730	87024638	8000	87024730	-4000	4000	-92
chr10	112145865	112153865	112150304	8000	112149865	-4000	4000	439
chr10	117545546	117553546	117548117	8000	117549546	-4000	4000	-1429
chr10	90908096	90916096	90915575	8000	90912096	-4000	4000	3479
chr10	5389101	5397101	5393826	8000	5393101	-4000	4000	725
chr10	68410064	68418064	68415015	8000	68414064	-4000	4000	951
chr10	75028624	75036624	75028952	8000	75032624	-4000	4000	-3672
chr10	3133718	3141718	3140695	8000	3137718	-4000	4000	2977
chr10	31525814	31533814	31526744	8000	31529814	-4000	4000	-3070
chr10	38356098	38364098	38363576	8000	38360098	-4000	4000	3478
chr10	73640881	73648881	73646787	8000	73644881	-4000	4000	1906
chr10	47309577	47317577	47312800	8000	47313577	-4000	4000	-777
chr10	88748776	88756776	88752600	8000	88752776	-4000	4000	-176
chr10	119163720	119171720	119168444	8000	119167720	-4000	4000	724
chr10	106569663	106577663	106577452	8000	106573663	-4000	4000	3789
chr10	5522771	5530771	5525379	8000	5526771	-4000	4000	-1392
chr10	49127154	49135154	49131957	8000	49131154	-4000	4000	803
chr10	127873841	127881841	127878359	8000	127877841	-4000	4000	518
chr10	112424379	112432379	112425417	8000	112428379	-4000	4000	-2962
chr10	49730641	49738641	49736367	8000	49734641	-4000	4000	1726
chr10	42888	50888	47210	8000	46888	-4000	4000	322
chr10	30305801	30313801	30313683	8000	30309801	-4000	4000	3882
chr10	50301586	50309586	50307205	8000	50305586	-4000	4000	1619
chr10	93073885	93081885	93077203	8000	93077885	-4000	4000	-682
chr10	99871577	99879577	99877281	8000	99875577	-4000	4000	1704
chr10	117206299	117214299	117209890	8000	117210299	-4000	4000	-409
chr10	5634867	5642867	5641802	8000	5638867	-4000	4000	2935
chr10	89417605	89425605	89418410	8000	89421605	-4000	4000	-3195
chr10	30457833	30465833	30460703	8000	30461833	-4000	4000	-1130
chr10	5494697	5502697	5499320	8000	5498697	-4000	4000	623
chr10	5494697	5502697	5499336	8000	5498697	-4000	4000	639
chr10	24579609	24587609	24585577	8000	24583609	-4000	4000	1968
chr10	87232908	87240908	87234941	8000	87236908	-4000	4000	-1967
chr10	37228567	37236567	37231669	8000	37232567	-4000	4000	-898
chr10	93055493	93063493	93058494	8000	93059493	-4000	4000	-999
chr10	15207643	15215643	15214167	8000	15211643	-4000	4000	2524
chr10	102159871	102167871	102160322	8000	102163871	-4000	4000	-3549
chr10	93662010	93670010	93662098	8000	93666010	-4000	4000	-3912
chr10	69100805	69108805	69103897	8000	69104805	-4000	4000	-908
chr10	70877184	70885184	70883735	8000	70881184	-4000	4000	2551
chr10	70564450	70572450	70566605	8000	70568450	-4000	4000	-1845
chr10	11456510	11464510	11463404	8000	11460510	-4000	4000	2894
chr10	110602048	110610048	110602559	8000	110606048	-4000	4000	-3489
chr10	11332675	11340675	11333448	8000	11336675	-4000	4000	-3227
chr10	122828167	122836167	122833707	8000	122832167	-4000	4000	1540
chr10	47323588	47331588	47325788	8000	47327588	-4000	4000	-1800
chr10	96589315	96597315	96595493	8000	96593315	-4000	4000	2178
chr10	7555270	7563270	7563229	8000	7559270	-4000	4000	3959
chr10	97431909	97439909	97432599	8000	97435909	-4000	4000	-3310
chr10	11456510	11464510	11463543	8000	11460510	-4000	4000	3033
chr10	23034523	23042523	23037311	8000	23038523	-4000	4000	-1212
chr10	92691647	92699647	92694746	8000	92695647	-4000	4000	-901
chr10	11456510	11464510	11463282	8000	11460510	-4000	4000	2772
chr10	15509954	15517954	15517178	8000	15513954	-4000	4000	3224
chr10	17233593	17241593	17233623	8000	17237593	-4000	4000	-3970
chr10	17907164	17915164	17910321	8000	17911164	-4000	4000	-843
chr10	24543848	24551848	24546197	8000	24547848	-4000	4000	-1651
chr10	29453338	29461338	29458553	8000	29457338	-4000	4000	1215
chr10	35604935	35612935	35605595	8000	35608935	-4000	4000	-3340
chr10	43613904	43621904	43616727	8000	43617904	-4000	4000	-1177
chr10	68208017	68216017	68210655	8000	68212017	-4000	4000	-1362
chr10	68410064	68418064	68416753	8000	68414064	-4000	4000	2689
chr10	70593348	70601348	70597980	8000	70597348	-4000	4000	632
chr10	70767238	70775238	70771384	8000	70771238	-4000	4000	146
chr10	73240504	73248504	73246008	8000	73244504	-4000	4000	1504
chr10	82983179	82991179	82985232	8000	82987179	-4000	4000	-1947
chr10	85595552	85603552	85602369	8000	85599552	-4000	4000	2817
chr10	87747512	87755512	87754560	8000	87751512	-4000	4000	3048
chr10	90908096	90916096	90912885	8000	90912096	-4000	4000	789
chr10	91624442	91632442	91630479	8000	91628442	-4000	4000	2037
chr10	95224928	95232928	95228749	8000	95228928	-4000	4000	-179
chr10	96339221	96347221	96345830	8000	96343221	-4000	4000	2609
chr10	102830516	102838516	102832618	8000	102834516	-4000	4000	-1898
chr10	104122385	104130385	104125545	8000	104126385	-4000	4000	-840
chr10	104122385	104130385	104125804	8000	104126385	-4000	4000	-581
chr10	117124521	117132521	117132183	8000	117128521	-4000	4000	3662
chr10	122926901	122934901	122932297	8000	122930901	-4000	4000	1396
chr10	126008381	126016381	126008486	8000	126012381	-4000	4000	-3895
chr10	133549901	133557901	133555978	8000	133553901	-4000	4000	2077
chr10	79512440	79520440	79513976	8000	79516440	-4000	4000	-2464
chr10	99871577	99879577	99877281	8000	99875577	-4000	4000	1704
chr10	104125888	104133888	104130180	8000	104129888	-4000	4000	292
chr10	119825147	119833147	119827846	8000	119829147	-4000	4000	-1301
chr10	250637	258637	252912	8000	254637	-4000	4000	-1725
chr10	72883694	72891694	72887575	8000	72887694	-4000	4000	-119
chr10	85595552	85603552	85602387	8000	85599552	-4000	4000	2835
chr10	91861475	91869475	91864462	8000	91865475	-4000	4000	-1013
chr10	122639736	122647736	122640348	8000	122643736	-4000	4000	-3388
chr10	133222412	133230412	133224924	8000	133226412	-4000	4000	-1488
chr10	43190535	43198535	43196097	8000	43194535	-4000	4000	1562
chr10	114973676	114981676	114975295	8000	114977676	-4000	4000	-2381
chr10	122693709	122701709	122699739	8000	122697709	-4000	4000	2030
chr10	111076907	111084907	111080112	8000	111080907	-4000	4000	-795
chr10	84255960	84263960	84258559	8000	84259960	-4000	4000	-1401
chr10	119825147	119833147	119827560	8000	119829147	-4000	4000	-1587
chr10	15207643	15215643	15213760	8000	15211643	-4000	4000	2117
chr10	75028624	75036624	75030829	8000	75032624	-4000	4000	-1795
chr10	102226186	102234186	102227663	8000	102230186	-4000	4000	-2523
chr10	122909111	122917111	122911712	8000	122913111	-4000	4000	-1399
chr10	122993513	123001513	122994381	8000	122997513	-4000	4000	-3132
chr10	15207643	15215643	15213095	8000	15211643	-4000	4000	1452
chr10	50129509	50137509	50130954	8000	50133509	-4000	4000	-2555
chr10	70877184	70885184	70877416	8000	70881184	-4000	4000	-3768
chr10	99606522	99614522	99610658	8000	99610522	-4000	4000	136
chr10	104451102	104459102	104454487	8000	104455102	-4000	4000	-615
chr10	132804392	132812392	132808415	8000	132808392	-4000	4000	23
chr10	13273796	13281796	13281039	8000	13277796	-4000	4000	3243
chr10	92042692	92050692	92049834	8000	92046692	-4000	4000	3142
chr10	112424379	112432379	112430827	8000	112428379	-4000	4000	2448
chr10	11456510	11464510	11462825	8000	11460510	-4000	4000	2315
chr10	12165961	12173961	12172823	8000	12169961	-4000	4000	2862
chr10	13207110	13215110	13209161	8000	13211110	-4000	4000	-1949
chr10	13434484	13442484	13441751	8000	13438484	-4000	4000	3267
chr10	14867741	14875741	14870624	8000	14871741	-4000	4000	-1117
chr10	14893359	14901359	14897435	8000	14897359	-4000	4000	76
chr10	22325542	22333542	22326910	8000	22329542	-4000	4000	-2632
chr10	23034523	23042523	23037309	8000	23038523	-4000	4000	-1214
chr10	25598229	25606229	25598241	8000	25602229	-4000	4000	-3988
chr10	27164135	27172135	27171010	8000	27168135	-4000	4000	2875
chr10	31801398	31809398	31807608	8000	31805398	-4000	4000	2210
chr10	37945573	37953573	37953033	8000	37949573	-4000	4000	3460
chr10	38356098	38364098	38362281	8000	38360098	-4000	4000	2183
chr10	43613904	43621904	43616370	8000	43617904	-4000	4000	-1534
chr10	46457099	46465099	46462595	8000	46461099	-4000	4000	1496
chr10	47309577	47317577	47310667	8000	47313577	-4000	4000	-2910
chr10	49323492	49331492	49323822	8000	49327492	-4000	4000	-3670
chr10	49323492	49331492	49324151	8000	49327492	-4000	4000	-3341
chr10	58366751	58374751	58368001	8000	58370751	-4000	4000	-2750
chr10	59646764	59654764	59652769	8000	59650764	-4000	4000	2005
chr10	72092032	72100032	72097271	8000	72096032	-4000	4000	1239
chr10	73249762	73257762	73256398	8000	73253762	-4000	4000	2636
chr10	75028624	75036624	75029231	8000	75032624	-4000	4000	-3393
chr10	87549461	87557461	87552225	8000	87553461	-4000	4000	-1236
chr10	91624442	91632442	91630828	8000	91628442	-4000	4000	2386
chr10	94329226	94337226	94334204	8000	94333226	-4000	4000	978
chr10	95233572	95241572	95238622	8000	95237572	-4000	4000	1050
chr10	97429444	97437444	97430540	8000	97433444	-4000	4000	-2904
chr10	97861000	97869000	97864182	8000	97865000	-4000	4000	-818
chr10	100284149	100292149	100290084	8000	100288149	-4000	4000	1935
chr10	102226186	102234186	102226608	8000	102230186	-4000	4000	-3578
chr10	103298796	103306796	103303772	8000	103302796	-4000	4000	976
chr10	104125888	104133888	104133628	8000	104129888	-4000	4000	3740
chr10	112145865	112153865	112153588	8000	112149865	-4000	4000	3723
chr10	112424379	112432379	112427405	8000	112428379	-4000	4000	-974
chr10	116659696	116667696	116665715	8000	116663696	-4000	4000	2019
chr10	119163720	119171720	119169290	8000	119167720	-4000	4000	1570
chr10	119825147	119833147	119826650	8000	119829147	-4000	4000	-2497
chr10	122334159	122342159	122334897	8000	122338159	-4000	4000	-3262
chr10	122828167	122836167	122833887	8000	122832167	-4000	4000	1720
chr10	122993513	123001513	122994060	8000	122997513	-4000	4000	-3453
chr10	128092659	128100659	128099179	8000	128096659	-4000	4000	2520
chr10	110602048	110610048	110602970	8000	110606048	-4000	4000	-3078
chr10	114290824	114298824	114295943	8000	114294824	-4000	4000	1119
chr10	46387784	46395784	46390872	8000	46391784	-4000	4000	-912
chr10	62807996	62815996	62812954	8000	62811996	-4000	4000	958
chr10	6423143	6431143	6430928	8000	6427143	-4000	4000	3785
chr10	5634867	5642867	5640749	8000	5638867	-4000	4000	1882
chr10	70427936	70435936	70432765	8000	70431936	-4000	4000	829
chr10	47497854	47505854	47503504	8000	47501854	-4000	4000	1650
chr10	72055034	72063034	72062758	8000	72059034	-4000	4000	3724
chr10	76865601	76873601	76870218	8000	76869601	-4000	4000	617
chr10	120905524	120913524	120908930	8000	120909524	-4000	4000	-594
chr10	73640881	73648881	73647193	8000	73644881	-4000	4000	2312
chr10	35568669	35576669	35570025	8000	35572669	-4000	4000	-2644
chr10	67914390	67922390	67916902	8000	67918390	-4000	4000	-1488
chr10	68337107	68345107	68337309	8000	68341107	-4000	4000	-3798
chr10	87366695	87374695	87367147	8000	87370695	-4000	4000	-3548
chr10	80642560	80650560	80644155	8000	80646560	-4000	4000	-2405
chr10	7555270	7563270	7563040	8000	7559270	-4000	4000	3770
chr10	82983179	82991179	82985518	8000	82987179	-4000	4000	-1661
chr10	15207643	15215643	15214058	8000	15211643	-4000	4000	2415
chr10	44991891	44999891	44991995	8000	44995891	-4000	4000	-3896
chr10	27164135	27172135	27170449	8000	27168135	-4000	4000	2314
chr10	70427936	70435936	70435507	8000	70431936	-4000	4000	3571
chr10	84181294	84189294	84184681	8000	84185294	-4000	4000	-613
chr10	100482646	100490646	100487755	8000	100486646	-4000	4000	1109
chr10	49706261	49714261	49708784	8000	49710261	-4000	4000	-1477
chr10	91510829	91518829	91512571	8000	91514829	-4000	4000	-2258
chr10	91861475	91869475	91863055	8000	91865475	-4000	4000	-2420
chr10	100284149	100292149	100290067	8000	100288149	-4000	4000	1918
chr10	104027286	104035286	104032686	8000	104031286	-4000	4000	1400
chr10	116376029	116384029	116379529	8000	116380029	-4000	4000	-500
chr10	61402642	61410642	61410618	8000	61406642	-4000	4000	3976
chr10	72883694	72891694	72887421	8000	72887694	-4000	4000	-273
chr10	24579609	24587609	24585845	8000	24583609	-4000	4000	2236
chr10	73768161	73776161	73770322	8000	73772161	-4000	4000	-1839
chr10	73768161	73776161	73771040	8000	73772161	-4000	4000	-1121
chr10	49706261	49714261	49708421	8000	49710261	-4000	4000	-1840
chr10	4844062	4852062	4847807	8000	4848062	-4000	4000	-255
chr10	24543848	24551848	24545232	8000	24547848	-4000	4000	-2616
chr10	89417605	89425605	89418227	8000	89421605	-4000	4000	-3378
chr10	110835468	110843468	110836155	8000	110839468	-4000	4000	-3313
chr10	110835468	110843468	110836157	8000	110839468	-4000	4000	-3311
chr10	82983179	82991179	82985207	8000	82987179	-4000	4000	-1972
chr10	100961134	100969134	100961945	8000	100965134	-4000	4000	-3189
chr10	110602048	110610048	110604272	8000	110606048	-4000	4000	-1776
chr10	3133718	3141718	3140714	8000	3137718	-4000	4000	2996
chr10	25598229	25606229	25599406	8000	25602229	-4000	4000	-2823
chr10	43613904	43621904	43616429	8000	43617904	-4000	4000	-1475
chr10	69567698	69575698	69572880	8000	69571698	-4000	4000	1182
chr10	88269864	88277864	88274789	8000	88273864	-4000	4000	925
chr10	112424379	112432379	112427224	8000	112428379	-4000	4000	-1155
chr10	47361496	47369496	47368143	8000	47365496	-4000	4000	2647
chr10	62807996	62815996	62812549	8000	62811996	-4000	4000	553
chr10	104122385	104130385	104125740	8000	104126385	-4000	4000	-645
chr10	119825147	119833147	119831523	8000	119829147	-4000	4000	2376
chr10	69567698	69575698	69572806	8000	69571698	-4000	4000	1108
chr10	5634867	5642867	5641826	8000	5638867	-4000	4000	2959
chr10	73003217	73011217	73008291	8000	73007217	-4000	4000	1074
chr10	75028624	75036624	75030771	8000	75032624	-4000	4000	-1853
chr10	120588065	120596065	120589597	8000	120592065	-4000	4000	-2468
chr10	79611455	79619455	79615060	8000	79615455	-4000	4000	-395
chr10	79611455	79619455	79613247	8000	79615455	-4000	4000	-2208
chr10	120905524	120913524	120909443	8000	120909524	-4000	4000	-81
chr10	116659696	116667696	116664969	8000	116663696	-4000	4000	1273
chr10	92691647	92699647	92692378	8000	92695647	-4000	4000	-3269
chr10	70593348	70601348	70598873	8000	70597348	-4000	4000	1525
chr10	45298298	45306298	45304316	8000	45302298	-4000	4000	2018
chr10	24977979	24985979	24984816	8000	24981979	-4000	4000	2837
chr10	49127154	49135154	49132091	8000	49131154	-4000	4000	937
chr10	30457833	30465833	30458115	8000	30461833	-4000	4000	-3718
chr10	46998488	47006488	47000992	8000	47002488	-4000	4000	-1496
chr10	75028624	75036624	75029366	8000	75032624	-4000	4000	-3258
chr10	47323588	47331588	47325643	8000	47327588	-4000	4000	-1945
chr10	129831233	129839233	129837871	8000	129835233	-4000	4000	2638
chr10	23438377	23446377	23442223	8000	23442377	-4000	4000	-154
chr10	15207643	15215643	15213200	8000	15211643	-4000	4000	1557
chr10	15207643	15215643	15213692	8000	15211643	-4000	4000	2049
chr10	31525814	31533814	31527071	8000	31529814	-4000	4000	-2743
chr10	72055034	72063034	72061025	8000	72059034	-4000	4000	1991
chr10	72055034	72063034	72061026	8000	72059034	-4000	4000	1992
chr10	26300558	26308558	26300941	8000	26304558	-4000	4000	-3617
chr10	45821594	45829594	45827250	8000	45825594	-4000	4000	1656
chr10	72930762	72938762	72932559	8000	72934762	-4000	4000	-2203
chr10	94849073	94857073	94850013	8000	94853073	-4000	4000	-3060
chr10	102064036	102072036	102066162	8000	102068036	-4000	4000	-1874
chr10	122693709	122701709	122698090	8000	122697709	-4000	4000	381
chr10	122510907	122518907	122514283	8000	122514907	-4000	4000	-624
chr10	12892625	12900625	12898677	8000	12896625	-4000	4000	2052
chr10	45442119	45450119	45443477	8000	45446119	-4000	4000	-2642
chr10	72930762	72938762	72932471	8000	72934762	-4000	4000	-2291
chr10	96185171	96193171	96192069	8000	96189171	-4000	4000	2898
chr10	100269280	100277280	100275311	8000	100273280	-4000	4000	2031
chr10	20775973	20783973	20782125	8000	20779973	-4000	4000	2152
chr10	90736823	90744823	90742248	8000	90740823	-4000	4000	1425
chr10	96056870	96064870	96058051	8000	96060870	-4000	4000	-2819
chr10	102226186	102234186	102230351	8000	102230186	-4000	4000	165
chr10	28678932	28686932	28681622	8000	28682932	-4000	4000	-1310
chr10	42888	50888	48714	8000	46888	-4000	4000	1826
chr10	97762751	97770751	97767693	8000	97766751	-4000	4000	942
chr10	27668874	27676874	27675131	8000	27672874	-4000	4000	2257
chr10	84255960	84263960	84258703	8000	84259960	-4000	4000	-1257
chr10	89201629	89209629	89206854	8000	89205629	-4000	4000	1225
chr10	73670287	73678287	73676067	8000	73674287	-4000	4000	1780
chr10	99848594	99856594	99851578	8000	99852594	-4000	4000	-1016
chr10	102226186	102234186	102229216	8000	102230186	-4000	4000	-970
chr10	11456510	11464510	11462394	8000	11460510	-4000	4000	1884
chr10	43613904	43621904	43616540	8000	43617904	-4000	4000	-1364
chr10	79512440	79520440	79515987	8000	79516440	-4000	4000	-453
chr10	126420997	126428997	126425843	8000	126424997	-4000	4000	846
chr10	103590027	103598027	103597888	8000	103594027	-4000	4000	3861
chr10	69629596	69637596	69632880	8000	69633596	-4000	4000	-716
chr10	100146094	100154094	100152129	8000	100150094	-4000	4000	2035
chr10	113779429	113787429	113780628	8000	113783429	-4000	4000	-2801
chr10	102146333	102154333	102148645	8000	102150333	-4000	4000	-1688
chr10	15207643	15215643	15211912	8000	15211643	-4000	4000	269
chr10	133222412	133230412	133224830	8000	133226412	-4000	4000	-1582
chr10	87747512	87755512	87754484	8000	87751512	-4000	4000	2972
chr10	25598229	25606229	25598309	8000	25602229	-4000	4000	-3920
chr10	72363340	72371340	72368084	8000	72367340	-4000	4000	744
chr10	71812298	71820298	71817467	8000	71816298	-4000	4000	1169
chr10	70767238	70775238	70771502	8000	70771238	-4000	4000	264
chr10	45999742	46007742	46003267	8000	46003742	-4000	4000	-475
chr10	114973676	114981676	114975558	8000	114977676	-4000	4000	-2118
chr10	16586611	16594611	16593302	8000	16590611	-4000	4000	2691
chr10	37945573	37953573	37953423	8000	37949573	-4000	4000	3850
chr10	116376029	116384029	116378490	8000	116380029	-4000	4000	-1539
chr10	56353227	56361227	56359504	8000	56357227	-4000	4000	2277
chr10	49323492	49331492	49324219	8000	49327492	-4000	4000	-3273
chr10	73003217	73011217	73009833	8000	73007217	-4000	4000	2616
chr10	117206299	117214299	117209918	8000	117210299	-4000	4000	-381
chr10	49706261	49714261	49708616	8000	49710261	-4000	4000	-1645
chr10	46457099	46465099	46462338	8000	46461099	-4000	4000	1239
chr10	70593348	70601348	70598286	8000	70597348	-4000	4000	938
chr10	99532524	99540524	99535016	8000	99536524	-4000	4000	-1508
chr10	117124521	117132521	117132233	8000	117128521	-4000	4000	3712
chr10	30457833	30465833	30459294	8000	30461833	-4000	4000	-2539
chr10	111076907	111084907	111079229	8000	111080907	-4000	4000	-1678
chr10	28678932	28686932	28681284	8000	28682932	-4000	4000	-1648
chr10	93302429	93310429	93310079	8000	93306429	-4000	4000	3650
chr10	14867741	14875741	14870636	8000	14871741	-4000	4000	-1105
chr10	50007654	50015654	50009894	8000	50011654	-4000	4000	-1760
chr10	73627612	73635612	73632083	8000	73631612	-4000	4000	471
chr10	84255960	84263960	84258642	8000	84259960	-4000	4000	-1318
chr10	88775626	88783626	88778099	8000	88779626	-4000	4000	-1527
chr10	94849073	94857073	94852880	8000	94853073	-4000	4000	-193
chr10	96185171	96193171	96191967	8000	96189171	-4000	4000	2796
chr10	117124521	117132521	117132201	8000	117128521	-4000	4000	3680
chr10	124980317	124988317	124983198	8000	124984317	-4000	4000	-1119
chr10	7555270	7563270	7563166	8000	7559270	-4000	4000	3896
chr10	15207643	15215643	15213677	8000	15211643	-4000	4000	2034
chr10	73419579	73427579	73422541	8000	73423579	-4000	4000	-1038
chr10	80141359	80149359	80142177	8000	80145359	-4000	4000	-3182
chr10	73240504	73248504	73246078	8000	73244504	-4000	4000	1574
chr11	92981066	92989066	92981726	8000	92985066	-4000	4000	-3340
chr11	65646918	65654918	65650704	8000	65650918	-4000	4000	-214
chr11	65646918	65654918	65650706	8000	65650918	-4000	4000	-212
chr11	74692429	74700429	74696455	8000	74696429	-4000	4000	26
chr11	7953537	7961537	7959977	8000	7957537	-4000	4000	2440
chr11	94304146	94312146	94306634	8000	94308146	-4000	4000	-1512
chr11	95972598	95980598	95979551	8000	95976598	-4000	4000	2953
chr11	5995445	6003445	6002681	8000	5999445	-4000	4000	3236
chr11	7087148	7095148	7090251	8000	7091148	-4000	4000	-897
chr11	66642469	66650469	66644187	8000	66646469	-4000	4000	-2282
chr11	67514912	67522912	67518990	8000	67518912	-4000	4000	78
chr11	92981066	92989066	92981694	8000	92985066	-4000	4000	-3372
chr11	4676171	4684171	4681939	8000	4680171	-4000	4000	1768
chr11	66422707	66430707	66423875	8000	66426707	-4000	4000	-2832
chr11	67487768	67495768	67495164	8000	67491768	-4000	4000	3396
chr11	125429389	125437389	125430003	8000	125433389	-4000	4000	-3386
chr11	54703902	54711902	54707054	8000	54707902	-4000	4000	-848
chr11	57229577	57237577	57236361	8000	57233577	-4000	4000	2784
chr11	116831751	116839751	116835925	8000	116835751	-4000	4000	174
chr11	6165355	6173355	6170149	8000	6169355	-4000	4000	794
chr11	5733089	5741089	5736653	8000	5737089	-4000	4000	-436
chr11	6165355	6173355	6169366	8000	6169355	-4000	4000	11
chr11	57229577	57237577	57236693	8000	57233577	-4000	4000	3116
chr11	63542462	63550462	63544682	8000	63546462	-4000	4000	-1780
chr11	65879740	65887740	65883975	8000	65883740	-4000	4000	235
chr11	93814232	93822232	93821144	8000	93818232	-4000	4000	2912
chr11	111726855	111734855	111726970	8000	111730855	-4000	4000	-3885
chr11	124019948	124027948	124023705	8000	124023948	-4000	4000	-243
chr11	105021443	105029443	105026352	8000	105025443	-4000	4000	909
chr11	44928423	44936423	44934776	8000	44932423	-4000	4000	2353
chr11	7087148	7095148	7089234	8000	7091148	-4000	4000	-1914
chr11	40110203	40118203	40116252	8000	40114203	-4000	4000	2049
chr11	54599069	54607069	54603129	8000	54603069	-4000	4000	60
chr11	55551419	55559419	55554516	8000	55555419	-4000	4000	-903
chr11	62209943	62217943	62210499	8000	62213943	-4000	4000	-3444
chr11	1833521	1841521	1837296	8000	1837521	-4000	4000	-225
chr11	6608768	6616768	6614891	8000	6612768	-4000	4000	2123
chr11	19172422	19180422	19175944	8000	19176422	-4000	4000	-478
chr11	19220063	19228063	19224820	8000	19224063	-4000	4000	757
chr11	30231261	30239261	30233690	8000	30235261	-4000	4000	-1571
chr11	31428401	31436401	31430415	8000	31432401	-4000	4000	-1986
chr11	33073188	33081188	33076319	8000	33077188	-4000	4000	-869
chr11	46379789	46387789	46386513	8000	46383789	-4000	4000	2724
chr11	55364918	55372918	55368016	8000	55368918	-4000	4000	-902
chr11	55662195	55670195	55665186	8000	55666195	-4000	4000	-1009
chr11	57368396	57376396	57368400	8000	57372396	-4000	4000	-3996
chr11	65040818	65048818	65047473	8000	65044818	-4000	4000	2655
chr11	65208006	65216006	65210833	8000	65212006	-4000	4000	-1173
chr11	65208006	65216006	65211341	8000	65212006	-4000	4000	-665
chr11	77212558	77220558	77212960	8000	77216558	-4000	4000	-3598
chr11	94304146	94312146	94305776	8000	94308146	-4000	4000	-2370
chr11	66422707	66430707	66424673	8000	66426707	-4000	4000	-2034
chr11	66642469	66650469	66644420	8000	66646469	-4000	4000	-2049
chr11	6997004	7005004	7000757	8000	7001004	-4000	4000	-247
chr11	33670102	33678102	33672873	8000	33674102	-4000	4000	-1229
chr11	19050455	19058455	19055655	8000	19054455	-4000	4000	1200
chr11	95817766	95825766	95818897	8000	95821766	-4000	4000	-2869
chr11	102374670	102382670	102378374	8000	102378670	-4000	4000	-296
chr11	102831801	102839801	102837397	8000	102835801	-4000	4000	1596
chr11	111533043	111541043	111536727	8000	111537043	-4000	4000	-316
chr11	125429389	125437389	125431425	8000	125433389	-4000	4000	-1964
chr11	6787558	6795558	6795005	8000	6791558	-4000	4000	3447
chr11	55887810	55895810	55889990	8000	55891810	-4000	4000	-1820
chr11	60168015	60176015	60173099	8000	60172015	-4000	4000	1084
chr11	61247444	61255444	61249666	8000	61251444	-4000	4000	-1778
chr11	62664496	62672496	62667762	8000	62668496	-4000	4000	-734
chr11	66422707	66430707	66424709	8000	66426707	-4000	4000	-1998
chr11	57480534	57488534	57485117	8000	57484534	-4000	4000	583
chr11	5043461	5051461	5046985	8000	5047461	-4000	4000	-476
chr11	58212084	58220084	58215206	8000	58216084	-4000	4000	-878
chr11	4594672	4602672	4600414	8000	4598672	-4000	4000	1742
chr11	56272819	56280819	56276105	8000	56276819	-4000	4000	-714
chr11	57546272	57554272	57546547	8000	57550272	-4000	4000	-3725
chr11	75582918	75590918	75587791	8000	75586918	-4000	4000	873
chr11	6842636	6850636	6846399	8000	6846636	-4000	4000	-237
chr11	67254082	67262082	67255145	8000	67258082	-4000	4000	-2937
chr11	56103658	56111658	56105462	8000	56107658	-4000	4000	-2196
chr11	108153215	108161215	108158836	8000	108157215	-4000	4000	1621
chr11	95067225	95075225	95067947	8000	95071225	-4000	4000	-3278
chr11	14500874	14508874	14505129	8000	14504874	-4000	4000	255
chr11	59453905	59461905	59457560	8000	59457905	-4000	4000	-345
chr11	112189805	112197805	112193595	8000	112193805	-4000	4000	-210
chr11	56413258	56421258	56417860	8000	56417258	-4000	4000	602
chr11	90038025	90046025	90041276	8000	90042025	-4000	4000	-749
chr11	54703902	54711902	54707116	8000	54707902	-4000	4000	-786
chr11	55364918	55372918	55367922	8000	55368918	-4000	4000	-996
chr11	30005730	30013730	30012176	8000	30009730	-4000	4000	2446
chr11	56227282	56235282	56233123	8000	56231282	-4000	4000	1841
chr11	100989941	100997941	100992943	8000	100993941	-4000	4000	-998
chr11	56284462	56292462	56290990	8000	56288462	-4000	4000	2528
chr11	62269160	62277160	62270946	8000	62273160	-4000	4000	-2214
chr11	58177616	58185616	58180086	8000	58181616	-4000	4000	-1530
chr11	5995445	6003445	6002554	8000	5999445	-4000	4000	3109
chr11	48213739	48221739	48217489	8000	48217739	-4000	4000	-250
chr11	94110208	94118208	94111558	8000	94114208	-4000	4000	-2650
chr11	125037489	125045489	125040784	8000	125041489	-4000	4000	-705
chr11	4651488	4659488	4655072	8000	4655488	-4000	4000	-416
chr11	47712494	47720494	47714318	8000	47716494	-4000	4000	-2176
chr11	66341374	66349374	66345967	8000	66345374	-4000	4000	593
chr11	117423772	117431772	117431680	8000	117427772	-4000	4000	3908
chr11	76549025	76557025	76550329	8000	76553025	-4000	4000	-2696
chr11	18013555	18021555	18021143	8000	18017555	-4000	4000	3588
chr11	59500511	59508511	59504092	8000	59504511	-4000	4000	-419
chr11	108304519	108312519	108310284	8000	108308519	-4000	4000	1765
chr11	124014732	124022732	124015988	8000	124018732	-4000	4000	-2744
chr11	124762498	124770498	124767883	8000	124766498	-4000	4000	1385
chr11	65169244	65177244	65172772	8000	65173244	-4000	4000	-472
chr11	67658160	67666160	67663321	8000	67662160	-4000	4000	1161
chr11	102229424	102237424	102232102	8000	102233424	-4000	4000	-1322
chr11	119309926	119317926	119314514	8000	119313926	-4000	4000	588
chr11	20152155	20160155	20159206	8000	20156155	-4000	4000	3051
chr11	25078638	25086638	25082504	8000	25082638	-4000	4000	-134
chr11	125787600	125795600	125789422	8000	125791600	-4000	4000	-2178
chr11	59204588	59212588	59211613	8000	59208588	-4000	4000	3025
chr11	30005730	30013730	30011770	8000	30009730	-4000	4000	2040
chr11	93726358	93734358	93729915	8000	93730358	-4000	4000	-443
chr11	55835738	55843738	55839548	8000	55839738	-4000	4000	-190
chr11	71577855	71585855	71582340	8000	71581855	-4000	4000	485
chr11	56249222	56257222	56253174	8000	56253222	-4000	4000	-48
chr11	5947347	5955347	5947946	8000	5951347	-4000	4000	-3401
chr11	59453905	59461905	59457417	8000	59457905	-4000	4000	-488
chr11	66422707	66430707	66424914	8000	66426707	-4000	4000	-1793
chr11	5782471	5790471	5788670	8000	5786471	-4000	4000	2199
chr11	74486519	74494519	74492261	8000	74490519	-4000	4000	1742
chr11	126419358	126427358	126424782	8000	126423358	-4000	4000	1424
chr11	7507377	7515377	7509663	8000	7511377	-4000	4000	-1714
chr11	18363045	18371045	18366091	8000	18367045	-4000	4000	-954
chr11	18363045	18371045	18366092	8000	18367045	-4000	4000	-953
chr11	58354124	58362124	58358135	8000	58358124	-4000	4000	11
chr11	116785367	116793367	116787047	8000	116789367	-4000	4000	-2320
chr11	47326031	47334031	47328682	8000	47330031	-4000	4000	-1349
chr11	71998864	72006864	72006226	8000	72002864	-4000	4000	3362
chr11	107959482	107967482	107962334	8000	107963482	-4000	4000	-1148
chr11	1106511	1114511	1107182	8000	1110511	-4000	4000	-3329
chr11	56413258	56421258	56417563	8000	56417258	-4000	4000	305
chr11	2125112	2133112	2130496	8000	2129112	-4000	4000	1384
chr11	55551419	55559419	55554459	8000	55555419	-4000	4000	-960
chr11	56272819	56280819	56275754	8000	56276819	-4000	4000	-1065
chr11	102707796	102715796	102714647	8000	102711796	-4000	4000	2851
chr11	4988431	4996431	4989741	8000	4992431	-4000	4000	-2690
chr11	33353023	33361023	33353432	8000	33357023	-4000	4000	-3591
chr11	68611334	68619334	68613236	8000	68615334	-4000	4000	-2098
chr11	110573042	110581042	110580804	8000	110577042	-4000	4000	3762
chr11	5195735	5203735	5200057	8000	5199735	-4000	4000	322
chr11	47433764	47441764	47441730	8000	47437764	-4000	4000	3966
chr11	56272819	56280819	56276316	8000	56276819	-4000	4000	-503
chr11	63907020	63915020	63909014	8000	63911020	-4000	4000	-2006
chr11	119351215	119359215	119358251	8000	119355215	-4000	4000	3036
chr11	7953537	7961537	7960624	8000	7957537	-4000	4000	3087
chr11	86948910	86956910	86949979	8000	86952910	-4000	4000	-2931
chr11	55824154	55832154	55827628	8000	55828154	-4000	4000	-526
chr11	60847081	60855081	60850393	8000	60851081	-4000	4000	-688
chr11	113405605	113413605	113410486	8000	113409605	-4000	4000	881
chr11	126198096	126206096	126203372	8000	126202096	-4000	4000	1276
chr11	66333333	66341333	66334996	8000	66337333	-4000	4000	-2337
chr11	125672255	125680255	125677978	8000	125676255	-4000	4000	1723
chr11	128832315	128840315	128839347	8000	128836315	-4000	4000	3032
chr11	123972661	123980661	123976903	8000	123976661	-4000	4000	242
chr11	5817483	5825483	5821174	8000	5821483	-4000	4000	-309
chr11	55569060	55577060	55572345	8000	55573060	-4000	4000	-715
chr11	66326241	66334241	66334219	8000	66330241	-4000	4000	3978
chr11	57229577	57237577	57235774	8000	57233577	-4000	4000	2197
chr11	10797625	10805625	10804977	8000	10801625	-4000	4000	3352
chr11	60392596	60400596	60397951	8000	60396596	-4000	4000	1355
chr11	124032013	124040013	124038950	8000	124036013	-4000	4000	2937
chr11	27361961	27369961	27368755	8000	27365961	-4000	4000	2794
chr11	36589156	36597156	36593087	8000	36593156	-4000	4000	-69
chr11	65371192	65379192	65376362	8000	65375192	-4000	4000	1170
chr11	114517645	114525645	114522195	8000	114521645	-4000	4000	550
chr11	124535635	124543635	124542771	8000	124539635	-4000	4000	3136
chr11	294200	302200	299462	8000	298200	-4000	4000	1262
chr11	59453905	59461905	59457606	8000	59457905	-4000	4000	-299
chr11	88500576	88508576	88508424	8000	88504576	-4000	4000	3848
chr11	112081150	112089150	112084886	8000	112085150	-4000	4000	-264
chr11	32383775	32391775	32389111	8000	32387775	-4000	4000	1336
chr11	56538340	56546340	56542916	8000	56542340	-4000	4000	576
chr11	86341943	86349943	86345368	8000	86345943	-4000	4000	-575
chr11	63569195	63577195	63575042	8000	63573195	-4000	4000	1847
chr11	124032013	124040013	124038740	8000	124036013	-4000	4000	2727
chr11	30005730	30013730	30012653	8000	30009730	-4000	4000	2923
chr11	58262792	58270792	58267896	8000	58266792	-4000	4000	1104
chr11	64930475	64938475	64931759	8000	64934475	-4000	4000	-2716
chr11	64930475	64938475	64931760	8000	64934475	-4000	4000	-2715
chr11	67421607	67429607	67423799	8000	67425607	-4000	4000	-1808
chr11	11957887	11965887	11964673	8000	11961887	-4000	4000	2786
chr11	56272819	56280819	56275657	8000	56276819	-4000	4000	-1162
chr11	64930475	64938475	64932887	8000	64934475	-4000	4000	-1588
chr11	124433445	124441445	124440570	8000	124437445	-4000	4000	3125
chr11	5883079	5891079	5884577	8000	5887079	-4000	4000	-2502
chr11	6207135	6215135	6211531	8000	6211135	-4000	4000	396
chr11	55909650	55917650	55913938	8000	55913650	-4000	4000	288
chr11	60044044	60052044	60047032	8000	60048044	-4000	4000	-1012
chr11	113683547	113691547	113688048	8000	113687547	-4000	4000	501
chr11	125896646	125904646	125899995	8000	125900646	-4000	4000	-651
chr11	5195735	5203735	5200596	8000	5199735	-4000	4000	861
chr11	7791974	7799974	7796409	8000	7795974	-4000	4000	435
chr11	9134825	9142825	9139635	8000	9138825	-4000	4000	810
chr11	30005730	30013730	30012263	8000	30009730	-4000	4000	2533
chr11	47585194	47593194	47589947	8000	47589194	-4000	4000	753
chr11	56173556	56181556	56177353	8000	56177556	-4000	4000	-203
chr11	65793214	65801214	65794720	8000	65797214	-4000	4000	-2494
chr11	76653524	76661524	76661151	8000	76657524	-4000	4000	3627
chr11	124535635	124543635	124543148	8000	124539635	-4000	4000	3513
chr11	124879691	124887691	124881309	8000	124883691	-4000	4000	-2382
chr11	119011793	119019793	119019290	8000	119015793	-4000	4000	3497
chr11	130472645	130480645	130473820	8000	130476645	-4000	4000	-2825
chr11	4089210	4097210	4091679	8000	4093210	-4000	4000	-1531
chr11	124879691	124887691	124885238	8000	124883691	-4000	4000	1547
chr11	8943202	8951202	8948354	8000	8947202	-4000	4000	1152
chr11	211030	219030	212685	8000	215030	-4000	4000	-2345
chr11	2996922	3004922	3001998	8000	3000922	-4000	4000	1076
chr11	5221464	5229464	5227034	8000	5225464	-4000	4000	1570
chr11	5817483	5825483	5821095	8000	5821483	-4000	4000	-388
chr11	7820818	7828818	7825161	8000	7824818	-4000	4000	343
chr11	19172422	19180422	19175970	8000	19176422	-4000	4000	-452
chr11	20152155	20160155	20156346	8000	20156155	-4000	4000	191
chr11	55364918	55372918	55368481	8000	55368918	-4000	4000	-437
chr11	56103658	56111658	56105379	8000	56107658	-4000	4000	-2279
chr11	56284462	56292462	56290299	8000	56288462	-4000	4000	1837
chr11	56284462	56292462	56290867	8000	56288462	-4000	4000	2405
chr11	56342998	56350998	56346534	8000	56346998	-4000	4000	-464
chr11	56538340	56546340	56543171	8000	56542340	-4000	4000	831
chr11	59204588	59212588	59212227	8000	59208588	-4000	4000	3639
chr11	61247444	61255444	61250000	8000	61251444	-4000	4000	-1444
chr11	64296031	64304031	64297228	8000	64300031	-4000	4000	-2803
chr11	67298485	67306485	67304845	8000	67302485	-4000	4000	2360
chr11	71545608	71553608	71548869	8000	71549608	-4000	4000	-739
chr11	76653524	76661524	76661509	8000	76657524	-4000	4000	3985
chr11	106047098	106055098	106053024	8000	106051098	-4000	4000	1926
chr11	117200337	117208337	117204349	8000	117204337	-4000	4000	12
chr11	124026634	124034634	124029631	8000	124030634	-4000	4000	-1003
chr11	130472645	130480645	130473047	8000	130476645	-4000	4000	-3598
chr11	119309926	119317926	119312933	8000	119313926	-4000	4000	-993
chr11	124879691	124887691	124886770	8000	124883691	-4000	4000	3079
chr11	6268127	6276127	6270300	8000	6272127	-4000	4000	-1827
chr11	69805968	69813968	69810515	8000	69809968	-4000	4000	547
chr11	71545608	71553608	71548647	8000	71549608	-4000	4000	-961
chr11	75582918	75590918	75587364	8000	75586918	-4000	4000	446
chr11	76345898	76353898	76351754	8000	76349898	-4000	4000	1856
chr11	56699884	56707884	56700682	8000	56703884	-4000	4000	-3202
chr11	58199202	58207202	58203593	8000	58203202	-4000	4000	391
chr11	61254286	61262286	61258974	8000	61258286	-4000	4000	688
chr11	5124776	5132776	5131959	8000	5128776	-4000	4000	3183
chr11	48242015	48250015	48245918	8000	48246015	-4000	4000	-97
chr11	4639060	4647060	4640243	8000	4643060	-4000	4000	-2817
chr11	6207135	6215135	6214862	8000	6211135	-4000	4000	3727
chr11	18929499	18937499	18934652	8000	18933499	-4000	4000	1153
chr11	48485722	48493722	48489455	8000	48489722	-4000	4000	-267
chr11	55551419	55559419	55554845	8000	55555419	-4000	4000	-574
chr11	112018653	112026653	112019171	8000	112022653	-4000	4000	-3482
chr11	112018653	112026653	112019172	8000	112022653	-4000	4000	-3481
chr11	124433445	124441445	124440152	8000	124437445	-4000	4000	2707
chr11	18723928	18731928	18728807	8000	18727928	-4000	4000	879
chr11	58190053	58198053	58191057	8000	58194053	-4000	4000	-2996
chr11	58398464	58406464	58402894	8000	58402464	-4000	4000	430
chr11	70185530	70193530	70189346	8000	70189530	-4000	4000	-184
chr11	113729187	113737187	113733517	8000	113733187	-4000	4000	330
chr11	120107286	120115286	120112260	8000	120111286	-4000	4000	974
chr11	95023596	95031596	95025536	8000	95027596	-4000	4000	-2060
chr11	66422707	66430707	66424448	8000	66426707	-4000	4000	-2259
chr11	7087148	7095148	7090285	8000	7091148	-4000	4000	-863
chr11	64760606	64768606	64767075	8000	64764606	-4000	4000	2469
chr11	56372553	56380553	56376216	8000	56376553	-4000	4000	-337
chr11	56605236	56613236	56613017	8000	56609236	-4000	4000	3781
chr11	64722911	64730911	64728986	8000	64726911	-4000	4000	2075
chr11	55598360	55606360	55603975	8000	55602360	-4000	4000	1615
chr11	13728346	13736346	13728863	8000	13732346	-4000	4000	-3483
chr11	56699884	56707884	56700528	8000	56703884	-4000	4000	-3356
chr11	30005730	30013730	30012170	8000	30009730	-4000	4000	2440
chr11	55364918	55372918	55368200	8000	55368918	-4000	4000	-718
chr11	5250392	5258392	5254373	8000	5254392	-4000	4000	-19
chr11	32383775	32391775	32388984	8000	32387775	-4000	4000	1209
chr11	55662195	55670195	55665509	8000	55666195	-4000	4000	-686
chr11	117816163	117824163	117820615	8000	117820163	-4000	4000	452
chr11	7653127	7661127	7653240	8000	7657127	-4000	4000	-3887
chr11	57547656	57555656	57554614	8000	57551656	-4000	4000	2958
chr11	1106511	1114511	1108024	8000	1110511	-4000	4000	-2487
chr11	1616958	1624958	1621829	8000	1620958	-4000	4000	871
chr11	9134825	9142825	9139547	8000	9138825	-4000	4000	722
chr11	95047338	95055338	95049982	8000	95051338	-4000	4000	-1356
chr11	113274436	113282436	113275521	8000	113278436	-4000	4000	-2915
chr11	46379789	46387789	46385355	8000	46383789	-4000	4000	1566
chr11	64296031	64304031	64300733	8000	64300031	-4000	4000	702
chr11	108153215	108161215	108160890	8000	108157215	-4000	4000	3675
chr11	119011793	119019793	119015074	8000	119015793	-4000	4000	-719
chr11	60871693	60879693	60875196	8000	60875693	-4000	4000	-497
chr11	4380897	4388897	4388440	8000	4384897	-4000	4000	3543
chr11	102374670	102382670	102378281	8000	102378670	-4000	4000	-389
chr11	6314946	6322946	6319727	8000	6318946	-4000	4000	781
chr11	73996277	74004277	74000512	8000	74000277	-4000	4000	235
chr11	57368396	57376396	57369901	8000	57372396	-4000	4000	-2495
chr11	59475361	59483361	59478015	8000	59479361	-4000	4000	-1346
chr11	59825273	59833273	59829463	8000	59829273	-4000	4000	190
chr11	77212558	77220558	77217230	8000	77216558	-4000	4000	672
chr11	124026634	124034634	124030357	8000	124030634	-4000	4000	-277
chr11	58417238	58425238	58423099	8000	58421238	-4000	4000	1861
chr11	118395211	118403211	118396391	8000	118399211	-4000	4000	-2820
chr11	3634512	3642512	3638737	8000	3638512	-4000	4000	225
chr11	4988431	4996431	4990595	8000	4992431	-4000	4000	-1836
chr11	56699884	56707884	56700719	8000	56703884	-4000	4000	-3165
chr11	59151039	59159039	59152365	8000	59155039	-4000	4000	-2674
chr11	59204588	59212588	59204691	8000	59208588	-4000	4000	-3897
chr11	59475361	59483361	59477587	8000	59479361	-4000	4000	-1774
chr11	64799510	64807510	64800368	8000	64803510	-4000	4000	-3142
chr11	66431075	66439075	66436880	8000	66435075	-4000	4000	1805
chr11	116831751	116839751	116836282	8000	116835751	-4000	4000	531
chr11	125672255	125680255	125677926	8000	125676255	-4000	4000	1671
chr11	7791974	7799974	7796045	8000	7795974	-4000	4000	71
chr11	3822978	3830978	3824910	8000	3826978	-4000	4000	-2068
chr11	116816700	116824700	116821686	8000	116820700	-4000	4000	986
chr11	4639060	4647060	4640554	8000	4643060	-4000	4000	-2506
chr11	8976576	8984576	8983007	8000	8980576	-4000	4000	2431
chr11	19050455	19058455	19055508	8000	19054455	-4000	4000	1053
chr11	56572774	56580774	56577363	8000	56576774	-4000	4000	589
chr11	128809267	128817267	128810937	8000	128813267	-4000	4000	-2330
chr11	1465457	1473457	1471311	8000	1469457	-4000	4000	1854
chr11	49949419	49957419	49953029	8000	49953419	-4000	4000	-390
chr11	66586176	66594176	66593037	8000	66590176	-4000	4000	2861
chr11	119089834	119097834	119097742	8000	119093834	-4000	4000	3908
chr11	6390998	6398998	6396131	8000	6394998	-4000	4000	1133
chr11	56090240	56098240	56093774	8000	56094240	-4000	4000	-466
chr11	124743474	124751474	124747147	8000	124747474	-4000	4000	-327
chr11	55808476	55816476	55812361	8000	55812476	-4000	4000	-115
chr11	14868044	14876044	14869697	8000	14872044	-4000	4000	-2347
chr11	57547656	57555656	57550119	8000	57551656	-4000	4000	-1537
chr11	57547656	57555656	57550120	8000	57551656	-4000	4000	-1536
chr11	55931456	55939456	55935959	8000	55935456	-4000	4000	503
chr11	57229577	57237577	57235831	8000	57233577	-4000	4000	2254
chr11	55931456	55939456	55935632	8000	55935456	-4000	4000	176
chr11	124748583	124756583	124753884	8000	124752583	-4000	4000	1301
chr11	5124776	5132776	5132066	8000	5128776	-4000	4000	3290
chr11	48242015	48250015	48245413	8000	48246015	-4000	4000	-602
chr11	55598360	55606360	55603982	8000	55602360	-4000	4000	1622
chr11	60871693	60879693	60875553	8000	60875693	-4000	4000	-140
chr11	32598721	32606721	32602726	8000	32602721	-4000	4000	5
chr11	32598721	32606721	32602778	8000	32602721	-4000	4000	57
chr11	58354124	58362124	58358504	8000	58358124	-4000	4000	380
chr11	4446361	4454361	4449621	8000	4450361	-4000	4000	-740
chr11	14873440	14881440	14878081	8000	14877440	-4000	4000	641
chr11	14873440	14881440	14878082	8000	14877440	-4000	4000	642
chr11	62788123	62796123	62794299	8000	62792123	-4000	4000	2176
chr11	66586176	66594176	66592727	8000	66590176	-4000	4000	2551
chr11	66602019	66610019	66605534	8000	66606019	-4000	4000	-485
chr11	7791974	7799974	7796722	8000	7795974	-4000	4000	748
chr11	3634512	3642512	3641887	8000	3638512	-4000	4000	3375
chr11	73996277	74004277	74000537	8000	74000277	-4000	4000	260
chr11	128454761	128462761	128460358	8000	128458761	-4000	4000	1597
chr11	4542144	4550144	4545693	8000	4546144	-4000	4000	-451
chr11	13008119	13016119	13010006	8000	13012119	-4000	4000	-2113
chr11	27650893	27658893	27657611	8000	27654893	-4000	4000	2718
chr11	34143670	34151670	34146137	8000	34147670	-4000	4000	-1533
chr11	34474791	34482791	34478964	8000	34478791	-4000	4000	173
chr11	67421607	67429607	67424245	8000	67425607	-4000	4000	-1362
chr11	30005730	30013730	30012521	8000	30009730	-4000	4000	2791
chr11	47350860	47358860	47355528	8000	47354860	-4000	4000	668
chr11	128809267	128817267	128810725	8000	128813267	-4000	4000	-2542
chr11	56342998	56350998	56346554	8000	56346998	-4000	4000	-444
chr11	6917994	6925994	6921639	8000	6921994	-4000	4000	-355
chr11	55648854	55656854	55651572	8000	55652854	-4000	4000	-1282
chr11	55808476	55816476	55811975	8000	55812476	-4000	4000	-501
chr11	90196429	90204429	90202290	8000	90200429	-4000	4000	1861
chr11	30231261	30239261	30233925	8000	30235261	-4000	4000	-1336
chr11	66422707	66430707	66422742	8000	66426707	-4000	4000	-3965
chr11	48242015	48250015	48245919	8000	48246015	-4000	4000	-96
chr11	6761626	6769626	6768358	8000	6765626	-4000	4000	2732
chr11	56413258	56421258	56417334	8000	56417258	-4000	4000	76
chr11	76345898	76353898	76351903	8000	76349898	-4000	4000	2005
chr11	1837680	1845680	1841186	8000	1841680	-4000	4000	-494
chr11	66422707	66430707	66424382	8000	66426707	-4000	4000	-2325
chr11	76653524	76661524	76660523	8000	76657524	-4000	4000	2999
chr11	46317409	46325409	46320381	8000	46321409	-4000	4000	-1028
chr11	62389412	62397412	62392093	8000	62393412	-4000	4000	-1319
chr11	13383266	13391266	13385722	8000	13387266	-4000	4000	-1544
chr11	18929499	18937499	18934393	8000	18933499	-4000	4000	894
chr11	56284462	56292462	56290869	8000	56288462	-4000	4000	2407
chr11	18170280	18178280	18174021	8000	18174280	-4000	4000	-259
chr11	119351215	119359215	119357207	8000	119355215	-4000	4000	1992
chr11	18929499	18937499	18934608	8000	18933499	-4000	4000	1109
chr11	123749580	123757580	123753855	8000	123753580	-4000	4000	275
chr11	2845105	2853105	2847967	8000	2849105	-4000	4000	-1138
chr11	55835738	55843738	55838862	8000	55839738	-4000	4000	-876
chr11	6240479	6248479	6240692	8000	6244479	-4000	4000	-3787
chr11	55551419	55559419	55555042	8000	55555419	-4000	4000	-377
chr11	77212558	77220558	77217269	8000	77216558	-4000	4000	711
chr11	105133714	105141714	105138932	8000	105137714	-4000	4000	1218
chr11	123905229	123913229	123906501	8000	123909229	-4000	4000	-2728
chr11	58223882	58231882	58228283	8000	58227882	-4000	4000	401
chr11	100989941	100997941	100992747	8000	100993941	-4000	4000	-1194
chr11	6787558	6795558	6794637	8000	6791558	-4000	4000	3079
chr11	56372553	56380553	56376149	8000	56376553	-4000	4000	-404
chr11	102687487	102695487	102693995	8000	102691487	-4000	4000	2508
chr11	13728346	13736346	13729002	8000	13732346	-4000	4000	-3344
chr11	124019948	124027948	124023881	8000	124023948	-4000	4000	-67
chr11	211030	219030	212446	8000	215030	-4000	4000	-2584
chr11	6887574	6895574	6892330	8000	6891574	-4000	4000	756
chr11	64598353	64606353	64600861	8000	64602353	-4000	4000	-1492
chr11	94373316	94381316	94380759	8000	94377316	-4000	4000	3443
chr11	5054650	5062650	5059317	8000	5058650	-4000	4000	667
chr11	57295638	57303638	57301894	8000	57299638	-4000	4000	2256
chr11	6617330	6625330	6624119	8000	6621330	-4000	4000	2789
chr11	55770382	55778382	55774287	8000	55774382	-4000	4000	-95
chr11	69000395	69008395	69005420	8000	69004395	-4000	4000	1025
chr11	126419358	126427358	126424924	8000	126423358	-4000	4000	1566
chr11	12940737	12948737	12944460	8000	12944737	-4000	4000	-277
chr11	45925319	45933319	45926787	8000	45929319	-4000	4000	-2532
chr11	65793214	65801214	65796039	8000	65797214	-4000	4000	-1175
chr11	4639060	4647060	4640417	8000	4643060	-4000	4000	-2643
chr11	55551419	55559419	55554409	8000	55555419	-4000	4000	-1010
chr11	55792500	55800500	55795579	8000	55796500	-4000	4000	-921
chr11	64933517	64941517	64935355	8000	64937517	-4000	4000	-2162
chr11	66559464	66567464	66564108	8000	66563464	-4000	4000	644
chr11	55931456	55939456	55935645	8000	55935456	-4000	4000	189
chr11	78167249	78175249	78174170	8000	78171249	-4000	4000	2921
chr11	125745867	125753867	125747747	8000	125749867	-4000	4000	-2120
chr11	126198096	126206096	126203517	8000	126202096	-4000	4000	1421
chr11	1270371	1278371	1276853	8000	1274371	-4000	4000	2482
chr11	6165355	6173355	6169513	8000	6169355	-4000	4000	158
chr11	21571686	21579686	21573374	8000	21575686	-4000	4000	-2312
chr11	32989316	32997316	32993261	8000	32993316	-4000	4000	-55
chr11	45925319	45933319	45928183	8000	45929319	-4000	4000	-1136
chr11	54599069	54607069	54603203	8000	54603069	-4000	4000	134
chr11	55835738	55843738	55839612	8000	55839738	-4000	4000	-126
chr11	61507018	61515018	61510640	8000	61511018	-4000	4000	-378
chr11	63406294	63414294	63408736	8000	63410294	-4000	4000	-1558
chr11	64890546	64898546	64895158	8000	64894546	-4000	4000	612
chr11	66586176	66594176	66590658	8000	66590176	-4000	4000	482
chr11	95067225	95075225	95068881	8000	95071225	-4000	4000	-2344
chr11	125896646	125904646	125900300	8000	125900646	-4000	4000	-346
chr11	4594672	4602672	4601733	8000	4598672	-4000	4000	3061
chr11	4651488	4659488	4652706	8000	4655488	-4000	4000	-2782
chr11	20152155	20160155	20159243	8000	20156155	-4000	4000	3088
chr11	35427823	35435823	35432782	8000	35431823	-4000	4000	959
chr11	58502807	58510807	58507410	8000	58506807	-4000	4000	603
chr11	123749580	123757580	123754145	8000	123753580	-4000	4000	565
chr11	62292281	62300281	62297597	8000	62296281	-4000	4000	1316
chr11	56173556	56181556	56177282	8000	56177556	-4000	4000	-274
chr11	44928423	44936423	44929296	8000	44932423	-4000	4000	-3127
chr11	55887810	55895810	55891153	8000	55891810	-4000	4000	-657
chr11	78431968	78439968	78436756	8000	78435968	-4000	4000	788
chr11	102858736	102866736	102866397	8000	102862736	-4000	4000	3661
chr11	102858736	102866736	102866399	8000	102862736	-4000	4000	3663
chr11	9134825	9142825	9139642	8000	9138825	-4000	4000	817
chr11	113396416	113404416	113399329	8000	113400416	-4000	4000	-1087
chr11	7087148	7095148	7090727	8000	7091148	-4000	4000	-421
chr11	66422707	66430707	66424673	8000	66426707	-4000	4000	-2034
chr11	66333333	66341333	66338672	8000	66337333	-4000	4000	1339
chr11	56737223	56745223	56743460	8000	56741223	-4000	4000	2237
chr11	48242015	48250015	48245211	8000	48246015	-4000	4000	-804
chr11	13383266	13391266	13388857	8000	13387266	-4000	4000	1591
chr11	71562735	71570735	71565859	8000	71566735	-4000	4000	-876
chr11	44080237	44088237	44083243	8000	44084237	-4000	4000	-994
chr11	125772113	125780113	125777311	8000	125776113	-4000	4000	1198
chr11	5195735	5203735	5199859	8000	5199735	-4000	4000	124
chr11	56103658	56111658	56105365	8000	56107658	-4000	4000	-2293
chr11	77212558	77220558	77214738	8000	77216558	-4000	4000	-1820
chr11	67658160	67666160	67664405	8000	67662160	-4000	4000	2245
chr11	66310494	66318494	66315158	8000	66314494	-4000	4000	664
chr11	71577855	71585855	71582130	8000	71581855	-4000	4000	275
chr11	118312175	118320175	118314487	8000	118316175	-4000	4000	-1688
chr11	125836072	125844072	125838404	8000	125840072	-4000	4000	-1668
chr11	315676	323676	319874	8000	319676	-4000	4000	198
chr11	119077972	119085972	119079136	8000	119081972	-4000	4000	-2836
chr11	7661100	7669100	7668546	8000	7665100	-4000	4000	3446
chr11	45643689	45651689	45650642	8000	45647689	-4000	4000	2953
chr11	48242015	48250015	48245608	8000	48246015	-4000	4000	-407
chr11	55909650	55917650	55913689	8000	55913650	-4000	4000	39
chr11	5963177	5971177	5967923	8000	5967177	-4000	4000	746
chr11	48485722	48493722	48489644	8000	48489722	-4000	4000	-78
chr11	95128645	95136645	95128997	8000	95132645	-4000	4000	-3648
chr11	40110203	40118203	40115128	8000	40114203	-4000	4000	925
chr11	55364918	55372918	55368080	8000	55368918	-4000	4000	-838
chr11	55909650	55917650	55913842	8000	55913650	-4000	4000	192
chr11	55648854	55656854	55651777	8000	55652854	-4000	4000	-1077
chr11	5751958	5759958	5754852	8000	5755958	-4000	4000	-1106
chr11	56605236	56613236	56612971	8000	56609236	-4000	4000	3735
chr11	46852717	46860717	46859049	8000	46856717	-4000	4000	2332
chr11	55961755	55969755	55968088	8000	55965755	-4000	4000	2333
chr11	5817483	5825483	5820602	8000	5821483	-4000	4000	-881
chr11	47173522	47181522	47179527	8000	47177522	-4000	4000	2005
chr11	59151039	59159039	59153410	8000	59155039	-4000	4000	-1629
chr11	64568875	64576875	64569718	8000	64572875	-4000	4000	-3157
chr11	68976021	68984021	68980467	8000	68980021	-4000	4000	446
chr11	22375503	22383503	22376029	8000	22379503	-4000	4000	-3474
chr11	48213739	48221739	48217427	8000	48217739	-4000	4000	-312
chr11	56284462	56292462	56290688	8000	56288462	-4000	4000	2226
chr11	61869519	61877519	61875956	8000	61873519	-4000	4000	2437
chr11	64760606	64768606	64767243	8000	64764606	-4000	4000	2637
chr11	112060404	112068404	112067966	8000	112064404	-4000	4000	3562
chr11	49977473	49985473	49981726	8000	49981473	-4000	4000	253
chr11	57383365	57391365	57389249	8000	57387365	-4000	4000	1884
chr11	58354124	58362124	58358713	8000	58358124	-4000	4000	589
chr11	62269160	62277160	62273053	8000	62273160	-4000	4000	-107
chr11	64933517	64941517	64935162	8000	64937517	-4000	4000	-2355
chr11	125429389	125437389	125431343	8000	125433389	-4000	4000	-2046
chr11	86437108	86445108	86441265	8000	86441108	-4000	4000	157
chr11	47568197	47576197	47572417	8000	47572197	-4000	4000	220
chr11	83451012	83459012	83455266	8000	83455012	-4000	4000	254
chr11	95067225	95075225	95068752	8000	95071225	-4000	4000	-2473
chr11	119334942	119342942	119339585	8000	119338942	-4000	4000	643
chr11	64722911	64730911	64730115	8000	64726911	-4000	4000	3204
chr11	4639060	4647060	4640555	8000	4643060	-4000	4000	-2505
chr11	5751958	5759958	5755672	8000	5755958	-4000	4000	-286
chr11	30005730	30013730	30012400	8000	30009730	-4000	4000	2670
chr11	47173522	47181522	47179556	8000	47177522	-4000	4000	2034
chr11	47173522	47181522	47179557	8000	47177522	-4000	4000	2035
chr11	65633439	65641439	65636227	8000	65637439	-4000	4000	-1212
chr11	107322360	107330360	107326798	8000	107326360	-4000	4000	438
chr11	124019948	124027948	124023171	8000	124023948	-4000	4000	-777
chr11	1106511	1114511	1107151	8000	1110511	-4000	4000	-3360
chr11	58434994	58442994	58440103	8000	58438994	-4000	4000	1109
chr11	7920592	7928592	7928164	8000	7924592	-4000	4000	3572
chr11	56249222	56257222	56252395	8000	56253222	-4000	4000	-827
chr11	123905229	123913229	123906762	8000	123909229	-4000	4000	-2467
chr11	4363263	4371263	4367483	8000	4367263	-4000	4000	220
chr11	4542144	4550144	4545577	8000	4546144	-4000	4000	-567
chr11	4089210	4097210	4091365	8000	4093210	-4000	4000	-1845
chr11	5043461	5051461	5046641	8000	5047461	-4000	4000	-820
chr11	63406294	63414294	63408127	8000	63410294	-4000	4000	-2167
chr11	6608768	6616768	6615466	8000	6612768	-4000	4000	2698
chr11	248984	256984	251842	8000	252984	-4000	4000	-1142
chr11	119186223	119194223	119189577	8000	119190223	-4000	4000	-646
chr11	60392596	60400596	60397975	8000	60396596	-4000	4000	1379
chr11	75582918	75590918	75587737	8000	75586918	-4000	4000	819
chr11	94177968	94185968	94181032	8000	94181968	-4000	4000	-936
chr11	124616356	124624356	124619794	8000	124620356	-4000	4000	-562
chr11	281388	289388	284398	8000	285388	-4000	4000	-990
chr11	45902465	45910465	45903052	8000	45906465	-4000	4000	-3413
chr11	55648854	55656854	55651163	8000	55652854	-4000	4000	-1691
chr11	56605236	56613236	56613069	8000	56609236	-4000	4000	3833
chr11	58199202	58207202	58203867	8000	58203202	-4000	4000	665
chr11	85652547	85660547	85654249	8000	85656547	-4000	4000	-2298
chr11	76345898	76353898	76351522	8000	76349898	-4000	4000	1624
chr11	6314946	6322946	6320277	8000	6318946	-4000	4000	1331
chr11	123719914	123727914	123725777	8000	123723914	-4000	4000	1863
chr11	114703069	114711069	114706907	8000	114707069	-4000	4000	-162
chr11	116831751	116839751	116837003	8000	116835751	-4000	4000	1252
chr11	122973570	122981570	122979432	8000	122977570	-4000	4000	1862
chr11	63755892	63763892	63759613	8000	63759892	-4000	4000	-279
chr11	55648854	55656854	55651378	8000	55652854	-4000	4000	-1476
chr11	102229424	102237424	102229839	8000	102233424	-4000	4000	-3585
chr11	58398464	58406464	58402882	8000	58402464	-4000	4000	418
chr11	60797305	60805305	60798456	8000	60801305	-4000	4000	-2849
chr11	102831801	102839801	102836560	8000	102835801	-4000	4000	759
chr11	61481822	61489822	61485401	8000	61485822	-4000	4000	-421
chr11	1550051	1558051	1554976	8000	1554051	-4000	4000	925
chr11	123972661	123980661	123977575	8000	123976661	-4000	4000	914
chr11	5963177	5971177	5968074	8000	5967177	-4000	4000	897
chr11	6787558	6795558	6794888	8000	6791558	-4000	4000	3330
chr11	123053489	123061489	123059897	8000	123057489	-4000	4000	2408
chr11	125896646	125904646	125900032	8000	125900646	-4000	4000	-614
chr11	56342998	56350998	56346915	8000	56346998	-4000	4000	-83
chr11	60168015	60176015	60172247	8000	60172015	-4000	4000	232
chr11	119089834	119097834	119096799	8000	119093834	-4000	4000	2965
chr11	18170280	18178280	18173312	8000	18174280	-4000	4000	-968
chr11	4988431	4996431	4992267	8000	4992431	-4000	4000	-164
chr11	55816571	55824571	55820018	8000	55820571	-4000	4000	-553
chr11	56272819	56280819	56276461	8000	56276819	-4000	4000	-358
chr11	4651488	4659488	4653436	8000	4655488	-4000	4000	-2052
chr11	72192323	72200323	72196071	8000	72196323	-4000	4000	-252
chr11	102392332	102400332	102398649	8000	102396332	-4000	4000	2317
chr11	4988431	4996431	4991482	8000	4992431	-4000	4000	-949
chr11	56249222	56257222	56252484	8000	56253222	-4000	4000	-738
chr11	294200	302200	299396	8000	298200	-4000	4000	1196
chr11	6268127	6276127	6270935	8000	6272127	-4000	4000	-1192
chr11	123972661	123980661	123977488	8000	123976661	-4000	4000	827
chr11	47173522	47181522	47176831	8000	47177522	-4000	4000	-691
chr11	58398464	58406464	58402792	8000	58402464	-4000	4000	328
chr11	56130721	56138721	56137596	8000	56134721	-4000	4000	2875
chr11	56130721	56138721	56137390	8000	56134721	-4000	4000	2669
chr11	133836631	133844631	133842517	8000	133840631	-4000	4000	1886
chr11	94304146	94312146	94305646	8000	94308146	-4000	4000	-2500
chr11	119180016	119188016	119185831	8000	119184016	-4000	4000	1815
chr11	124019948	124027948	124023433	8000	124023948	-4000	4000	-515
chr11	66326241	66334241	66332606	8000	66330241	-4000	4000	2365
chr11	66341374	66349374	66346736	8000	66345374	-4000	4000	1362
chr11	6240479	6248479	6241691	8000	6244479	-4000	4000	-2788
chr11	6240479	6248479	6241692	8000	6244479	-4000	4000	-2787
chr11	60772733	60780733	60773433	8000	60776733	-4000	4000	-3300
chr11	66559464	66567464	66562124	8000	66563464	-4000	4000	-1340
chr11	90038025	90046025	90041170	8000	90042025	-4000	4000	-855
chr11	18363045	18371045	18366038	8000	18367045	-4000	4000	-1007
chr11	18404425	18412425	18407213	8000	18408425	-4000	4000	-1212
chr11	33029582	33037582	33032667	8000	33033582	-4000	4000	-915
chr11	59500511	59508511	59504481	8000	59504511	-4000	4000	-30
chr11	56985843	56993843	56989680	8000	56989843	-4000	4000	-163
chr11	72135892	72143892	72139030	8000	72139892	-4000	4000	-862
chr11	76653524	76661524	76660622	8000	76657524	-4000	4000	3098
chr11	102080554	102088554	102083256	8000	102084554	-4000	4000	-1298
chr11	1626707	1634707	1630577	8000	1630707	-4000	4000	-130
chr11	85652547	85660547	85654127	8000	85656547	-4000	4000	-2420
chr11	102229424	102237424	102229856	8000	102233424	-4000	4000	-3568
chr11	6617330	6625330	6621571	8000	6621330	-4000	4000	241
chr11	18404425	18412425	18407635	8000	18408425	-4000	4000	-790
chr11	25078638	25086638	25082193	8000	25082638	-4000	4000	-445
chr11	55569060	55577060	55572496	8000	55573060	-4000	4000	-564
chr11	57295638	57303638	57300002	8000	57299638	-4000	4000	364
chr11	57295638	57303638	57300003	8000	57299638	-4000	4000	365
chr11	58354124	58362124	58358741	8000	58358124	-4000	4000	617
chr11	73861133	73869133	73864467	8000	73865133	-4000	4000	-666
chr11	125896646	125904646	125900154	8000	125900646	-4000	4000	-492
chr11	55808476	55816476	55811652	8000	55812476	-4000	4000	-824
chr11	18929499	18937499	18933850	8000	18933499	-4000	4000	351
chr11	6787558	6795558	6794816	8000	6791558	-4000	4000	3258
chr11	55931456	55939456	55936336	8000	55935456	-4000	4000	880
chr11	58223882	58231882	58228538	8000	58227882	-4000	4000	656
chr11	4446361	4454361	4450036	8000	4450361	-4000	4000	-325
chr11	93726358	93734358	93727206	8000	93730358	-4000	4000	-3152
chr11	4089210	4097210	4095019	8000	4093210	-4000	4000	1809
chr11	95023596	95031596	95026666	8000	95027596	-4000	4000	-930
chr11	4489497	4497497	4489597	8000	4493497	-4000	4000	-3900
chr11	20152155	20160155	20156493	8000	20156155	-4000	4000	338
chr11	119077972	119085972	119085142	8000	119081972	-4000	4000	3170
chr11	4542144	4550144	4545727	8000	4546144	-4000	4000	-417
chr11	58177616	58185616	58180086	8000	58181616	-4000	4000	-1530
chr11	19050455	19058455	19055295	8000	19054455	-4000	4000	840
chr11	55961755	55969755	55967586	8000	55965755	-4000	4000	1831
chr11	56090240	56098240	56093820	8000	56094240	-4000	4000	-420
chr11	49977473	49985473	49981905	8000	49981473	-4000	4000	432
chr11	93814232	93822232	93820586	8000	93818232	-4000	4000	2354
chr11	7920592	7928592	7928004	8000	7924592	-4000	4000	3412
chr11	56699884	56707884	56700855	8000	56703884	-4000	4000	-3029
chr11	128809267	128817267	128811109	8000	128813267	-4000	4000	-2158
chr11	48242015	48250015	48245246	8000	48246015	-4000	4000	-769
chr11	60466752	60474752	60468637	8000	60470752	-4000	4000	-2115
chr11	60466752	60474752	60468639	8000	60470752	-4000	4000	-2113
chr11	58502807	58510807	58507380	8000	58506807	-4000	4000	573
chr11	58223882	58231882	58228496	8000	58227882	-4000	4000	614
chr11	58830065	58838065	58834587	8000	58834065	-4000	4000	522
chr11	76794153	76802153	76796302	8000	76798153	-4000	4000	-1851
chr11	4676171	4684171	4682515	8000	4680171	-4000	4000	2344
chr11	89713872	89721872	89714333	8000	89717872	-4000	4000	-3539
chr11	36589156	36597156	36593885	8000	36593156	-4000	4000	729
chr11	62419195	62427195	62423107	8000	62423195	-4000	4000	-88
chr11	58199202	58207202	58203379	8000	58203202	-4000	4000	177
chr11	1730821	1738821	1735431	8000	1734821	-4000	4000	610
chr11	20152155	20160155	20156641	8000	20156155	-4000	4000	486
chr11	58398464	58406464	58402840	8000	58402464	-4000	4000	376
chr11	8220309	8228309	8224590	8000	8224309	-4000	4000	281
chr11	86948910	86956910	86951100	8000	86952910	-4000	4000	-1810
chr11	123972661	123980661	123977157	8000	123976661	-4000	4000	496
chr11	55931456	55939456	55935610	8000	55935456	-4000	4000	154
chr11	124419942	124427942	124424702	8000	124423942	-4000	4000	760
chr11	6761626	6769626	6768541	8000	6765626	-4000	4000	2915
chr11	46379789	46387789	46386131	8000	46383789	-4000	4000	2342
chr11	54703902	54711902	54707739	8000	54707902	-4000	4000	-163
chr11	211030	219030	212869	8000	215030	-4000	4000	-2161
chr11	62802860	62810860	62807493	8000	62806860	-4000	4000	633
chr11	111726855	111734855	111726959	8000	111730855	-4000	4000	-3896
chr11	6997004	7005004	7001094	8000	7001004	-4000	4000	90
chr11	6997004	7005004	7001484	8000	7001004	-4000	4000	480
chr11	5772165	5780165	5778032	8000	5776165	-4000	4000	1867
chr11	10503579	10511579	10505993	8000	10507579	-4000	4000	-1586
chr11	124014732	124022732	124016491	8000	124018732	-4000	4000	-2241
chr11	72192323	72200323	72195647	8000	72196323	-4000	4000	-676
chr11	123749580	123757580	123753846	8000	123753580	-4000	4000	266
chr11	61016377	61024377	61017989	8000	61020377	-4000	4000	-2388
chr11	119186223	119194223	119187675	8000	119190223	-4000	4000	-2548
chr11	64296031	64304031	64297129	8000	64300031	-4000	4000	-2902
chr11	64296031	64304031	64297441	8000	64300031	-4000	4000	-2590
chr11	95972598	95980598	95979038	8000	95976598	-4000	4000	2440
chr11	3634512	3642512	3638601	8000	3638512	-4000	4000	89
chr11	60919443	60927443	60923169	8000	60923443	-4000	4000	-274
chr11	60919443	60927443	60923338	8000	60923443	-4000	4000	-105
chr11	75582918	75590918	75587071	8000	75586918	-4000	4000	153
chr11	56372553	56380553	56376154	8000	56376553	-4000	4000	-399
chr11	112060404	112068404	112064054	8000	112064404	-4000	4000	-350
chr11	4651488	4659488	4654503	8000	4655488	-4000	4000	-985
chr11	30005730	30013730	30012183	8000	30009730	-4000	4000	2453
chr11	55636309	55644309	55638452	8000	55640309	-4000	4000	-1857
chr11	124378394	124386394	124382492	8000	124382394	-4000	4000	98
chr11	4651488	4659488	4652927	8000	4655488	-4000	4000	-2561
chr11	5852749	5860749	5857002	8000	5856749	-4000	4000	253
chr11	56357511	56365511	56360417	8000	56361511	-4000	4000	-1094
chr11	56413258	56421258	56417883	8000	56417258	-4000	4000	625
chr11	68976021	68984021	68980804	8000	68980021	-4000	4000	783
chr11	1550051	1558051	1555161	8000	1554051	-4000	4000	1110
chr11	5221464	5229464	5225561	8000	5225464	-4000	4000	97
chr11	6470683	6478683	6476330	8000	6474683	-4000	4000	1647
chr11	57546272	57554272	57546641	8000	57550272	-4000	4000	-3631
chr11	88500576	88508576	88507729	8000	88504576	-4000	4000	3153
chr11	90196429	90204429	90202545	8000	90200429	-4000	4000	2116
chr11	120329686	120337686	120330247	8000	120333686	-4000	4000	-3439
chr11	124315262	124323262	124319886	8000	124319262	-4000	4000	624
chr11	124877471	124885471	124878676	8000	124881471	-4000	4000	-2795
chr11	62762710	62770710	62762943	8000	62766710	-4000	4000	-3767
chr11	62762710	62770710	62762944	8000	62766710	-4000	4000	-3766
chr11	5817483	5825483	5821264	8000	5821483	-4000	4000	-219
chr11	55808476	55816476	55812208	8000	55812476	-4000	4000	-268
chr11	56737223	56745223	56742947	8000	56741223	-4000	4000	1724
chr11	78167249	78175249	78174257	8000	78171249	-4000	4000	3008
chr11	30005730	30013730	30011871	8000	30009730	-4000	4000	2141
chr11	56249222	56257222	56252963	8000	56253222	-4000	4000	-259
chr11	123065872	123073872	123073359	8000	123069872	-4000	4000	3487
chr11	90038025	90046025	90041398	8000	90042025	-4000	4000	-627
chr11	4594672	4602672	4600188	8000	4598672	-4000	4000	1516
chr11	95023596	95031596	95027057	8000	95027596	-4000	4000	-539
chr11	93808378	93816378	93812071	8000	93812378	-4000	4000	-307
chr11	94995519	95003519	94999075	8000	94999519	-4000	4000	-444
chr11	55931456	55939456	55936037	8000	55935456	-4000	4000	581
chr11	124262224	124270224	124265120	8000	124266224	-4000	4000	-1104
chr11	57814431	57822431	57817480	8000	57818431	-4000	4000	-951
chr11	4380897	4388897	4385406	8000	4384897	-4000	4000	509
chr11	10303397	10311397	10306344	8000	10307397	-4000	4000	-1053
chr11	27361961	27369961	27368906	8000	27365961	-4000	4000	2945
chr11	56572774	56580774	56577440	8000	56576774	-4000	4000	666
chr11	59151039	59159039	59152856	8000	59155039	-4000	4000	-2183
chr11	18134488	18142488	18137283	8000	18138488	-4000	4000	-1205
chr11	55551419	55559419	55555048	8000	55555419	-4000	4000	-371
chr11	55909650	55917650	55914571	8000	55913650	-4000	4000	921
chr11	113405605	113413605	113412592	8000	113409605	-4000	4000	2987
chr11	6207135	6215135	6211698	8000	6211135	-4000	4000	563
chr11	5043461	5051461	5046982	8000	5047461	-4000	4000	-479
chr11	55887810	55895810	55891271	8000	55891810	-4000	4000	-539
chr11	56737223	56745223	56742871	8000	56741223	-4000	4000	1648
chr11	105978092	105986092	105980433	8000	105982092	-4000	4000	-1659
chr11	113396416	113404416	113399497	8000	113400416	-4000	4000	-919
chr11	118522832	118530832	118524997	8000	118526832	-4000	4000	-1835
chr11	7661100	7669100	7666547	8000	7665100	-4000	4000	1447
chr11	55835738	55843738	55839529	8000	55839738	-4000	4000	-209
chr11	64296031	64304031	64297333	8000	64300031	-4000	4000	-2698
chr11	64742389	64750389	64746662	8000	64746389	-4000	4000	273
chr11	66586176	66594176	66590542	8000	66590176	-4000	4000	366
chr11	56316639	56324639	56319181	8000	56320639	-4000	4000	-1458
chr11	47712494	47720494	47714284	8000	47716494	-4000	4000	-2210
chr11	55551419	55559419	55555190	8000	55555419	-4000	4000	-229
chr11	119186223	119194223	119188676	8000	119190223	-4000	4000	-1547
chr11	4380897	4388897	4388330	8000	4384897	-4000	4000	3433
chr11	55770382	55778382	55774129	8000	55774382	-4000	4000	-253
chr11	60871693	60879693	60873222	8000	60875693	-4000	4000	-2471
chr11	6787558	6795558	6795516	8000	6791558	-4000	4000	3958
chr11	8916076	8924076	8921461	8000	8920076	-4000	4000	1385
chr11	18227423	18235423	18231662	8000	18231423	-4000	4000	239
chr11	34468060	34476060	34471446	8000	34472060	-4000	4000	-614
chr11	48213739	48221739	48216823	8000	48217739	-4000	4000	-916
chr11	54703902	54711902	54707001	8000	54707902	-4000	4000	-901
chr11	57295638	57303638	57301944	8000	57299638	-4000	4000	2306
chr11	58620639	58628639	58624574	8000	58624639	-4000	4000	-65
chr11	60067115	60075115	60070383	8000	60071115	-4000	4000	-732
chr11	61254286	61262286	61258850	8000	61258286	-4000	4000	564
chr11	62802860	62810860	62803835	8000	62806860	-4000	4000	-3025
chr11	75582918	75590918	75586987	8000	75586918	-4000	4000	69
chr11	76549025	76557025	76550329	8000	76553025	-4000	4000	-2696
chr11	94495578	94503578	94496679	8000	94499578	-4000	4000	-2899
chr11	116785367	116793367	116790796	8000	116789367	-4000	4000	1429
chr11	117423772	117431772	117428349	8000	117427772	-4000	4000	577
chr11	119132059	119140059	119132969	8000	119136059	-4000	4000	-3090
chr11	64983945	64991945	64989335	8000	64987945	-4000	4000	1390
chr11	5836928	5844928	5841018	8000	5840928	-4000	4000	90
chr11	56660618	56668618	56664020	8000	56664618	-4000	4000	-598
chr11	56699884	56707884	56701100	8000	56703884	-4000	4000	-2784
chr11	6887574	6895574	6892432	8000	6891574	-4000	4000	858
chr11	119309926	119317926	119310877	8000	119313926	-4000	4000	-3049
chr11	119351215	119359215	119358794	8000	119355215	-4000	4000	3579
chr11	5995445	6003445	6002942	8000	5999445	-4000	4000	3497
chr11	11957887	11965887	11964436	8000	11961887	-4000	4000	2549
chr11	13008119	13016119	13010199	8000	13012119	-4000	4000	-1920
chr11	30005730	30013730	30011931	8000	30009730	-4000	4000	2201
chr11	55835738	55843738	55839035	8000	55839738	-4000	4000	-703
chr11	55835738	55843738	55839332	8000	55839738	-4000	4000	-406
chr11	56155394	56163394	56159806	8000	56159394	-4000	4000	412
chr11	57699710	57707710	57703923	8000	57703710	-4000	4000	213
chr11	57814431	57822431	57818099	8000	57818431	-4000	4000	-332
chr11	58262792	58270792	58267472	8000	58266792	-4000	4000	680
chr11	61481822	61489822	61482719	8000	61485822	-4000	4000	-3103
chr11	63542462	63550462	63544829	8000	63546462	-4000	4000	-1633
chr11	66292664	66300664	66296306	8000	66296664	-4000	4000	-358
chr11	67254082	67262082	67255455	8000	67258082	-4000	4000	-2627
chr11	67394410	67402410	67401116	8000	67398410	-4000	4000	2706
chr11	70185530	70193530	70188114	8000	70189530	-4000	4000	-1416
chr11	70463854	70471854	70470629	8000	70467854	-4000	4000	2775
chr11	71524669	71532669	71527279	8000	71528669	-4000	4000	-1390
chr11	77874720	77882720	77878824	8000	77878720	-4000	4000	104
chr11	85652547	85660547	85660409	8000	85656547	-4000	4000	3862
chr11	92981066	92989066	92982322	8000	92985066	-4000	4000	-2744
chr11	94495578	94503578	94496920	8000	94499578	-4000	4000	-2658
chr11	104938866	104946866	104944768	8000	104942866	-4000	4000	1902
chr11	108304519	108312519	108312485	8000	108308519	-4000	4000	3966
chr11	123801408	123809408	123805691	8000	123805408	-4000	4000	283
chr11	124433445	124441445	124440886	8000	124437445	-4000	4000	3441
chr11	315676	323676	320790	8000	319676	-4000	4000	1114
chr11	56227282	56235282	56232722	8000	56231282	-4000	4000	1440
chr11	56660618	56668618	56664204	8000	56664618	-4000	4000	-414
chr11	64760606	64768606	64767248	8000	64764606	-4000	4000	2642
chr11	5043461	5051461	5046843	8000	5047461	-4000	4000	-618
chr11	62269160	62277160	62270199	8000	62273160	-4000	4000	-2961
chr11	56538340	56546340	56542433	8000	56542340	-4000	4000	93
chr11	66036765	66044765	66043506	8000	66040765	-4000	4000	2741
chr11	77212558	77220558	77217252	8000	77216558	-4000	4000	694
chr11	105037326	105045326	105044642	8000	105041326	-4000	4000	3316
chr11	55648854	55656854	55651696	8000	55652854	-4000	4000	-1158
chr11	55887810	55895810	55888111	8000	55891810	-4000	4000	-3699
chr11	4676171	4684171	4682191	8000	4680171	-4000	4000	2020
chr11	17489895	17497895	17496806	8000	17493895	-4000	4000	2911
chr11	57383365	57391365	57389259	8000	57387365	-4000	4000	1894
chr11	6196186	6204186	6200128	8000	6200186	-4000	4000	-58
chr11	112081150	112089150	112082475	8000	112085150	-4000	4000	-2675
chr11	116831751	116839751	116837360	8000	116835751	-4000	4000	1609
chr11	124877471	124885471	124878363	8000	124881471	-4000	4000	-3108
chr11	67582656	67590656	67586187	8000	67586656	-4000	4000	-469
chr11	123878920	123886920	123884530	8000	123882920	-4000	4000	1610
chr11	124378394	124386394	124383355	8000	124382394	-4000	4000	961
chr11	10569091	10577091	10576488	8000	10573091	-4000	4000	3397
chr11	20505338	20513338	20508326	8000	20509338	-4000	4000	-1012
chr11	45925319	45933319	45928271	8000	45929319	-4000	4000	-1048
chr11	66586176	66594176	66590609	8000	66590176	-4000	4000	433
chr11	66586176	66594176	66592777	8000	66590176	-4000	4000	2601
chr11	116831751	116839751	116835819	8000	116835751	-4000	4000	68
chr11	248984	256984	250838	8000	252984	-4000	4000	-2146
chr11	4542144	4550144	4545658	8000	4546144	-4000	4000	-486
chr11	5782471	5790471	5788544	8000	5786471	-4000	4000	2073
chr11	18013555	18021555	18020935	8000	18017555	-4000	4000	3380
chr11	44080237	44088237	44081184	8000	44084237	-4000	4000	-3053
chr11	46317409	46325409	46320757	8000	46321409	-4000	4000	-652
chr11	55792500	55800500	55796176	8000	55796500	-4000	4000	-324
chr11	55961755	55969755	55968245	8000	55965755	-4000	4000	2490
chr11	56357511	56365511	56360407	8000	56361511	-4000	4000	-1104
chr11	56985843	56993843	56989074	8000	56989843	-4000	4000	-769
chr11	69000395	69008395	69006247	8000	69004395	-4000	4000	1852
chr11	89713872	89721872	89717842	8000	89717872	-4000	4000	-30
chr11	92981066	92989066	92982351	8000	92985066	-4000	4000	-2715
chr11	93726358	93734358	93727300	8000	93730358	-4000	4000	-3058
chr11	94495578	94503578	94496757	8000	94499578	-4000	4000	-2821
chr11	94995519	95003519	94997451	8000	94999519	-4000	4000	-2068
chr11	113986313	113994313	113986636	8000	113990313	-4000	4000	-3677
chr11	130206362	130214362	130208589	8000	130210362	-4000	4000	-1773
chr11	1106511	1114511	1107658	8000	1110511	-4000	4000	-2853
chr11	4446361	4454361	4450034	8000	4450361	-4000	4000	-327
chr11	34474791	34482791	34480183	8000	34478791	-4000	4000	1392
chr11	55569060	55577060	55573033	8000	55573060	-4000	4000	-27
chr11	55931456	55939456	55936056	8000	55935456	-4000	4000	600
chr11	55989681	55997681	55994493	8000	55993681	-4000	4000	812
chr11	56227282	56235282	56232538	8000	56231282	-4000	4000	1256
chr11	66422707	66430707	66425032	8000	66426707	-4000	4000	-1675
chr11	66431075	66439075	66436082	8000	66435075	-4000	4000	1007
chr11	311272	319272	314144	8000	315272	-4000	4000	-1128
chr11	2314204	2322204	2317875	8000	2318204	-4000	4000	-329
chr11	4591013	4599013	4594739	8000	4595013	-4000	4000	-274
chr11	7087148	7095148	7090223	8000	7091148	-4000	4000	-925
chr11	8916076	8924076	8919548	8000	8920076	-4000	4000	-528
chr11	10303397	10311397	10306012	8000	10307397	-4000	4000	-1385
chr11	21571686	21579686	21574971	8000	21575686	-4000	4000	-715
chr11	48213739	48221739	48217233	8000	48217739	-4000	4000	-506
chr11	56103658	56111658	56105468	8000	56107658	-4000	4000	-2190
chr11	57814431	57822431	57818189	8000	57818431	-4000	4000	-242
chr11	60044044	60052044	60046975	8000	60048044	-4000	4000	-1069
chr11	62788123	62796123	62794272	8000	62792123	-4000	4000	2149
chr11	66326241	66334241	66333626	8000	66330241	-4000	4000	3385
chr11	67298485	67306485	67304950	8000	67302485	-4000	4000	2465
chr11	67627303	67635303	67634325	8000	67631303	-4000	4000	3022
chr11	76345898	76353898	76352780	8000	76349898	-4000	4000	2882
chr11	76653524	76661524	76660983	8000	76657524	-4000	4000	3459
chr11	83451012	83459012	83458213	8000	83455012	-4000	4000	3201
chr11	86948910	86956910	86950293	8000	86952910	-4000	4000	-2617
chr11	104990235	104998235	104997452	8000	104994235	-4000	4000	3217
chr11	113274436	113282436	113276871	8000	113278436	-4000	4000	-1565
chr11	113793874	113801874	113801588	8000	113797874	-4000	4000	3714
chr11	120226334	120234334	120229275	8000	120230334	-4000	4000	-1059
chr11	124262224	124270224	124265517	8000	124266224	-4000	4000	-707
chr11	124315262	124323262	124320026	8000	124319262	-4000	4000	764
chr11	124879691	124887691	124886468	8000	124883691	-4000	4000	2777
chr11	128930731	128938731	128937429	8000	128934731	-4000	4000	2698
chr11	1837680	1845680	1841559	8000	1841680	-4000	4000	-121
chr11	43916274	43924274	43919086	8000	43920274	-4000	4000	-1188
chr11	67582656	67590656	67584743	8000	67586656	-4000	4000	-1913
chr11	124616356	124624356	124619816	8000	124620356	-4000	4000	-540
chr11	105037326	105045326	105044409	8000	105041326	-4000	4000	3083
chr11	3634512	3642512	3640063	8000	3638512	-4000	4000	1551
chr11	18448063	18456063	18451120	8000	18452063	-4000	4000	-943
chr11	25078638	25086638	25078671	8000	25082638	-4000	4000	-3967
chr11	47774087	47782087	47779162	8000	47778087	-4000	4000	1075
chr11	56227282	56235282	56232753	8000	56231282	-4000	4000	1471
chr11	57480534	57488534	57485117	8000	57484534	-4000	4000	583
chr11	58434994	58442994	58440024	8000	58438994	-4000	4000	1030
chr11	59151039	59159039	59152430	8000	59155039	-4000	4000	-2609
chr11	60094467	60102467	60095618	8000	60098467	-4000	4000	-2849
chr11	65040818	65048818	65046505	8000	65044818	-4000	4000	1687
chr11	83183451	83191451	83184765	8000	83187451	-4000	4000	-2686
chr11	86948910	86956910	86954866	8000	86952910	-4000	4000	1956
chr11	95023596	95031596	95025918	8000	95027596	-4000	4000	-1678
chr11	112081150	112089150	112085330	8000	112085150	-4000	4000	180
chr11	116831751	116839751	116832805	8000	116835751	-4000	4000	-2946
chr11	118395211	118403211	118401632	8000	118399211	-4000	4000	2421
chr11	122973570	122981570	122977778	8000	122977570	-4000	4000	208
chr11	124877471	124885471	124878351	8000	124881471	-4000	4000	-3120
chr11	3221030	3229030	3228706	8000	3225030	-4000	4000	3676
chr11	18723928	18731928	18728914	8000	18727928	-4000	4000	986
chr11	26993087	27001087	26994970	8000	26997087	-4000	4000	-2117
chr11	30005730	30013730	30011526	8000	30009730	-4000	4000	1796
chr11	119040188	119048188	119045608	8000	119044188	-4000	4000	1420
chr11	122973570	122981570	122981461	8000	122977570	-4000	4000	3891
chr11	4988431	4996431	4989785	8000	4992431	-4000	4000	-2646
chr11	126198096	126206096	126205570	8000	126202096	-4000	4000	3474
chr11	55551419	55559419	55555398	8000	55555419	-4000	4000	-21
chr11	56272819	56280819	56276484	8000	56276819	-4000	4000	-335
chr11	128809267	128817267	128810940	8000	128813267	-4000	4000	-2327
chr11	56155394	56163394	56159472	8000	56159394	-4000	4000	78
chr11	59204588	59212588	59211469	8000	59208588	-4000	4000	2881
chr11	6787558	6795558	6794975	8000	6791558	-4000	4000	3417
chr11	19050455	19058455	19055301	8000	19054455	-4000	4000	846
chr11	58212084	58220084	58215330	8000	58216084	-4000	4000	-754
chr11	112081150	112089150	112082289	8000	112085150	-4000	4000	-2861
chr11	123905229	123913229	123906892	8000	123909229	-4000	4000	-2337
chr11	6617330	6625330	6623523	8000	6621330	-4000	4000	2193
chr11	54703902	54711902	54706972	8000	54707902	-4000	4000	-930
chr11	124184780	124192780	124185781	8000	124188780	-4000	4000	-2999
chr11	5221464	5229464	5226982	8000	5225464	-4000	4000	1518
chr11	123972661	123980661	123977238	8000	123976661	-4000	4000	577
chr11	55887810	55895810	55891393	8000	55891810	-4000	4000	-417
chr11	66505657	66513657	66509118	8000	66509657	-4000	4000	-539
chr11	72135892	72143892	72139879	8000	72139892	-4000	4000	-13
chr11	92981066	92989066	92982489	8000	92985066	-4000	4000	-2577
chr11	124378394	124386394	124383217	8000	124382394	-4000	4000	823
chr11	124535635	124543635	124543294	8000	124539635	-4000	4000	3659
chr11	108103761	108111761	108104492	8000	108107761	-4000	4000	-3269
chr11	6997004	7005004	7000277	8000	7001004	-4000	4000	-727
chr11	55551419	55559419	55554507	8000	55555419	-4000	4000	-912
chr11	44055977	44063977	44059884	8000	44059977	-4000	4000	-93
chr11	55961755	55969755	55968440	8000	55965755	-4000	4000	2685
chr11	76653524	76661524	76660840	8000	76657524	-4000	4000	3316
chr11	124014732	124022732	124015835	8000	124018732	-4000	4000	-2897
chr11	124019948	124027948	124023273	8000	124023948	-4000	4000	-675
chr11	48971324	48979324	48979071	8000	48975324	-4000	4000	3747
chr11	78167249	78175249	78173924	8000	78171249	-4000	4000	2675
chr11	57229577	57237577	57235962	8000	57233577	-4000	4000	2385
chr11	69000395	69008395	69006092	8000	69004395	-4000	4000	1697
chr11	71993597	72001597	71995492	8000	71997597	-4000	4000	-2105
chr11	5981892	5989892	5986152	8000	5985892	-4000	4000	260
chr11	6761626	6769626	6768928	8000	6765626	-4000	4000	3302
chr11	64890546	64898546	64892749	8000	64894546	-4000	4000	-1797
chr11	22375503	22383503	22375997	8000	22379503	-4000	4000	-3506
chr11	71562735	71570735	71565901	8000	71566735	-4000	4000	-834
chr11	4676171	4684171	4681906	8000	4680171	-4000	4000	1735
chr11	57229577	57237577	57236055	8000	57233577	-4000	4000	2478
chr11	64568875	64576875	64571036	8000	64572875	-4000	4000	-1839
chr11	124014732	124022732	124016137	8000	124018732	-4000	4000	-2595
chr11	134148001	134156001	134148650	8000	134152001	-4000	4000	-3351
chr11	6617330	6625330	6619417	8000	6621330	-4000	4000	-1913
chr11	65646918	65654918	65649763	8000	65650918	-4000	4000	-1155
chr11	124433445	124441445	124440750	8000	124437445	-4000	4000	3305
chr11	111282401	111290401	111285742	8000	111286401	-4000	4000	-659
chr11	123905229	123913229	123906505	8000	123909229	-4000	4000	-2724
chr11	5195735	5203735	5200681	8000	5199735	-4000	4000	946
chr11	47585194	47593194	47589925	8000	47589194	-4000	4000	731
chr11	30005730	30013730	30010981	8000	30009730	-4000	4000	1251
chr11	56605236	56613236	56613053	8000	56609236	-4000	4000	3817
chr11	61481822	61489822	61484692	8000	61485822	-4000	4000	-1130
chr11	6165355	6173355	6169499	8000	6169355	-4000	4000	144
chr11	54599069	54607069	54603344	8000	54603069	-4000	4000	275
chr11	112189805	112197805	112193750	8000	112193805	-4000	4000	-55
chr11	90083131	90091131	90086854	8000	90087131	-4000	4000	-277
chr11	123936573	123944573	123943261	8000	123940573	-4000	4000	2688
chr11	124019948	124027948	124023407	8000	124023948	-4000	4000	-541
chr11	6268127	6276127	6270841	8000	6272127	-4000	4000	-1286
chr11	128454761	128462761	128458804	8000	128458761	-4000	4000	43
chr11	4542144	4550144	4545376	8000	4546144	-4000	4000	-768
chr11	56637489	56645489	56642292	8000	56641489	-4000	4000	803
chr11	60067115	60075115	60070431	8000	60071115	-4000	4000	-684
chr11	48242015	48250015	48245626	8000	48246015	-4000	4000	-389
chr11	64235264	64243264	64237197	8000	64239264	-4000	4000	-2067
chr11	90196429	90204429	90202370	8000	90200429	-4000	4000	1941
chr11	111726855	111734855	111726866	8000	111730855	-4000	4000	-3989
chr11	126419358	126427358	126424802	8000	126423358	-4000	4000	1444
chr11	5124776	5132776	5132037	8000	5128776	-4000	4000	3261
chr11	18929499	18937499	18934426	8000	18933499	-4000	4000	927
chr11	60711807	60719807	60715398	8000	60715807	-4000	4000	-409
chr11	94177968	94185968	94179924	8000	94181968	-4000	4000	-2044
chr11	32100665	32108665	32103475	8000	32104665	-4000	4000	-1190
chr11	77212558	77220558	77213860	8000	77216558	-4000	4000	-2698
chr11	7791974	7799974	7796683	8000	7795974	-4000	4000	709
chr11	49141092	49149092	49146851	8000	49145092	-4000	4000	1759
chr11	89713872	89721872	89717823	8000	89717872	-4000	4000	-49
chr11	126198096	126206096	126205546	8000	126202096	-4000	4000	3450
chr11	65862441	65870441	65864730	8000	65866441	-4000	4000	-1711
chr11	13488054	13496054	13492241	8000	13492054	-4000	4000	187
chr11	35427823	35435823	35432493	8000	35431823	-4000	4000	670
chr11	108103761	108111761	108104297	8000	108107761	-4000	4000	-3464
chr11	55551419	55559419	55554669	8000	55555419	-4000	4000	-750
chr11	5947347	5955347	5947373	8000	5951347	-4000	4000	-3974
chr11	18602403	18610403	18609789	8000	18606403	-4000	4000	3386
chr11	59453905	59461905	59456987	8000	59457905	-4000	4000	-918
chr11	66310494	66318494	66315301	8000	66314494	-4000	4000	807
chr11	6207135	6215135	6214443	8000	6211135	-4000	4000	3308
chr11	48260778	48268778	48264016	8000	48264778	-4000	4000	-762
chr11	56227282	56235282	56232409	8000	56231282	-4000	4000	1127
chr11	2314204	2322204	2316625	8000	2318204	-4000	4000	-1579
chr11	59151039	59159039	59153149	8000	59155039	-4000	4000	-1890
chr11	61481822	61489822	61482398	8000	61485822	-4000	4000	-3424
chr11	61481822	61489822	61485910	8000	61485822	-4000	4000	88
chr11	57229577	57237577	57236383	8000	57233577	-4000	4000	2806
chr11	5733089	5741089	5737088	8000	5737089	-4000	4000	-1
chr11	64722911	64730911	64728893	8000	64726911	-4000	4000	1982
chr11	66310494	66318494	66316258	8000	66314494	-4000	4000	1764
chr11	55824154	55832154	55827492	8000	55828154	-4000	4000	-662
chr11	1693755	1701755	1697290	8000	1697755	-4000	4000	-465
chr11	6314946	6322946	6319229	8000	6318946	-4000	4000	283
chr11	48260778	48268778	48264046	8000	48264778	-4000	4000	-732
chr11	55961755	55969755	55968165	8000	55965755	-4000	4000	2410
chr11	65793214	65801214	65793944	8000	65797214	-4000	4000	-3270
chr11	77037973	77045973	77040615	8000	77041973	-4000	4000	-1358
chr11	59475361	59483361	59477793	8000	59479361	-4000	4000	-1568
chr11	7953537	7961537	7960657	8000	7957537	-4000	4000	3120
chr11	48303152	48311152	48306929	8000	48307152	-4000	4000	-223
chr11	118395211	118403211	118401658	8000	118399211	-4000	4000	2447
chr11	125429389	125437389	125431199	8000	125433389	-4000	4000	-2190
chr11	134315564	134323564	134318683	8000	134319564	-4000	4000	-881
chr11	47173522	47181522	47176606	8000	47177522	-4000	4000	-916
chr11	55824154	55832154	55828094	8000	55828154	-4000	4000	-60
chr11	56342998	56350998	56346121	8000	56346998	-4000	4000	-877
chr11	66586176	66594176	66591393	8000	66590176	-4000	4000	1217
chr11	94177968	94185968	94180854	8000	94181968	-4000	4000	-1114
chr11	119309926	119317926	119311539	8000	119313926	-4000	4000	-2387
chr11	124391534	124399534	124396751	8000	124395534	-4000	4000	1217
chr11	18929499	18937499	18934365	8000	18933499	-4000	4000	866
chr11	132332822	132340822	132335170	8000	132336822	-4000	4000	-1652
chr11	71545608	71553608	71548614	8000	71549608	-4000	4000	-994
chr11	124014732	124022732	124016094	8000	124018732	-4000	4000	-2638
chr11	36589156	36597156	36593736	8000	36593156	-4000	4000	580
chr11	62744319	62752319	62752017	8000	62748319	-4000	4000	3698
chr11	66341374	66349374	66346601	8000	66345374	-4000	4000	1227
chr11	54599069	54607069	54603458	8000	54603069	-4000	4000	389
chr11	55909650	55917650	55913809	8000	55913650	-4000	4000	159
chr11	55824154	55832154	55827821	8000	55828154	-4000	4000	-333
chr11	4446361	4454361	4449637	8000	4450361	-4000	4000	-724
chr11	9015476	9023476	9021942	8000	9019476	-4000	4000	2466
chr11	76653524	76661524	76659586	8000	76657524	-4000	4000	2062
chr11	129856003	129864003	129858803	8000	129860003	-4000	4000	-1200
chr11	49141092	49149092	49148638	8000	49145092	-4000	4000	3546
chr11	89713872	89721872	89717457	8000	89717872	-4000	4000	-415
chr11	125090389	125098389	125097708	8000	125094389	-4000	4000	3319
chr11	33029582	33037582	33032459	8000	33033582	-4000	4000	-1123
chr11	5124776	5132776	5132478	8000	5128776	-4000	4000	3702
chr11	62904679	62912679	62910930	8000	62908679	-4000	4000	2251
chr11	73861133	73869133	73863215	8000	73865133	-4000	4000	-1918
chr11	54599069	54607069	54603376	8000	54603069	-4000	4000	307
chr11	5852749	5860749	5856844	8000	5856749	-4000	4000	95
chr11	58398464	58406464	58403229	8000	58402464	-4000	4000	765
chr11	1106511	1114511	1110141	8000	1110511	-4000	4000	-370
chr11	5772165	5780165	5778383	8000	5776165	-4000	4000	2218
chr11	56103658	56111658	56105590	8000	56107658	-4000	4000	-2068
chr11	281388	289388	285169	8000	285388	-4000	4000	-219
chr11	18363045	18371045	18365806	8000	18367045	-4000	4000	-1239
chr11	35427823	35435823	35432499	8000	35431823	-4000	4000	676
chr11	56284462	56292462	56290558	8000	56288462	-4000	4000	2096
chr11	66422707	66430707	66424005	8000	66426707	-4000	4000	-2702
chr11	56413258	56421258	56417331	8000	56417258	-4000	4000	73
chr11	6997004	7005004	6999878	8000	7001004	-4000	4000	-1126
chr11	64930475	64938475	64931592	8000	64934475	-4000	4000	-2883
chr11	66422707	66430707	66424773	8000	66426707	-4000	4000	-1934
chr11	114439932	114447932	114447832	8000	114443932	-4000	4000	3900
chr11	61247444	61255444	61249734	8000	61251444	-4000	4000	-1710
chr11	4363263	4371263	4368071	8000	4367263	-4000	4000	808
chr11	94995519	95003519	94997742	8000	94999519	-4000	4000	-1777
chr11	66505657	66513657	66509145	8000	66509657	-4000	4000	-512
chr11	43916274	43924274	43919925	8000	43920274	-4000	4000	-349
chr11	61254286	61262286	61258788	8000	61258286	-4000	4000	502
chr11	56605236	56613236	56612675	8000	56609236	-4000	4000	3439
chr11	6207135	6215135	6211768	8000	6211135	-4000	4000	633
chr11	130472645	130480645	130473440	8000	130476645	-4000	4000	-3205
chr11	134244279	134252279	134249144	8000	134248279	-4000	4000	865
chr11	119077972	119085972	119078264	8000	119081972	-4000	4000	-3708
chr11	5124776	5132776	5132083	8000	5128776	-4000	4000	3307
chr11	43852617	43860617	43855728	8000	43856617	-4000	4000	-889
chr11	7953537	7961537	7961091	8000	7957537	-4000	4000	3554
chr11	76345898	76353898	76351537	8000	76349898	-4000	4000	1639
chr11	55569060	55577060	55572637	8000	55573060	-4000	4000	-423
chr11	76549025	76557025	76550323	8000	76553025	-4000	4000	-2702
chr11	129859636	129867636	129864635	8000	129863636	-4000	4000	999
chr11	8689351	8697351	8694087	8000	8693351	-4000	4000	736
chr11	55364918	55372918	55368537	8000	55368918	-4000	4000	-381
chr11	56272819	56280819	56275640	8000	56276819	-4000	4000	-1179
chr11	134244279	134252279	134248364	8000	134248279	-4000	4000	85
chr11	6196186	6204186	6199839	8000	6200186	-4000	4000	-347
chr11	113274436	113282436	113277149	8000	113278436	-4000	4000	-1287
chr11	2155779	2163779	2159789	8000	2159779	-4000	4000	10
chr11	18700312	18708312	18706055	8000	18704312	-4000	4000	1743
chr11	6240479	6248479	6240564	8000	6244479	-4000	4000	-3915
chr11	6240479	6248479	6241573	8000	6244479	-4000	4000	-2906
chr11	111348255	111356255	111354248	8000	111352255	-4000	4000	1993
chr11	294200	302200	294744	8000	298200	-4000	4000	-3456
chr11	311272	319272	315068	8000	315272	-4000	4000	-204
chr11	4639060	4647060	4640574	8000	4643060	-4000	4000	-2486
chr11	5043461	5051461	5047272	8000	5047461	-4000	4000	-189
chr11	5250392	5258392	5254483	8000	5254392	-4000	4000	91
chr11	5947347	5955347	5947499	8000	5951347	-4000	4000	-3848
chr11	5981892	5989892	5986580	8000	5985892	-4000	4000	688
chr11	6240479	6248479	6241542	8000	6244479	-4000	4000	-2937
chr11	6787558	6795558	6795265	8000	6791558	-4000	4000	3707
chr11	6873619	6881619	6877293	8000	6877619	-4000	4000	-326
chr11	6997004	7005004	6999764	8000	7001004	-4000	4000	-1240
chr11	7507377	7515377	7509830	8000	7511377	-4000	4000	-1547
chr11	7653127	7661127	7653161	8000	7657127	-4000	4000	-3966
chr11	7791974	7799974	7796235	8000	7795974	-4000	4000	261
chr11	7791974	7799974	7796795	8000	7795974	-4000	4000	821
chr11	8976576	8984576	8984116	8000	8980576	-4000	4000	3540
chr11	13008119	13016119	13010646	8000	13012119	-4000	4000	-1473
chr11	17388498	17396498	17395276	8000	17392498	-4000	4000	2778
chr11	18170280	18178280	18173765	8000	18174280	-4000	4000	-515
chr11	18404425	18412425	18407427	8000	18408425	-4000	4000	-998
chr11	20379782	20387782	20383057	8000	20383782	-4000	4000	-725
chr11	21571686	21579686	21573348	8000	21575686	-4000	4000	-2338
chr11	27361961	27369961	27368737	8000	27365961	-4000	4000	2776
chr11	30334223	30342223	30336695	8000	30338223	-4000	4000	-1528
chr11	46852717	46860717	46859277	8000	46856717	-4000	4000	2560
chr11	47585194	47593194	47586728	8000	47589194	-4000	4000	-2466
chr11	47774087	47782087	47780372	8000	47778087	-4000	4000	2285
chr11	48260778	48268778	48263953	8000	48264778	-4000	4000	-825
chr11	48303152	48311152	48306440	8000	48307152	-4000	4000	-712
chr11	55824154	55832154	55827697	8000	55828154	-4000	4000	-457
chr11	55835738	55843738	55839525	8000	55839738	-4000	4000	-213
chr11	56130721	56138721	56137390	8000	56134721	-4000	4000	2669
chr11	56155394	56163394	56159930	8000	56159394	-4000	4000	536
chr11	56316639	56324639	56319189	8000	56320639	-4000	4000	-1450
chr11	56486435	56494435	56491349	8000	56490435	-4000	4000	914
chr11	56737223	56745223	56743543	8000	56741223	-4000	4000	2320
chr11	56985843	56993843	56989122	8000	56989843	-4000	4000	-721
chr11	57547656	57555656	57554470	8000	57551656	-4000	4000	2814
chr11	57657865	57665865	57661208	8000	57661865	-4000	4000	-657
chr11	58177616	58185616	58180094	8000	58181616	-4000	4000	-1522
chr11	59500511	59508511	59503660	8000	59504511	-4000	4000	-851
chr11	59632716	59640716	59638193	8000	59636716	-4000	4000	1477
chr11	60797305	60805305	60798473	8000	60801305	-4000	4000	-2832
chr11	60919443	60927443	60927321	8000	60923443	-4000	4000	3878
chr11	61254286	61262286	61259198	8000	61258286	-4000	4000	912
chr11	61743001	61751001	61744085	8000	61747001	-4000	4000	-2916
chr11	62904679	62912679	62910021	8000	62908679	-4000	4000	1342
chr11	63907020	63915020	63908920	8000	63911020	-4000	4000	-2100
chr11	64722911	64730911	64728909	8000	64726911	-4000	4000	1998
chr11	64742389	64750389	64746700	8000	64746389	-4000	4000	311
chr11	65169244	65177244	65171355	8000	65173244	-4000	4000	-1889
chr11	66310494	66318494	66315158	8000	66314494	-4000	4000	664
chr11	66586176	66594176	66592365	8000	66590176	-4000	4000	2189
chr11	68750620	68758620	68754928	8000	68754620	-4000	4000	308
chr11	68976021	68984021	68980949	8000	68980021	-4000	4000	928
chr11	69000395	69008395	69006243	8000	69004395	-4000	4000	1848
chr11	71524669	71532669	71527626	8000	71528669	-4000	4000	-1043
chr11	71562735	71570735	71566314	8000	71566735	-4000	4000	-421
chr11	71577855	71585855	71582668	8000	71581855	-4000	4000	813
chr11	72135892	72143892	72139480	8000	72139892	-4000	4000	-412
chr11	76653524	76661524	76661470	8000	76657524	-4000	4000	3946
chr11	86274813	86282813	86278066	8000	86278813	-4000	4000	-747
chr11	89713872	89721872	89717568	8000	89717872	-4000	4000	-304
chr11	89713872	89721872	89717842	8000	89717872	-4000	4000	-30
chr11	90083131	90091131	90087047	8000	90087131	-4000	4000	-84
chr11	93726358	93734358	93727203	8000	93730358	-4000	4000	-3155
chr11	103903189	103911189	103909526	8000	103907189	-4000	4000	2337
chr11	110573042	110581042	110579651	8000	110577042	-4000	4000	2609
chr11	111782286	111790286	111786324	8000	111786286	-4000	4000	38
chr11	113274436	113282436	113275292	8000	113278436	-4000	4000	-3144
chr11	113405605	113413605	113410626	8000	113409605	-4000	4000	1021
chr11	113986313	113994313	113989762	8000	113990313	-4000	4000	-551
chr11	114439932	114447932	114440737	8000	114443932	-4000	4000	-3195
chr11	118158806	118166806	118166709	8000	118162806	-4000	4000	3903
chr11	119186223	119194223	119190724	8000	119190223	-4000	4000	501
chr11	123053489	123061489	123061254	8000	123057489	-4000	4000	3765
chr11	124378394	124386394	124383184	8000	124382394	-4000	4000	790
chr11	124629113	124637113	124631312	8000	124633113	-4000	4000	-1801
chr11	124762498	124770498	124767112	8000	124766498	-4000	4000	614
chr11	124762498	124770498	124767571	8000	124766498	-4000	4000	1073
chr11	125896646	125904646	125900351	8000	125900646	-4000	4000	-295
chr11	128832315	128840315	128840132	8000	128836315	-4000	4000	3817
chr11	18170280	18178280	18173954	8000	18174280	-4000	4000	-326
chr11	55648854	55656854	55651611	8000	55652854	-4000	4000	-1243
chr11	123936573	123944573	123939863	8000	123940573	-4000	4000	-710
chr11	6617330	6625330	6622066	8000	6621330	-4000	4000	736
chr11	6787558	6795558	6795005	8000	6791558	-4000	4000	3447
chr11	55770382	55778382	55774246	8000	55774382	-4000	4000	-136
chr11	58434994	58442994	58439624	8000	58438994	-4000	4000	630
chr11	61254286	61262286	61258968	8000	61258286	-4000	4000	682
chr11	70185530	70193530	70185633	8000	70189530	-4000	4000	-3897
chr11	66341374	66349374	66347075	8000	66345374	-4000	4000	1701
chr11	128454761	128462761	128459614	8000	128458761	-4000	4000	853
chr11	59475361	59483361	59477793	8000	59479361	-4000	4000	-1568
chr11	66505657	66513657	66510647	8000	66509657	-4000	4000	990
chr11	55636309	55644309	55639289	8000	55640309	-4000	4000	-1020
chr11	56985843	56993843	56988915	8000	56989843	-4000	4000	-928
chr11	6617330	6625330	6623920	8000	6621330	-4000	4000	2590
chr11	55364918	55372918	55368746	8000	55368918	-4000	4000	-172
chr11	59475361	59483361	59477973	8000	59479361	-4000	4000	-1388
chr11	4489497	4497497	4489597	8000	4493497	-4000	4000	-3900
chr11	55792500	55800500	55796116	8000	55796500	-4000	4000	-384
chr11	56342998	56350998	56346809	8000	56346998	-4000	4000	-189
chr11	65862441	65870441	65864986	8000	65866441	-4000	4000	-1455
chr11	101447564	101455564	101453662	8000	101451564	-4000	4000	2098
chr11	94177968	94185968	94180805	8000	94181968	-4000	4000	-1163
chr11	56227282	56235282	56232120	8000	56231282	-4000	4000	838
chr11	58212084	58220084	58215128	8000	58216084	-4000	4000	-956
chr11	63307783	63315783	63311301	8000	63311783	-4000	4000	-482
chr11	110573042	110581042	110580135	8000	110577042	-4000	4000	3093
chr11	124535635	124543635	124542815	8000	124539635	-4000	4000	3180
chr11	119334942	119342942	119342680	8000	119338942	-4000	4000	3738
chr11	66586176	66594176	66591573	8000	66590176	-4000	4000	1397
chr11	128809267	128817267	128811093	8000	128813267	-4000	4000	-2174
chr11	128832315	128840315	128839453	8000	128836315	-4000	4000	3138
chr11	5995445	6003445	6003107	8000	5999445	-4000	4000	3662
chr11	6842636	6850636	6846586	8000	6846636	-4000	4000	-50
chr11	78012971	78020971	78017072	8000	78016971	-4000	4000	101
chr11	124419942	124427942	124424729	8000	124423942	-4000	4000	787
chr11	56103658	56111658	56105110	8000	56107658	-4000	4000	-2548
chr11	62664496	62672496	62667762	8000	62668496	-4000	4000	-734
chr11	59204588	59212588	59210704	8000	59208588	-4000	4000	2116
chr11	102707796	102715796	102715313	8000	102711796	-4000	4000	3517
chr11	2924273	2932273	2925052	8000	2928273	-4000	4000	-3221
chr11	3634512	3642512	3638804	8000	3638512	-4000	4000	292
chr11	4542144	4550144	4545987	8000	4546144	-4000	4000	-157
chr11	4591013	4599013	4594197	8000	4595013	-4000	4000	-816
chr11	4988431	4996431	4989826	8000	4992431	-4000	4000	-2605
chr11	5124776	5132776	5132245	8000	5128776	-4000	4000	3469
chr11	5836928	5844928	5841579	8000	5840928	-4000	4000	651
chr11	5947347	5955347	5947870	8000	5951347	-4000	4000	-3477
chr11	6427049	6435049	6431254	8000	6431049	-4000	4000	205
chr11	6608768	6616768	6615315	8000	6612768	-4000	4000	2547
chr11	6617330	6625330	6623482	8000	6621330	-4000	4000	2152
chr11	6917994	6925994	6921207	8000	6921994	-4000	4000	-787
chr11	6997004	7005004	7000693	8000	7001004	-4000	4000	-311
chr11	6997004	7005004	7001505	8000	7001004	-4000	4000	501
chr11	7507377	7515377	7509974	8000	7511377	-4000	4000	-1403
chr11	7791974	7799974	7796185	8000	7795974	-4000	4000	211
chr11	7933171	7941171	7939513	8000	7937171	-4000	4000	2342
chr11	8976576	8984576	8983904	8000	8980576	-4000	4000	3328
chr11	9444127	9452127	9445096	8000	9448127	-4000	4000	-3031
chr11	14500874	14508874	14507722	8000	14504874	-4000	4000	2848
chr11	17388498	17396498	17395173	8000	17392498	-4000	4000	2675
chr11	17489895	17497895	17496804	8000	17493895	-4000	4000	2909
chr11	18134488	18142488	18137755	8000	18138488	-4000	4000	-733
chr11	18227423	18235423	18231526	8000	18231423	-4000	4000	103
chr11	19050455	19058455	19056323	8000	19054455	-4000	4000	1868
chr11	31786324	31794324	31794105	8000	31790324	-4000	4000	3781
chr11	34474791	34482791	34480143	8000	34478791	-4000	4000	1352
chr11	40110203	40118203	40115327	8000	40114203	-4000	4000	1124
chr11	47326031	47334031	47332253	8000	47330031	-4000	4000	2222
chr11	55267114	55275114	55270915	8000	55271114	-4000	4000	-199
chr11	55364918	55372918	55368231	8000	55368918	-4000	4000	-687
chr11	55551419	55559419	55554739	8000	55555419	-4000	4000	-680
chr11	55551419	55559419	55555221	8000	55555419	-4000	4000	-198
chr11	55648854	55656854	55650956	8000	55652854	-4000	4000	-1898
chr11	55792500	55800500	55796250	8000	55796500	-4000	4000	-250
chr11	55808476	55816476	55812344	8000	55812476	-4000	4000	-132
chr11	55961755	55969755	55968377	8000	55965755	-4000	4000	2622
chr11	55989681	55997681	55994356	8000	55993681	-4000	4000	675
chr11	56090240	56098240	56093406	8000	56094240	-4000	4000	-834
chr11	56103658	56111658	56105505	8000	56107658	-4000	4000	-2153
chr11	56119311	56127311	56123258	8000	56123311	-4000	4000	-53
chr11	56173556	56181556	56176899	8000	56177556	-4000	4000	-657
chr11	56249222	56257222	56252447	8000	56253222	-4000	4000	-775
chr11	56272819	56280819	56275766	8000	56276819	-4000	4000	-1053
chr11	56272819	56280819	56275844	8000	56276819	-4000	4000	-975
chr11	56284462	56292462	56290543	8000	56288462	-4000	4000	2081
chr11	56284462	56292462	56290697	8000	56288462	-4000	4000	2235
chr11	56316639	56324639	56318342	8000	56320639	-4000	4000	-2297
chr11	56316639	56324639	56318773	8000	56320639	-4000	4000	-1866
chr11	56342998	56350998	56346885	8000	56346998	-4000	4000	-113
chr11	56357511	56365511	56360758	8000	56361511	-4000	4000	-753
chr11	56605236	56613236	56612831	8000	56609236	-4000	4000	3595
chr11	56985843	56993843	56988949	8000	56989843	-4000	4000	-894
chr11	58177616	58185616	58180265	8000	58181616	-4000	4000	-1351
chr11	58212084	58220084	58215250	8000	58216084	-4000	4000	-834
chr11	59123412	59131412	59124410	8000	59127412	-4000	4000	-3002
chr11	59151039	59159039	59152696	8000	59155039	-4000	4000	-2343
chr11	59204588	59212588	59211802	8000	59208588	-4000	4000	3214
chr11	59475361	59483361	59478089	8000	59479361	-4000	4000	-1272
chr11	59632716	59640716	59638266	8000	59636716	-4000	4000	1550
chr11	61016377	61024377	61019330	8000	61020377	-4000	4000	-1047
chr11	61295451	61303451	61302267	8000	61299451	-4000	4000	2816
chr11	61394866	61402866	61398353	8000	61398866	-4000	4000	-513
chr11	65353613	65361613	65357182	8000	65357613	-4000	4000	-431
chr11	65793214	65801214	65795278	8000	65797214	-4000	4000	-1936
chr11	65887635	65895635	65887698	8000	65891635	-4000	4000	-3937
chr11	66009505	66017505	66017087	8000	66013505	-4000	4000	3582
chr11	66559464	66567464	66560668	8000	66563464	-4000	4000	-2796
chr11	71524669	71532669	71527548	8000	71528669	-4000	4000	-1121
chr11	71577855	71585855	71582308	8000	71581855	-4000	4000	453
chr11	72572141	72580141	72578909	8000	72576141	-4000	4000	2768
chr11	75582918	75590918	75587491	8000	75586918	-4000	4000	573
chr11	78012971	78020971	78016685	8000	78016971	-4000	4000	-286
chr11	78012971	78020971	78017021	8000	78016971	-4000	4000	50
chr11	85632539	85640539	85634146	8000	85636539	-4000	4000	-2393
chr11	85632539	85640539	85635786	8000	85636539	-4000	4000	-753
chr11	86274813	86282813	86277077	8000	86278813	-4000	4000	-1736
chr11	89713872	89721872	89717428	8000	89717872	-4000	4000	-444
chr11	94373316	94381316	94380071	8000	94377316	-4000	4000	2755
chr11	95067225	95075225	95067789	8000	95071225	-4000	4000	-3436
chr11	102831801	102839801	102838589	8000	102835801	-4000	4000	2788
chr11	106047098	106055098	106053614	8000	106051098	-4000	4000	2516
chr11	110573042	110581042	110579343	8000	110577042	-4000	4000	2301
chr11	112189805	112197805	112193481	8000	112193805	-4000	4000	-324
chr11	116785367	116793367	116790147	8000	116789367	-4000	4000	780
chr11	116816700	116824700	116821630	8000	116820700	-4000	4000	930
chr11	119309926	119317926	119310441	8000	119313926	-4000	4000	-3485
chr11	119309926	119317926	119312300	8000	119313926	-4000	4000	-1626
chr11	120329686	120337686	120330440	8000	120333686	-4000	4000	-3246
chr11	123801408	123809408	123805828	8000	123805408	-4000	4000	420
chr11	123972661	123980661	123977449	8000	123976661	-4000	4000	788
chr11	124262224	124270224	124265548	8000	124266224	-4000	4000	-676
chr11	125672255	125680255	125672621	8000	125676255	-4000	4000	-3634
chr11	125745867	125753867	125748956	8000	125749867	-4000	4000	-911
chr11	5250392	5258392	5254340	8000	5254392	-4000	4000	-52
chr11	5995445	6003445	6003075	8000	5999445	-4000	4000	3630
chr11	30005730	30013730	30011206	8000	30009730	-4000	4000	1476
chr11	30005730	30013730	30011665	8000	30009730	-4000	4000	1935
chr11	47350860	47358860	47352630	8000	47354860	-4000	4000	-2230
chr11	78167249	78175249	78174479	8000	78171249	-4000	4000	3230
chr11	111904564	111912564	111910408	8000	111908564	-4000	4000	1844
chr11	6165355	6173355	6170018	8000	6169355	-4000	4000	663
chr11	110573042	110581042	110579213	8000	110577042	-4000	4000	2171
chr11	95972598	95980598	95979424	8000	95976598	-4000	4000	2826
chr11	292107	300107	294169	8000	296107	-4000	4000	-1938
chr11	86274813	86282813	86277185	8000	86278813	-4000	4000	-1628
chr11	116816700	116824700	116821373	8000	116820700	-4000	4000	673
chr11	122973570	122981570	122979302	8000	122977570	-4000	4000	1732
chr11	18602403	18610403	18610221	8000	18606403	-4000	4000	3818
chr11	90038025	90046025	90041220	8000	90042025	-4000	4000	-805
chr11	78167249	78175249	78173877	8000	78171249	-4000	4000	2628
chr11	32383775	32391775	32388338	8000	32387775	-4000	4000	563
chr11	86274813	86282813	86278533	8000	86278813	-4000	4000	-280
chr11	46739048	46747048	46744545	8000	46743048	-4000	4000	1497
chr11	123972661	123980661	123977617	8000	123976661	-4000	4000	956
chr11	124032013	124040013	124038903	8000	124036013	-4000	4000	2890
chr11	18265977	18273977	18266966	8000	18269977	-4000	4000	-3011
chr11	65208006	65216006	65211298	8000	65212006	-4000	4000	-708
chr11	123719914	123727914	123726020	8000	123723914	-4000	4000	2106
chr11	124879691	124887691	124887194	8000	124883691	-4000	4000	3503
chr11	59500511	59508511	59503745	8000	59504511	-4000	4000	-766
chr11	119020114	119028114	119020162	8000	119024114	-4000	4000	-3952
chr11	124014732	124022732	124016063	8000	124018732	-4000	4000	-2669
chr11	68150863	68158863	68156475	8000	68154863	-4000	4000	1612
chr11	134315564	134323564	134318877	8000	134319564	-4000	4000	-687
chr11	73996277	74004277	74003933	8000	74000277	-4000	4000	3656
chr11	75797535	75805535	75798288	8000	75801535	-4000	4000	-3247
chr11	63755892	63763892	63758182	8000	63759892	-4000	4000	-1710
chr11	9134825	9142825	9138975	8000	9138825	-4000	4000	150
chr11	18274668	18282668	18279859	8000	18278668	-4000	4000	1191
chr11	119180016	119188016	119185649	8000	119184016	-4000	4000	1633
chr11	30231261	30239261	30233994	8000	30235261	-4000	4000	-1267
chr11	40110203	40118203	40114846	8000	40114203	-4000	4000	643
chr11	28016619	28024619	28021223	8000	28020619	-4000	4000	604
chr11	102707796	102715796	102713358	8000	102711796	-4000	4000	1562
chr11	124535635	124543635	124543001	8000	124539635	-4000	4000	3366
chr11	248984	256984	252640	8000	252984	-4000	4000	-344
chr11	26993087	27001087	26994794	8000	26997087	-4000	4000	-2293
chr11	119309926	119317926	119310468	8000	119313926	-4000	4000	-3458
chr11	55636309	55644309	55638752	8000	55640309	-4000	4000	-1557
chr11	62904679	62912679	62910115	8000	62908679	-4000	4000	1436
chr11	34468060	34476060	34471408	8000	34472060	-4000	4000	-652
chr11	55792500	55800500	55796039	8000	55796500	-4000	4000	-461
chr11	60392596	60400596	60392779	8000	60396596	-4000	4000	-3817
chr11	76653524	76661524	76659647	8000	76657524	-4000	4000	2123
chr11	108143603	108151603	108146326	8000	108147603	-4000	4000	-1277
chr11	117816163	117824163	117820563	8000	117820163	-4000	4000	400
chr11	73966366	73974366	73969304	8000	73970366	-4000	4000	-1062
chr11	4651488	4659488	4653331	8000	4655488	-4000	4000	-2157
chr11	55824154	55832154	55827892	8000	55828154	-4000	4000	-262
chr11	49949419	49957419	49952723	8000	49953419	-4000	4000	-696
chr11	89713872	89721872	89717578	8000	89717872	-4000	4000	-294
chr11	86274813	86282813	86277170	8000	86278813	-4000	4000	-1643
chr11	9015476	9023476	9021083	8000	9019476	-4000	4000	1607
chr11	56486435	56494435	56490649	8000	56490435	-4000	4000	214
chr11	102080554	102088554	102081261	8000	102084554	-4000	4000	-3293
chr11	55887810	55895810	55891700	8000	55891810	-4000	4000	-110
chr11	105021443	105029443	105029145	8000	105025443	-4000	4000	3702
chr11	56413258	56421258	56418200	8000	56417258	-4000	4000	942
chr11	54599069	54607069	54603419	8000	54603069	-4000	4000	350
chr11	76345898	76353898	76351160	8000	76349898	-4000	4000	1262
chr11	118954559	118962559	118957644	8000	118958559	-4000	4000	-915
chr11	8933578	8941578	8937986	8000	8937578	-4000	4000	408
chr11	27123809	27131809	27127503	8000	27127809	-4000	4000	-306
chr11	55824154	55832154	55827929	8000	55828154	-4000	4000	-225
chr11	55824154	55832154	55827930	8000	55828154	-4000	4000	-224
chr11	106047098	106055098	106053292	8000	106051098	-4000	4000	2194
chr11	69767022	69775022	69773345	8000	69771022	-4000	4000	2323
chr11	128832315	128840315	128839124	8000	128836315	-4000	4000	2809
chr11	20152155	20160155	20159248	8000	20156155	-4000	4000	3093
chr11	66973009	66981009	66975623	8000	66977009	-4000	4000	-1386
chr11	65862441	65870441	65864790	8000	65866441	-4000	4000	-1651
chr11	26993087	27001087	26994820	8000	26997087	-4000	4000	-2267
chr11	5836928	5844928	5841632	8000	5840928	-4000	4000	704
chr11	56538340	56546340	56543118	8000	56542340	-4000	4000	778
chr11	7953537	7961537	7961165	8000	7957537	-4000	4000	3628
chr11	61961515	61969515	61962450	8000	61965515	-4000	4000	-3065
chr11	124419942	124427942	124424584	8000	124423942	-4000	4000	642
chr11	56103658	56111658	56105744	8000	56107658	-4000	4000	-1914
chr11	64602174	64610174	64607257	8000	64606174	-4000	4000	1083
chr11	5195735	5203735	5200317	8000	5199735	-4000	4000	582
chr11	5947347	5955347	5948115	8000	5951347	-4000	4000	-3232
chr11	6427049	6435049	6431914	8000	6431049	-4000	4000	865
chr11	20117601	20125601	20118264	8000	20121601	-4000	4000	-3337
chr11	47350860	47358860	47355439	8000	47354860	-4000	4000	579
chr11	49977473	49985473	49981656	8000	49981473	-4000	4000	183
chr11	57229577	57237577	57236763	8000	57233577	-4000	4000	3186
chr11	67421607	67429607	67424039	8000	67425607	-4000	4000	-1568
chr11	67638555	67646555	67642756	8000	67642555	-4000	4000	201
chr11	68936602	68944602	68936659	8000	68940602	-4000	4000	-3943
chr11	113945079	113953079	113946331	8000	113949079	-4000	4000	-2748
chr11	123936573	123944573	123943383	8000	123940573	-4000	4000	2810
chr11	124026634	124034634	124029966	8000	124030634	-4000	4000	-668
chr11	124616356	124624356	124619420	8000	124620356	-4000	4000	-936
chr11	125438881	125446881	125446011	8000	125442881	-4000	4000	3130
chr11	56413258	56421258	56417339	8000	56417258	-4000	4000	81
chr11	58212084	58220084	58215554	8000	58216084	-4000	4000	-530
chr11	65169244	65177244	65175447	8000	65173244	-4000	4000	2203
chr11	59453905	59461905	59457676	8000	59457905	-4000	4000	-229
chr11	124014732	124022732	124016257	8000	124018732	-4000	4000	-2475
chr11	18170280	18178280	18173869	8000	18174280	-4000	4000	-411
chr11	86948910	86956910	86951424	8000	86952910	-4000	4000	-1486
chr11	119309926	119317926	119314552	8000	119313926	-4000	4000	626
chr11	6617330	6625330	6623776	8000	6621330	-4000	4000	2446
chr11	123053489	123061489	123061117	8000	123057489	-4000	4000	3628
chr11	82818936	82826936	82825006	8000	82822936	-4000	4000	2070
chr11	211030	219030	216640	8000	215030	-4000	4000	1610
chr11	56985843	56993843	56988973	8000	56989843	-4000	4000	-870
chr11	62664496	62672496	62667756	8000	62668496	-4000	4000	-740
chr11	124378394	124386394	124382850	8000	124382394	-4000	4000	456
chr11	2155779	2163779	2159821	8000	2159779	-4000	4000	42
chr11	58177616	58185616	58179817	8000	58181616	-4000	4000	-1799
chr11	93726358	93734358	93729905	8000	93730358	-4000	4000	-453
chr11	7953537	7961537	7960781	8000	7957537	-4000	4000	3244
chr11	56119311	56127311	56123001	8000	56123311	-4000	4000	-310
chr11	66586176	66594176	66591330	8000	66590176	-4000	4000	1154
chr11	110573042	110581042	110580920	8000	110577042	-4000	4000	3878
chr11	3822978	3830978	3824901	8000	3826978	-4000	4000	-2077
chr11	5836928	5844928	5841190	8000	5840928	-4000	4000	262
chr11	10503579	10511579	10506556	8000	10507579	-4000	4000	-1023
chr11	65353613	65361613	65355892	8000	65357613	-4000	4000	-1721
chr11	65353613	65361613	65357192	8000	65357613	-4000	4000	-421
chr11	110460884	110468884	110462526	8000	110464884	-4000	4000	-2358
chr11	55835738	55843738	55839633	8000	55839738	-4000	4000	-105
chr11	56605236	56613236	56612952	8000	56609236	-4000	4000	3716
chr11	56660618	56668618	56664611	8000	56664618	-4000	4000	-7
chr11	58830065	58838065	58837048	8000	58834065	-4000	4000	2983
chr11	94373316	94381316	94380459	8000	94377316	-4000	4000	3143
chr11	124014732	124022732	124016013	8000	124018732	-4000	4000	-2719
chr11	5883079	5891079	5884376	8000	5887079	-4000	4000	-2703
chr11	6917994	6925994	6921717	8000	6921994	-4000	4000	-277
chr11	55569060	55577060	55572876	8000	55573060	-4000	4000	-184
chr11	56486435	56494435	56491163	8000	56490435	-4000	4000	728
chr11	62240812	62248812	62242349	8000	62244812	-4000	4000	-2463
chr11	64219891	64227891	64223484	8000	64223891	-4000	4000	-407
chr11	64296031	64304031	64300374	8000	64300031	-4000	4000	343
chr11	66009505	66017505	66016848	8000	66013505	-4000	4000	3343
chr11	77318017	77326017	77325335	8000	77322017	-4000	4000	3318
chr11	122973570	122981570	122979385	8000	122977570	-4000	4000	1815
chr11	5043461	5051461	5047294	8000	5047461	-4000	4000	-167
chr11	47585194	47593194	47589935	8000	47589194	-4000	4000	741
chr11	66310494	66318494	66314996	8000	66314494	-4000	4000	502
chr11	66422707	66430707	66426181	8000	66426707	-4000	4000	-526
chr11	119089834	119097834	119097056	8000	119093834	-4000	4000	3222
chr11	56372553	56380553	56376192	8000	56376553	-4000	4000	-361
chr11	294200	302200	299390	8000	298200	-4000	4000	1190
chr11	3213944	3221944	3218738	8000	3217944	-4000	4000	794
chr11	7087148	7095148	7089295	8000	7091148	-4000	4000	-1853
chr11	76140232	76148232	76140956	8000	76144232	-4000	4000	-3276
chr11	56342998	56350998	56346608	8000	56346998	-4000	4000	-390
chr11	124032013	124040013	124038748	8000	124036013	-4000	4000	2735
chr11	48213739	48221739	48217184	8000	48217739	-4000	4000	-555
chr11	130206362	130214362	130208501	8000	130210362	-4000	4000	-1861
chr11	47327406	47335406	47335107	8000	47331406	-4000	4000	3701
chr11	65887635	65895635	65888358	8000	65891635	-4000	4000	-3277
chr11	94495578	94503578	94498376	8000	94499578	-4000	4000	-1202
chr11	55816571	55824571	55819891	8000	55820571	-4000	4000	-680
chr11	55835738	55843738	55839691	8000	55839738	-4000	4000	-47
chr11	1106511	1114511	1108035	8000	1110511	-4000	4000	-2476
chr11	18929499	18937499	18934269	8000	18933499	-4000	4000	770
chr11	56227282	56235282	56232289	8000	56231282	-4000	4000	1007
chr11	65169244	65177244	65171461	8000	65173244	-4000	4000	-1783
chr11	66559464	66567464	66560694	8000	66563464	-4000	4000	-2770
chr11	68976021	68984021	68980619	8000	68980021	-4000	4000	598
chr11	117200337	117208337	117204317	8000	117204337	-4000	4000	-20
chr11	18134488	18142488	18137925	8000	18138488	-4000	4000	-563
chr11	5195735	5203735	5199983	8000	5199735	-4000	4000	248
chr11	14873440	14881440	14880139	8000	14877440	-4000	4000	2699
chr11	18602403	18610403	18609596	8000	18606403	-4000	4000	3193
chr11	45643689	45651689	45650182	8000	45647689	-4000	4000	2493
chr11	95023596	95031596	95025810	8000	95027596	-4000	4000	-1786
chr11	6207135	6215135	6211667	8000	6211135	-4000	4000	532
chr11	6997004	7005004	7000130	8000	7001004	-4000	4000	-874
chr11	94177968	94185968	94180110	8000	94181968	-4000	4000	-1858
chr11	49977473	49985473	49981921	8000	49981473	-4000	4000	448
chr11	119077972	119085972	119078171	8000	119081972	-4000	4000	-3801
chr11	48303152	48311152	48307120	8000	48307152	-4000	4000	-32
chr11	86948910	86956910	86952420	8000	86952910	-4000	4000	-490
chr11	3634512	3642512	3640101	8000	3638512	-4000	4000	1589
chr11	6997004	7005004	6999937	8000	7001004	-4000	4000	-1067
chr11	9015476	9023476	9021034	8000	9019476	-4000	4000	1558
chr11	122111340	122119340	122116144	8000	122115340	-4000	4000	804
chr11	47585194	47593194	47586802	8000	47589194	-4000	4000	-2392
chr11	48213739	48221739	48217350	8000	48217739	-4000	4000	-389
chr11	48260778	48268778	48264548	8000	48264778	-4000	4000	-230
chr11	78167249	78175249	78174176	8000	78171249	-4000	4000	2927
chr11	56637489	56645489	56641641	8000	56641489	-4000	4000	152
chr11	119089834	119097834	119097285	8000	119093834	-4000	4000	3451
chr11	56372553	56380553	56376244	8000	56376553	-4000	4000	-309
chr11	64296031	64304031	64297154	8000	64300031	-4000	4000	-2877
chr11	68936602	68944602	68939561	8000	68940602	-4000	4000	-1041
chr11	2924273	2932273	2925196	8000	2928273	-4000	4000	-3077
chr11	49949419	49957419	49952785	8000	49953419	-4000	4000	-634
chr11	55770382	55778382	55773496	8000	55774382	-4000	4000	-886
chr11	62429542	62437542	62433746	8000	62433542	-4000	4000	204
chr11	66559464	66567464	66560665	8000	66563464	-4000	4000	-2799
chr11	68025282	68033282	68026077	8000	68029282	-4000	4000	-3205
chr11	94110208	94118208	94112404	8000	94114208	-4000	4000	-1804
chr11	112060404	112068404	112064242	8000	112064404	-4000	4000	-162
chr11	128832315	128840315	128839091	8000	128836315	-4000	4000	2776
chr11	5228678	5236678	5234201	8000	5232678	-4000	4000	1523
chr11	5883079	5891079	5884928	8000	5887079	-4000	4000	-2151
chr11	33073188	33081188	33081121	8000	33077188	-4000	4000	3933
chr11	58199202	58207202	58204107	8000	58203202	-4000	4000	905
chr11	67487154	67495154	67495131	8000	67491154	-4000	4000	3977
chr11	3634512	3642512	3641902	8000	3638512	-4000	4000	3390
chr11	40110203	40118203	40115718	8000	40114203	-4000	4000	1515
chr11	126198096	126206096	126205583	8000	126202096	-4000	4000	3487
chr11	55648854	55656854	55651098	8000	55652854	-4000	4000	-1756
chr11	64760606	64768606	64767620	8000	64764606	-4000	4000	3014
chr11	118395211	118403211	118401583	8000	118399211	-4000	4000	2372
chr11	47350860	47358860	47351464	8000	47354860	-4000	4000	-3396
chr11	57547656	57555656	57552337	8000	57551656	-4000	4000	681
chr11	62209943	62217943	62210416	8000	62213943	-4000	4000	-3527
chr11	54703902	54711902	54707243	8000	54707902	-4000	4000	-659
chr11	56538340	56546340	56542768	8000	56542340	-4000	4000	428
chr11	94110208	94118208	94110961	8000	94114208	-4000	4000	-3247
chr11	121187490	121195490	121189809	8000	121191490	-4000	4000	-1681
chr11	123936573	123944573	123943447	8000	123940573	-4000	4000	2874
chr11	4988431	4996431	4989833	8000	4992431	-4000	4000	-2598
chr11	66973009	66981009	66975379	8000	66977009	-4000	4000	-1630
chr11	75582918	75590918	75587859	8000	75586918	-4000	4000	941
chr11	54703902	54711902	54707609	8000	54707902	-4000	4000	-293
chr11	55824154	55832154	55827449	8000	55828154	-4000	4000	-705
chr11	18170280	18178280	18173675	8000	18174280	-4000	4000	-605
chr11	57699710	57707710	57704071	8000	57703710	-4000	4000	361
chr11	27490418	27498418	27497000	8000	27494418	-4000	4000	2582
chr11	117896641	117904641	117903737	8000	117900641	-4000	4000	3096
chr11	4446361	4454361	4450089	8000	4450361	-4000	4000	-272
chr11	48260778	48268778	48264541	8000	48264778	-4000	4000	-237
chr11	8220309	8228309	8224523	8000	8224309	-4000	4000	214
chr11	101447564	101455564	101455102	8000	101451564	-4000	4000	3538
chr11	6873619	6881619	6876971	8000	6877619	-4000	4000	-648
chr11	94995519	95003519	94998583	8000	94999519	-4000	4000	-936
chr11	20152155	20160155	20156448	8000	20156155	-4000	4000	293
chr11	18700312	18708312	18701783	8000	18704312	-4000	4000	-2529
chr11	7933171	7941171	7939078	8000	7937171	-4000	4000	1907
chr11	62788123	62796123	62794941	8000	62792123	-4000	4000	2818
chr11	59204588	59212588	59211180	8000	59208588	-4000	4000	2592
chr11	100989941	100997941	100992204	8000	100993941	-4000	4000	-1737
chr11	123936573	123944573	123943704	8000	123940573	-4000	4000	3131
chr11	5817483	5825483	5820732	8000	5821483	-4000	4000	-751
chr11	7933171	7941171	7938717	8000	7937171	-4000	4000	1546
chr11	67514912	67522912	67519887	8000	67518912	-4000	4000	975
chr11	67658160	67666160	67664507	8000	67662160	-4000	4000	2347
chr11	110573042	110581042	110579711	8000	110577042	-4000	4000	2669
chr11	2314204	2322204	2316270	8000	2318204	-4000	4000	-1934
chr11	5043461	5051461	5047210	8000	5047461	-4000	4000	-251
chr11	5043461	5051461	5046927	8000	5047461	-4000	4000	-534
chr11	123801408	123809408	123806030	8000	123805408	-4000	4000	622
chr11	124014732	124022732	124016111	8000	124018732	-4000	4000	-2621
chr11	70432584	70440584	70433686	8000	70436584	-4000	4000	-2898
chr11	77037973	77045973	77040670	8000	77041973	-4000	4000	-1303
chr11	102707796	102715796	102714558	8000	102711796	-4000	4000	2762
chr11	75582918	75590918	75587371	8000	75586918	-4000	4000	453
chr11	123936573	123944573	123943189	8000	123940573	-4000	4000	2616
chr11	6165355	6173355	6169486	8000	6169355	-4000	4000	131
chr11	6917994	6925994	6921851	8000	6921994	-4000	4000	-143
chr11	55792500	55800500	55795626	8000	55796500	-4000	4000	-874
chr11	315676	323676	319891	8000	319676	-4000	4000	215
chr11	48321955	48329955	48325119	8000	48325955	-4000	4000	-836
chr11	55770382	55778382	55774120	8000	55774382	-4000	4000	-262
chr11	6427049	6435049	6431122	8000	6431049	-4000	4000	73
chr11	5250392	5258392	5254397	8000	5254392	-4000	4000	5
chr11	56699884	56707884	56701040	8000	56703884	-4000	4000	-2844
chr11	112081150	112089150	112082735	8000	112085150	-4000	4000	-2415
chr11	1626707	1634707	1630700	8000	1630707	-4000	4000	-7
chr11	123749580	123757580	123753610	8000	123753580	-4000	4000	30
chr11	83183451	83191451	83184963	8000	83187451	-4000	4000	-2488
chr11	61247444	61255444	61249926	8000	61251444	-4000	4000	-1518
chr11	66326241	66334241	66332383	8000	66330241	-4000	4000	2142
chr11	75582918	75590918	75587036	8000	75586918	-4000	4000	118
chr11	20505338	20513338	20508354	8000	20509338	-4000	4000	-984
chr11	56316639	56324639	56318651	8000	56320639	-4000	4000	-1988
chr11	3667083	3675083	3669347	8000	3671083	-4000	4000	-1736
chr11	4446361	4454361	4449822	8000	4450361	-4000	4000	-539
chr11	7920592	7928592	7927822	8000	7924592	-4000	4000	3230
chr11	20117601	20125601	20118195	8000	20121601	-4000	4000	-3406
chr11	89713872	89721872	89715966	8000	89717872	-4000	4000	-1906
chr11	6608768	6616768	6614903	8000	6612768	-4000	4000	2135
chr11	106047098	106055098	106052130	8000	106051098	-4000	4000	1032
chr11	11957887	11965887	11964652	8000	11961887	-4000	4000	2765
chr11	111282401	111290401	111285832	8000	111286401	-4000	4000	-569
chr11	22375503	22383503	22376082	8000	22379503	-4000	4000	-3421
chr11	54703902	54711902	54707196	8000	54707902	-4000	4000	-706
chr11	57321986	57329986	57326436	8000	57325986	-4000	4000	450
chr11	123905229	123913229	123906486	8000	123909229	-4000	4000	-2743
chr11	56316639	56324639	56318338	8000	56320639	-4000	4000	-2301
chr11	4676171	4684171	4681776	8000	4680171	-4000	4000	1605
chr11	7507377	7515377	7510345	8000	7511377	-4000	4000	-1032
chr11	13383266	13391266	13386660	8000	13387266	-4000	4000	-606
chr11	27650893	27658893	27657931	8000	27654893	-4000	4000	3038
chr11	45643689	45651689	45649825	8000	45647689	-4000	4000	2136
chr11	55662195	55670195	55665847	8000	55666195	-4000	4000	-348
chr11	55792500	55800500	55795974	8000	55796500	-4000	4000	-526
chr11	55835738	55843738	55838927	8000	55839738	-4000	4000	-811
chr11	56605236	56613236	56612569	8000	56609236	-4000	4000	3333
chr11	58199202	58207202	58204017	8000	58203202	-4000	4000	815
chr11	61254286	61262286	61258918	8000	61258286	-4000	4000	632
chr11	76549025	76557025	76550069	8000	76553025	-4000	4000	-2956
chr11	110460884	110468884	110462360	8000	110464884	-4000	4000	-2524
chr11	119077972	119085972	119079182	8000	119081972	-4000	4000	-2790
chr11	124026634	124034634	124030336	8000	124030634	-4000	4000	-298
chr11	126198096	126206096	126205494	8000	126202096	-4000	4000	3398
chr11	7791974	7799974	7796894	8000	7795974	-4000	4000	920
chr11	60392596	60400596	60400433	8000	60396596	-4000	4000	3837
chr11	113274436	113282436	113275327	8000	113278436	-4000	4000	-3109
chr11	113793874	113801874	113801533	8000	113797874	-4000	4000	3659
chr11	72572141	72580141	72576629	8000	72576141	-4000	4000	488
chr11	56538340	56546340	56543239	8000	56542340	-4000	4000	899
chr11	56699884	56707884	56701301	8000	56703884	-4000	4000	-2583
chr11	57383365	57391365	57387785	8000	57387365	-4000	4000	420
chr11	61863354	61871354	61863742	8000	61867354	-4000	4000	-3612
chr11	4651488	4659488	4652523	8000	4655488	-4000	4000	-2965
chr11	59151039	59159039	59153187	8000	59155039	-4000	4000	-1852
chr11	66310494	66318494	66314759	8000	66314494	-4000	4000	265
chr11	73393474	73401474	73395274	8000	73397474	-4000	4000	-2200
chr11	73393474	73401474	73395275	8000	73397474	-4000	4000	-2199
chr11	67623938	67631938	67628258	8000	67627938	-4000	4000	320
chr11	2314204	2322204	2317875	8000	2318204	-4000	4000	-329
chr11	30231261	30239261	30233848	8000	30235261	-4000	4000	-1413
chr11	55808476	55816476	55811748	8000	55812476	-4000	4000	-728
chr11	57229577	57237577	57236636	8000	57233577	-4000	4000	3059
chr11	86948910	86956910	86951284	8000	86952910	-4000	4000	-1626
chr11	93434487	93442487	93437552	8000	93438487	-4000	4000	-935
chr11	119351215	119359215	119358049	8000	119355215	-4000	4000	2834
chr11	123053489	123061489	123061153	8000	123057489	-4000	4000	3664
chr11	123749580	123757580	123754207	8000	123753580	-4000	4000	627
chr11	56737223	56745223	56743182	8000	56741223	-4000	4000	1959
chr11	59123412	59131412	59126044	8000	59127412	-4000	4000	-1368
chr11	18134488	18142488	18137303	8000	18138488	-4000	4000	-1185
chr11	55808476	55816476	55812023	8000	55812476	-4000	4000	-453
chr11	6873619	6881619	6876858	8000	6877619	-4000	4000	-761
chr11	43490933	43498933	43493926	8000	43494933	-4000	4000	-1007
chr11	85953175	85961175	85958802	8000	85957175	-4000	4000	1627
chr11	102831801	102839801	102836021	8000	102835801	-4000	4000	220
chr12	129067725	129075725	129074679	8000	129071725	-4000	4000	2954
chr12	21760955	21768955	21766289	8000	21764955	-4000	4000	1334
chr12	49640666	49648666	49644213	8000	49644666	-4000	4000	-453
chr12	56034435	56042435	56034996	8000	56038435	-4000	4000	-3439
chr12	8937467	8945467	8942416	8000	8941467	-4000	4000	949
chr12	122710756	122718756	122716431	8000	122714756	-4000	4000	1675
chr12	123931720	123939720	123932107	8000	123935720	-4000	4000	-3613
chr12	22059773	22067773	22062363	8000	22063773	-4000	4000	-1410
chr12	65962291	65970291	65965275	8000	65966291	-4000	4000	-1016
chr12	95511839	95519839	95513720	8000	95515839	-4000	4000	-2119
chr12	132192372	132200372	132197073	8000	132196372	-4000	4000	701
chr12	7685784	7693784	7690655	8000	7689784	-4000	4000	871
chr12	52581589	52589589	52587718	8000	52585589	-4000	4000	2129
chr12	52073495	52081495	52073851	8000	52077495	-4000	4000	-3644
chr12	105070197	105078197	105070627	8000	105074197	-4000	4000	-3570
chr12	106974778	106982778	106978030	8000	106978778	-4000	4000	-748
chr12	132581188	132589188	132581451	8000	132585188	-4000	4000	-3737
chr12	6816799	6824799	6819381	8000	6820799	-4000	4000	-1418
chr12	6835847	6843847	6839602	8000	6839847	-4000	4000	-245
chr12	7645400	7653400	7652481	8000	7649400	-4000	4000	3081
chr12	7685784	7693784	7689818	8000	7689784	-4000	4000	34
chr12	8171320	8179320	8175944	8000	8175320	-4000	4000	624
chr12	44385762	44393762	44388556	8000	44389762	-4000	4000	-1206
chr12	48469622	48477622	48472889	8000	48473622	-4000	4000	-733
chr12	71694968	71702968	71700922	8000	71698968	-4000	4000	1954
chr12	122710756	122718756	122716655	8000	122714756	-4000	4000	1899
chr12	49328409	49336409	49330241	8000	49332409	-4000	4000	-2168
chr12	53098345	53106345	53100845	8000	53102345	-4000	4000	-1500
chr12	130368637	130376637	130371503	8000	130372637	-4000	4000	-1134
chr12	52670736	52678736	52678549	8000	52674736	-4000	4000	3813
chr12	70634073	70642073	70635853	8000	70638073	-4000	4000	-2220
chr12	907452	915452	913131	8000	911452	-4000	4000	1679
chr12	52640558	52648558	52648272	8000	52644558	-4000	4000	3714
chr12	6816799	6824799	6824716	8000	6820799	-4000	4000	3917
chr12	53098345	53106345	53102213	8000	53102345	-4000	4000	-132
chr12	98609405	98617405	98614033	8000	98613405	-4000	4000	628
chr12	55449347	55457347	55453152	8000	55453347	-4000	4000	-195
chr12	55950105	55958105	55954206	8000	55954105	-4000	4000	101
chr12	71121085	71129085	71125193	8000	71125085	-4000	4000	108
chr12	113007723	113015723	113010335	8000	113011723	-4000	4000	-1388
chr12	50928510	50936510	50930059	8000	50932510	-4000	4000	-2451
chr12	52389931	52397931	52396936	8000	52393931	-4000	4000	3005
chr12	56356568	56364568	56362022	8000	56360568	-4000	4000	1454
chr12	56356568	56364568	56362761	8000	56360568	-4000	4000	2193
chr12	7713559	7721559	7715401	8000	7717559	-4000	4000	-2158
chr12	109979841	109987841	109983472	8000	109983841	-4000	4000	-369
chr12	53153663	53161663	53158595	8000	53157663	-4000	4000	932
chr12	45904040	45912040	45907498	8000	45908040	-4000	4000	-542
chr12	123616943	123624943	123618748	8000	123620943	-4000	4000	-2195
chr12	10820960	10828960	10825808	8000	10824960	-4000	4000	848
chr12	52539909	52547909	52546481	8000	52543909	-4000	4000	2572
chr12	53427672	53435672	53431424	8000	53431672	-4000	4000	-248
chr12	89584049	89592049	89591266	8000	89588049	-4000	4000	3217
chr12	95964720	95972720	95966457	8000	95968720	-4000	4000	-2263
chr12	116572606	116580606	116575909	8000	116576606	-4000	4000	-697
chr12	48143789	48151789	48145095	8000	48147789	-4000	4000	-2694
chr12	6835847	6843847	6843022	8000	6839847	-4000	4000	3175
chr12	52055507	52063507	52057414	8000	52059507	-4000	4000	-2093
chr12	55026017	55034017	55029705	8000	55030017	-4000	4000	-312
chr12	53187323	53195323	53193803	8000	53191323	-4000	4000	2480
chr12	100199669	100207669	100201060	8000	100203669	-4000	4000	-2609
chr12	52640558	52648558	52646766	8000	52644558	-4000	4000	2208
chr12	89343235	89351235	89349395	8000	89347235	-4000	4000	2160
chr12	114349911	114357911	114355672	8000	114353911	-4000	4000	1761
chr12	41570745	41578745	41573540	8000	41574745	-4000	4000	-1205
chr12	50171788	50179788	50177679	8000	50175788	-4000	4000	1891
chr12	76340474	76348474	76348374	8000	76344474	-4000	4000	3900
chr12	89415718	89423718	89420795	8000	89419718	-4000	4000	1077
chr12	121304245	121312245	121308584	8000	121308245	-4000	4000	339
chr12	53098345	53106345	53105212	8000	53102345	-4000	4000	2867
chr12	113094819	113102819	113096791	8000	113098819	-4000	4000	-2028
chr12	68150768	68158768	68157955	8000	68154768	-4000	4000	3187
chr12	20749386	20757386	20750686	8000	20753386	-4000	4000	-2700
chr12	6816799	6824799	6817239	8000	6820799	-4000	4000	-3560
chr12	27077057	27085057	27082315	8000	27081057	-4000	4000	1258
chr12	52483176	52491176	52487409	8000	52487176	-4000	4000	233
chr12	50744657	50752657	50744714	8000	50748657	-4000	4000	-3943
chr12	56994836	57002836	56996576	8000	56998836	-4000	4000	-2260
chr12	9748486	9756486	9753253	8000	9752486	-4000	4000	767
chr12	122722076	122730076	122729773	8000	122726076	-4000	4000	3697
chr12	7685784	7693784	7690152	8000	7689784	-4000	4000	368
chr12	10014796	10022796	10017858	8000	10018796	-4000	4000	-938
chr12	41570745	41578745	41572574	8000	41574745	-4000	4000	-2171
chr12	55289988	55297988	55295074	8000	55293988	-4000	4000	1086
chr12	56592193	56600193	56598941	8000	56596193	-4000	4000	2748
chr12	115953905	115961905	115958941	8000	115957905	-4000	4000	1036
chr12	133198369	133206369	133203806	8000	133202369	-4000	4000	1437
chr12	8093881	8101881	8096055	8000	8097881	-4000	4000	-1826
chr12	20749386	20757386	20750709	8000	20753386	-4000	4000	-2677
chr12	112022689	112030689	112029287	8000	112026689	-4000	4000	2598
chr12	84855491	84863491	84861179	8000	84859491	-4000	4000	1688
chr12	50883884	50891884	50887418	8000	50887884	-4000	4000	-466
chr12	120573588	120581588	120575837	8000	120577588	-4000	4000	-1751
chr12	11261914	11269914	11267965	8000	11265914	-4000	4000	2051
chr12	79769563	79777563	79774599	8000	79773563	-4000	4000	1036
chr12	123704399	123712399	123707025	8000	123708399	-4000	4000	-1374
chr12	55720705	55728705	55721305	8000	55724705	-4000	4000	-3400
chr12	56356568	56364568	56361737	8000	56360568	-4000	4000	1169
chr12	75499863	75507863	75501943	8000	75503863	-4000	4000	-1920
chr12	128703911	128711911	128705777	8000	128707911	-4000	4000	-2134
chr12	47968967	47976967	47973419	8000	47972967	-4000	4000	452
chr12	53206567	53214567	53211396	8000	53210567	-4000	4000	829
chr12	55397467	55405467	55400743	8000	55401467	-4000	4000	-724
chr12	52420070	52428070	52424352	8000	52424070	-4000	4000	282
chr12	55318364	55326364	55320715	8000	55322364	-4000	4000	-1649
chr12	54030888	54038888	54033103	8000	54034888	-4000	4000	-1785
chr12	15899478	15907478	15902921	8000	15903478	-4000	4000	-557
chr12	21467250	21475250	21471492	8000	21471250	-4000	4000	242
chr12	51056424	51064424	51064047	8000	51060424	-4000	4000	3623
chr12	57024517	57032517	57030214	8000	57028517	-4000	4000	1697
chr12	54391261	54399261	54398667	8000	54395261	-4000	4000	3406
chr12	5042788	5050788	5045015	8000	5046788	-4000	4000	-1773
chr12	61704273	61712273	61710218	8000	61708273	-4000	4000	1945
chr12	10062031	10070031	10065688	8000	10066031	-4000	4000	-343
chr12	6462517	6470517	6466382	8000	6466517	-4000	4000	-135
chr12	56634175	56642175	56638295	8000	56638175	-4000	4000	120
chr12	2937138	2945138	2939435	8000	2941138	-4000	4000	-1703
chr12	6462517	6470517	6463098	8000	6466517	-4000	4000	-3419
chr12	49640666	49648666	49643313	8000	49644666	-4000	4000	-1353
chr12	50171788	50179788	50177404	8000	50175788	-4000	4000	1616
chr12	52539909	52547909	52544721	8000	52543909	-4000	4000	812
chr12	54288111	54296111	54292441	8000	54292111	-4000	4000	330
chr12	70634073	70642073	70635710	8000	70638073	-4000	4000	-2363
chr12	114666255	114674255	114672124	8000	114670255	-4000	4000	1869
chr12	120309249	120317249	120313059	8000	120313249	-4000	4000	-190
chr12	123616943	123624943	123618759	8000	123620943	-4000	4000	-2184
chr12	123931720	123939720	123931760	8000	123935720	-4000	4000	-3960
chr12	54575239	54583239	54583229	8000	54579239	-4000	4000	3990
chr12	18735188	18743188	18737397	8000	18739188	-4000	4000	-1791
chr12	49093136	49101136	49097705	8000	49097136	-4000	4000	569
chr12	57743727	57751727	57745220	8000	57747727	-4000	4000	-2507
chr12	118028687	118036687	118034212	8000	118032687	-4000	4000	1525
chr12	122697293	122705293	122702198	8000	122701293	-4000	4000	905
chr12	55950105	55958105	55958061	8000	55954105	-4000	4000	3956
chr12	122499454	122507454	122500732	8000	122503454	-4000	4000	-2722
chr12	5042788	5050788	5044749	8000	5046788	-4000	4000	-2039
chr12	6342843	6350843	6348051	8000	6346843	-4000	4000	1208
chr12	6662477	6670477	6667572	8000	6666477	-4000	4000	1095
chr12	7085587	7093587	7090224	8000	7089587	-4000	4000	637
chr12	11261914	11269914	11267651	8000	11265914	-4000	4000	1737
chr12	44385762	44393762	44388679	8000	44389762	-4000	4000	-1083
chr12	47964878	47972878	47968257	8000	47968878	-4000	4000	-621
chr12	51089656	51097656	51095231	8000	51093656	-4000	4000	1575
chr12	55423192	55431192	55427034	8000	55427192	-4000	4000	-158
chr12	57599418	57607418	57607071	8000	57603418	-4000	4000	3653
chr12	84855491	84863491	84861576	8000	84859491	-4000	4000	2085
chr12	108518214	108526214	108519457	8000	108522214	-4000	4000	-2757
chr12	122697293	122705293	122702527	8000	122701293	-4000	4000	1234
chr12	122710756	122718756	122716828	8000	122714756	-4000	4000	2072
chr12	123931720	123939720	123935353	8000	123935720	-4000	4000	-367
chr12	52442651	52450651	52449579	8000	52446651	-4000	4000	2928
chr12	100418055	100426055	100420146	8000	100422055	-4000	4000	-1909
chr12	100624288	100632288	100624533	8000	100628288	-4000	4000	-3755
chr12	48198339	48206339	48203122	8000	48202339	-4000	4000	783
chr12	108284044	108292044	108291974	8000	108288044	-4000	4000	3930
chr12	68838197	68846197	68839349	8000	68842197	-4000	4000	-2848
chr12	26967579	26975579	26974162	8000	26971579	-4000	4000	2583
chr12	55217975	55225975	55221363	8000	55221975	-4000	4000	-612
chr12	56445700	56453700	56451166	8000	56449700	-4000	4000	1466
chr12	57209361	57217361	57209755	8000	57213361	-4000	4000	-3606
chr12	130161740	130169740	130164145	8000	130165740	-4000	4000	-1595
chr12	56994836	57002836	56995628	8000	56998836	-4000	4000	-3208
chr12	10820960	10828960	10825588	8000	10824960	-4000	4000	628
chr12	52833804	52841804	52839777	8000	52837804	-4000	4000	1973
chr12	9991694	9999694	9999038	8000	9995694	-4000	4000	3344
chr12	51993078	52001078	51995711	8000	51997078	-4000	4000	-1367
chr12	57024517	57032517	57028753	8000	57028517	-4000	4000	236
chr12	89415718	89423718	89420904	8000	89419718	-4000	4000	1186
chr12	102193520	102201520	102196391	8000	102197520	-4000	4000	-1129
chr12	52685626	52693626	52691193	8000	52689626	-4000	4000	1567
chr12	57582633	57590633	57583129	8000	57586633	-4000	4000	-3504
chr12	52483176	52491176	52490065	8000	52487176	-4000	4000	2889
chr12	108565368	108573368	108567388	8000	108569368	-4000	4000	-1980
chr12	120719640	120727640	120720021	8000	120723640	-4000	4000	-3619
chr12	123658604	123666604	123659878	8000	123662604	-4000	4000	-2726
chr12	53187323	53195323	53193838	8000	53191323	-4000	4000	2515
chr12	6462517	6470517	6466080	8000	6466517	-4000	4000	-437
chr12	6634075	6642075	6638965	8000	6638075	-4000	4000	890
chr12	10112777	10120777	10118390	8000	10116777	-4000	4000	1613
chr12	10187804	10195804	10190076	8000	10191804	-4000	4000	-1728
chr12	21467250	21475250	21474884	8000	21471250	-4000	4000	3634
chr12	21760955	21768955	21765644	8000	21764955	-4000	4000	689
chr12	31787185	31795185	31792022	8000	31791185	-4000	4000	837
chr12	42455715	42463715	42460477	8000	42459715	-4000	4000	762
chr12	52011889	52019889	52013715	8000	52015889	-4000	4000	-2174
chr12	52483176	52491176	52487805	8000	52487176	-4000	4000	629
chr12	52640558	52648558	52647807	8000	52644558	-4000	4000	3249
chr12	56109910	56117910	56117479	8000	56113910	-4000	4000	3569
chr12	57605804	57613804	57613422	8000	57609804	-4000	4000	3618
chr12	71694968	71702968	71696443	8000	71698968	-4000	4000	-2525
chr12	71694968	71702968	71697491	8000	71698968	-4000	4000	-1477
chr12	123931720	123939720	123937091	8000	123935720	-4000	4000	1371
chr12	129067725	129075725	129074796	8000	129071725	-4000	4000	3071
chr12	130161740	130169740	130164212	8000	130165740	-4000	4000	-1528
chr12	11387540	11395540	11393539	8000	11391540	-4000	4000	1999
chr12	100560414	100568414	100563491	8000	100564414	-4000	4000	-923
chr12	9748486	9756486	9754678	8000	9752486	-4000	4000	2192
chr12	53322575	53330575	53328237	8000	53326575	-4000	4000	1662
chr12	114349911	114357911	114355612	8000	114353911	-4000	4000	1701
chr12	118141584	118149584	118144679	8000	118145584	-4000	4000	-905
chr12	11261914	11269914	11267240	8000	11265914	-4000	4000	1326
chr12	18679169	18687169	18684268	8000	18683169	-4000	4000	1099
chr12	47232662	47240662	47235965	8000	47236662	-4000	4000	-697
chr12	56109910	56117910	56117508	8000	56113910	-4000	4000	3598
chr12	118028687	118036687	118033897	8000	118032687	-4000	4000	1210
chr12	40365285	40373285	40367140	8000	40369285	-4000	4000	-2145
chr12	57455280	57463280	57456634	8000	57459280	-4000	4000	-2646
chr12	103936763	103944763	103942628	8000	103940763	-4000	4000	1865
chr12	42455715	42463715	42459845	8000	42459715	-4000	4000	130
chr12	52640558	52648558	52648309	8000	52644558	-4000	4000	3751
chr12	120123202	120131202	120127916	8000	120127202	-4000	4000	714
chr12	8052844	8060844	8059715	8000	8056844	-4000	4000	2871
chr12	48038897	48046897	48044357	8000	48042897	-4000	4000	1460
chr12	120494493	120502493	120496100	8000	120498493	-4000	4000	-2393
chr12	122499454	122507454	122505292	8000	122503454	-4000	4000	1838
chr12	122499454	122507454	122505293	8000	122503454	-4000	4000	1839
chr12	4483735	4491735	4489844	8000	4487735	-4000	4000	2109
chr12	11181993	11189993	11186106	8000	11185993	-4000	4000	113
chr12	46354188	46362188	46361177	8000	46358188	-4000	4000	2989
chr12	55950105	55958105	55957110	8000	55954105	-4000	4000	3005
chr12	52420070	52428070	52424367	8000	52424070	-4000	4000	297
chr12	49640666	49648666	49641534	8000	49644666	-4000	4000	-3132
chr12	11387540	11395540	11393326	8000	11391540	-4000	4000	1786
chr12	51993078	52001078	51993987	8000	51997078	-4000	4000	-3091
chr12	109594125	109602125	109596553	8000	109598125	-4000	4000	-1572
chr12	120758510	120766510	120764873	8000	120762510	-4000	4000	2363
chr12	129067725	129075725	129074175	8000	129071725	-4000	4000	2450
chr12	132619753	132627753	132625744	8000	132623753	-4000	4000	1991
chr12	47968967	47976967	47974171	8000	47972967	-4000	4000	1204
chr12	21760955	21768955	21766217	8000	21764955	-4000	4000	1262
chr12	22059773	22067773	22061300	8000	22063773	-4000	4000	-2473
chr12	52510575	52518575	52516801	8000	52514575	-4000	4000	2226
chr12	57622125	57630125	57625715	8000	57626125	-4000	4000	-410
chr12	76340474	76348474	76347118	8000	76344474	-4000	4000	2644
chr12	110023028	110031028	110028230	8000	110027028	-4000	4000	1202
chr12	12913937	12921937	12915917	8000	12917937	-4000	4000	-2020
chr12	12913937	12921937	12915918	8000	12917937	-4000	4000	-2019
chr12	52670736	52678736	52676443	8000	52674736	-4000	4000	1707
chr12	108246537	108254537	108248251	8000	108250537	-4000	4000	-2286
chr12	54288111	54296111	54292991	8000	54292111	-4000	4000	880
chr12	55328687	55336687	55332208	8000	55332687	-4000	4000	-479
chr12	4556047	4564047	4559125	8000	4560047	-4000	4000	-922
chr12	88045016	88053016	88049204	8000	88049016	-4000	4000	188
chr12	113007723	113015723	113010027	8000	113011723	-4000	4000	-1696
chr12	45010672	45018672	45016336	8000	45014672	-4000	4000	1664
chr12	70430292	70438292	70430715	8000	70434292	-4000	4000	-3577
chr12	55449347	55457347	55453134	8000	55453347	-4000	4000	-213
chr12	10695089	10703089	10702085	8000	10699089	-4000	4000	2996
chr12	50079611	50087611	50082329	8000	50083611	-4000	4000	-1282
chr12	89584049	89592049	89590354	8000	89588049	-4000	4000	2305
chr12	100560414	100568414	100563401	8000	100564414	-4000	4000	-1013
chr12	8937467	8945467	8939739	8000	8941467	-4000	4000	-1728
chr12	48899503	48907503	48904317	8000	48903503	-4000	4000	814
chr12	49961682	49969682	49962318	8000	49965682	-4000	4000	-3364
chr12	49328409	49336409	49330869	8000	49332409	-4000	4000	-1540
chr12	12718369	12726369	12722241	8000	12722369	-4000	4000	-128
chr12	25104335	25112335	25107968	8000	25108335	-4000	4000	-367
chr12	83130870	83138870	83132383	8000	83134870	-4000	4000	-2487
chr12	54640589	54648589	54644697	8000	54644589	-4000	4000	108
chr12	39546033	39554033	39554019	8000	39550033	-4000	4000	3986
chr12	122499454	122507454	122500870	8000	122503454	-4000	4000	-2584
chr12	6342843	6350843	6347791	8000	6346843	-4000	4000	948
chr12	9991694	9999694	9997275	8000	9995694	-4000	4000	1581
chr12	10820960	10828960	10826109	8000	10824960	-4000	4000	1149
chr12	52833804	52841804	52834244	8000	52837804	-4000	4000	-3560
chr12	79769563	79777563	79775116	8000	79773563	-4000	4000	1553
chr12	120337330	120345330	120341493	8000	120341330	-4000	4000	163
chr12	120758510	120766510	120764115	8000	120762510	-4000	4000	1605
chr12	7067032	7075032	7070072	8000	7071032	-4000	4000	-960
chr12	8217260	8225260	8222464	8000	8221260	-4000	4000	1204
chr12	26331352	26339352	26339343	8000	26335352	-4000	4000	3991
chr12	47730363	47738363	47738228	8000	47734363	-4000	4000	3865
chr12	55328687	55336687	55332567	8000	55332687	-4000	4000	-120
chr12	6816799	6824799	6823620	8000	6820799	-4000	4000	2821
chr12	110023028	110031028	110028533	8000	110027028	-4000	4000	1505
chr12	110529245	110537245	110530575	8000	110533245	-4000	4000	-2670
chr12	120091099	120099099	120097132	8000	120095099	-4000	4000	2033
chr12	54575239	54583239	54577228	8000	54579239	-4000	4000	-2011
chr12	123594582	123602582	123596665	8000	123598582	-4000	4000	-1917
chr12	9144840	9152840	9152261	8000	9148840	-4000	4000	3421
chr12	23525504	23533504	23533460	8000	23529504	-4000	4000	3956
chr12	53289638	53297638	53292383	8000	53293638	-4000	4000	-1255
chr12	25201246	25209246	25204181	8000	25205246	-4000	4000	-1065
chr12	119681791	119689791	119687591	8000	119685791	-4000	4000	1800
chr12	52442651	52450651	52450616	8000	52446651	-4000	4000	3965
chr12	9144840	9152840	9148896	8000	9148840	-4000	4000	56
chr12	49123782	49131782	49128123	8000	49127782	-4000	4000	341
chr12	5042788	5050788	5045402	8000	5046788	-4000	4000	-1386
chr12	123704399	123712399	123706774	8000	123708399	-4000	4000	-1625
chr12	123931720	123939720	123933419	8000	123935720	-4000	4000	-2301
chr12	54358445	54366445	54362867	8000	54362445	-4000	4000	422
chr12	129067725	129075725	129073798	8000	129071725	-4000	4000	2073
chr12	129067725	129075725	129073799	8000	129071725	-4000	4000	2074
chr12	11387540	11395540	11393156	8000	11391540	-4000	4000	1616
chr12	53206567	53214567	53213600	8000	53210567	-4000	4000	3033
chr12	57804071	57812071	57810383	8000	57808071	-4000	4000	2312
chr12	76340474	76348474	76345550	8000	76344474	-4000	4000	1076
chr12	105070197	105078197	105073908	8000	105074197	-4000	4000	-289
chr12	122697293	122705293	122702594	8000	122701293	-4000	4000	1301
chr12	124942825	124950825	124950756	8000	124946825	-4000	4000	3931
chr12	54575239	54583239	54582096	8000	54579239	-4000	4000	2857
chr12	49060676	49068676	49065433	8000	49064676	-4000	4000	757
chr12	128980968	128988968	128982994	8000	128984968	-4000	4000	-1974
chr12	129067725	129075725	129074768	8000	129071725	-4000	4000	3043
chr12	32741650	32749650	32746999	8000	32745650	-4000	4000	1349
chr12	42455715	42463715	42459504	8000	42459715	-4000	4000	-211
chr12	50107313	50115313	50109460	8000	50111313	-4000	4000	-1853
chr12	56710612	56718612	56712443	8000	56714612	-4000	4000	-2169
chr12	57209361	57217361	57211784	8000	57213361	-4000	4000	-1577
chr12	57209361	57217361	57212526	8000	57213361	-4000	4000	-835
chr12	6646301	6654301	6652978	8000	6650301	-4000	4000	2677
chr12	9748486	9756486	9755201	8000	9752486	-4000	4000	2715
chr12	52305163	52313163	52306197	8000	52309163	-4000	4000	-2966
chr12	48899503	48907503	48905065	8000	48903503	-4000	4000	1562
chr12	49972923	49980923	49973304	8000	49976923	-4000	4000	-3619
chr12	51887727	51895727	51888070	8000	51891727	-4000	4000	-3657
chr12	55128750	55136750	55130270	8000	55132750	-4000	4000	-2480
chr12	57222449	57230449	57229778	8000	57226449	-4000	4000	3329
chr12	50171788	50179788	50177760	8000	50175788	-4000	4000	1972
chr12	57448062	57456062	57450066	8000	57452062	-4000	4000	-1996
chr12	103766453	103774453	103773876	8000	103770453	-4000	4000	3423
chr12	48522570	48530570	48525996	8000	48526570	-4000	4000	-574
chr12	6774455	6782455	6777285	8000	6778455	-4000	4000	-1170
chr12	68197349	68205349	68201763	8000	68201349	-4000	4000	414
chr12	101382618	101390618	101383140	8000	101386618	-4000	4000	-3478
chr12	120091099	120099099	120097163	8000	120095099	-4000	4000	2064
chr12	122722076	122730076	122729617	8000	122726076	-4000	4000	3541
chr12	129067725	129075725	129074124	8000	129071725	-4000	4000	2399
chr12	52420070	52428070	52424485	8000	52424070	-4000	4000	415
chr12	109451523	109459523	109451810	8000	109455523	-4000	4000	-3713
chr12	52670736	52678736	52675321	8000	52674736	-4000	4000	585
chr12	56109910	56117910	56110578	8000	56113910	-4000	4000	-3332
chr12	14938031	14946031	14942666	8000	14942031	-4000	4000	635
chr12	52305163	52313163	52306218	8000	52309163	-4000	4000	-2945
chr12	112019449	112027449	112019811	8000	112023449	-4000	4000	-3638
chr12	55633833	55641833	55637537	8000	55637833	-4000	4000	-296
chr12	52685626	52693626	52692432	8000	52689626	-4000	4000	2806
chr12	10614923	10622923	10619816	8000	10618923	-4000	4000	893
chr12	57622125	57630125	57624262	8000	57626125	-4000	4000	-1863
chr12	49862896	49870896	49870433	8000	49866896	-4000	4000	3537
chr12	55217975	55225975	55221316	8000	55221975	-4000	4000	-659
chr12	55423192	55431192	55426704	8000	55427192	-4000	4000	-488
chr12	55950105	55958105	55957419	8000	55954105	-4000	4000	3314
chr12	57209361	57217361	57210362	8000	57213361	-4000	4000	-2999
chr12	57804071	57812071	57810440	8000	57808071	-4000	4000	2369
chr12	75499863	75507863	75506857	8000	75503863	-4000	4000	2994
chr12	100560414	100568414	100561893	8000	100564414	-4000	4000	-2521
chr12	106974778	106982778	106977998	8000	106978778	-4000	4000	-780
chr12	47705734	47713734	47711630	8000	47709734	-4000	4000	1896
chr12	49972923	49980923	49974449	8000	49976923	-4000	4000	-2474
chr12	113094819	113102819	113094879	8000	113098819	-4000	4000	-3940
chr12	95298799	95306799	95299966	8000	95302799	-4000	4000	-2833
chr12	11181993	11189993	11186337	8000	11185993	-4000	4000	344
chr12	57209361	57217361	57210353	8000	57213361	-4000	4000	-3008
chr12	100337715	100345715	100339068	8000	100341715	-4000	4000	-2647
chr12	6534374	6542374	6540167	8000	6538374	-4000	4000	1793
chr12	6662477	6670477	6669036	8000	6666477	-4000	4000	2559
chr12	14910039	14918039	14915506	8000	14914039	-4000	4000	1467
chr12	49961682	49969682	49962109	8000	49965682	-4000	4000	-3573
chr12	122199471	122207471	122200552	8000	122203471	-4000	4000	-2919
chr12	49060676	49068676	49065027	8000	49064676	-4000	4000	351
chr12	79769563	79777563	79775829	8000	79773563	-4000	4000	2266
chr12	3589973	3597973	3593177	8000	3593973	-4000	4000	-796
chr12	7067032	7075032	7069890	8000	7071032	-4000	4000	-1142
chr12	48143789	48151789	48145235	8000	48147789	-4000	4000	-2554
chr12	52603570	52611570	52608351	8000	52607570	-4000	4000	781
chr12	9991694	9999694	9998354	8000	9995694	-4000	4000	2660
chr12	51182936	51190936	51190449	8000	51186936	-4000	4000	3513
chr12	69955097	69963097	69958520	8000	69959097	-4000	4000	-577
chr12	130161740	130169740	130164274	8000	130165740	-4000	4000	-1466
chr12	57448062	57456062	57455703	8000	57452062	-4000	4000	3641
chr12	89343235	89351235	89350976	8000	89347235	-4000	4000	3741
chr12	101124641	101132641	101127981	8000	101128641	-4000	4000	-660
chr12	120736008	120744008	120739326	8000	120740008	-4000	4000	-682
chr12	69604564	69612564	69610548	8000	69608564	-4000	4000	1984
chr12	7685784	7693784	7689793	8000	7689784	-4000	4000	9
chr12	76340474	76348474	76346370	8000	76344474	-4000	4000	1896
chr12	133198369	133206369	133203051	8000	133202369	-4000	4000	682
chr12	49082656	49090656	49089986	8000	49086656	-4000	4000	3330
chr12	55026017	55034017	55026913	8000	55030017	-4000	4000	-3104
chr12	109273978	109281978	109279857	8000	109277978	-4000	4000	1879
chr12	11303077	11311077	11308532	8000	11307077	-4000	4000	1455
chr12	49328409	49336409	49330981	8000	49332409	-4000	4000	-1428
chr12	52603570	52611570	52608411	8000	52607570	-4000	4000	841
chr12	55950105	55958105	55957220	8000	55954105	-4000	4000	3115
chr12	6234271	6242271	6235559	8000	6238271	-4000	4000	-2712
chr12	52802549	52810549	52807192	8000	52806549	-4000	4000	643
chr12	52670736	52678736	52677417	8000	52674736	-4000	4000	2681
chr12	11387540	11395540	11393764	8000	11391540	-4000	4000	2224
chr12	48978620	48986620	48980530	8000	48982620	-4000	4000	-2090
chr12	5042788	5050788	5045183	8000	5046788	-4000	4000	-1605
chr12	8051517	8059517	8059031	8000	8055517	-4000	4000	3514
chr12	31787185	31795185	31791660	8000	31791185	-4000	4000	475
chr12	78209010	78217010	78210511	8000	78213010	-4000	4000	-2499
chr12	133198369	133206369	133203244	8000	133202369	-4000	4000	875
chr12	45904040	45912040	45904963	8000	45908040	-4000	4000	-3077
chr12	55026017	55034017	55028208	8000	55030017	-4000	4000	-1809
chr12	113007723	113015723	113010398	8000	113011723	-4000	4000	-1325
chr12	115953905	115961905	115959865	8000	115957905	-4000	4000	1960
chr12	130161740	130169740	130165356	8000	130165740	-4000	4000	-384
chr12	112505918	112513918	112509586	8000	112509918	-4000	4000	-332
chr12	52373812	52381812	52378079	8000	52377812	-4000	4000	267
chr12	6614835	6622835	6621127	8000	6618835	-4000	4000	2292
chr12	101389116	101397116	101396406	8000	101393116	-4000	4000	3290
chr12	21793389	21801389	21801057	8000	21797389	-4000	4000	3668
chr12	53322575	53330575	53328950	8000	53326575	-4000	4000	2375
chr12	95964720	95972720	95966453	8000	95968720	-4000	4000	-2267
chr12	6816799	6824799	6819539	8000	6820799	-4000	4000	-1260
chr12	51182936	51190936	51190393	8000	51186936	-4000	4000	3457
chr12	56336410	56344410	56343418	8000	56340410	-4000	4000	3008
chr12	64498114	64506114	64501436	8000	64502114	-4000	4000	-678
chr12	49972923	49980923	49975495	8000	49976923	-4000	4000	-1428
chr12	54544243	54552243	54549883	8000	54548243	-4000	4000	1640
chr12	27077057	27085057	27082376	8000	27081057	-4000	4000	1319
chr12	53289638	53297638	53293565	8000	53293638	-4000	4000	-73
chr12	57605804	57613804	57608589	8000	57609804	-4000	4000	-1215
chr12	56336410	56344410	56343835	8000	56340410	-4000	4000	3425
chr12	76340474	76348474	76346339	8000	76344474	-4000	4000	1865
chr12	108617895	108625895	108623831	8000	108621895	-4000	4000	1936
chr12	56783790	56791790	56787249	8000	56787790	-4000	4000	-541
chr12	53942544	53950544	53945244	8000	53946544	-4000	4000	-1300
chr12	108641109	108649109	108648746	8000	108645109	-4000	4000	3637
chr12	57513569	57521569	57516513	8000	57517569	-4000	4000	-1056
chr12	8051517	8059517	8059027	8000	8055517	-4000	4000	3510
chr12	10802051	10810051	10806567	8000	10806051	-4000	4000	516
chr12	47232662	47240662	47236345	8000	47236662	-4000	4000	-317
chr12	52356006	52364006	52362379	8000	52360006	-4000	4000	2373
chr12	55831433	55839433	55838555	8000	55835433	-4000	4000	3122
chr12	55831433	55839433	55838707	8000	55835433	-4000	4000	3274
chr12	57513569	57521569	57516500	8000	57517569	-4000	4000	-1069
chr12	8217260	8225260	8224116	8000	8221260	-4000	4000	2856
chr12	132700985	132708985	132701337	8000	132704985	-4000	4000	-3648
chr12	68150768	68158768	68158233	8000	68154768	-4000	4000	3465
chr12	42455715	42463715	42459896	8000	42459715	-4000	4000	181
chr12	64498114	64506114	64502036	8000	64502114	-4000	4000	-78
chr12	80705474	80713474	80708901	8000	80709474	-4000	4000	-573
chr12	7645400	7653400	7649679	8000	7649400	-4000	4000	279
chr12	95511839	95519839	95517915	8000	95515839	-4000	4000	2076
chr12	26962650	26970650	26964812	8000	26966650	-4000	4000	-1838
chr12	76340474	76348474	76347240	8000	76344474	-4000	4000	2766
chr12	10802051	10810051	10809883	8000	10806051	-4000	4000	3832
chr12	68741809	68749809	68741930	8000	68745809	-4000	4000	-3879
chr12	130161740	130169740	130164673	8000	130165740	-4000	4000	-1067
chr12	7713559	7721559	7715247	8000	7717559	-4000	4000	-2312
chr12	57605804	57613804	57613630	8000	57609804	-4000	4000	3826
chr12	61704273	61712273	61710268	8000	61708273	-4000	4000	1995
chr12	95511839	95519839	95514264	8000	95515839	-4000	4000	-1575
chr12	110486385	110494385	110486553	8000	110490385	-4000	4000	-3832
chr12	7808512	7816512	7814239	8000	7812512	-4000	4000	1727
chr12	52305163	52313163	52308369	8000	52309163	-4000	4000	-794
chr12	122823528	122831528	122826569	8000	122827528	-4000	4000	-959
chr12	106974778	106982778	106977744	8000	106978778	-4000	4000	-1034
chr12	49270600	49278600	49272339	8000	49274600	-4000	4000	-2261
chr12	52833804	52841804	52833836	8000	52837804	-4000	4000	-3968
chr12	9748486	9756486	9754494	8000	9752486	-4000	4000	2008
chr12	57024517	57032517	57028863	8000	57028517	-4000	4000	346
chr12	52073495	52081495	52077106	8000	52077495	-4000	4000	-389
chr12	8529305	8537305	8537263	8000	8533305	-4000	4000	3958
chr12	41570745	41578745	41573437	8000	41574745	-4000	4000	-1308
chr12	48649211	48657211	48653548	8000	48653211	-4000	4000	337
chr12	52305163	52313163	52306059	8000	52309163	-4000	4000	-3104
chr12	56266966	56274966	56273122	8000	56270966	-4000	4000	2156
chr12	57815927	57823927	57821457	8000	57819927	-4000	4000	1530
chr12	121835527	121843527	121839627	8000	121839527	-4000	4000	100
chr12	122199471	122207471	122200625	8000	122203471	-4000	4000	-2846
chr12	122499454	122507454	122505622	8000	122503454	-4000	4000	2168
chr12	123405353	123413353	123407893	8000	123409353	-4000	4000	-1460
chr12	130392133	130400133	130399711	8000	130396133	-4000	4000	3578
chr12	120758510	120766510	120765060	8000	120762510	-4000	4000	2550
chr12	48649211	48657211	48654972	8000	48653211	-4000	4000	1761
chr12	6614835	6622835	6621081	8000	6618835	-4000	4000	2246
chr12	52442651	52450651	52450426	8000	52446651	-4000	4000	3775
chr12	102832889	102840889	102840489	8000	102836889	-4000	4000	3600
chr12	120318115	120326115	120325944	8000	120322115	-4000	4000	3829
chr12	110715680	110723680	110722252	8000	110719680	-4000	4000	2572
chr12	52685626	52693626	52692508	8000	52689626	-4000	4000	2882
chr12	56034435	56042435	56035040	8000	56038435	-4000	4000	-3395
chr12	52802549	52810549	52807731	8000	52806549	-4000	4000	1182
chr12	113007723	113015723	113009107	8000	113011723	-4000	4000	-2616
chr12	52442651	52450651	52447874	8000	52446651	-4000	4000	1223
chr12	10802051	10810051	10806130	8000	10806051	-4000	4000	79
chr12	45010672	45018672	45016389	8000	45014672	-4000	4000	1717
chr12	105070197	105078197	105070734	8000	105074197	-4000	4000	-3463
chr12	121999927	122007927	122003692	8000	122003927	-4000	4000	-235
chr12	29496840	29504840	29497620	8000	29500840	-4000	4000	-3220
chr12	31667142	31675142	31668121	8000	31671142	-4000	4000	-3021
chr12	109273978	109281978	109281621	8000	109277978	-4000	4000	3643
chr12	6727875	6735875	6730773	8000	6731875	-4000	4000	-1102
chr12	8217260	8225260	8222345	8000	8221260	-4000	4000	1085
chr12	6634075	6642075	6638177	8000	6638075	-4000	4000	102
chr12	7645400	7653400	7652668	8000	7649400	-4000	4000	3268
chr12	48143789	48151789	48145257	8000	48147789	-4000	4000	-2532
chr12	52442651	52450651	52450460	8000	52446651	-4000	4000	3809
chr12	54640589	54648589	54645654	8000	54644589	-4000	4000	1065
chr12	52305163	52313163	52306243	8000	52309163	-4000	4000	-2920
chr12	9144840	9152840	9148952	8000	9148840	-4000	4000	112
chr12	56994836	57002836	56995860	8000	56998836	-4000	4000	-2976
chr12	216621	224621	222589	8000	220621	-4000	4000	1968
chr12	6727875	6735875	6731067	8000	6731875	-4000	4000	-808
chr12	12469282	12477282	12476718	8000	12473282	-4000	4000	3436
chr12	27691564	27699564	27691778	8000	27695564	-4000	4000	-3786
chr12	45010672	45018672	45016537	8000	45014672	-4000	4000	1865
chr12	48563684	48571684	48569967	8000	48567684	-4000	4000	2283
chr12	50096707	50104707	50104593	8000	50100707	-4000	4000	3886
chr12	52833804	52841804	52839466	8000	52837804	-4000	4000	1662
chr12	53187323	53195323	53193762	8000	53191323	-4000	4000	2439
chr12	53942544	53950544	53944999	8000	53946544	-4000	4000	-1545
chr12	54575239	54583239	54581003	8000	54579239	-4000	4000	1764
chr12	54575239	54583239	54582791	8000	54579239	-4000	4000	3552
chr12	55217975	55225975	55221280	8000	55221975	-4000	4000	-695
chr12	55423192	55431192	55426990	8000	55427192	-4000	4000	-202
chr12	56919133	56927133	56924043	8000	56923133	-4000	4000	910
chr12	106974778	106982778	106977351	8000	106978778	-4000	4000	-1427
chr12	110903535	110911535	110904682	8000	110907535	-4000	4000	-2853
chr12	110903535	110911535	110910925	8000	110907535	-4000	4000	3390
chr12	122267432	122275432	122274038	8000	122271432	-4000	4000	2606
chr12	26967579	26975579	26973974	8000	26971579	-4000	4000	2395
chr12	51056424	51064424	51064017	8000	51060424	-4000	4000	3593
chr12	5042788	5050788	5045103	8000	5046788	-4000	4000	-1685
chr12	6324757	6332757	6330006	8000	6328757	-4000	4000	1249
chr12	6646301	6654301	6646968	8000	6650301	-4000	4000	-3333
chr12	8217260	8225260	8222027	8000	8221260	-4000	4000	767
chr12	8518366	8526366	8521155	8000	8522366	-4000	4000	-1211
chr12	10600193	10608193	10606314	8000	10604193	-4000	4000	2121
chr12	10802051	10810051	10806419	8000	10806051	-4000	4000	368
chr12	14780582	14788582	14786840	8000	14784582	-4000	4000	2258
chr12	16033381	16041381	16036320	8000	16037381	-4000	4000	-1061
chr12	46760761	46768761	46765351	8000	46764761	-4000	4000	590
chr12	48761790	48769790	48768023	8000	48765790	-4000	4000	2233
chr12	50476004	50484004	50477602	8000	50480004	-4000	4000	-2402
chr12	54030888	54038888	54033357	8000	54034888	-4000	4000	-1531
chr12	57815927	57823927	57820079	8000	57819927	-4000	4000	152
chr12	70634073	70642073	70635717	8000	70638073	-4000	4000	-2356
chr12	103984987	103992987	103985653	8000	103988987	-4000	4000	-3334
chr12	105165130	105173130	105168164	8000	105169130	-4000	4000	-966
chr12	113188368	113196368	113195739	8000	113192368	-4000	4000	3371
chr12	52802549	52810549	52807745	8000	52806549	-4000	4000	1196
chr12	21631342	21639342	21637158	8000	21635342	-4000	4000	1816
chr12	130785600	130793600	130790843	8000	130789600	-4000	4000	1243
chr12	6324757	6332757	6329221	8000	6328757	-4000	4000	464
chr12	7685784	7693784	7689986	8000	7689784	-4000	4000	202
chr12	21467250	21475250	21468710	8000	21471250	-4000	4000	-2540
chr12	5042788	5050788	5044785	8000	5046788	-4000	4000	-2003
chr12	109846945	109854945	109852693	8000	109850945	-4000	4000	1748
chr12	41570745	41578745	41573410	8000	41574745	-4000	4000	-1335
chr12	49640666	49648666	49641742	8000	49644666	-4000	4000	-2924
chr12	50079611	50087611	50079920	8000	50083611	-4000	4000	-3691
chr12	56947431	56955431	56952071	8000	56951431	-4000	4000	640
chr12	121013763	121021763	121020591	8000	121017763	-4000	4000	2828
chr12	122710756	122718756	122716312	8000	122714756	-4000	4000	1556
chr12	122710756	122718756	122716313	8000	122714756	-4000	4000	1557
chr12	7067032	7075032	7068464	8000	7071032	-4000	4000	-2568
chr12	6614835	6622835	6621339	8000	6618835	-4000	4000	2504
chr12	22059773	22067773	22060876	8000	22063773	-4000	4000	-2897
chr12	51324442	51332442	51328516	8000	51328442	-4000	4000	74
chr12	56109910	56117910	56110645	8000	56113910	-4000	4000	-3265
chr12	61704273	61712273	61710304	8000	61708273	-4000	4000	2031
chr12	68244242	68252242	68248819	8000	68248242	-4000	4000	577
chr12	85010311	85018311	85017474	8000	85014311	-4000	4000	3163
chr12	100624288	100632288	100624417	8000	100628288	-4000	4000	-3871
chr12	130392133	130400133	130399100	8000	130396133	-4000	4000	2967
chr12	10219128	10227128	10222109	8000	10223128	-4000	4000	-1019
chr12	6342843	6350843	6347874	8000	6346843	-4000	4000	1031
chr12	7154945	7162945	7156427	8000	7158945	-4000	4000	-2518
chr12	8171320	8179320	8177998	8000	8175320	-4000	4000	2678
chr12	51511763	51519763	51514341	8000	51515763	-4000	4000	-1422
chr12	51887727	51895727	51891321	8000	51891727	-4000	4000	-406
chr12	52442651	52450651	52450455	8000	52446651	-4000	4000	3804
chr12	52464516	52472516	52471722	8000	52468516	-4000	4000	3206
chr12	56034435	56042435	56036003	8000	56038435	-4000	4000	-2432
chr12	56336410	56344410	56343454	8000	56340410	-4000	4000	3044
chr12	88488793	88496793	88493207	8000	88492793	-4000	4000	414
chr12	102008840	102016840	102013097	8000	102012840	-4000	4000	257
chr12	110023028	110031028	110028592	8000	110027028	-4000	4000	1564
chr12	118145801	118153801	118152230	8000	118149801	-4000	4000	2429
chr12	123931720	123939720	123931995	8000	123935720	-4000	4000	-3725
chr12	130785600	130793600	130791445	8000	130789600	-4000	4000	1845
chr12	120318115	120326115	120322296	8000	120322115	-4000	4000	181
chr12	27498185	27506185	27502048	8000	27502185	-4000	4000	-137
chr12	55217975	55225975	55221806	8000	55221975	-4000	4000	-169
chr12	55397467	55405467	55400783	8000	55401467	-4000	4000	-684
chr12	101382618	101390618	101383643	8000	101386618	-4000	4000	-2975
chr12	110623841	110631841	110626380	8000	110627841	-4000	4000	-1461
chr12	132619753	132627753	132624925	8000	132623753	-4000	4000	1172
chr12	22059773	22067773	22060889	8000	22063773	-4000	4000	-2884
chr12	53098345	53106345	53101151	8000	53102345	-4000	4000	-1194
chr12	53942544	53950544	53946323	8000	53946544	-4000	4000	-221
chr12	55680568	55688568	55685019	8000	55684568	-4000	4000	451
chr12	102193520	102201520	102197018	8000	102197520	-4000	4000	-502
chr12	71694968	71702968	71701181	8000	71698968	-4000	4000	2213
chr12	41570745	41578745	41573317	8000	41574745	-4000	4000	-1428
chr12	55026017	55034017	55026929	8000	55030017	-4000	4000	-3088
chr12	41570745	41578745	41573208	8000	41574745	-4000	4000	-1537
chr12	52510575	52518575	52517704	8000	52514575	-4000	4000	3129
chr12	52785685	52793685	52790849	8000	52789685	-4000	4000	1164
chr12	55217975	55225975	55221042	8000	55221975	-4000	4000	-933
chr12	113094819	113102819	113096918	8000	113098819	-4000	4000	-1901
chr12	113188368	113196368	113195724	8000	113192368	-4000	4000	3356
chr12	7770121	7778121	7770455	8000	7774121	-4000	4000	-3666
chr12	52603570	52611570	52610805	8000	52607570	-4000	4000	3235
chr12	87976035	87984035	87983186	8000	87980035	-4000	4000	3151
chr12	131137469	131145469	131139216	8000	131141469	-4000	4000	-2253
chr12	6634075	6642075	6640412	8000	6638075	-4000	4000	2337
chr12	53322575	53330575	53328771	8000	53326575	-4000	4000	2196
chr12	55950105	55958105	55953687	8000	55954105	-4000	4000	-418
chr12	27077057	27085057	27081090	8000	27081057	-4000	4000	33
chr12	48961340	48969340	48968284	8000	48965340	-4000	4000	2944
chr12	6774455	6782455	6778037	8000	6778455	-4000	4000	-418
chr12	11387540	11395540	11393699	8000	11391540	-4000	4000	2159
chr12	53206567	53214567	53213241	8000	53210567	-4000	4000	2674
chr12	1643212	1651212	1646084	8000	1647212	-4000	4000	-1128
chr12	106233881	106241881	106238093	8000	106237881	-4000	4000	212
chr12	95996753	96004753	96000938	8000	96000753	-4000	4000	185
chr12	56109910	56117910	56110989	8000	56113910	-4000	4000	-2921
chr12	48522570	48530570	48526375	8000	48526570	-4000	4000	-195
chr12	52670736	52678736	52677409	8000	52674736	-4000	4000	2673
chr12	54358445	54366445	54363571	8000	54362445	-4000	4000	1126
chr12	55465200	55473200	55469523	8000	55469200	-4000	4000	323
chr12	69270358	69278358	69273043	8000	69274358	-4000	4000	-1315
chr12	109451523	109459523	109457645	8000	109455523	-4000	4000	2122
chr12	41068415	41076415	41070079	8000	41072415	-4000	4000	-2336
chr12	52073495	52081495	52073704	8000	52077495	-4000	4000	-3791
chr12	907452	915452	914062	8000	911452	-4000	4000	2610
chr12	30705552	30713552	30711747	8000	30709552	-4000	4000	2195
chr12	122622396	122630396	122622469	8000	122626396	-4000	4000	-3927
chr12	39546033	39554033	39553831	8000	39550033	-4000	4000	3798
chr12	10802051	10810051	10809354	8000	10806051	-4000	4000	3303
chr12	52817408	52825408	52824306	8000	52821408	-4000	4000	2898
chr12	108246537	108254537	108248006	8000	108250537	-4000	4000	-2531
chr12	111346554	111354554	111347663	8000	111350554	-4000	4000	-2891
chr12	57622125	57630125	57624950	8000	57626125	-4000	4000	-1175
chr12	55423192	55431192	55426358	8000	55427192	-4000	4000	-834
chr12	6816799	6824799	6817269	8000	6820799	-4000	4000	-3530
chr12	55950105	55958105	55953843	8000	55954105	-4000	4000	-262
chr12	117027148	117035148	117028217	8000	117031148	-4000	4000	-2931
chr12	51056424	51064424	51056452	8000	51060424	-4000	4000	-3972
chr12	69270358	69278358	69273119	8000	69274358	-4000	4000	-1239
chr12	11347823	11355823	11353291	8000	11351823	-4000	4000	1468
chr12	80376880	80384880	80377157	8000	80380880	-4000	4000	-3723
chr12	48326279	48334279	48329513	8000	48330279	-4000	4000	-766
chr12	7324719	7332719	7328336	8000	7328719	-4000	4000	-383
chr12	113188368	113196368	113195793	8000	113192368	-4000	4000	3425
chr12	6534374	6542374	6540533	8000	6538374	-4000	4000	2159
chr12	106885316	106893316	106886819	8000	106889316	-4000	4000	-2497
chr12	186077	194077	193333	8000	190077	-4000	4000	3256
chr12	100337715	100345715	100339438	8000	100341715	-4000	4000	-2277
chr12	6662477	6670477	6667636	8000	6666477	-4000	4000	1159
chr12	57622125	57630125	57625135	8000	57626125	-4000	4000	-990
chr12	117027148	117035148	117027478	8000	117031148	-4000	4000	-3670
chr12	49093136	49101136	49097694	8000	49097136	-4000	4000	558
chr12	6816799	6824799	6819442	8000	6820799	-4000	4000	-1357
chr12	6835847	6843847	6839400	8000	6839847	-4000	4000	-447
chr12	10062031	10070031	10065655	8000	10066031	-4000	4000	-376
chr12	76849696	76857696	76850872	8000	76853696	-4000	4000	-2824
chr12	85878992	85886992	85882304	8000	85882992	-4000	4000	-688
chr12	27321959	27329959	27322367	8000	27325959	-4000	4000	-3592
chr12	34025694	34033694	34026168	8000	34029694	-4000	4000	-3526
chr12	80705474	80713474	80708593	8000	80709474	-4000	4000	-881
chr12	108617895	108625895	108623022	8000	108621895	-4000	4000	1127
chr12	53060379	53068379	53068172	8000	53064379	-4000	4000	3793
chr12	57209361	57217361	57211296	8000	57213361	-4000	4000	-2065
chr12	102832889	102840889	102839154	8000	102836889	-4000	4000	2265
chr12	130392133	130400133	130398648	8000	130396133	-4000	4000	2515
chr12	68150768	68158768	68155466	8000	68154768	-4000	4000	698
chr12	98609405	98617405	98614192	8000	98613405	-4000	4000	787
chr12	122467599	122475599	122473583	8000	122471599	-4000	4000	1984
chr12	10408312	10416312	10409525	8000	10412312	-4000	4000	-2787
chr12	42153104	42161104	42160475	8000	42157104	-4000	4000	3371
chr12	49123782	49131782	49127969	8000	49127782	-4000	4000	187
chr12	56266966	56274966	56273499	8000	56270966	-4000	4000	2533
chr12	56266966	56274966	56274833	8000	56270966	-4000	4000	3867
chr12	57249762	57257762	57255054	8000	57253762	-4000	4000	1292
chr12	58868149	58876149	58872440	8000	58872149	-4000	4000	291
chr12	71694968	71702968	71697330	8000	71698968	-4000	4000	-1638
chr12	110214793	110222793	110218295	8000	110218793	-4000	4000	-498
chr12	128980968	128988968	128983096	8000	128984968	-4000	4000	-1872
chr12	8217260	8225260	8221985	8000	8221260	-4000	4000	725
chr12	80705474	80713474	80707790	8000	80709474	-4000	4000	-1684
chr12	122697293	122705293	122703163	8000	122701293	-4000	4000	1870
chr12	52561782	52569782	52568277	8000	52565782	-4000	4000	2495
chr12	123704399	123712399	123704644	8000	123708399	-4000	4000	-3755
chr12	6234271	6242271	6235559	8000	6238271	-4000	4000	-2712
chr12	52802549	52810549	52808831	8000	52806549	-4000	4000	2282
chr12	8217260	8225260	8223542	8000	8221260	-4000	4000	2282
chr12	76340474	76348474	76347255	8000	76344474	-4000	4000	2781
chr12	18679169	18687169	18684204	8000	18683169	-4000	4000	1035
chr12	55680568	55688568	55682251	8000	55684568	-4000	4000	-2317
chr12	70350993	70358993	70353969	8000	70354993	-4000	4000	-1024
chr12	6835847	6843847	6842997	8000	6839847	-4000	4000	3150
chr12	54575239	54583239	54582774	8000	54579239	-4000	4000	3535
chr12	55950105	55958105	55952385	8000	55954105	-4000	4000	-1720
chr12	92766637	92774637	92772552	8000	92770637	-4000	4000	1915
chr12	7713559	7721559	7715203	8000	7717559	-4000	4000	-2356
chr12	76849696	76857696	76852141	8000	76853696	-4000	4000	-1555
chr12	51993078	52001078	51995043	8000	51997078	-4000	4000	-2035
chr12	55950105	55958105	55957489	8000	55954105	-4000	4000	3384
chr12	5042788	5050788	5044481	8000	5046788	-4000	4000	-2307
chr12	55423192	55431192	55426892	8000	55427192	-4000	4000	-300
chr12	102193520	102201520	102197165	8000	102197520	-4000	4000	-355
chr12	80705474	80713474	80708105	8000	80709474	-4000	4000	-1369
chr12	6835847	6843847	6843481	8000	6839847	-4000	4000	3634
chr12	121999927	122007927	122003905	8000	122003927	-4000	4000	-22
chr12	43785543	43793543	43786813	8000	43789543	-4000	4000	-2730
chr12	9748486	9756486	9755143	8000	9752486	-4000	4000	2657
chr12	48181926	48189926	48184417	8000	48185926	-4000	4000	-1509
chr12	118028687	118036687	118033897	8000	118032687	-4000	4000	1210
chr12	71121085	71129085	71125373	8000	71125085	-4000	4000	288
chr12	95511839	95519839	95511981	8000	95515839	-4000	4000	-3858
chr12	110486385	110494385	110491857	8000	110490385	-4000	4000	1472
chr12	110623841	110631841	110626422	8000	110627841	-4000	4000	-1419
chr12	51182936	51190936	51190202	8000	51186936	-4000	4000	3266
chr12	132581188	132589188	132581456	8000	132585188	-4000	4000	-3732
chr12	129067725	129075725	129074922	8000	129071725	-4000	4000	3197
chr12	10065554	10073554	10073402	8000	10069554	-4000	4000	3848
chr12	52640558	52648558	52647781	8000	52644558	-4000	4000	3223
chr12	53153663	53161663	53158619	8000	53157663	-4000	4000	956
chr12	2937138	2945138	2939584	8000	2941138	-4000	4000	-1554
chr12	7713559	7721559	7717040	8000	7717559	-4000	4000	-519
chr12	8474330	8482330	8476177	8000	8478330	-4000	4000	-2153
chr12	9590551	9598551	9595370	8000	9594551	-4000	4000	819
chr12	11347823	11355823	11354555	8000	11351823	-4000	4000	2732
chr12	27691564	27699564	27691784	8000	27695564	-4000	4000	-3780
chr12	40365285	40373285	40367703	8000	40369285	-4000	4000	-1582
chr12	49060676	49068676	49065126	8000	49064676	-4000	4000	450
chr12	49328409	49336409	49330302	8000	49332409	-4000	4000	-2107
chr12	49640666	49648666	49644159	8000	49644666	-4000	4000	-507
chr12	49760934	49768934	49761701	8000	49764934	-4000	4000	-3233
chr12	49832043	49840043	49838945	8000	49836043	-4000	4000	2902
chr12	49972923	49980923	49973522	8000	49976923	-4000	4000	-3401
chr12	50171788	50179788	50177072	8000	50175788	-4000	4000	1284
chr12	50744657	50752657	50744810	8000	50748657	-4000	4000	-3847
chr12	52389931	52397931	52395760	8000	52393931	-4000	4000	1829
chr12	52464516	52472516	52469209	8000	52468516	-4000	4000	693
chr12	52510575	52518575	52517172	8000	52514575	-4000	4000	2597
chr12	53098345	53106345	53105600	8000	53102345	-4000	4000	3255
chr12	55633833	55641833	55637590	8000	55637833	-4000	4000	-243
chr12	56783790	56791790	56784863	8000	56787790	-4000	4000	-2927
chr12	57605804	57613804	57613580	8000	57609804	-4000	4000	3776
chr12	61704273	61712273	61710256	8000	61708273	-4000	4000	1983
chr12	70350993	70358993	70353912	8000	70354993	-4000	4000	-1081
chr12	76340474	76348474	76346362	8000	76344474	-4000	4000	1888
chr12	76854709	76862709	76860409	8000	76858709	-4000	4000	1700
chr12	80376880	80384880	80377847	8000	80380880	-4000	4000	-3033
chr12	92766637	92774637	92770333	8000	92770637	-4000	4000	-304
chr12	95298799	95306799	95300243	8000	95302799	-4000	4000	-2556
chr12	95968662	95976662	95976492	8000	95972662	-4000	4000	3830
chr12	98609405	98617405	98613591	8000	98613405	-4000	4000	186
chr12	102193520	102201520	102197668	8000	102197520	-4000	4000	148
chr12	104113086	104121086	104119681	8000	104117086	-4000	4000	2595
chr12	106233881	106241881	106239728	8000	106237881	-4000	4000	1847
chr12	110214793	110222793	110218389	8000	110218793	-4000	4000	-404
chr12	110368900	110376900	110376179	8000	110372900	-4000	4000	3279
chr12	112972460	112980460	112978667	8000	112976460	-4000	4000	2207
chr12	120494493	120502493	120498117	8000	120498493	-4000	4000	-376
chr12	120758510	120766510	120766278	8000	120762510	-4000	4000	3768
chr12	122267432	122275432	122273021	8000	122271432	-4000	4000	1589
chr12	122697293	122705293	122702444	8000	122701293	-4000	4000	1151
chr12	123704399	123712399	123704617	8000	123708399	-4000	4000	-3782
chr12	129067725	129075725	129073720	8000	129071725	-4000	4000	1995
chr12	108617895	108625895	108623886	8000	108621895	-4000	4000	1991
chr12	123931720	123939720	123933458	8000	123935720	-4000	4000	-2262
chr12	11303077	11311077	11309372	8000	11307077	-4000	4000	2295
chr12	80705474	80713474	80707714	8000	80709474	-4000	4000	-1760
chr12	80705474	80713474	80708031	8000	80709474	-4000	4000	-1443
chr12	57622125	57630125	57626906	8000	57626125	-4000	4000	781
chr12	54288111	54296111	54292790	8000	54292111	-4000	4000	679
chr12	47232662	47240662	47236180	8000	47236662	-4000	4000	-482
chr12	5042788	5050788	5045911	8000	5046788	-4000	4000	-877
chr12	30705552	30713552	30711755	8000	30709552	-4000	4000	2203
chr12	48961340	48969340	48966039	8000	48965340	-4000	4000	699
chr12	6816799	6824799	6823698	8000	6820799	-4000	4000	2899
chr12	52373812	52381812	52381447	8000	52377812	-4000	4000	3635
chr12	118414033	118422033	118414434	8000	118418033	-4000	4000	-3599
chr12	32741650	32749650	32746989	8000	32745650	-4000	4000	1339
chr12	52685626	52693626	52692479	8000	52689626	-4000	4000	2853
chr12	108284044	108292044	108291894	8000	108288044	-4000	4000	3850
chr12	6835847	6843847	6838018	8000	6839847	-4000	4000	-1829
chr12	122710756	122718756	122715451	8000	122714756	-4000	4000	695
chr12	5042788	5050788	5044663	8000	5046788	-4000	4000	-2125
chr12	5042788	5050788	5045281	8000	5046788	-4000	4000	-1507
chr12	7915230	7923230	7921286	8000	7919230	-4000	4000	2056
chr12	7915230	7923230	7921447	8000	7919230	-4000	4000	2217
chr12	10062031	10070031	10065594	8000	10066031	-4000	4000	-437
chr12	10600193	10608193	10607878	8000	10604193	-4000	4000	3685
chr12	11347823	11355823	11354555	8000	11351823	-4000	4000	2732
chr12	12641108	12649108	12642152	8000	12645108	-4000	4000	-2956
chr12	12913937	12921937	12915712	8000	12917937	-4000	4000	-2225
chr12	14938031	14946031	14938425	8000	14942031	-4000	4000	-3606
chr12	18735188	18743188	18738433	8000	18739188	-4000	4000	-755
chr12	21467250	21475250	21470206	8000	21471250	-4000	4000	-1044
chr12	21467250	21475250	21471158	8000	21471250	-4000	4000	-92
chr12	21467250	21475250	21471601	8000	21471250	-4000	4000	351
chr12	21760955	21768955	21765929	8000	21764955	-4000	4000	974
chr12	21793389	21801389	21800883	8000	21797389	-4000	4000	3494
chr12	26962650	26970650	26963435	8000	26966650	-4000	4000	-3215
chr12	26962650	26970650	26964829	8000	26966650	-4000	4000	-1821
chr12	27077057	27085057	27082447	8000	27081057	-4000	4000	1390
chr12	41570745	41578745	41573604	8000	41574745	-4000	4000	-1141
chr12	43789723	43797723	43795525	8000	43793723	-4000	4000	1802
chr12	45915131	45923131	45922037	8000	45919131	-4000	4000	2906
chr12	47232662	47240662	47236171	8000	47236662	-4000	4000	-491
chr12	48198339	48206339	48202813	8000	48202339	-4000	4000	474
chr12	48824941	48832941	48830552	8000	48828941	-4000	4000	1611
chr12	49640666	49648666	49643703	8000	49644666	-4000	4000	-963
chr12	49972923	49980923	49975521	8000	49976923	-4000	4000	-1402
chr12	50079611	50087611	50080715	8000	50083611	-4000	4000	-2896
chr12	52011889	52019889	52013905	8000	52015889	-4000	4000	-1984
chr12	52356006	52364006	52360967	8000	52360006	-4000	4000	961
chr12	52389931	52397931	52395169	8000	52393931	-4000	4000	1238
chr12	52561782	52569782	52568256	8000	52565782	-4000	4000	2474
chr12	52603570	52611570	52609271	8000	52607570	-4000	4000	1701
chr12	52670736	52678736	52678597	8000	52674736	-4000	4000	3861
chr12	54544243	54552243	54549962	8000	54548243	-4000	4000	1719
chr12	54626811	54634811	54631741	8000	54630811	-4000	4000	930
chr12	55318364	55326364	55321006	8000	55322364	-4000	4000	-1358
chr12	55328687	55336687	55332392	8000	55332687	-4000	4000	-295
chr12	55397467	55405467	55401283	8000	55401467	-4000	4000	-184
chr12	55465200	55473200	55469646	8000	55469200	-4000	4000	446
chr12	55489316	55497316	55492735	8000	55493316	-4000	4000	-581
chr12	55680568	55688568	55684991	8000	55684568	-4000	4000	423
chr12	57599418	57607418	57606984	8000	57603418	-4000	4000	3566
chr12	63805792	63813792	63808980	8000	63809792	-4000	4000	-812
chr12	65244355	65252355	65246291	8000	65248355	-4000	4000	-2064
chr12	65962291	65970291	65963281	8000	65966291	-4000	4000	-3010
chr12	75499863	75507863	75499994	8000	75503863	-4000	4000	-3869
chr12	76340474	76348474	76346912	8000	76344474	-4000	4000	2438
chr12	76849696	76857696	76851060	8000	76853696	-4000	4000	-2636
chr12	80705474	80713474	80708581	8000	80709474	-4000	4000	-893
chr12	80715671	80723671	80717437	8000	80719671	-4000	4000	-2234
chr12	89584049	89592049	89591292	8000	89588049	-4000	4000	3243
chr12	90959682	90967682	90964263	8000	90963682	-4000	4000	581
chr12	91046491	91054491	91051508	8000	91050491	-4000	4000	1017
chr12	94303675	94311675	94310025	8000	94307675	-4000	4000	2350
chr12	101389116	101397116	101395640	8000	101393116	-4000	4000	2524
chr12	101482997	101490997	101486430	8000	101486997	-4000	4000	-567
chr12	102193520	102201520	102197311	8000	102197520	-4000	4000	-209
chr12	102193520	102201520	102197646	8000	102197520	-4000	4000	126
chr12	102832889	102840889	102840477	8000	102836889	-4000	4000	3588
chr12	103984987	103992987	103987127	8000	103988987	-4000	4000	-1860
chr12	106974778	106982778	106977620	8000	106978778	-4000	4000	-1158
chr12	108897043	108905043	108900567	8000	108901043	-4000	4000	-476
chr12	112156188	112164188	112162428	8000	112160188	-4000	4000	2240
chr12	114666255	114674255	114671915	8000	114670255	-4000	4000	1660
chr12	116572606	116580606	116575950	8000	116576606	-4000	4000	-656
chr12	123594582	123602582	123596763	8000	123598582	-4000	4000	-1819
chr12	129067725	129075725	129073916	8000	129071725	-4000	4000	2191
chr12	130161740	130169740	130164193	8000	130165740	-4000	4000	-1547
chr12	133103526	133111526	133106491	8000	133107526	-4000	4000	-1035
chr12	133198369	133206369	133204085	8000	133202369	-4000	4000	1716
chr12	26967579	26975579	26974013	8000	26971579	-4000	4000	2434
chr12	48961340	48969340	48966090	8000	48965340	-4000	4000	750
chr12	55128750	55136750	55130439	8000	55132750	-4000	4000	-2311
chr12	56919133	56927133	56923875	8000	56923133	-4000	4000	742
chr12	114349911	114357911	114355794	8000	114353911	-4000	4000	1883
chr12	114349911	114357911	114355941	8000	114353911	-4000	4000	2030
chr12	123405353	123413353	123407745	8000	123409353	-4000	4000	-1608
chr12	56356568	56364568	56361413	8000	56360568	-4000	4000	845
chr12	52464516	52472516	52469423	8000	52468516	-4000	4000	907
chr12	7154945	7162945	7158137	8000	7158945	-4000	4000	-808
chr12	51993078	52001078	51994019	8000	51997078	-4000	4000	-3059
chr12	80715671	80723671	80717347	8000	80719671	-4000	4000	-2324
chr12	48038897	48046897	48045336	8000	48042897	-4000	4000	2439
chr12	130392133	130400133	130399774	8000	130396133	-4000	4000	3641
chr12	52785685	52793685	52790286	8000	52789685	-4000	4000	601
chr12	103936763	103944763	103938421	8000	103940763	-4000	4000	-2342
chr12	42455715	42463715	42459687	8000	42459715	-4000	4000	-28
chr12	49640666	49648666	49643148	8000	49644666	-4000	4000	-1518
chr12	52764155	52772155	52771187	8000	52768155	-4000	4000	3032
chr12	106059345	106067345	106067089	8000	106063345	-4000	4000	3744
chr12	95511839	95519839	95517795	8000	95515839	-4000	4000	1956
chr12	52581589	52589589	52587801	8000	52585589	-4000	4000	2212
chr12	55950105	55958105	55955534	8000	55954105	-4000	4000	1429
chr12	51887727	51895727	51891146	8000	51891727	-4000	4000	-581
chr12	55680568	55688568	55681999	8000	55684568	-4000	4000	-2569
chr12	56592193	56600193	56599171	8000	56596193	-4000	4000	2978
chr12	132192372	132200372	132197214	8000	132196372	-4000	4000	842
chr12	95511839	95519839	95511897	8000	95515839	-4000	4000	-3942
chr12	10219128	10227128	10221871	8000	10223128	-4000	4000	-1257
chr12	10219128	10227128	10221973	8000	10223128	-4000	4000	-1155
chr12	57249762	57257762	57254777	8000	57253762	-4000	4000	1015
chr12	109532705	109540705	109534547	8000	109536705	-4000	4000	-2158
chr12	12641108	12649108	12642907	8000	12645108	-4000	4000	-2201
chr12	186077	194077	192500	8000	190077	-4000	4000	2423
chr12	52389931	52397931	52396231	8000	52393931	-4000	4000	2300
chr12	68741809	68749809	68741898	8000	68745809	-4000	4000	-3911
chr12	53477162	53485162	53483704	8000	53481162	-4000	4000	2542
chr12	8171320	8179320	8175921	8000	8175320	-4000	4000	601
chr12	22059773	22067773	22061312	8000	22063773	-4000	4000	-2461
chr12	55328687	55336687	55332158	8000	55332687	-4000	4000	-529
chr12	55633833	55641833	55637267	8000	55637833	-4000	4000	-566
chr12	52442651	52450651	52447408	8000	52446651	-4000	4000	757
chr12	56994836	57002836	57002361	8000	56998836	-4000	4000	3525
chr12	122267432	122275432	122272530	8000	122271432	-4000	4000	1098
chr12	50171788	50179788	50177199	8000	50175788	-4000	4000	1411
chr12	56445700	56453700	56451373	8000	56449700	-4000	4000	1673
chr12	117137991	117145991	117145861	8000	117141991	-4000	4000	3870
chr12	41570745	41578745	41572744	8000	41574745	-4000	4000	-2001
chr12	48198339	48206339	48202960	8000	48202339	-4000	4000	621
chr12	111346554	111354554	111347871	8000	111350554	-4000	4000	-2683
chr12	43785543	43793543	43786504	8000	43789543	-4000	4000	-3039
chr12	118145801	118153801	118152339	8000	118149801	-4000	4000	2538
chr12	121304245	121312245	121309773	8000	121308245	-4000	4000	1528
chr12	68244242	68252242	68248772	8000	68248242	-4000	4000	530
chr12	56356568	56364568	56361306	8000	56360568	-4000	4000	738
chr12	10062031	10070031	10065856	8000	10066031	-4000	4000	-175
chr12	21760955	21768955	21766321	8000	21764955	-4000	4000	1366
chr12	27954084	27962084	27958288	8000	27958084	-4000	4000	204
chr12	27077057	27085057	27081228	8000	27081057	-4000	4000	171
chr12	55289988	55297988	55294770	8000	55293988	-4000	4000	782
chr12	123704399	123712399	123707039	8000	123708399	-4000	4000	-1360
chr12	6342843	6350843	6348982	8000	6346843	-4000	4000	2139
chr12	114666255	114674255	114674242	8000	114670255	-4000	4000	3987
chr12	5042788	5050788	5044793	8000	5046788	-4000	4000	-1995
chr12	6816799	6824799	6819298	8000	6820799	-4000	4000	-1501
chr12	7085587	7093587	7091549	8000	7089587	-4000	4000	1962
chr12	34025694	34033694	34026421	8000	34029694	-4000	4000	-3273
chr12	47232662	47240662	47235833	8000	47236662	-4000	4000	-829
chr12	48469622	48477622	48472708	8000	48473622	-4000	4000	-914
chr12	48522570	48530570	48525902	8000	48526570	-4000	4000	-668
chr12	48563684	48571684	48567970	8000	48567684	-4000	4000	286
chr12	49523425	49531425	49526018	8000	49527425	-4000	4000	-1407
chr12	51887727	51895727	51889284	8000	51891727	-4000	4000	-2443
chr12	51887727	51895727	51891076	8000	51891727	-4000	4000	-651
chr12	54358445	54366445	54362785	8000	54362445	-4000	4000	340
chr12	54575239	54583239	54577447	8000	54579239	-4000	4000	-1792
chr12	69597570	69605570	69597676	8000	69601570	-4000	4000	-3894
chr12	123405353	123413353	123407624	8000	123409353	-4000	4000	-1729
chr12	129067725	129075725	129074536	8000	129071725	-4000	4000	2811
chr12	6816799	6824799	6824383	8000	6820799	-4000	4000	3584
chr12	47232662	47240662	47236292	8000	47236662	-4000	4000	-370
chr12	8598170	8606170	8604189	8000	8602170	-4000	4000	2019
chr12	11261914	11269914	11268134	8000	11265914	-4000	4000	2220
chr12	26901181	26909181	26905412	8000	26905181	-4000	4000	231
chr12	48469622	48477622	48472991	8000	48473622	-4000	4000	-631
chr12	56947431	56955431	56951866	8000	56951431	-4000	4000	435
chr12	55397467	55405467	55401110	8000	55401467	-4000	4000	-357
chr12	6234271	6242271	6235559	8000	6238271	-4000	4000	-2712
chr12	11303077	11311077	11308474	8000	11307077	-4000	4000	1397
chr12	106506198	106514198	106509633	8000	106510198	-4000	4000	-565
chr12	57209361	57217361	57211303	8000	57213361	-4000	4000	-2058
chr12	49014975	49022975	49021615	8000	49018975	-4000	4000	2640
chr12	56947431	56955431	56951984	8000	56951431	-4000	4000	553
chr12	16033381	16041381	16036817	8000	16037381	-4000	4000	-564
chr12	31667142	31675142	31667913	8000	31671142	-4000	4000	-3229
chr12	41570745	41578745	41573361	8000	41574745	-4000	4000	-1384
chr12	45915131	45923131	45922120	8000	45919131	-4000	4000	2989
chr12	76340474	76348474	76346706	8000	76344474	-4000	4000	2232
chr12	91046491	91054491	91051478	8000	91050491	-4000	4000	987
chr12	52011889	52019889	52014189	8000	52015889	-4000	4000	-1700
chr12	57209361	57217361	57212526	8000	57213361	-4000	4000	-835
chr12	66343431	66351431	66349039	8000	66347431	-4000	4000	1608
chr12	106059345	106067345	106067273	8000	106063345	-4000	4000	3928
chr12	6727875	6735875	6731215	8000	6731875	-4000	4000	-660
chr12	128703911	128711911	128705201	8000	128707911	-4000	4000	-2710
chr12	110214793	110222793	110218252	8000	110218793	-4000	4000	-541
chr12	123658604	123666604	123659795	8000	123662604	-4000	4000	-2809
chr12	56356568	56364568	56356569	8000	56360568	-4000	4000	-3999
chr12	71923248	71931248	71923943	8000	71927248	-4000	4000	-3305
chr12	55289988	55297988	55294899	8000	55293988	-4000	4000	911
chr12	56994836	57002836	57002831	8000	56998836	-4000	4000	3995
chr12	98722457	98730457	98723218	8000	98726457	-4000	4000	-3239
chr12	119681791	119689791	119687494	8000	119685791	-4000	4000	1703
chr12	95511839	95519839	95518024	8000	95515839	-4000	4000	2185
chr12	106974778	106982778	106978571	8000	106978778	-4000	4000	-207
chr12	89415718	89423718	89421217	8000	89419718	-4000	4000	1499
chr12	96265824	96273824	96267251	8000	96269824	-4000	4000	-2573
chr12	55318364	55326364	55320839	8000	55322364	-4000	4000	-1525
chr12	55950105	55958105	55955327	8000	55954105	-4000	4000	1222
chr12	27691564	27699564	27697199	8000	27695564	-4000	4000	1635
chr12	49123782	49131782	49128752	8000	49127782	-4000	4000	970
chr12	70350993	70358993	70353999	8000	70354993	-4000	4000	-994
chr12	71605599	71613599	71610349	8000	71609599	-4000	4000	750
chr12	108585851	108593851	108591720	8000	108589851	-4000	4000	1869
chr12	53098345	53106345	53100741	8000	53102345	-4000	4000	-1604
chr12	130161740	130169740	130163053	8000	130165740	-4000	4000	-2687
chr12	10820960	10828960	10825900	8000	10824960	-4000	4000	940
chr12	31276584	31284584	31282736	8000	31280584	-4000	4000	2152
chr12	52510575	52518575	52517651	8000	52514575	-4000	4000	3076
chr12	51182936	51190936	51190092	8000	51186936	-4000	4000	3156
chr12	85297784	85305784	85301528	8000	85301784	-4000	4000	-256
chr12	102193520	102201520	102196199	8000	102197520	-4000	4000	-1321
chr12	94303675	94311675	94305223	8000	94307675	-4000	4000	-2452
chr12	6342843	6350843	6349201	8000	6346843	-4000	4000	2358
chr12	11387540	11395540	11393873	8000	11391540	-4000	4000	2333
chr12	26331352	26339352	26338462	8000	26335352	-4000	4000	3110
chr12	47778722	47786722	47783747	8000	47782722	-4000	4000	1025
chr12	52310301	52318301	52316560	8000	52314301	-4000	4000	2259
chr12	80715671	80723671	80717275	8000	80719671	-4000	4000	-2396
chr12	50171788	50179788	50177835	8000	50175788	-4000	4000	2047
chr12	102193520	102201520	102197337	8000	102197520	-4000	4000	-183
chr12	25201246	25209246	25204195	8000	25205246	-4000	4000	-1051
chr12	5042788	5050788	5045842	8000	5046788	-4000	4000	-946
chr12	8052844	8060844	8059945	8000	8056844	-4000	4000	3101
chr12	78209010	78217010	78211639	8000	78213010	-4000	4000	-1371
chr12	109264226	109272226	109266287	8000	109268226	-4000	4000	-1939
chr12	52670736	52678736	52675496	8000	52674736	-4000	4000	760
chr12	133198369	133206369	133203937	8000	133202369	-4000	4000	1568
chr12	89343235	89351235	89348359	8000	89347235	-4000	4000	1124
chr12	122467599	122475599	122473540	8000	122471599	-4000	4000	1941
chr12	122467599	122475599	122473906	8000	122471599	-4000	4000	2307
chr12	57622125	57630125	57628838	8000	57626125	-4000	4000	2713
chr12	111753107	111761107	111755668	8000	111757107	-4000	4000	-1439
chr12	48143789	48151789	48145650	8000	48147789	-4000	4000	-2139
chr12	122722076	122730076	122729700	8000	122726076	-4000	4000	3624
chr12	71694968	71702968	71699275	8000	71698968	-4000	4000	307
chr12	53412446	53420446	53415680	8000	53416446	-4000	4000	-766
chr12	53295452	53303452	53295534	8000	53299452	-4000	4000	-3918
chr12	100337715	100345715	100338852	8000	100341715	-4000	4000	-2863
chr12	6552886	6560886	6557636	8000	6556886	-4000	4000	750
chr12	52373812	52381812	52380568	8000	52377812	-4000	4000	2756
chr12	116572606	116580606	116576275	8000	116576606	-4000	4000	-331
chr12	6462517	6470517	6464942	8000	6466517	-4000	4000	-1575
chr12	55449347	55457347	55452766	8000	55453347	-4000	4000	-581
chr12	117027148	117035148	117028045	8000	117031148	-4000	4000	-3103
chr12	100560414	100568414	100563571	8000	100564414	-4000	4000	-843
chr12	6527955	6535955	6528274	8000	6531955	-4000	4000	-3681
chr12	106974778	106982778	106977751	8000	106978778	-4000	4000	-1027
chr12	129067725	129075725	129073689	8000	129071725	-4000	4000	1964
chr12	121835527	121843527	121839987	8000	121839527	-4000	4000	460
chr12	129067725	129075725	129074283	8000	129071725	-4000	4000	2558
chr12	49954878	49962878	49955462	8000	49958878	-4000	4000	-3416
chr12	3036676	3044676	3038048	8000	3040676	-4000	4000	-2628
chr12	48038897	48046897	48045346	8000	48042897	-4000	4000	2449
chr12	49640666	49648666	49642822	8000	49644666	-4000	4000	-1844
chr12	123466054	123474054	123472637	8000	123470054	-4000	4000	2583
chr12	130161740	130169740	130163956	8000	130165740	-4000	4000	-1784
chr12	52356006	52364006	52360864	8000	52360006	-4000	4000	858
chr12	55289988	55297988	55295069	8000	55293988	-4000	4000	1081
chr12	7085587	7093587	7088932	8000	7089587	-4000	4000	-655
chr12	21793389	21801389	21800946	8000	21797389	-4000	4000	3557
chr12	54288111	54296111	54293165	8000	54292111	-4000	4000	1054
chr12	54358445	54366445	54362978	8000	54362445	-4000	4000	533
chr12	55318364	55326364	55320821	8000	55322364	-4000	4000	-1543
chr12	57209361	57217361	57210046	8000	57213361	-4000	4000	-3315
chr12	71605599	71613599	71613342	8000	71609599	-4000	4000	3743
chr12	106233881	106241881	106239344	8000	106237881	-4000	4000	1463
chr12	106758803	106766803	106761455	8000	106762803	-4000	4000	-1348
chr12	108518214	108526214	108518831	8000	108522214	-4000	4000	-3383
chr12	109084188	109092188	109085930	8000	109088188	-4000	4000	-2258
chr12	130392133	130400133	130399758	8000	130396133	-4000	4000	3625
chr12	133198369	133206369	133203782	8000	133202369	-4000	4000	1413
chr12	133198369	133206369	133204009	8000	133202369	-4000	4000	1640
chr12	6662477	6670477	6663132	8000	6666477	-4000	4000	-3345
chr12	27077057	27085057	27082133	8000	27081057	-4000	4000	1076
chr12	69597570	69605570	69597984	8000	69601570	-4000	4000	-3586
chr12	47232662	47240662	47235811	8000	47236662	-4000	4000	-851
chr12	50096707	50104707	50104656	8000	50100707	-4000	4000	3949
chr12	53322575	53330575	53329278	8000	53326575	-4000	4000	2703
chr12	56592193	56600193	56598403	8000	56596193	-4000	4000	2210
chr12	89584049	89592049	89590318	8000	89588049	-4000	4000	2269
chr12	109779087	109787087	109786773	8000	109783087	-4000	4000	3686
chr12	123411039	123419039	123415515	8000	123415039	-4000	4000	476
chr12	88045016	88053016	88050415	8000	88049016	-4000	4000	1399
chr13	36297638	36305638	36304363	8000	36301638	-4000	4000	2725
chr13	110519066	110527066	110523684	8000	110523066	-4000	4000	618
chr13	52472628	52480628	52473937	8000	52476628	-4000	4000	-2691
chr13	20969036	20977036	20974786	8000	20973036	-4000	4000	1750
chr13	23887099	23895099	23891400	8000	23891099	-4000	4000	301
chr13	101706804	101714804	101714489	8000	101710804	-4000	4000	3685
chr13	69696594	69704594	69701495	8000	69700594	-4000	4000	901
chr13	113168386	113176386	113171716	8000	113172386	-4000	4000	-670
chr13	41123569	41131569	41130567	8000	41127569	-4000	4000	2998
chr13	41185834	41193834	41193389	8000	41189834	-4000	4000	3555
chr13	96981713	96989713	96986489	8000	96985713	-4000	4000	776
chr13	19169772	19177772	19177302	8000	19173772	-4000	4000	3530
chr13	19169772	19177772	19177510	8000	19173772	-4000	4000	3738
chr13	39005865	39013865	39013395	8000	39009865	-4000	4000	3530
chr13	98789429	98797429	98794721	8000	98793429	-4000	4000	1292
chr13	108203439	108211439	108210437	8000	108207439	-4000	4000	2998
chr13	26040597	26048597	26046455	8000	26044597	-4000	4000	1858
chr13	37099259	37107259	37104841	8000	37103259	-4000	4000	1582
chr13	111301737	111309737	111303184	8000	111305737	-4000	4000	-2553
chr13	61405858	61413858	61411396	8000	61409858	-4000	4000	1538
chr13	85788790	85796790	85795540	8000	85792790	-4000	4000	2750
chr13	20969036	20977036	20974977	8000	20973036	-4000	4000	1941
chr13	20134255	20142255	20141937	8000	20138255	-4000	4000	3682
chr13	106537673	106545673	106543770	8000	106541673	-4000	4000	2097
chr13	30760426	30768426	30764089	8000	30764426	-4000	4000	-337
chr13	102725367	102733367	102732605	8000	102729367	-4000	4000	3238
chr13	102725367	102733367	102732774	8000	102729367	-4000	4000	3407
chr13	112067706	112075706	112071036	8000	112071706	-4000	4000	-670
chr13	112430689	112438689	112434557	8000	112434689	-4000	4000	-132
chr13	19819482	19827482	19824574	8000	19823482	-4000	4000	1092
chr13	28291335	28299335	28294809	8000	28295335	-4000	4000	-526
chr13	36438870	36446870	36442178	8000	36442870	-4000	4000	-692
chr13	41185834	41193834	41192891	8000	41189834	-4000	4000	3057
chr13	38961925	38969925	38968474	8000	38965925	-4000	4000	2549
chr13	24878279	24886279	24885658	8000	24882279	-4000	4000	3379
chr13	37005312	37013312	37009396	8000	37009312	-4000	4000	84
chr13	112067706	112075706	112069171	8000	112071706	-4000	4000	-2535
chr13	25095254	25103254	25096241	8000	25099254	-4000	4000	-3013
chr13	28296346	28304346	28303255	8000	28300346	-4000	4000	2909
chr13	39005865	39013865	39013184	8000	39009865	-4000	4000	3319
chr13	41123569	41131569	41130621	8000	41127569	-4000	4000	3052
chr13	83873205	83881205	83880123	8000	83877205	-4000	4000	2918
chr13	108203439	108211439	108210569	8000	108207439	-4000	4000	3130
chr13	113145529	113153529	113149170	8000	113149529	-4000	4000	-359
chr13	37558583	37566583	37563321	8000	37562583	-4000	4000	738
chr13	26684948	26692948	26685840	8000	26688948	-4000	4000	-3108
chr13	27956918	27964918	27963277	8000	27960918	-4000	4000	2359
chr13	113637473	113645473	113637884	8000	113641473	-4000	4000	-3589
chr13	27922313	27930313	27924481	8000	27926313	-4000	4000	-1832
chr13	80331976	80339976	80337103	8000	80335976	-4000	4000	1127
chr13	83873205	83881205	83879470	8000	83877205	-4000	4000	2265
chr13	113116685	113124685	113122863	8000	113120685	-4000	4000	2178
chr13	113145529	113153529	113147491	8000	113149529	-4000	4000	-2038
chr13	45389316	45397316	45397291	8000	45393316	-4000	4000	3975
chr13	95575759	95583759	95578058	8000	95579759	-4000	4000	-1701
chr13	49695320	49703320	49701895	8000	49699320	-4000	4000	2575
chr13	113973783	113981783	113979268	8000	113977783	-4000	4000	1485
chr13	27271192	27279192	27273335	8000	27275192	-4000	4000	-1857
chr13	95575759	95583759	95582258	8000	95579759	-4000	4000	2499
chr13	113637473	113645473	113637884	8000	113641473	-4000	4000	-3589
chr13	69696594	69704594	69701585	8000	69700594	-4000	4000	991
chr13	78610289	78618289	78616320	8000	78614289	-4000	4000	2031
chr13	113319672	113327672	113324466	8000	113323672	-4000	4000	794
chr13	23887099	23895099	23891257	8000	23891099	-4000	4000	158
chr13	36693839	36701839	36695167	8000	36697839	-4000	4000	-2672
chr13	78594362	78602362	78601589	8000	78598362	-4000	4000	3227
chr13	102761888	102769888	102769388	8000	102765888	-4000	4000	3500
chr13	113319672	113327672	113324449	8000	113323672	-4000	4000	777
chr13	25095254	25103254	25098130	8000	25099254	-4000	4000	-1124
chr13	41185834	41193834	41192822	8000	41189834	-4000	4000	2988
chr13	53048057	53056057	53050015	8000	53052057	-4000	4000	-2042
chr13	37005312	37013312	37010645	8000	37009312	-4000	4000	1333
chr13	102725367	102733367	102730154	8000	102729367	-4000	4000	787
chr13	31328276	31336276	31329575	8000	31332276	-4000	4000	-2701
chr13	27790768	27798768	27793679	8000	27794768	-4000	4000	-1089
chr13	44428143	44436143	44436046	8000	44432143	-4000	4000	3903
chr13	40725128	40733128	40729408	8000	40729128	-4000	4000	280
chr13	98679801	98687801	98687634	8000	98683801	-4000	4000	3833
chr13	32396268	32404268	32398424	8000	32400268	-4000	4000	-1844
chr13	50016481	50024481	50016653	8000	50020481	-4000	4000	-3828
chr13	57725311	57733311	57726157	8000	57729311	-4000	4000	-3154
chr13	27062156	27070156	27069225	8000	27066156	-4000	4000	3069
chr13	108230243	108238243	108232301	8000	108234243	-4000	4000	-1942
chr13	102725367	102733367	102730037	8000	102729367	-4000	4000	670
chr13	21488691	21496691	21496161	8000	21492691	-4000	4000	3470
chr13	37099259	37107259	37104182	8000	37103259	-4000	4000	923
chr13	61405858	61413858	61412132	8000	61409858	-4000	4000	2274
chr13	32396268	32404268	32396919	8000	32400268	-4000	4000	-3349
chr13	53048057	53056057	53050243	8000	53052057	-4000	4000	-1814
chr13	85788790	85796790	85793781	8000	85792790	-4000	4000	991
chr13	113116685	113124685	113117520	8000	113120685	-4000	4000	-3165
chr13	83873205	83881205	83879762	8000	83877205	-4000	4000	2557
chr13	108203439	108211439	108210110	8000	108207439	-4000	4000	2671
chr13	85788790	85796790	85796263	8000	85792790	-4000	4000	3473
chr13	83873205	83881205	83879530	8000	83877205	-4000	4000	2325
chr13	51020120	51028120	51020585	8000	51024120	-4000	4000	-3535
chr13	49205779	49213779	49207135	8000	49209779	-4000	4000	-2644
chr13	50016481	50024481	50017007	8000	50020481	-4000	4000	-3474
chr13	102871994	102879994	102875569	8000	102875994	-4000	4000	-425
chr13	45280893	45288893	45283478	8000	45284893	-4000	4000	-1415
chr13	40927924	40935924	40933281	8000	40931924	-4000	4000	1357
chr13	108230243	108238243	108230351	8000	108234243	-4000	4000	-3892
chr13	98020296	98028296	98021850	8000	98024296	-4000	4000	-2446
chr13	30656770	30664770	30658031	8000	30660770	-4000	4000	-2739
chr13	36438870	36446870	36442716	8000	36442870	-4000	4000	-154
chr13	36438870	36446870	36442758	8000	36442870	-4000	4000	-112
chr13	41466871	41474871	41470640	8000	41470871	-4000	4000	-231
chr13	37099259	37107259	37104383	8000	37103259	-4000	4000	1124
chr13	110874540	110882540	110879842	8000	110878540	-4000	4000	1302
chr13	102725367	102733367	102732808	8000	102729367	-4000	4000	3441
chr13	52373167	52381167	52378185	8000	52377167	-4000	4000	1018
chr13	51862232	51870232	51865457	8000	51866232	-4000	4000	-775
chr13	98679801	98687801	98686253	8000	98683801	-4000	4000	2452
chr13	35669022	35677022	35671026	8000	35673022	-4000	4000	-1996
chr13	83873205	83881205	83880638	8000	83877205	-4000	4000	3433
chr13	94705622	94713622	94712100	8000	94709622	-4000	4000	2478
chr13	114301817	114309817	114304830	8000	114305817	-4000	4000	-987
chr13	25095254	25103254	25097603	8000	25099254	-4000	4000	-1651
chr13	106485745	106493745	106492070	8000	106489745	-4000	4000	2325
chr13	113263108	113271108	113264783	8000	113267108	-4000	4000	-2325
chr13	32295125	32303125	32295870	8000	32299125	-4000	4000	-3255
chr13	79552077	79560077	79552694	8000	79556077	-4000	4000	-3383
chr13	28696064	28704064	28701299	8000	28700064	-4000	4000	1235
chr13	51862232	51870232	51865374	8000	51866232	-4000	4000	-858
chr13	23887099	23895099	23891835	8000	23891099	-4000	4000	736
chr13	49629872	49637872	49630786	8000	49633872	-4000	4000	-3086
chr13	49656674	49664674	49661032	8000	49660674	-4000	4000	358
chr13	85788790	85796790	85794135	8000	85792790	-4000	4000	1345
chr13	52373167	52381167	52378471	8000	52377167	-4000	4000	1304
chr13	102761888	102769888	102766198	8000	102765888	-4000	4000	310
chr13	83873205	83881205	83880784	8000	83877205	-4000	4000	3579
chr13	51020120	51028120	51025347	8000	51024120	-4000	4000	1227
chr13	51280239	51288239	51280957	8000	51284239	-4000	4000	-3282
chr13	102725367	102733367	102732773	8000	102729367	-4000	4000	3406
chr13	52838889	52846889	52844790	8000	52842889	-4000	4000	1901
chr13	27252691	27260691	27256219	8000	27256691	-4000	4000	-472
chr13	105487034	105495034	105490004	8000	105491034	-4000	4000	-1030
chr13	49218377	49226377	49222269	8000	49222377	-4000	4000	-108
chr13	25095254	25103254	25098334	8000	25099254	-4000	4000	-920
chr13	98679801	98687801	98686245	8000	98683801	-4000	4000	2444
chr13	51280239	51288239	51280884	8000	51284239	-4000	4000	-3355
chr13	83873205	83881205	83880361	8000	83877205	-4000	4000	3156
chr13	30656770	30664770	30658928	8000	30660770	-4000	4000	-1842
chr13	102725367	102733367	102733099	8000	102729367	-4000	4000	3732
chr13	94705622	94713622	94711145	8000	94709622	-4000	4000	1523
chr13	25095254	25103254	25096139	8000	25099254	-4000	4000	-3115
chr13	48707226	48715226	48708033	8000	48711226	-4000	4000	-3193
chr13	57725311	57733311	57725837	8000	57729311	-4000	4000	-3474
chr13	96981713	96989713	96986489	8000	96985713	-4000	4000	776
chr13	75855870	75863870	75856562	8000	75859870	-4000	4000	-3308
chr13	28696064	28704064	28700976	8000	28700064	-4000	4000	912
chr13	48707226	48715226	48708575	8000	48711226	-4000	4000	-2651
chr13	73073541	73081541	73075924	8000	73077541	-4000	4000	-1617
chr13	46049186	46057186	46053790	8000	46053186	-4000	4000	604
chr13	48707226	48715226	48707632	8000	48711226	-4000	4000	-3594
chr13	26751200	26759200	26758866	8000	26755200	-4000	4000	3666
chr13	52128639	52136639	52133151	8000	52132639	-4000	4000	512
chr13	78610289	78618289	78615672	8000	78614289	-4000	4000	1383
chr13	85788790	85796790	85795484	8000	85792790	-4000	4000	2694
chr13	19169772	19177772	19174098	8000	19173772	-4000	4000	326
chr13	46827546	46835546	46835500	8000	46831546	-4000	4000	3954
chr13	49218377	49226377	49222313	8000	49222377	-4000	4000	-64
chr13	25095254	25103254	25098102	8000	25099254	-4000	4000	-1152
chr13	27271192	27279192	27273096	8000	27275192	-4000	4000	-2096
chr13	77760242	77768242	77763394	8000	77764242	-4000	4000	-848
chr13	61405858	61413858	61411367	8000	61409858	-4000	4000	1509
chr13	108203439	108211439	108209605	8000	108207439	-4000	4000	2166
chr13	31328276	31336276	31329504	8000	31332276	-4000	4000	-2772
chr13	33062143	33070143	33065349	8000	33066143	-4000	4000	-794
chr13	59661583	59669583	59666675	8000	59665583	-4000	4000	1092
chr13	77038474	77046474	77045084	8000	77042474	-4000	4000	2610
chr13	111301737	111309737	111303080	8000	111305737	-4000	4000	-2657
chr13	114268723	114276723	114272586	8000	114272723	-4000	4000	-137
chr13	49629872	49637872	49630515	8000	49633872	-4000	4000	-3357
chr13	113263108	113271108	113264633	8000	113267108	-4000	4000	-2475
chr13	32396268	32404268	32397012	8000	32400268	-4000	4000	-3256
chr13	51763709	51771709	51771287	8000	51767709	-4000	4000	3578
chr13	80331976	80339976	80337350	8000	80335976	-4000	4000	1374
chr13	37005312	37013312	37010632	8000	37009312	-4000	4000	1320
chr13	49527946	49535946	49534253	8000	49531946	-4000	4000	2307
chr13	20969036	20977036	20975352	8000	20973036	-4000	4000	2316
chr13	24708472	24716472	24709759	8000	24712472	-4000	4000	-2713
chr13	37558583	37566583	37563217	8000	37562583	-4000	4000	634
chr13	40927924	40935924	40933267	8000	40931924	-4000	4000	1343
chr13	45710559	45718559	45714162	8000	45714559	-4000	4000	-397
chr13	83873205	83881205	83877978	8000	83877205	-4000	4000	773
chr13	108203439	108211439	108211188	8000	108207439	-4000	4000	3749
chr13	113263108	113271108	113263491	8000	113267108	-4000	4000	-3617
chr13	113637473	113645473	113637709	8000	113641473	-4000	4000	-3764
chr13	40927924	40935924	40933600	8000	40931924	-4000	4000	1676
chr13	112430689	112438689	112434637	8000	112434689	-4000	4000	-52
chr13	113451819	113459819	113453243	8000	113455819	-4000	4000	-2576
chr13	113451819	113459819	113453408	8000	113455819	-4000	4000	-2411
chr13	66298834	66306834	66302976	8000	66302834	-4000	4000	142
chr13	45389316	45397316	45395974	8000	45393316	-4000	4000	2658
chr13	76876175	76884175	76881528	8000	76880175	-4000	4000	1353
chr13	23887099	23895099	23891660	8000	23891099	-4000	4000	561
chr13	24317031	24325031	24321397	8000	24321031	-4000	4000	366
chr13	85788790	85796790	85796411	8000	85792790	-4000	4000	3621
chr13	85788790	85796790	85796412	8000	85792790	-4000	4000	3622
chr13	39005865	39013865	39013088	8000	39009865	-4000	4000	3223
chr13	32396268	32404268	32396925	8000	32400268	-4000	4000	-3343
chr13	41185834	41193834	41193126	8000	41189834	-4000	4000	3292
chr13	46049186	46057186	46055796	8000	46053186	-4000	4000	2610
chr13	31130973	31138973	31137317	8000	31134973	-4000	4000	2344
chr13	40808460	40816460	40808533	8000	40812460	-4000	4000	-3927
chr13	78610289	78618289	78617142	8000	78614289	-4000	4000	2853
chr13	78610289	78618289	78617143	8000	78614289	-4000	4000	2854
chr13	98020296	98028296	98022910	8000	98024296	-4000	4000	-1386
chr13	102725367	102733367	102729398	8000	102729367	-4000	4000	31
chr13	20217962	20225962	20223469	8000	20221962	-4000	4000	1507
chr13	78610289	78618289	78616147	8000	78614289	-4000	4000	1858
chr13	41185834	41193834	41193149	8000	41189834	-4000	4000	3315
chr13	20724731	20732731	20728997	8000	20728731	-4000	4000	266
chr13	85788790	85796790	85795773	8000	85792790	-4000	4000	2983
chr13	85788790	85796790	85795857	8000	85792790	-4000	4000	3067
chr13	32295125	32303125	32295216	8000	32299125	-4000	4000	-3909
chr13	102725367	102733367	102730507	8000	102729367	-4000	4000	1140
chr13	112430689	112438689	112434512	8000	112434689	-4000	4000	-177
chr13	33062143	33070143	33064029	8000	33066143	-4000	4000	-2114
chr13	28696064	28704064	28701357	8000	28700064	-4000	4000	1293
chr13	96981713	96989713	96987684	8000	96985713	-4000	4000	1971
chr13	111301737	111309737	111303059	8000	111305737	-4000	4000	-2678
chr13	39046109	39054109	39048123	8000	39050109	-4000	4000	-1986
chr13	49629872	49637872	49630673	8000	49633872	-4000	4000	-3199
chr13	25095254	25103254	25096991	8000	25099254	-4000	4000	-2263
chr13	106485745	106493745	106493260	8000	106489745	-4000	4000	3515
chr13	77891481	77899481	77898156	8000	77895481	-4000	4000	2675
chr13	98789429	98797429	98793768	8000	98793429	-4000	4000	339
chr13	52373167	52381167	52378394	8000	52377167	-4000	4000	1227
chr13	19819482	19827482	19824640	8000	19823482	-4000	4000	1158
chr13	44935249	44943249	44941129	8000	44939249	-4000	4000	1880
chr13	30971500	30979500	30974928	8000	30975500	-4000	4000	-572
chr13	25095254	25103254	25097971	8000	25099254	-4000	4000	-1283
chr13	49656674	49664674	49661000	8000	49660674	-4000	4000	326
chr13	96981713	96989713	96987472	8000	96985713	-4000	4000	1759
chr13	28674959	28682959	28678072	8000	28678959	-4000	4000	-887
chr13	28696064	28704064	28701424	8000	28700064	-4000	4000	1360
chr13	37005312	37013312	37009798	8000	37009312	-4000	4000	486
chr13	41212369	41220369	41217173	8000	41216369	-4000	4000	804
chr13	46827546	46835546	46834644	8000	46831546	-4000	4000	3098
chr13	46827546	46835546	46834893	8000	46831546	-4000	4000	3347
chr13	49218377	49226377	49222125	8000	49222377	-4000	4000	-252
chr13	78610289	78618289	78617089	8000	78614289	-4000	4000	2800
chr13	80331976	80339976	80337690	8000	80335976	-4000	4000	1714
chr13	85788790	85796790	85795185	8000	85792790	-4000	4000	2395
chr13	110635996	110643996	110638346	8000	110639996	-4000	4000	-1650
chr13	30656770	30664770	30658231	8000	30660770	-4000	4000	-2539
chr13	78594362	78602362	78599562	8000	78598362	-4000	4000	1200
chr13	48707226	48715226	48707228	8000	48711226	-4000	4000	-3998
chr13	52472628	52480628	52475003	8000	52476628	-4000	4000	-1625
chr13	20399666	20407666	20404060	8000	20403666	-4000	4000	394
chr13	25095254	25103254	25098152	8000	25099254	-4000	4000	-1102
chr13	80331976	80339976	80336832	8000	80335976	-4000	4000	856
chr13	33962558	33970558	33966119	8000	33966558	-4000	4000	-439
chr13	19169772	19177772	19177148	8000	19173772	-4000	4000	3376
chr13	19418877	19426877	19423150	8000	19422877	-4000	4000	273
chr13	21488691	21496691	21495250	8000	21492691	-4000	4000	2559
chr13	24317031	24325031	24321048	8000	24321031	-4000	4000	17
chr13	24317031	24325031	24321325	8000	24321031	-4000	4000	294
chr13	24878279	24886279	24883109	8000	24882279	-4000	4000	830
chr13	25095254	25103254	25097644	8000	25099254	-4000	4000	-1610
chr13	28674959	28682959	28678049	8000	28678959	-4000	4000	-910
chr13	30656770	30664770	30659329	8000	30660770	-4000	4000	-1441
chr13	30921572	30929572	30921674	8000	30925572	-4000	4000	-3898
chr13	32396268	32404268	32398537	8000	32400268	-4000	4000	-1731
chr13	33062143	33070143	33064043	8000	33066143	-4000	4000	-2100
chr13	38961925	38969925	38966746	8000	38965925	-4000	4000	821
chr13	39005865	39013865	39013112	8000	39009865	-4000	4000	3247
chr13	41080006	41088006	41082814	8000	41084006	-4000	4000	-1192
chr13	41123569	41131569	41131065	8000	41127569	-4000	4000	3496
chr13	41123569	41131569	41131130	8000	41127569	-4000	4000	3561
chr13	41185834	41193834	41193709	8000	41189834	-4000	4000	3875
chr13	43209130	43217130	43213931	8000	43213130	-4000	4000	801
chr13	44935249	44943249	44941271	8000	44939249	-4000	4000	2022
chr13	46827546	46835546	46834770	8000	46831546	-4000	4000	3224
chr13	77891481	77899481	77896418	8000	77895481	-4000	4000	937
chr13	78610289	78618289	78617130	8000	78614289	-4000	4000	2841
chr13	80331976	80339976	80336742	8000	80335976	-4000	4000	766
chr13	83873205	83881205	83880972	8000	83877205	-4000	4000	3767
chr13	85788790	85796790	85795896	8000	85792790	-4000	4000	3106
chr13	94432811	94440811	94439962	8000	94436811	-4000	4000	3151
chr13	94570054	94578054	94578019	8000	94574054	-4000	4000	3965
chr13	96981713	96989713	96987550	8000	96985713	-4000	4000	1837
chr13	102681747	102689747	102686303	8000	102685747	-4000	4000	556
chr13	102725367	102733367	102730982	8000	102729367	-4000	4000	1615
chr13	102725367	102733367	102733304	8000	102729367	-4000	4000	3937
chr13	113319672	113327672	113322370	8000	113323672	-4000	4000	-1302
chr13	114268723	114276723	114272408	8000	114272723	-4000	4000	-315
chr13	29501947	29509947	29503003	8000	29505947	-4000	4000	-2944
chr13	30760426	30768426	30764185	8000	30764426	-4000	4000	-241
chr13	40808460	40816460	40809585	8000	40812460	-4000	4000	-2875
chr13	39005865	39013865	39013504	8000	39009865	-4000	4000	3639
chr13	99958964	99966964	99965387	8000	99962964	-4000	4000	2423
chr13	19169772	19177772	19174055	8000	19173772	-4000	4000	283
chr13	25095254	25103254	25096240	8000	25099254	-4000	4000	-3014
chr13	37558583	37566583	37563302	8000	37562583	-4000	4000	719
chr13	49527946	49535946	49533876	8000	49531946	-4000	4000	1930
chr13	85788790	85796790	85795161	8000	85792790	-4000	4000	2371
chr13	59661583	59669583	59666801	8000	59665583	-4000	4000	1218
chr13	49304650	49312650	49310783	8000	49308650	-4000	4000	2133
chr13	32295125	32303125	32295275	8000	32299125	-4000	4000	-3850
chr13	20183463	20191463	20189144	8000	20187463	-4000	4000	1681
chr13	113733736	113741736	113735418	8000	113737736	-4000	4000	-2318
chr13	94570054	94578054	94574579	8000	94574054	-4000	4000	525
chr13	19418877	19426877	19425011	8000	19422877	-4000	4000	2134
chr13	32396268	32404268	32398437	8000	32400268	-4000	4000	-1831
chr13	27999274	28007274	28004067	8000	28003274	-4000	4000	793
chr13	49205779	49213779	49207516	8000	49209779	-4000	4000	-2263
chr13	27790768	27798768	27793836	8000	27794768	-4000	4000	-932
chr13	106485745	106493745	106493110	8000	106489745	-4000	4000	3365
chr13	102725367	102733367	102733252	8000	102729367	-4000	4000	3885
chr13	23887099	23895099	23891665	8000	23891099	-4000	4000	566
chr13	24317031	24325031	24321392	8000	24321031	-4000	4000	361
chr13	109204005	109212005	109206614	8000	109208005	-4000	4000	-1391
chr13	19819482	19827482	19824594	8000	19823482	-4000	4000	1112
chr13	112481011	112489011	112486067	8000	112485011	-4000	4000	1056
chr13	110635996	110643996	110638279	8000	110639996	-4000	4000	-1717
chr13	113116685	113124685	113118580	8000	113120685	-4000	4000	-2105
chr13	49656674	49664674	49660905	8000	49660674	-4000	4000	231
chr13	44428143	44436143	44436090	8000	44432143	-4000	4000	3947
chr13	20183463	20191463	20188983	8000	20187463	-4000	4000	1520
chr13	39005865	39013865	39013406	8000	39009865	-4000	4000	3541
chr13	75855870	75863870	75858442	8000	75859870	-4000	4000	-1428
chr13	80331976	80339976	80337030	8000	80335976	-4000	4000	1054
chr13	28696064	28704064	28701249	8000	28700064	-4000	4000	1185
chr13	51280239	51288239	51280533	8000	51284239	-4000	4000	-3706
chr13	113116685	113124685	113117571	8000	113120685	-4000	4000	-3114
chr13	37099259	37107259	37104763	8000	37103259	-4000	4000	1504
chr13	20217962	20225962	20223279	8000	20221962	-4000	4000	1317
chr13	41080006	41088006	41082749	8000	41084006	-4000	4000	-1257
chr13	46827546	46835546	46834762	8000	46831546	-4000	4000	3216
chr13	98789429	98797429	98793842	8000	98793429	-4000	4000	413
chr13	39046109	39054109	39047807	8000	39050109	-4000	4000	-2302
chr13	96981713	96989713	96987419	8000	96985713	-4000	4000	1706
chr13	40927924	40935924	40932876	8000	40931924	-4000	4000	952
chr13	83873205	83881205	83878529	8000	83877205	-4000	4000	1324
chr13	77760242	77768242	77763873	8000	77764242	-4000	4000	-369
chr13	46827546	46835546	46834835	8000	46831546	-4000	4000	3289
chr13	25242222	25250222	25249479	8000	25246222	-4000	4000	3257
chr13	96981713	96989713	96986832	8000	96985713	-4000	4000	1119
chr13	19169772	19177772	19177500	8000	19173772	-4000	4000	3728
chr13	77760242	77768242	77760885	8000	77764242	-4000	4000	-3357
chr13	49205779	49213779	49207287	8000	49209779	-4000	4000	-2492
chr13	26128115	26136115	26132382	8000	26132115	-4000	4000	267
chr13	52373167	52381167	52377707	8000	52377167	-4000	4000	540
chr13	72704367	72712367	72710071	8000	72708367	-4000	4000	1704
chr13	30971500	30979500	30974911	8000	30975500	-4000	4000	-589
chr13	51280239	51288239	51280931	8000	51284239	-4000	4000	-3308
chr13	53048057	53056057	53050131	8000	53052057	-4000	4000	-1926
chr13	83873205	83881205	83880537	8000	83877205	-4000	4000	3332
chr13	30656770	30664770	30658698	8000	30660770	-4000	4000	-2072
chr13	30656770	30664770	30659199	8000	30660770	-4000	4000	-1571
chr13	50016481	50024481	50016790	8000	50020481	-4000	4000	-3691
chr13	77641263	77649263	77644298	8000	77645263	-4000	4000	-965
chr13	83873205	83881205	83879424	8000	83877205	-4000	4000	2219
chr13	100526437	100534437	100530137	8000	100530437	-4000	4000	-300
chr13	100599625	100607625	100604137	8000	100603625	-4000	4000	512
chr13	102675958	102683958	102679162	8000	102679958	-4000	4000	-796
chr14	102338702	102346702	102339137	8000	102342702	-4000	4000	-3565
chr14	20056983	20064983	20060141	8000	20060983	-4000	4000	-842
chr14	20636696	20644696	20641364	8000	20640696	-4000	4000	668
chr14	58644321	58652321	58645551	8000	58648321	-4000	4000	-2770
chr14	104048667	104056667	104052150	8000	104052667	-4000	4000	-517
chr14	63593039	63601039	63599754	8000	63597039	-4000	4000	2715
chr14	105045395	105053395	105050503	8000	105049395	-4000	4000	1108
chr14	39393684	39401684	39401374	8000	39397684	-4000	4000	3690
chr14	39027919	39035919	39032682	8000	39031919	-4000	4000	763
chr14	20056983	20064983	20060488	8000	20060983	-4000	4000	-495
chr14	20778467	20786467	20781943	8000	20782467	-4000	4000	-524
chr14	24332025	24340025	24337996	8000	24336025	-4000	4000	1971
chr14	68870128	68878128	68875004	8000	68874128	-4000	4000	876
chr14	19972565	19980565	19976493	8000	19976565	-4000	4000	-72
chr14	20010143	20018143	20015132	8000	20014143	-4000	4000	989
chr14	59591976	59599976	59596686	8000	59595976	-4000	4000	710
chr14	77470394	77478394	77475718	8000	77474394	-4000	4000	1324
chr14	100875753	100883753	100883069	8000	100879753	-4000	4000	3316
chr14	21517080	21525080	21524259	8000	21521080	-4000	4000	3179
chr14	19826253	19834253	19828139	8000	19830253	-4000	4000	-2114
chr14	19917578	19925578	19921446	8000	19921578	-4000	4000	-132
chr14	24261538	24269538	24269536	8000	24265538	-4000	4000	3998
chr14	58644321	58652321	58645584	8000	58648321	-4000	4000	-2737
chr14	24375604	24383604	24377834	8000	24379604	-4000	4000	-1770
chr14	24501353	24509353	24506193	8000	24505353	-4000	4000	840
chr14	69240020	69248020	69241817	8000	69244020	-4000	4000	-2203
chr14	73474484	73482484	73478548	8000	73478484	-4000	4000	64
chr14	44500149	44508149	44505860	8000	44504149	-4000	4000	1711
chr14	74258738	74266738	74259694	8000	74262738	-4000	4000	-3044
chr14	96259929	96267929	96264371	8000	96263929	-4000	4000	442
chr14	20220702	20228702	20223866	8000	20224702	-4000	4000	-836
chr14	56795905	56803905	56802064	8000	56799905	-4000	4000	2159
chr14	19917578	19925578	19921356	8000	19921578	-4000	4000	-222
chr14	35533054	35541054	35534439	8000	35537054	-4000	4000	-2615
chr14	94458717	94466717	94463103	8000	94462717	-4000	4000	386
chr14	69240020	69248020	69241007	8000	69244020	-4000	4000	-3013
chr14	34705113	34713113	34711258	8000	34709113	-4000	4000	2145
chr14	21663886	21671886	21665438	8000	21667886	-4000	4000	-2448
chr14	24375604	24383604	24377672	8000	24379604	-4000	4000	-1932
chr14	53945736	53953736	53950855	8000	53949736	-4000	4000	1119
chr14	29572479	29580479	29577178	8000	29576479	-4000	4000	699
chr14	73474484	73482484	73478609	8000	73478484	-4000	4000	125
chr14	24074100	24082100	24077781	8000	24078100	-4000	4000	-319
chr14	23269477	23277477	23276461	8000	23273477	-4000	4000	2984
chr14	99165287	99173287	99171369	8000	99169287	-4000	4000	2082
chr14	21517080	21525080	21524781	8000	21521080	-4000	4000	3701
chr14	31287788	31295788	31293891	8000	31291788	-4000	4000	2103
chr14	20307368	20315368	20313706	8000	20311368	-4000	4000	2338
chr14	20744380	20752380	20747895	8000	20748380	-4000	4000	-485
chr14	74356008	74364008	74358393	8000	74360008	-4000	4000	-1615
chr14	74494183	74502183	74499328	8000	74498183	-4000	4000	1145
chr14	28766277	28774277	28767915	8000	28770277	-4000	4000	-2362
chr14	91576696	91584696	91580894	8000	91580696	-4000	4000	198
chr14	28766277	28774277	28768422	8000	28770277	-4000	4000	-1855
chr14	24332025	24340025	24338311	8000	24336025	-4000	4000	2286
chr14	64585381	64593381	64586862	8000	64589381	-4000	4000	-2519
chr14	64585381	64593381	64589226	8000	64589381	-4000	4000	-155
chr14	20010143	20018143	20015144	8000	20014143	-4000	4000	1001
chr14	23040060	23048060	23042784	8000	23044060	-4000	4000	-1276
chr14	20442401	20450401	20447156	8000	20446401	-4000	4000	755
chr14	21517080	21525080	21523598	8000	21521080	-4000	4000	2518
chr14	21663886	21671886	21665278	8000	21667886	-4000	4000	-2608
chr14	73591766	73599766	73595322	8000	73595766	-4000	4000	-444
chr14	20141471	20149471	20144603	8000	20145471	-4000	4000	-868
chr14	23113306	23121306	23117587	8000	23117306	-4000	4000	281
chr14	23269477	23277477	23276450	8000	23273477	-4000	4000	2973
chr14	23377982	23385982	23384672	8000	23381982	-4000	4000	2690
chr14	24127829	24135829	24132232	8000	24131829	-4000	4000	403
chr14	28766277	28774277	28767377	8000	28770277	-4000	4000	-2900
chr14	88461778	88469778	88469004	8000	88465778	-4000	4000	3226
chr14	91228532	91236532	91235030	8000	91232532	-4000	4000	2498
chr14	105168938	105176938	105176748	8000	105172938	-4000	4000	3810
chr14	76866304	76874304	76870189	8000	76870304	-4000	4000	-115
chr14	91961991	91969991	91969861	8000	91965991	-4000	4000	3870
chr14	19398486	19406486	19402594	8000	19402486	-4000	4000	108
chr14	20307368	20315368	20313683	8000	20311368	-4000	4000	2315
chr14	23269477	23277477	23276526	8000	23273477	-4000	4000	3049
chr14	23342314	23350314	23347649	8000	23346314	-4000	4000	1335
chr14	38250000	38258000	38255065	8000	38254000	-4000	4000	1065
chr14	52272724	52280724	52274982	8000	52276724	-4000	4000	-1742
chr14	88461778	88469778	88469604	8000	88465778	-4000	4000	3826
chr14	100875753	100883753	100882519	8000	100879753	-4000	4000	2766
chr14	24332025	24340025	24338666	8000	24336025	-4000	4000	2641
chr14	20578892	20586892	20584127	8000	20582892	-4000	4000	1235
chr14	20993035	21001035	20994860	8000	20997035	-4000	4000	-2175
chr14	23322175	23330175	23322253	8000	23326175	-4000	4000	-3922
chr14	24569518	24577518	24576246	8000	24573518	-4000	4000	2728
chr14	70456427	70464427	70457587	8000	70460427	-4000	4000	-2840
chr14	70456427	70464427	70458127	8000	70460427	-4000	4000	-2300
chr14	77931014	77939014	77933267	8000	77935014	-4000	4000	-1747
chr14	52272724	52280724	52274737	8000	52276724	-4000	4000	-1987
chr14	31287788	31295788	31293982	8000	31291788	-4000	4000	2194
chr14	20240349	20248349	20242951	8000	20244349	-4000	4000	-1398
chr14	21629836	21637836	21634714	8000	21633836	-4000	4000	878
chr14	94044287	94052287	94044585	8000	94048287	-4000	4000	-3702
chr14	23641639	23649639	23643212	8000	23645639	-4000	4000	-2427
chr14	44500149	44508149	44504645	8000	44504149	-4000	4000	496
chr14	24805454	24813454	24812457	8000	24809454	-4000	4000	3003
chr14	22942270	22950270	22946459	8000	22946270	-4000	4000	189
chr14	21347301	21355301	21348191	8000	21351301	-4000	4000	-3110
chr14	23043062	23051062	23043370	8000	23047062	-4000	4000	-3692
chr14	52324598	52332598	52327253	8000	52328598	-4000	4000	-1345
chr14	23040060	23048060	23042576	8000	23044060	-4000	4000	-1484
chr14	54838008	54846008	54843217	8000	54842008	-4000	4000	1209
chr14	63680216	63688216	63686394	8000	63684216	-4000	4000	2178
chr14	35397513	35405513	35404554	8000	35401513	-4000	4000	3041
chr14	36469207	36477207	36473790	8000	36473207	-4000	4000	583
chr14	23342314	23350314	23347599	8000	23346314	-4000	4000	1285
chr14	100875753	100883753	100881630	8000	100879753	-4000	4000	1877
chr14	91865411	91873411	91870056	8000	91869411	-4000	4000	645
chr14	23564038	23572038	23571820	8000	23568038	-4000	4000	3782
chr14	24314036	24322036	24319431	8000	24318036	-4000	4000	1395
chr14	36673921	36681921	36676195	8000	36677921	-4000	4000	-1726
chr14	45112282	45120282	45116143	8000	45116282	-4000	4000	-139
chr14	94438464	94446464	94442712	8000	94442464	-4000	4000	248
chr14	51726727	51734727	51728175	8000	51730727	-4000	4000	-2552
chr14	64585381	64593381	64588185	8000	64589381	-4000	4000	-1196
chr14	73271107	73279107	73276470	8000	73275107	-4000	4000	1363
chr14	24314036	24322036	24319398	8000	24318036	-4000	4000	1362
chr14	100875753	100883753	100883183	8000	100879753	-4000	4000	3430
chr14	58547297	58555297	58547952	8000	58551297	-4000	4000	-3345
chr14	94372747	94380747	94379463	8000	94376747	-4000	4000	2716
chr14	22845041	22853041	22845318	8000	22849041	-4000	4000	-3723
chr14	23408740	23416740	23414024	8000	23412740	-4000	4000	1284
chr14	54838008	54846008	54843773	8000	54842008	-4000	4000	1765
chr14	22942270	22950270	22947888	8000	22946270	-4000	4000	1618
chr14	21205136	21213136	21210672	8000	21209136	-4000	4000	1536
chr14	20552093	20560093	20556604	8000	20556093	-4000	4000	511
chr14	23095062	23103062	23095168	8000	23099062	-4000	4000	-3894
chr14	24332025	24340025	24338088	8000	24336025	-4000	4000	2063
chr14	100875753	100883753	100882048	8000	100879753	-4000	4000	2295
chr14	20010143	20018143	20015042	8000	20014143	-4000	4000	899
chr14	23040060	23048060	23042911	8000	23044060	-4000	4000	-1149
chr14	29572479	29580479	29578331	8000	29576479	-4000	4000	1852
chr14	100875753	100883753	100882585	8000	100879753	-4000	4000	2832
chr14	35533054	35541054	35534413	8000	35537054	-4000	4000	-2641
chr14	94483274	94491274	94487402	8000	94487274	-4000	4000	128
chr14	102726561	102734561	102729745	8000	102730561	-4000	4000	-816
chr14	21012763	21020763	21018006	8000	21016763	-4000	4000	1243
chr14	75009769	75017769	75017071	8000	75013769	-4000	4000	3302
chr14	100875753	100883753	100883049	8000	100879753	-4000	4000	3296
chr14	49893054	49901054	49894421	8000	49897054	-4000	4000	-2633
chr14	74401894	74409894	74407667	8000	74405894	-4000	4000	1773
chr14	96383288	96391288	96385559	8000	96387288	-4000	4000	-1729
chr14	20744380	20752380	20747672	8000	20748380	-4000	4000	-708
chr14	95540724	95548724	95544010	8000	95544724	-4000	4000	-714
chr14	24332025	24340025	24338384	8000	24336025	-4000	4000	2359
chr14	88608431	88616431	88611943	8000	88612431	-4000	4000	-488
chr14	23322175	23330175	23323065	8000	23326175	-4000	4000	-3110
chr14	19826253	19834253	19828008	8000	19830253	-4000	4000	-2245
chr14	56795905	56803905	56802340	8000	56799905	-4000	4000	2435
chr14	21495175	21503175	21496641	8000	21499175	-4000	4000	-2534
chr14	22845041	22853041	22845320	8000	22849041	-4000	4000	-3721
chr14	60705539	60713539	60709839	8000	60709539	-4000	4000	300
chr14	30616064	30624064	30622462	8000	30620064	-4000	4000	2398
chr14	60965965	60973965	60968246	8000	60969965	-4000	4000	-1719
chr14	94300248	94308248	94304420	8000	94304248	-4000	4000	172
chr14	91576696	91584696	91580985	8000	91580696	-4000	4000	289
chr14	88608431	88616431	88615659	8000	88612431	-4000	4000	3228
chr14	20473089	20481089	20474636	8000	20477089	-4000	4000	-2453
chr14	39393684	39401684	39399371	8000	39397684	-4000	4000	1687
chr14	50233563	50241563	50237582	8000	50237563	-4000	4000	19
chr14	91865411	91873411	91870168	8000	91869411	-4000	4000	757
chr14	101559452	101567452	101562472	8000	101563452	-4000	4000	-980
chr14	19826253	19834253	19828004	8000	19830253	-4000	4000	-2249
chr14	22981894	22989894	22989842	8000	22985894	-4000	4000	3948
chr14	60639421	60647421	60646407	8000	60643421	-4000	4000	2986
chr14	61792428	61800428	61794948	8000	61796428	-4000	4000	-1480
chr14	24065729	24073729	24068796	8000	24069729	-4000	4000	-933
chr14	19917578	19925578	19920797	8000	19921578	-4000	4000	-781
chr14	22916525	22924525	22922557	8000	22920525	-4000	4000	2032
chr14	23516857	23524857	23524665	8000	23520857	-4000	4000	3808
chr14	35533054	35541054	35536334	8000	35537054	-4000	4000	-720
chr14	75115502	75123502	75118872	8000	75119502	-4000	4000	-630
chr14	24261538	24269538	24268741	8000	24265538	-4000	4000	3203
chr14	90404268	90412268	90404973	8000	90408268	-4000	4000	-3295
chr14	61744259	61752259	61747017	8000	61748259	-4000	4000	-1242
chr14	20636696	20644696	20641517	8000	20640696	-4000	4000	821
chr14	46835629	46843629	46840981	8000	46839629	-4000	4000	1352
chr14	54470484	54478484	54475389	8000	54474484	-4000	4000	905
chr14	23095062	23103062	23095311	8000	23099062	-4000	4000	-3751
chr14	20010143	20018143	20014826	8000	20014143	-4000	4000	683
chr14	24602480	24610480	24606685	8000	24606480	-4000	4000	205
chr14	64222433	64230433	64227592	8000	64226433	-4000	4000	1159
chr14	100734224	100742224	100734314	8000	100738224	-4000	4000	-3910
chr14	20993035	21001035	20994551	8000	20997035	-4000	4000	-2484
chr14	36469207	36477207	36473561	8000	36473207	-4000	4000	354
chr14	31096117	31104117	31100754	8000	31100117	-4000	4000	637
chr14	20056983	20064983	20060306	8000	20060983	-4000	4000	-677
chr14	35313474	35321474	35317393	8000	35317474	-4000	4000	-81
chr14	69565799	69573799	69571105	8000	69569799	-4000	4000	1306
chr14	101559452	101567452	101561804	8000	101563452	-4000	4000	-1648
chr14	20888348	20896348	20891996	8000	20892348	-4000	4000	-352
chr14	63593039	63601039	63599618	8000	63597039	-4000	4000	2579
chr14	24415283	24423283	24417001	8000	24419283	-4000	4000	-2282
chr14	57196507	57204507	57204021	8000	57200507	-4000	4000	3514
chr14	21629836	21637836	21634760	8000	21633836	-4000	4000	924
chr14	20636696	20644696	20641191	8000	20640696	-4000	4000	495
chr14	20744380	20752380	20747926	8000	20748380	-4000	4000	-454
chr14	22916525	22924525	22920786	8000	22920525	-4000	4000	261
chr14	105006482	105014482	105011754	8000	105010482	-4000	4000	1272
chr14	58644321	58652321	58646870	8000	58648321	-4000	4000	-1451
chr14	44500149	44508149	44505922	8000	44504149	-4000	4000	1773
chr14	44500149	44508149	44507044	8000	44504149	-4000	4000	2895
chr14	21495175	21503175	21499134	8000	21499175	-4000	4000	-41
chr14	23352403	23360403	23357295	8000	23356403	-4000	4000	892
chr14	23408740	23416740	23415117	8000	23412740	-4000	4000	2377
chr14	20993035	21001035	20996956	8000	20997035	-4000	4000	-79
chr14	49621174	49629174	49628026	8000	49625174	-4000	4000	2852
chr14	77255495	77263495	77259487	8000	77259495	-4000	4000	-8
chr14	70456427	70464427	70457578	8000	70460427	-4000	4000	-2849
chr14	23040060	23048060	23042784	8000	23044060	-4000	4000	-1276
chr14	23641639	23649639	23644454	8000	23645639	-4000	4000	-1185
chr14	68783660	68791660	68790044	8000	68787660	-4000	4000	2384
chr14	73271107	73279107	73276658	8000	73275107	-4000	4000	1551
chr14	90181853	90189853	90184592	8000	90185853	-4000	4000	-1261
chr14	92112122	92120122	92116152	8000	92116122	-4000	4000	30
chr14	24185157	24193157	24187764	8000	24189157	-4000	4000	-1393
chr14	24074100	24082100	24077011	8000	24078100	-4000	4000	-1089
chr14	38250000	38258000	38256367	8000	38254000	-4000	4000	2367
chr14	94483274	94491274	94487342	8000	94487274	-4000	4000	68
chr14	23095062	23103062	23097702	8000	23099062	-4000	4000	-1360
chr14	60639421	60647421	60646363	8000	60643421	-4000	4000	2942
chr14	23269477	23277477	23275407	8000	23273477	-4000	4000	1930
chr14	24415283	24423283	24416593	8000	24419283	-4000	4000	-2690
chr14	20220702	20228702	20224337	8000	20224702	-4000	4000	-365
chr14	103133439	103141439	103135280	8000	103137439	-4000	4000	-2159
chr14	23516857	23524857	23522572	8000	23520857	-4000	4000	1715
chr14	50414501	50422501	50419994	8000	50418501	-4000	4000	1493
chr14	95688628	95696628	95690734	8000	95692628	-4000	4000	-1894
chr14	50322265	50330265	50325736	8000	50326265	-4000	4000	-529
chr14	23641639	23649639	23645242	8000	23645639	-4000	4000	-397
chr14	22981894	22989894	22982056	8000	22985894	-4000	4000	-3838
chr14	20636696	20644696	20641458	8000	20640696	-4000	4000	762
chr14	23095062	23103062	23097772	8000	23099062	-4000	4000	-1290
chr14	24805454	24813454	24812724	8000	24809454	-4000	4000	3270
chr14	23269477	23277477	23276440	8000	23273477	-4000	4000	2963
chr14	94764223	94772223	94768551	8000	94768223	-4000	4000	328
chr14	38250000	38258000	38255613	8000	38254000	-4000	4000	1613
chr14	76782009	76790009	76787499	8000	76786009	-4000	4000	1490
chr14	20778467	20786467	20782253	8000	20782467	-4000	4000	-214
chr14	67723374	67731374	67726096	8000	67727374	-4000	4000	-1278
chr14	19932757	19940757	19935972	8000	19936757	-4000	4000	-785
chr14	54838008	54846008	54844029	8000	54842008	-4000	4000	2021
chr14	77422675	77430675	77422914	8000	77426675	-4000	4000	-3761
chr14	64222433	64230433	64227745	8000	64226433	-4000	4000	1312
chr14	90181853	90189853	90184146	8000	90185853	-4000	4000	-1707
chr14	53945736	53953736	53950248	8000	53949736	-4000	4000	512
chr14	20141471	20149471	20144476	8000	20145471	-4000	4000	-995
chr14	68870128	68878128	68877148	8000	68874128	-4000	4000	3020
chr14	21517080	21525080	21523724	8000	21521080	-4000	4000	2644
chr14	50971262	50979262	50977131	8000	50975262	-4000	4000	1869
chr14	73271107	73279107	73277077	8000	73275107	-4000	4000	1970
chr14	73615888	73623888	73616921	8000	73619888	-4000	4000	-2967
chr14	100875753	100883753	100882330	8000	100879753	-4000	4000	2577
chr14	94372747	94380747	94379553	8000	94376747	-4000	4000	2806
chr14	19826253	19834253	19828243	8000	19830253	-4000	4000	-2010
chr14	44920324	44928324	44927422	8000	44924324	-4000	4000	3098
chr14	46647010	46655010	46651777	8000	46651010	-4000	4000	767
chr14	24065729	24073729	24073529	8000	24069729	-4000	4000	3800
chr14	74472192	74480192	74480158	8000	74476192	-4000	4000	3966
chr14	96383288	96391288	96385646	8000	96387288	-4000	4000	-1642
chr14	102928380	102936380	102933823	8000	102932380	-4000	4000	1443
chr14	69046881	69054881	69054772	8000	69050881	-4000	4000	3891
chr14	75951079	75959079	75954421	8000	75955079	-4000	4000	-658
chr14	70518358	70526358	70522783	8000	70522358	-4000	4000	425
chr14	54934949	54942949	54941558	8000	54938949	-4000	4000	2609
chr14	93214586	93222586	93220287	8000	93218586	-4000	4000	1701
chr14	105006482	105014482	105010685	8000	105010482	-4000	4000	203
chr14	70518358	70526358	70523227	8000	70522358	-4000	4000	869
chr14	100875753	100883753	100883463	8000	100879753	-4000	4000	3710
chr14	22981894	22989894	22987301	8000	22985894	-4000	4000	1407
chr14	74855435	74863435	74863170	8000	74859435	-4000	4000	3735
chr14	20636696	20644696	20641289	8000	20640696	-4000	4000	593
chr14	24415283	24423283	24417341	8000	24419283	-4000	4000	-1942
chr14	61546976	61554976	61547752	8000	61550976	-4000	4000	-3224
chr14	20010143	20018143	20014735	8000	20014143	-4000	4000	592
chr14	77261483	77269483	77269314	8000	77265483	-4000	4000	3831
chr14	105045395	105053395	105051370	8000	105049395	-4000	4000	1975
chr14	30733694	30741694	30735656	8000	30737694	-4000	4000	-2038
chr14	38209067	38217067	38210142	8000	38213067	-4000	4000	-2925
chr14	70456427	70464427	70457602	8000	70460427	-4000	4000	-2825
chr14	24375604	24383604	24376433	8000	24379604	-4000	4000	-3171
chr14	20141471	20149471	20144585	8000	20145471	-4000	4000	-886
chr14	19826253	19834253	19828091	8000	19830253	-4000	4000	-2162
chr14	64585381	64593381	64587047	8000	64589381	-4000	4000	-2334
chr14	21012763	21020763	21017742	8000	21016763	-4000	4000	979
chr14	39393684	39401684	39401656	8000	39397684	-4000	4000	3972
chr14	45112282	45120282	45114520	8000	45116282	-4000	4000	-1762
chr14	71737229	71745229	71739290	8000	71741229	-4000	4000	-1939
chr14	77757104	77765104	77761109	8000	77761104	-4000	4000	5
chr14	105006482	105014482	105011806	8000	105010482	-4000	4000	1324
chr14	90181853	90189853	90184262	8000	90185853	-4000	4000	-1591
chr14	30889799	30897799	30895493	8000	30893799	-4000	4000	1694
chr14	69046881	69054881	69052393	8000	69050881	-4000	4000	1512
chr14	73591766	73599766	73592180	8000	73595766	-4000	4000	-3586
chr14	95082228	95090228	95089731	8000	95086228	-4000	4000	3503
chr14	23377982	23385982	23378847	8000	23381982	-4000	4000	-3135
chr14	24375604	24383604	24377660	8000	24379604	-4000	4000	-1944
chr14	20197075	20205075	20197770	8000	20201075	-4000	4000	-3305
chr14	100875753	100883753	100880793	8000	100879753	-4000	4000	1040
chr14	18598097	18606097	18601450	8000	18602097	-4000	4000	-647
chr14	20056983	20064983	20060944	8000	20060983	-4000	4000	-39
chr14	22608963	22616963	22609862	8000	22612963	-4000	4000	-3101
chr14	24415283	24423283	24415459	8000	24419283	-4000	4000	-3824
chr14	21086077	21094077	21089397	8000	21090077	-4000	4000	-680
chr14	23408740	23416740	23414997	8000	23412740	-4000	4000	2257
chr14	20353904	20361904	20357542	8000	20357904	-4000	4000	-362
chr14	21663886	21671886	21665860	8000	21667886	-4000	4000	-2026
chr14	24286598	24294598	24292948	8000	24290598	-4000	4000	2350
chr14	35397513	35405513	35402010	8000	35401513	-4000	4000	497
chr14	52324598	52332598	52327220	8000	52328598	-4000	4000	-1378
chr14	67577955	67585955	67581886	8000	67581955	-4000	4000	-69
chr14	70456427	70464427	70458922	8000	70460427	-4000	4000	-1505
chr14	99938060	99946060	99939282	8000	99942060	-4000	4000	-2778
chr14	99938060	99946060	99940034	8000	99942060	-4000	4000	-2026
chr14	61744259	61752259	61744799	8000	61748259	-4000	4000	-3460
chr14	24569518	24577518	24573569	8000	24573518	-4000	4000	51
chr14	64222433	64230433	64225010	8000	64226433	-4000	4000	-1423
chr14	64222433	64230433	64225526	8000	64226433	-4000	4000	-907
chr14	93925608	93933608	93929013	8000	93929608	-4000	4000	-595
chr14	104933244	104941244	104940493	8000	104937244	-4000	4000	3249
chr14	20240349	20248349	20242810	8000	20244349	-4000	4000	-1539
chr14	24074662	24082662	24082641	8000	24078662	-4000	4000	3979
chr14	24602480	24610480	24606730	8000	24606480	-4000	4000	250
chr14	28766277	28774277	28768935	8000	28770277	-4000	4000	-1342
chr14	49614530	49622530	49622112	8000	49618530	-4000	4000	3582
chr14	70518358	70526358	70523252	8000	70522358	-4000	4000	894
chr14	72965451	72973451	72969745	8000	72969451	-4000	4000	294
chr14	72965451	72973451	72969945	8000	72969451	-4000	4000	494
chr14	75954097	75962097	75959087	8000	75958097	-4000	4000	990
chr14	81467547	81475547	81475304	8000	81471547	-4000	4000	3757
chr14	90404268	90412268	90408156	8000	90408268	-4000	4000	-112
chr14	95082228	95090228	95086737	8000	95086228	-4000	4000	509
chr14	95403266	95411266	95409493	8000	95407266	-4000	4000	2227
chr14	101559452	101567452	101562880	8000	101563452	-4000	4000	-572
chr14	20197075	20205075	20198111	8000	20201075	-4000	4000	-2964
chr14	20361667	20369667	20368808	8000	20365667	-4000	4000	3141
chr14	20636696	20644696	20641664	8000	20640696	-4000	4000	968
chr14	35109130	35117130	35109932	8000	35113130	-4000	4000	-3198
chr14	39132973	39140973	39136547	8000	39136973	-4000	4000	-426
chr14	22769042	22777042	22771323	8000	22773042	-4000	4000	-1719
chr14	93214586	93222586	93222333	8000	93218586	-4000	4000	3747
chr14	20473089	20481089	20474903	8000	20477089	-4000	4000	-2186
chr14	36469207	36477207	36477061	8000	36473207	-4000	4000	3854
chr14	21564520	21572520	21570062	8000	21568520	-4000	4000	1542
chr14	21663886	21671886	21665730	8000	21667886	-4000	4000	-2156
chr14	20697216	20705216	20700595	8000	20701216	-4000	4000	-621
chr14	94372747	94380747	94379499	8000	94376747	-4000	4000	2752
chr14	74494183	74502183	74501526	8000	74498183	-4000	4000	3343
chr14	18598097	18606097	18601251	8000	18602097	-4000	4000	-846
chr14	91961991	91969991	91969784	8000	91965991	-4000	4000	3793
chr14	73591766	73599766	73592106	8000	73595766	-4000	4000	-3660
chr14	24375604	24383604	24377673	8000	24379604	-4000	4000	-1931
chr14	24134967	24142967	24136292	8000	24138967	-4000	4000	-2675
chr14	20220702	20228702	20223765	8000	20224702	-4000	4000	-937
chr14	24602480	24610480	24608320	8000	24606480	-4000	4000	1840
chr14	94276460	94284460	94284050	8000	94280460	-4000	4000	3590
chr14	21012763	21020763	21018206	8000	21016763	-4000	4000	1443
chr14	23408740	23416740	23415212	8000	23412740	-4000	4000	2472
chr14	24501353	24509353	24508206	8000	24505353	-4000	4000	2853
chr14	23372403	23380403	23377321	8000	23376403	-4000	4000	918
chr14	74356008	74364008	74358101	8000	74360008	-4000	4000	-1907
chr14	70518358	70526358	70522889	8000	70522358	-4000	4000	531
chr14	20056983	20064983	20060336	8000	20060983	-4000	4000	-647
chr14	74356008	74364008	74357813	8000	74360008	-4000	4000	-2195
chr14	60965965	60973965	60968485	8000	60969965	-4000	4000	-1480
chr14	64470503	64478503	64473570	8000	64474503	-4000	4000	-933
chr14	46647010	46655010	46651589	8000	46651010	-4000	4000	579
chr14	20197075	20205075	20197930	8000	20201075	-4000	4000	-3145
chr14	23043062	23051062	23049699	8000	23047062	-4000	4000	2637
chr14	91453508	91461508	91461427	8000	91457508	-4000	4000	3919
chr14	24162452	24170452	24163927	8000	24166452	-4000	4000	-2525
chr14	24162452	24170452	24164769	8000	24166452	-4000	4000	-1683
chr14	45196890	45204890	45204150	8000	45200890	-4000	4000	3260
chr14	44500149	44508149	44506854	8000	44504149	-4000	4000	2705
chr14	52853268	52861268	52858541	8000	52857268	-4000	4000	1273
chr14	20744380	20752380	20747946	8000	20748380	-4000	4000	-434
chr14	24332025	24340025	24339482	8000	24336025	-4000	4000	3457
chr14	21629836	21637836	21634075	8000	21633836	-4000	4000	239
chr14	44500149	44508149	44505523	8000	44504149	-4000	4000	1374
chr14	23408740	23416740	23416016	8000	23412740	-4000	4000	3276
chr14	58644321	58652321	58645777	8000	58648321	-4000	4000	-2544
chr14	63289508	63297508	63290979	8000	63293508	-4000	4000	-2529
chr14	20141471	20149471	20144092	8000	20145471	-4000	4000	-1379
chr14	41900549	41908549	41904208	8000	41904549	-4000	4000	-341
chr14	46647010	46655010	46651765	8000	46651010	-4000	4000	755
chr14	95688628	95696628	95691265	8000	95692628	-4000	4000	-1363
chr14	24569518	24577518	24575288	8000	24573518	-4000	4000	1770
chr14	20010143	20018143	20014484	8000	20014143	-4000	4000	341
chr14	20578892	20586892	20583894	8000	20582892	-4000	4000	1002
chr14	94764223	94772223	94768614	8000	94768223	-4000	4000	391
chr14	24261538	24269538	24269111	8000	24265538	-4000	4000	3573
chr14	24332025	24340025	24338666	8000	24336025	-4000	4000	2641
chr14	60705539	60713539	60713453	8000	60709539	-4000	4000	3914
chr14	24332025	24340025	24338666	8000	24336025	-4000	4000	2641
chr14	24569518	24577518	24573677	8000	24573518	-4000	4000	159
chr14	23043062	23051062	23043410	8000	23047062	-4000	4000	-3652
chr14	19972565	19980565	19975887	8000	19976565	-4000	4000	-678
chr14	20552093	20560093	20556612	8000	20556093	-4000	4000	519
chr14	94458717	94466717	94463055	8000	94462717	-4000	4000	338
chr14	52770989	52778989	52771239	8000	52774989	-4000	4000	-3750
chr14	20744380	20752380	20747955	8000	20748380	-4000	4000	-425
chr14	104933244	104941244	104940739	8000	104937244	-4000	4000	3495
chr14	20010143	20018143	20014736	8000	20014143	-4000	4000	593
chr14	20636696	20644696	20641247	8000	20640696	-4000	4000	551
chr14	21495175	21503175	21496814	8000	21499175	-4000	4000	-2361
chr14	21629836	21637836	21634815	8000	21633836	-4000	4000	979
chr14	22981894	22989894	22987392	8000	22985894	-4000	4000	1498
chr14	23054564	23062564	23054571	8000	23058564	-4000	4000	-3993
chr14	23372403	23380403	23373364	8000	23376403	-4000	4000	-3039
chr14	23408740	23416740	23415081	8000	23412740	-4000	4000	2341
chr14	23564038	23572038	23569512	8000	23568038	-4000	4000	1474
chr14	24261538	24269538	24262350	8000	24265538	-4000	4000	-3188
chr14	24415283	24423283	24415859	8000	24419283	-4000	4000	-3424
chr14	28766277	28774277	28768605	8000	28770277	-4000	4000	-1672
chr14	70456427	70464427	70458327	8000	70460427	-4000	4000	-2100
chr14	73271107	73279107	73276721	8000	73275107	-4000	4000	1614
chr14	73591766	73599766	73595342	8000	73595766	-4000	4000	-424
chr14	74356008	74364008	74357817	8000	74360008	-4000	4000	-2191
chr14	94458717	94466717	94463129	8000	94462717	-4000	4000	412
chr14	52000809	52008809	52005373	8000	52004809	-4000	4000	564
chr14	91961991	91969991	91969523	8000	91965991	-4000	4000	3532
chr14	96259929	96267929	96264299	8000	96263929	-4000	4000	370
chr14	21381194	21389194	21385311	8000	21385194	-4000	4000	117
chr14	24314036	24322036	24318470	8000	24318036	-4000	4000	434
chr14	92684994	92692994	92685145	8000	92688994	-4000	4000	-3849
chr14	64542173	64550173	64542631	8000	64546173	-4000	4000	-3542
chr14	19972565	19980565	19975687	8000	19976565	-4000	4000	-878
chr14	23641639	23649639	23643120	8000	23645639	-4000	4000	-2519
chr14	24415283	24423283	24417387	8000	24419283	-4000	4000	-1896
chr14	45199190	45207190	45206162	8000	45203190	-4000	4000	2972
chr14	28766277	28774277	28767843	8000	28770277	-4000	4000	-2434
chr14	24569518	24577518	24574487	8000	24573518	-4000	4000	969
chr14	77470394	77478394	77475688	8000	77474394	-4000	4000	1294
chr14	96259929	96267929	96263997	8000	96263929	-4000	4000	68
chr14	104764494	104772494	104772377	8000	104768494	-4000	4000	3883
chr14	50715763	50723763	50722458	8000	50719763	-4000	4000	2695
chr14	24065729	24073729	24069155	8000	24069729	-4000	4000	-574
chr14	19932757	19940757	19935815	8000	19936757	-4000	4000	-942
chr14	19972565	19980565	19975814	8000	19976565	-4000	4000	-751
chr14	20353904	20361904	20354874	8000	20357904	-4000	4000	-3030
chr14	20353904	20361904	20357443	8000	20357904	-4000	4000	-461
chr14	20888348	20896348	20891984	8000	20892348	-4000	4000	-364
chr14	20997871	21005871	21000980	8000	21001871	-4000	4000	-891
chr14	21564520	21572520	21569815	8000	21568520	-4000	4000	1295
chr14	21564520	21572520	21570433	8000	21568520	-4000	4000	1913
chr14	22883678	22891678	22884696	8000	22887678	-4000	4000	-2982
chr14	22981894	22989894	22987919	8000	22985894	-4000	4000	2025
chr14	23372403	23380403	23373324	8000	23376403	-4000	4000	-3079
chr14	23372403	23380403	23377248	8000	23376403	-4000	4000	845
chr14	23377982	23385982	23378472	8000	23381982	-4000	4000	-3510
chr14	24074100	24082100	24075859	8000	24078100	-4000	4000	-2241
chr14	24209955	24217955	24211557	8000	24213955	-4000	4000	-2398
chr14	24415283	24423283	24416809	8000	24419283	-4000	4000	-2474
chr14	24415283	24423283	24417359	8000	24419283	-4000	4000	-1924
chr14	30733694	30741694	30735733	8000	30737694	-4000	4000	-1961
chr14	36469207	36477207	36477011	8000	36473207	-4000	4000	3804
chr14	44500149	44508149	44507143	8000	44504149	-4000	4000	2994
chr14	50322265	50330265	50330150	8000	50326265	-4000	4000	3885
chr14	52272724	52280724	52274878	8000	52276724	-4000	4000	-1846
chr14	52324598	52332598	52327224	8000	52328598	-4000	4000	-1374
chr14	54838008	54846008	54843107	8000	54842008	-4000	4000	1099
chr14	56795905	56803905	56801895	8000	56799905	-4000	4000	1990
chr14	57465300	57473300	57471331	8000	57469300	-4000	4000	2031
chr14	58644321	58652321	58645742	8000	58648321	-4000	4000	-2579
chr14	59367405	59375405	59367488	8000	59371405	-4000	4000	-3917
chr14	67723374	67731374	67725248	8000	67727374	-4000	4000	-2126
chr14	74855435	74863435	74856947	8000	74859435	-4000	4000	-2488
chr14	74855435	74863435	74863032	8000	74859435	-4000	4000	3597
chr14	76866304	76874304	76870163	8000	76870304	-4000	4000	-141
chr14	89790669	89798669	89797314	8000	89794669	-4000	4000	2645
chr14	91961991	91969991	91969533	8000	91965991	-4000	4000	3542
chr14	94483274	94491274	94489704	8000	94487274	-4000	4000	2430
chr14	21663886	21671886	21665177	8000	21667886	-4000	4000	-2709
chr14	22981894	22989894	22987930	8000	22985894	-4000	4000	2036
chr14	51253655	51261655	51254382	8000	51257655	-4000	4000	-3273
chr14	55144112	55152112	55145167	8000	55148112	-4000	4000	-2945
chr14	56795905	56803905	56801912	8000	56799905	-4000	4000	2007
chr14	63289508	63297508	63290919	8000	63293508	-4000	4000	-2589
chr14	63680216	63688216	63686569	8000	63684216	-4000	4000	2353
chr14	67655820	67663820	67662528	8000	67659820	-4000	4000	2708
chr14	93930166	93938166	93934512	8000	93934166	-4000	4000	346
chr14	96259929	96267929	96263690	8000	96263929	-4000	4000	-239
chr14	44500149	44508149	44504660	8000	44504149	-4000	4000	511
chr14	23269477	23277477	23276111	8000	23273477	-4000	4000	2634
chr14	52000809	52008809	52005226	8000	52004809	-4000	4000	417
chr14	21495175	21503175	21495244	8000	21499175	-4000	4000	-3931
chr14	54838008	54846008	54843878	8000	54842008	-4000	4000	1870
chr14	105045395	105053395	105051284	8000	105049395	-4000	4000	1889
chr14	20636696	20644696	20641584	8000	20640696	-4000	4000	888
chr14	20993035	21001035	20997002	8000	20997035	-4000	4000	-33
chr14	38250000	38258000	38255643	8000	38254000	-4000	4000	1643
chr14	63680216	63688216	63686183	8000	63684216	-4000	4000	1967
chr14	68783660	68791660	68790090	8000	68787660	-4000	4000	2430
chr14	92699807	92707807	92704091	8000	92703807	-4000	4000	284
chr14	58644321	58652321	58647203	8000	58648321	-4000	4000	-1118
chr14	63593039	63601039	63598789	8000	63597039	-4000	4000	1750
chr14	102726561	102734561	102729186	8000	102730561	-4000	4000	-1375
chr14	20197075	20205075	20197434	8000	20201075	-4000	4000	-3641
chr14	21517080	21525080	21522526	8000	21521080	-4000	4000	1446
chr14	23408740	23416740	23416257	8000	23412740	-4000	4000	3517
chr14	19917578	19925578	19921343	8000	19921578	-4000	4000	-235
chr14	24074100	24082100	24076679	8000	24078100	-4000	4000	-1421
chr14	18598097	18606097	18601450	8000	18602097	-4000	4000	-647
chr14	20952436	20960436	20955916	8000	20956436	-4000	4000	-520
chr14	67655820	67663820	67659923	8000	67659820	-4000	4000	103
chr14	23342314	23350314	23349325	8000	23346314	-4000	4000	3011
chr14	61792428	61800428	61792872	8000	61796428	-4000	4000	-3556
chr14	24375604	24383604	24376676	8000	24379604	-4000	4000	-2928
chr14	54535292	54543292	54538448	8000	54539292	-4000	4000	-844
chr14	54535292	54543292	54538450	8000	54539292	-4000	4000	-842
chr14	55144112	55152112	55148308	8000	55148112	-4000	4000	196
chr14	24134967	24142967	24136185	8000	24138967	-4000	4000	-2782
chr14	74855435	74863435	74862820	8000	74859435	-4000	4000	3385
chr14	101559452	101567452	101562316	8000	101563452	-4000	4000	-1136
chr14	23377982	23385982	23379338	8000	23381982	-4000	4000	-2644
chr14	39393684	39401684	39401479	8000	39397684	-4000	4000	3795
chr14	41900549	41908549	41904414	8000	41904549	-4000	4000	-135
chr14	52770989	52778989	52771033	8000	52774989	-4000	4000	-3956
chr14	67177803	67185803	67180836	8000	67181803	-4000	4000	-967
chr14	70456427	70464427	70458581	8000	70460427	-4000	4000	-1846
chr14	76497837	76505837	76498451	8000	76501837	-4000	4000	-3386
chr14	99496190	99504190	99502287	8000	99500190	-4000	4000	2097
chr14	44500149	44508149	44506129	8000	44504149	-4000	4000	1980
chr14	100734224	100742224	100734810	8000	100738224	-4000	4000	-3414
chr14	20744380	20752380	20748007	8000	20748380	-4000	4000	-373
chr14	21629836	21637836	21634150	8000	21633836	-4000	4000	314
chr14	23095062	23103062	23098575	8000	23099062	-4000	4000	-487
chr14	69565799	69573799	69571051	8000	69569799	-4000	4000	1252
chr14	67577955	67585955	67583880	8000	67581955	-4000	4000	1925
chr14	19932757	19940757	19936140	8000	19936757	-4000	4000	-617
chr14	20993035	21001035	20996796	8000	20997035	-4000	4000	-239
chr14	70028366	70036366	70030427	8000	70032366	-4000	4000	-1939
chr14	94276460	94284460	94278618	8000	94280460	-4000	4000	-1842
chr14	23408740	23416740	23415035	8000	23412740	-4000	4000	2295
chr14	19932757	19940757	19935861	8000	19936757	-4000	4000	-896
chr14	24002408	24010408	24004409	8000	24006408	-4000	4000	-1999
chr14	52724590	52732590	52727560	8000	52728590	-4000	4000	-1030
chr14	39393684	39401684	39401518	8000	39397684	-4000	4000	3834
chr14	35109130	35117130	35110596	8000	35113130	-4000	4000	-2534
chr14	23372403	23380403	23375734	8000	23376403	-4000	4000	-669
chr14	64222433	64230433	64226189	8000	64226433	-4000	4000	-244
chr14	20888348	20896348	20891698	8000	20892348	-4000	4000	-650
chr14	21663886	21671886	21665436	8000	21667886	-4000	4000	-2450
chr14	74855435	74863435	74862874	8000	74859435	-4000	4000	3439
chr14	102220847	102228847	102222956	8000	102224847	-4000	4000	-1891
chr14	20010143	20018143	20014882	8000	20014143	-4000	4000	739
chr14	58547297	58555297	58548156	8000	58551297	-4000	4000	-3141
chr14	21495175	21503175	21496589	8000	21499175	-4000	4000	-2586
chr14	100875753	100883753	100881825	8000	100879753	-4000	4000	2072
chr14	77255495	77263495	77256811	8000	77259495	-4000	4000	-2684
chr14	93214586	93222586	93218697	8000	93218586	-4000	4000	111
chr14	20552093	20560093	20556824	8000	20556093	-4000	4000	731
chr14	23408740	23416740	23415689	8000	23412740	-4000	4000	2949
chr14	70518358	70526358	70524790	8000	70522358	-4000	4000	2432
chr14	70577257	70585257	70584938	8000	70581257	-4000	4000	3681
chr14	77668404	77676404	77674036	8000	77672404	-4000	4000	1632
chr14	44903257	44911257	44905697	8000	44907257	-4000	4000	-1560
chr14	18598097	18606097	18601924	8000	18602097	-4000	4000	-173
chr14	77255495	77263495	77256717	8000	77259495	-4000	4000	-2778
chr14	59367405	59375405	59369423	8000	59371405	-4000	4000	-1982
chr14	41900549	41908549	41904215	8000	41904549	-4000	4000	-334
chr14	21205136	21213136	21212977	8000	21209136	-4000	4000	3841
chr14	58644321	58652321	58645696	8000	58648321	-4000	4000	-2625
chr14	94458717	94466717	94464729	8000	94462717	-4000	4000	2012
chr14	20507169	20515169	20510889	8000	20511169	-4000	4000	-280
chr14	24245114	24253114	24249373	8000	24249114	-4000	4000	259
chr14	24235242	24243242	24239937	8000	24239242	-4000	4000	695
chr14	73571658	73579658	73575315	8000	73575658	-4000	4000	-343
chr14	23408740	23416740	23416055	8000	23412740	-4000	4000	3315
chr14	23040060	23048060	23042534	8000	23044060	-4000	4000	-1526
chr14	52272724	52280724	52274826	8000	52276724	-4000	4000	-1898
chr14	23040060	23048060	23042846	8000	23044060	-4000	4000	-1214
chr14	44903257	44911257	44904599	8000	44907257	-4000	4000	-2658
chr14	19826253	19834253	19828149	8000	19830253	-4000	4000	-2104
chr14	23040060	23048060	23042907	8000	23044060	-4000	4000	-1153
chr14	22769042	22777042	22770266	8000	22773042	-4000	4000	-2776
chr14	70456427	70464427	70458493	8000	70460427	-4000	4000	-1934
chr14	74356008	74364008	74357315	8000	74360008	-4000	4000	-2693
chr14	20993035	21001035	20994860	8000	20997035	-4000	4000	-2175
chr14	24134967	24142967	24139430	8000	24138967	-4000	4000	463
chr14	50113130	50121130	50118317	8000	50117130	-4000	4000	1187
chr14	73474484	73482484	73478635	8000	73478484	-4000	4000	151
chr14	88608431	88616431	88610907	8000	88612431	-4000	4000	-1524
chr14	90404268	90412268	90404862	8000	90408268	-4000	4000	-3406
chr14	24375604	24383604	24377624	8000	24379604	-4000	4000	-1980
chr14	38250000	38258000	38254704	8000	38254000	-4000	4000	704
chr14	54838008	54846008	54842912	8000	54842008	-4000	4000	904
chr14	23564038	23572038	23571444	8000	23568038	-4000	4000	3406
chr14	30616064	30624064	30616679	8000	30620064	-4000	4000	-3385
chr14	31442036	31450036	31447989	8000	31446036	-4000	4000	1953
chr14	36673921	36681921	36676447	8000	36677921	-4000	4000	-1474
chr14	49614530	49622530	49621993	8000	49618530	-4000	4000	3463
chr14	59591976	59599976	59596676	8000	59595976	-4000	4000	700
chr14	63289508	63297508	63291034	8000	63293508	-4000	4000	-2474
chr14	94458717	94466717	94462923	8000	94462717	-4000	4000	206
chr14	67647708	67655708	67650745	8000	67651708	-4000	4000	-963
chr14	20353904	20361904	20356400	8000	20357904	-4000	4000	-1504
chr14	52000809	52008809	52005255	8000	52004809	-4000	4000	446
chr14	53945736	53953736	53953377	8000	53949736	-4000	4000	3641
chr14	77668404	77676404	77674108	8000	77672404	-4000	4000	1704
chr14	100875753	100883753	100880717	8000	100879753	-4000	4000	964
chr14	19972565	19980565	19975952	8000	19976565	-4000	4000	-613
chr14	20552093	20560093	20556342	8000	20556093	-4000	4000	249
chr14	30889799	30897799	30895724	8000	30893799	-4000	4000	1925
chr15	52063375	52071375	52063993	8000	52067375	-4000	4000	-3382
chr15	23639549	23647549	23645285	8000	23643549	-4000	4000	1736
chr15	43272271	43280271	43279221	8000	43276271	-4000	4000	2950
chr15	98960530	98968530	98962642	8000	98964530	-4000	4000	-1888
chr15	24974723	24982723	24974841	8000	24978723	-4000	4000	-3882
chr15	38353249	38361249	38353325	8000	38357249	-4000	4000	-3924
chr15	98960530	98968530	98964323	8000	98964530	-4000	4000	-207
chr15	34063458	34071458	34063489	8000	34067458	-4000	4000	-3969
chr15	75931969	75939969	75932904	8000	75935969	-4000	4000	-3065
chr15	34375068	34383068	34381737	8000	34379068	-4000	4000	2669
chr15	78273835	78281835	78275730	8000	78277835	-4000	4000	-2105
chr15	83251884	83259884	83257936	8000	83255884	-4000	4000	2052
chr15	84665538	84673538	84670756	8000	84669538	-4000	4000	1218
chr15	96336263	96344263	96337471	8000	96340263	-4000	4000	-2792
chr15	101171727	101179727	101177858	8000	101175727	-4000	4000	2131
chr15	78100370	78108370	78105326	8000	78104370	-4000	4000	956
chr15	51719011	51727011	51719475	8000	51723011	-4000	4000	-3536
chr15	83251884	83259884	83257606	8000	83255884	-4000	4000	1722
chr15	25673273	25681273	25679411	8000	25677273	-4000	4000	2138
chr15	75291807	75299807	75293731	8000	75295807	-4000	4000	-2076
chr15	43595563	43603563	43598910	8000	43599563	-4000	4000	-653
chr15	75017495	75025495	75019073	8000	75021495	-4000	4000	-2422
chr15	82435153	82443153	82436568	8000	82439153	-4000	4000	-2585
chr15	34521095	34529095	34527935	8000	34525095	-4000	4000	2840
chr15	43595563	43603563	43601008	8000	43599563	-4000	4000	1445
chr15	84941798	84949798	84943465	8000	84945798	-4000	4000	-2333
chr15	69268217	69276217	69268813	8000	69272217	-4000	4000	-3404
chr15	74332472	74340472	74335257	8000	74336472	-4000	4000	-1215
chr15	101802887	101810887	101806277	8000	101806887	-4000	4000	-610
chr15	65190760	65198760	65198153	8000	65194760	-4000	4000	3393
chr15	30356566	30364566	30361400	8000	30360566	-4000	4000	834
chr15	34063458	34071458	34063553	8000	34067458	-4000	4000	-3905
chr15	36806248	36814248	36808574	8000	36810248	-4000	4000	-1674
chr15	43595563	43603563	43601507	8000	43599563	-4000	4000	1944
chr15	44714851	44722851	44715603	8000	44718851	-4000	4000	-3248
chr15	74172872	74180872	74180014	8000	74176872	-4000	4000	3142
chr15	52751053	52759053	52757416	8000	52755053	-4000	4000	2363
chr15	84941798	84949798	84945476	8000	84945798	-4000	4000	-322
chr15	101918042	101926042	101922720	8000	101922042	-4000	4000	678
chr15	66778849	66786849	66781987	8000	66782849	-4000	4000	-862
chr15	74715542	74723542	74720837	8000	74719542	-4000	4000	1295
chr15	51719011	51727011	51719600	8000	51723011	-4000	4000	-3411
chr15	74172872	74180872	74180139	8000	74176872	-4000	4000	3267
chr15	74172872	74180872	74180140	8000	74176872	-4000	4000	3268
chr15	80751621	80759621	80754214	8000	80755621	-4000	4000	-1407
chr15	90225679	90233679	90225689	8000	90229679	-4000	4000	-3990
chr15	90891776	90899776	90893409	8000	90895776	-4000	4000	-2367
chr15	36885204	36893204	36891427	8000	36889204	-4000	4000	2223
chr15	43595563	43603563	43600082	8000	43599563	-4000	4000	519
chr15	72665599	72673599	72666062	8000	72669599	-4000	4000	-3537
chr15	98960530	98968530	98961568	8000	98964530	-4000	4000	-2962
chr15	45672314	45680314	45676201	8000	45676314	-4000	4000	-113
chr15	73301205	73309205	73301380	8000	73305205	-4000	4000	-3825
chr15	25673273	25681273	25679743	8000	25677273	-4000	4000	2470
chr15	29116252	29124252	29123383	8000	29120252	-4000	4000	3131
chr15	43769279	43777279	43776513	8000	43773279	-4000	4000	3234
chr15	65574753	65582753	65581997	8000	65578753	-4000	4000	3244
chr15	75723688	75731688	75727391	8000	75727688	-4000	4000	-297
chr15	81327088	81335088	81332966	8000	81331088	-4000	4000	1878
chr15	88652483	88660483	88655544	8000	88656483	-4000	4000	-939
chr15	45088650	45096650	45095969	8000	45092650	-4000	4000	3319
chr15	72155806	72163806	72163386	8000	72159806	-4000	4000	3580
chr15	96336263	96344263	96338808	8000	96340263	-4000	4000	-1455
chr15	66546130	66554130	66553142	8000	66550130	-4000	4000	3012
chr15	24974723	24982723	24976367	8000	24978723	-4000	4000	-2356
chr15	34354633	34362633	34362580	8000	34358633	-4000	4000	3947
chr15	41277887	41285887	41278821	8000	41281887	-4000	4000	-3066
chr15	42734730	42742730	42735937	8000	42738730	-4000	4000	-2793
chr15	61848389	61856389	61854524	8000	61852389	-4000	4000	2135
chr15	72747294	72755294	72752299	8000	72751294	-4000	4000	1005
chr15	85135145	85143145	85138083	8000	85139145	-4000	4000	-1062
chr15	88455501	88463501	88459542	8000	88459501	-4000	4000	41
chr15	90891776	90899776	90893767	8000	90895776	-4000	4000	-2009
chr15	99967437	99975437	99974425	8000	99971437	-4000	4000	2988
chr15	41499551	41507551	41505257	8000	41503551	-4000	4000	1706
chr15	90879564	90887564	90881660	8000	90883564	-4000	4000	-1904
chr15	52063375	52071375	52064761	8000	52067375	-4000	4000	-2614
chr15	43595563	43603563	43598316	8000	43599563	-4000	4000	-1247
chr15	78497453	78505453	78498113	8000	78501453	-4000	4000	-3340
chr15	101802887	101810887	101806094	8000	101806887	-4000	4000	-793
chr15	48819741	48827741	48825599	8000	48823741	-4000	4000	1858
chr15	74332472	74340472	74338689	8000	74336472	-4000	4000	2217
chr15	30934941	30942941	30937179	8000	30938941	-4000	4000	-1762
chr15	39795008	39803008	39801435	8000	39799008	-4000	4000	2427
chr15	41499551	41507551	41504195	8000	41503551	-4000	4000	644
chr15	65323127	65331127	65330388	8000	65327127	-4000	4000	3261
chr15	73885214	73893214	73889081	8000	73889214	-4000	4000	-133
chr15	90891776	90899776	90893146	8000	90895776	-4000	4000	-2630
chr15	23435038	23443038	23441226	8000	23439038	-4000	4000	2188
chr15	22091857	22099857	22095210	8000	22095857	-4000	4000	-647
chr15	40935073	40943073	40936402	8000	40939073	-4000	4000	-2671
chr15	101171727	101179727	101178962	8000	101175727	-4000	4000	3235
chr15	49854238	49862238	49860345	8000	49858238	-4000	4000	2107
chr15	34063458	34071458	34063663	8000	34067458	-4000	4000	-3795
chr15	40728340	40736340	40729888	8000	40732340	-4000	4000	-2452
chr15	23681400	23689400	23686793	8000	23685400	-4000	4000	1393
chr15	77609027	77617027	77615479	8000	77613027	-4000	4000	2452
chr15	34354633	34362633	34362602	8000	34358633	-4000	4000	3969
chr15	75931969	75939969	75933182	8000	75935969	-4000	4000	-2787
chr15	54624707	54632707	54628385	8000	54628707	-4000	4000	-322
chr15	90891776	90899776	90893784	8000	90895776	-4000	4000	-1992
chr15	43399061	43407061	43404514	8000	43403061	-4000	4000	1453
chr15	36806248	36814248	36808640	8000	36810248	-4000	4000	-1608
chr15	44550818	44558818	44557501	8000	44554818	-4000	4000	2683
chr15	51443711	51451711	51449123	8000	51447711	-4000	4000	1412
chr15	90498239	90506239	90500144	8000	90502239	-4000	4000	-2095
chr15	82655281	82663281	82659646	8000	82659281	-4000	4000	365
chr15	34786230	34794230	34790323	8000	34790230	-4000	4000	93
chr15	74043827	74051827	74044537	8000	74047827	-4000	4000	-3290
chr15	83251884	83259884	83257087	8000	83255884	-4000	4000	1203
chr15	68723806	68731806	68726002	8000	68727806	-4000	4000	-1804
chr15	77609027	77617027	77615381	8000	77613027	-4000	4000	2354
chr15	24679393	24687393	24682025	8000	24683393	-4000	4000	-1368
chr15	24679393	24687393	24682026	8000	24683393	-4000	4000	-1367
chr15	74827802	74835802	74831108	8000	74831802	-4000	4000	-694
chr15	88871353	88879353	88872880	8000	88875353	-4000	4000	-2473
chr15	43769279	43777279	43777107	8000	43773279	-4000	4000	3828
chr15	43864412	43872412	43866155	8000	43868412	-4000	4000	-2257
chr15	65049337	65057337	65055199	8000	65053337	-4000	4000	1862
chr15	72747294	72755294	72751584	8000	72751294	-4000	4000	290
chr15	34521095	34529095	34527466	8000	34525095	-4000	4000	2371
chr15	75208169	75216169	75208755	8000	75212169	-4000	4000	-3414
chr15	74821757	74829757	74824362	8000	74825757	-4000	4000	-1395
chr15	77033475	77041475	77037270	8000	77037475	-4000	4000	-205
chr15	79468304	79476304	79468403	8000	79472304	-4000	4000	-3901
chr15	72404367	72412367	72406749	8000	72408367	-4000	4000	-1618
chr15	77481607	77489607	77485446	8000	77485607	-4000	4000	-161
chr15	23639549	23647549	23644682	8000	23643549	-4000	4000	1133
chr15	33862121	33870121	33864156	8000	33866121	-4000	4000	-1965
chr15	43866761	43874761	43873959	8000	43870761	-4000	4000	3198
chr15	70650554	70658554	70657126	8000	70654554	-4000	4000	2572
chr15	48819741	48827741	48825722	8000	48823741	-4000	4000	1981
chr15	23435038	23443038	23440724	8000	23439038	-4000	4000	1686
chr15	89660367	89668367	89667011	8000	89664367	-4000	4000	2644
chr15	40031690	40039690	40032210	8000	40035690	-4000	4000	-3480
chr15	57949424	57957424	57955227	8000	57953424	-4000	4000	1803
chr15	41513176	41521176	41513745	8000	41517176	-4000	4000	-3431
chr15	90879564	90887564	90881367	8000	90883564	-4000	4000	-2197
chr15	99131593	99139593	99131630	8000	99135593	-4000	4000	-3963
chr15	24974723	24982723	24974918	8000	24978723	-4000	4000	-3805
chr15	71814259	71822259	71817601	8000	71818259	-4000	4000	-658
chr15	65323127	65331127	65329561	8000	65327127	-4000	4000	2434
chr15	34974341	34982341	34981699	8000	34978341	-4000	4000	3358
chr15	34063458	34071458	34064367	8000	34067458	-4000	4000	-3091
chr15	34974341	34982341	34981817	8000	34978341	-4000	4000	3476
chr15	83251884	83259884	83257509	8000	83255884	-4000	4000	1625
chr15	48404313	48412313	48410981	8000	48408313	-4000	4000	2668
chr15	42541356	42549356	42548139	8000	42545356	-4000	4000	2783
chr15	74821757	74829757	74824403	8000	74825757	-4000	4000	-1354
chr15	43228590	43236590	43233284	8000	43232590	-4000	4000	694
chr15	71814259	71822259	71817585	8000	71818259	-4000	4000	-674
chr15	74332472	74340472	74338664	8000	74336472	-4000	4000	2192
chr15	96336263	96344263	96337562	8000	96340263	-4000	4000	-2701
chr15	101802887	101810887	101805780	8000	101806887	-4000	4000	-1107
chr15	75670322	75678322	75675562	8000	75674322	-4000	4000	1240
chr15	65323127	65331127	65329058	8000	65327127	-4000	4000	1931
chr15	20527856	20535856	20534331	8000	20531856	-4000	4000	2475
chr15	23639549	23647549	23644347	8000	23643549	-4000	4000	798
chr15	43272271	43280271	43279278	8000	43276271	-4000	4000	3007
chr15	75897078	75905078	75904504	8000	75901078	-4000	4000	3426
chr15	100912626	100920626	100914711	8000	100916626	-4000	4000	-1915
chr15	39795008	39803008	39800760	8000	39799008	-4000	4000	1752
chr15	69268217	69276217	69268556	8000	69272217	-4000	4000	-3661
chr15	42938897	42946897	42945232	8000	42942897	-4000	4000	2335
chr15	78344225	78352225	78348124	8000	78348225	-4000	4000	-101
chr15	34747032	34755032	34752677	8000	34751032	-4000	4000	1645
chr15	100396395	100404395	100402626	8000	100400395	-4000	4000	2231
chr15	23681400	23689400	23686867	8000	23685400	-4000	4000	1467
chr15	25673273	25681273	25679902	8000	25677273	-4000	4000	2629
chr15	39795008	39803008	39801995	8000	39799008	-4000	4000	2987
chr15	48404313	48412313	48408668	8000	48408313	-4000	4000	355
chr15	23639549	23647549	23645157	8000	23643549	-4000	4000	1608
chr15	47770228	47778228	47770871	8000	47774228	-4000	4000	-3357
chr15	89774754	89782754	89778178	8000	89778754	-4000	4000	-576
chr15	65049337	65057337	65053658	8000	65053337	-4000	4000	321
chr15	75269455	75277455	75270086	8000	75273455	-4000	4000	-3369
chr15	34747032	34755032	34752694	8000	34751032	-4000	4000	1662
chr15	54624707	54632707	54627884	8000	54628707	-4000	4000	-823
chr15	101802887	101810887	101806414	8000	101806887	-4000	4000	-473
chr15	34337719	34345719	34343050	8000	34341719	-4000	4000	1331
chr15	89627056	89635056	89628709	8000	89631056	-4000	4000	-2347
chr15	74065857	74073857	74071561	8000	74069857	-4000	4000	1704
chr15	97969833	97977833	97970007	8000	97973833	-4000	4000	-3826
chr15	52063375	52071375	52064106	8000	52067375	-4000	4000	-3269
chr15	34747032	34755032	34753302	8000	34751032	-4000	4000	2270
chr15	36806248	36814248	36808604	8000	36810248	-4000	4000	-1644
chr15	32693095	32701095	32696544	8000	32697095	-4000	4000	-551
chr15	45161576	45169576	45161799	8000	45165576	-4000	4000	-3777
chr15	72747294	72755294	72752186	8000	72751294	-4000	4000	892
chr15	75339224	75347224	75339809	8000	75343224	-4000	4000	-3415
chr15	84035842	84043842	84037838	8000	84039842	-4000	4000	-2004
chr15	23681400	23689400	23686531	8000	23685400	-4000	4000	1131
chr15	89467398	89475398	89471665	8000	89471398	-4000	4000	267
chr15	74332472	74340472	74335249	8000	74336472	-4000	4000	-1223
chr15	101171727	101179727	101177962	8000	101175727	-4000	4000	2235
chr15	29116252	29124252	29123384	8000	29120252	-4000	4000	3132
chr15	101649596	101657596	101650093	8000	101653596	-4000	4000	-3503
chr15	43272271	43280271	43279739	8000	43276271	-4000	4000	3468
chr15	74332472	74340472	74332773	8000	74336472	-4000	4000	-3699
chr15	34225784	34233784	34230024	8000	34229784	-4000	4000	240
chr15	89780895	89788895	89785422	8000	89784895	-4000	4000	527
chr15	45161576	45169576	45161818	8000	45165576	-4000	4000	-3758
chr15	74405289	74413289	74411968	8000	74409289	-4000	4000	2679
chr15	48819741	48827741	48825917	8000	48823741	-4000	4000	2176
chr15	41513176	41521176	41520967	8000	41517176	-4000	4000	3791
chr15	65049337	65057337	65054861	8000	65053337	-4000	4000	1524
chr15	48339373	48347373	48341471	8000	48343373	-4000	4000	-1902
chr15	65190760	65198760	65198344	8000	65194760	-4000	4000	3584
chr15	99131593	99139593	99132977	8000	99135593	-4000	4000	-2616
chr15	100647701	100655701	100648426	8000	100651701	-4000	4000	-3275
chr15	43769279	43777279	43775844	8000	43773279	-4000	4000	2565
chr15	88652483	88660483	88655544	8000	88656483	-4000	4000	-939
chr15	40217123	40225123	40220792	8000	40221123	-4000	4000	-331
chr15	40728340	40736340	40729513	8000	40732340	-4000	4000	-2827
chr15	77033475	77041475	77037069	8000	77037475	-4000	4000	-406
chr15	101171727	101179727	101177978	8000	101175727	-4000	4000	2251
chr15	34354633	34362633	34355077	8000	34358633	-4000	4000	-3556
chr15	66332191	66340191	66336831	8000	66336191	-4000	4000	640
chr15	43695222	43703222	43699178	8000	43699222	-4000	4000	-44
chr15	41376996	41384996	41380221	8000	41380996	-4000	4000	-775
chr15	65323127	65331127	65328463	8000	65327127	-4000	4000	1336
chr15	40083890	40091890	40088189	8000	40087890	-4000	4000	299
chr15	72665599	72673599	72666062	8000	72669599	-4000	4000	-3537
chr15	75897078	75905078	75899600	8000	75901078	-4000	4000	-1478
chr15	30997061	31005061	31001881	8000	31001061	-4000	4000	820
chr15	55198966	55206966	55205563	8000	55202966	-4000	4000	2597
chr15	38484103	38492103	38490219	8000	38488103	-4000	4000	2116
chr15	41499551	41507551	41505290	8000	41503551	-4000	4000	1739
chr15	65323127	65331127	65329443	8000	65327127	-4000	4000	2316
chr15	73885214	73893214	73886092	8000	73889214	-4000	4000	-3122
chr15	41499551	41507551	41502968	8000	41503551	-4000	4000	-583
chr15	73315859	73323859	73323242	8000	73319859	-4000	4000	3383
chr15	28837832	28845832	28838709	8000	28841832	-4000	4000	-3123
chr15	43527620	43535620	43534929	8000	43531620	-4000	4000	3309
chr15	43527620	43535620	43535132	8000	43531620	-4000	4000	3512
chr15	57546717	57554717	57547641	8000	57550717	-4000	4000	-3076
chr15	75594083	75602083	75598433	8000	75598083	-4000	4000	350
chr15	74172872	74180872	74175451	8000	74176872	-4000	4000	-1421
chr15	74172872	74180872	74175955	8000	74176872	-4000	4000	-917
chr15	40952512	40960512	40955645	8000	40956512	-4000	4000	-867
chr15	42565994	42573994	42566647	8000	42569994	-4000	4000	-3347
chr15	65323127	65331127	65329564	8000	65327127	-4000	4000	2437
chr15	66546130	66554130	66553012	8000	66550130	-4000	4000	2882
chr15	74405289	74413289	74410898	8000	74409289	-4000	4000	1609
chr15	82280930	82288930	82283032	8000	82284930	-4000	4000	-1898
chr15	77609027	77617027	77615060	8000	77613027	-4000	4000	2033
chr15	24974723	24982723	24976904	8000	24978723	-4000	4000	-1819
chr15	89205869	89213869	89210149	8000	89209869	-4000	4000	280
chr15	28837832	28845832	28838787	8000	28841832	-4000	4000	-3045
chr15	40952512	40960512	40953437	8000	40956512	-4000	4000	-3075
chr15	41178725	41186725	41183900	8000	41182725	-4000	4000	1175
chr15	43181144	43189144	43181207	8000	43185144	-4000	4000	-3937
chr15	64735891	64743891	64740926	8000	64739891	-4000	4000	1035
chr15	66546130	66554130	66551811	8000	66550130	-4000	4000	1681
chr15	72280727	72288727	72286077	8000	72284727	-4000	4000	1350
chr15	74626558	74634558	74627360	8000	74630558	-4000	4000	-3198
chr15	80593933	80601933	80597779	8000	80597933	-4000	4000	-154
chr15	93023996	93031996	93026056	8000	93027996	-4000	4000	-1940
chr15	34375068	34383068	34379158	8000	34379068	-4000	4000	90
chr15	45672314	45680314	45673720	8000	45676314	-4000	4000	-2594
chr15	51001895	51009895	51004629	8000	51005895	-4000	4000	-1266
chr15	38353249	38361249	38353597	8000	38357249	-4000	4000	-3652
chr15	101171727	101179727	101177131	8000	101175727	-4000	4000	1404
chr15	41891933	41899933	41892938	8000	41895933	-4000	4000	-2995
chr15	39795008	39803008	39801566	8000	39799008	-4000	4000	2558
chr15	23435038	23443038	23440885	8000	23439038	-4000	4000	1847
chr15	41277887	41285887	41278820	8000	41281887	-4000	4000	-3067
chr15	43181144	43189144	43184418	8000	43185144	-4000	4000	-726
chr15	45088650	45096650	45095571	8000	45092650	-4000	4000	2921
chr15	69268217	69276217	69268791	8000	69272217	-4000	4000	-3426
chr15	20527856	20535856	20535645	8000	20531856	-4000	4000	3789
chr15	22825789	22833789	22829403	8000	22829789	-4000	4000	-386
chr15	41499551	41507551	41507119	8000	41503551	-4000	4000	3568
chr15	44411758	44419758	44415197	8000	44415758	-4000	4000	-561
chr15	45161576	45169576	45161830	8000	45165576	-4000	4000	-3746
chr15	50271389	50279389	50277952	8000	50275389	-4000	4000	2563
chr15	50271389	50279389	50278452	8000	50275389	-4000	4000	3063
chr15	64451303	64459303	64455186	8000	64455303	-4000	4000	-117
chr15	65574753	65582753	65576647	8000	65578753	-4000	4000	-2106
chr15	66546130	66554130	66552166	8000	66550130	-4000	4000	2036
chr15	73301205	73309205	73303266	8000	73305205	-4000	4000	-1939
chr15	74441977	74449977	74449197	8000	74445977	-4000	4000	3220
chr15	78273835	78281835	78275720	8000	78277835	-4000	4000	-2115
chr15	85135145	85143145	85138407	8000	85139145	-4000	4000	-738
chr15	90962190	90970190	90966378	8000	90966190	-4000	4000	188
chr15	55822922	55830922	55829758	8000	55826922	-4000	4000	2836
chr15	82280930	82288930	82282641	8000	82284930	-4000	4000	-2289
chr15	52543045	52551045	52550743	8000	52547045	-4000	4000	3698
chr15	24974723	24982723	24978301	8000	24978723	-4000	4000	-422
chr15	30934941	30942941	30941821	8000	30938941	-4000	4000	2880
chr15	40390288	40398288	40393686	8000	40394288	-4000	4000	-602
chr15	80947776	80955776	80950721	8000	80951776	-4000	4000	-1055
chr15	82435153	82443153	82436664	8000	82439153	-4000	4000	-2489
chr15	82435153	82443153	82437145	8000	82439153	-4000	4000	-2008
chr15	97969833	97977833	97972569	8000	97973833	-4000	4000	-1264
chr15	63263776	63271776	63263824	8000	63267776	-4000	4000	-3952
chr15	63604618	63612618	63609067	8000	63608618	-4000	4000	449
chr15	101816197	101824197	101818384	8000	101820197	-4000	4000	-1813
chr15	42349666	42357666	42354455	8000	42353666	-4000	4000	789
chr15	47770228	47778228	47771825	8000	47774228	-4000	4000	-2403
chr15	73315859	73323859	73323330	8000	73319859	-4000	4000	3471
chr15	48984476	48992476	48988849	8000	48988476	-4000	4000	373
chr15	63121872	63129872	63127397	8000	63125872	-4000	4000	1525
chr15	78591269	78599269	78596401	8000	78595269	-4000	4000	1132
chr15	73315859	73323859	73323674	8000	73319859	-4000	4000	3815
chr15	42349666	42357666	42351333	8000	42353666	-4000	4000	-2333
chr15	75670322	75678322	75676390	8000	75674322	-4000	4000	2068
chr15	74332472	74340472	74339682	8000	74336472	-4000	4000	3210
chr15	65144219	65152219	65150670	8000	65148219	-4000	4000	2451
chr15	72404367	72412367	72407840	8000	72408367	-4000	4000	-527
chr15	33862121	33870121	33864177	8000	33866121	-4000	4000	-1944
chr15	67830582	67838582	67832281	8000	67834582	-4000	4000	-2301
chr15	63604618	63612618	63612309	8000	63608618	-4000	4000	3691
chr15	41178725	41186725	41184134	8000	41182725	-4000	4000	1409
chr15	42154701	42162701	42160812	8000	42158701	-4000	4000	2111
chr15	52577317	52585317	52584749	8000	52581317	-4000	4000	3432
chr15	88652483	88660483	88655555	8000	88656483	-4000	4000	-928
chr15	62840631	62848631	62840652	8000	62844631	-4000	4000	-3979
chr15	82335993	82343993	82342735	8000	82339993	-4000	4000	2742
chr15	43800427	43808427	43800470	8000	43804427	-4000	4000	-3957
chr15	72155806	72163806	72163661	8000	72159806	-4000	4000	3855
chr15	65049337	65057337	65054130	8000	65053337	-4000	4000	793
chr15	75670322	75678322	75677845	8000	75674322	-4000	4000	3523
chr15	64683573	64691573	64690493	8000	64687573	-4000	4000	2920
chr15	92464728	92472728	92468293	8000	92468728	-4000	4000	-435
chr15	40952512	40960512	40955752	8000	40956512	-4000	4000	-760
chr15	82335993	82343993	82342553	8000	82339993	-4000	4000	2560
chr15	101816197	101824197	101818614	8000	101820197	-4000	4000	-1583
chr15	73315859	73323859	73321630	8000	73319859	-4000	4000	1771
chr15	73710514	73718514	73711361	8000	73714514	-4000	4000	-3153
chr15	30934941	30942941	30941752	8000	30938941	-4000	4000	2811
chr15	34337719	34345719	34341875	8000	34341719	-4000	4000	156
chr15	43350569	43358569	43351929	8000	43354569	-4000	4000	-2640
chr15	63305126	63313126	63305649	8000	63309126	-4000	4000	-3477
chr15	90879564	90887564	90881449	8000	90883564	-4000	4000	-2115
chr15	27750875	27758875	27755349	8000	27754875	-4000	4000	474
chr15	43228590	43236590	43233661	8000	43232590	-4000	4000	1071
chr15	83012423	83020423	83018802	8000	83016423	-4000	4000	2379
chr15	51052598	51060598	51057619	8000	51056598	-4000	4000	1021
chr15	84035842	84043842	84036991	8000	84039842	-4000	4000	-2851
chr15	22863052	22871052	22866904	8000	22867052	-4000	4000	-148
chr15	23435038	23443038	23441617	8000	23439038	-4000	4000	2579
chr15	23639549	23647549	23645282	8000	23643549	-4000	4000	1733
chr15	23681400	23689400	23686921	8000	23685400	-4000	4000	1521
chr15	34974341	34982341	34982200	8000	34978341	-4000	4000	3859
chr15	41499551	41507551	41504113	8000	41503551	-4000	4000	562
chr15	42135034	42143034	42141891	8000	42139034	-4000	4000	2857
chr15	43181144	43189144	43186047	8000	43185144	-4000	4000	903
chr15	43595563	43603563	43600670	8000	43599563	-4000	4000	1107
chr15	43864412	43872412	43866257	8000	43868412	-4000	4000	-2155
chr15	44661732	44669732	44665951	8000	44665732	-4000	4000	219
chr15	51052598	51060598	51058425	8000	51056598	-4000	4000	1827
chr15	54624707	54632707	54626873	8000	54628707	-4000	4000	-1834
chr15	66487656	66495656	66490732	8000	66491656	-4000	4000	-924
chr15	72665599	72673599	72665784	8000	72669599	-4000	4000	-3815
chr15	72734475	72742475	72735206	8000	72738475	-4000	4000	-3269
chr15	74172872	74180872	74174982	8000	74176872	-4000	4000	-1890
chr15	74172872	74180872	74175356	8000	74176872	-4000	4000	-1516
chr15	74172872	74180872	74176028	8000	74176872	-4000	4000	-844
chr15	74715542	74723542	74722602	8000	74719542	-4000	4000	3060
chr15	77609027	77617027	77614982	8000	77613027	-4000	4000	1955
chr15	77609027	77617027	77615576	8000	77613027	-4000	4000	2549
chr15	79294239	79302239	79294653	8000	79298239	-4000	4000	-3586
chr15	82655281	82663281	82659661	8000	82659281	-4000	4000	380
chr15	101171727	101179727	101177900	8000	101175727	-4000	4000	2173
chr15	101649596	101657596	101654596	8000	101653596	-4000	4000	1000
chr15	101816197	101824197	101818632	8000	101820197	-4000	4000	-1565
chr15	73315859	73323859	73323779	8000	73319859	-4000	4000	3920
chr15	44411758	44419758	44415257	8000	44415758	-4000	4000	-501
chr15	54624707	54632707	54627034	8000	54628707	-4000	4000	-1673
chr15	55822922	55830922	55829962	8000	55826922	-4000	4000	3040
chr15	79294239	79302239	79297065	8000	79298239	-4000	4000	-1174
chr15	79468304	79476304	79468328	8000	79472304	-4000	4000	-3976
chr15	89198355	89206355	89200881	8000	89202355	-4000	4000	-1474
chr15	43864412	43872412	43866274	8000	43868412	-4000	4000	-2138
chr15	43695222	43703222	43699155	8000	43699222	-4000	4000	-67
chr15	20527856	20535856	20535186	8000	20531856	-4000	4000	3330
chr15	60415609	60423609	60423519	8000	60419609	-4000	4000	3910
chr15	43193227	43201227	43194451	8000	43197227	-4000	4000	-2776
chr15	63903036	63911036	63908575	8000	63907036	-4000	4000	1539
chr15	92613448	92621448	92618247	8000	92617448	-4000	4000	799
chr15	61848389	61856389	61854524	8000	61852389	-4000	4000	2135
chr15	30997061	31005061	31002493	8000	31001061	-4000	4000	1432
chr15	30997061	31005061	31002987	8000	31001061	-4000	4000	1926
chr15	41499637	41507637	41507558	8000	41503637	-4000	4000	3921
chr15	43527620	43535620	43534668	8000	43531620	-4000	4000	3048
chr15	43595563	43603563	43599162	8000	43599563	-4000	4000	-401
chr15	44763829	44771829	44767691	8000	44767829	-4000	4000	-138
chr15	45073185	45081185	45073377	8000	45077185	-4000	4000	-3808
chr15	48339373	48347373	48341530	8000	48343373	-4000	4000	-1843
chr15	48404313	48412313	48410892	8000	48408313	-4000	4000	2579
chr15	51719011	51727011	51724800	8000	51723011	-4000	4000	1789
chr15	65049337	65057337	65052994	8000	65053337	-4000	4000	-343
chr15	66332191	66340191	66337095	8000	66336191	-4000	4000	904
chr15	69444427	69452427	69445041	8000	69448427	-4000	4000	-3386
chr15	72747294	72755294	72752412	8000	72751294	-4000	4000	1118
chr15	73885214	73893214	73888448	8000	73889214	-4000	4000	-766
chr15	73885214	73893214	73889190	8000	73889214	-4000	4000	-24
chr15	78163468	78171468	78163534	8000	78167468	-4000	4000	-3934
chr15	78591269	78599269	78596535	8000	78595269	-4000	4000	1266
chr15	78955906	78963906	78962025	8000	78959906	-4000	4000	2119
chr15	82037778	82045778	82043489	8000	82041778	-4000	4000	1711
chr15	82037778	82045778	82043689	8000	82041778	-4000	4000	1911
chr15	82126233	82134233	82130296	8000	82130233	-4000	4000	63
chr15	82655281	82663281	82662755	8000	82659281	-4000	4000	3474
chr15	83251884	83259884	83257516	8000	83255884	-4000	4000	1632
chr15	90879564	90887564	90885038	8000	90883564	-4000	4000	1474
chr15	90962190	90970190	90966996	8000	90966190	-4000	4000	806
chr15	92464728	92472728	92472274	8000	92468728	-4000	4000	3546
chr15	40570949	40578949	40573664	8000	40574949	-4000	4000	-1285
chr15	48404313	48412313	48411014	8000	48408313	-4000	4000	2701
chr15	88871353	88879353	88871468	8000	88875353	-4000	4000	-3885
chr15	34354633	34362633	34356438	8000	34358633	-4000	4000	-2195
chr15	43272271	43280271	43276951	8000	43276271	-4000	4000	680
chr15	23681400	23689400	23686050	8000	23685400	-4000	4000	650
chr15	36885204	36893204	36892361	8000	36889204	-4000	4000	3157
chr15	89739638	89747638	89743368	8000	89743638	-4000	4000	-270
chr15	20527856	20535856	20535018	8000	20531856	-4000	4000	3162
chr15	81327088	81335088	81332829	8000	81331088	-4000	4000	1741
chr15	84035842	84043842	84039400	8000	84039842	-4000	4000	-442
chr15	84035842	84043842	84039401	8000	84039842	-4000	4000	-441
chr15	80134393	80142393	80137707	8000	80138393	-4000	4000	-686
chr15	23681400	23689400	23686420	8000	23685400	-4000	4000	1020
chr15	33862121	33870121	33866047	8000	33866121	-4000	4000	-74
chr15	65574753	65582753	65576504	8000	65578753	-4000	4000	-2249
chr15	74172872	74180872	74175712	8000	74176872	-4000	4000	-1160
chr15	101802887	101810887	101806121	8000	101806887	-4000	4000	-766
chr15	101816197	101824197	101818394	8000	101820197	-4000	4000	-1803
chr15	65190760	65198760	65198596	8000	65194760	-4000	4000	3836
chr15	79294239	79302239	79294319	8000	79298239	-4000	4000	-3920
chr15	101266817	101274817	101272802	8000	101270817	-4000	4000	1985
chr15	52577317	52585317	52585094	8000	52581317	-4000	4000	3777
chr15	78273835	78281835	78274315	8000	78277835	-4000	4000	-3520
chr15	90950093	90958093	90950504	8000	90954093	-4000	4000	-3589
chr15	82037778	82045778	82044138	8000	82041778	-4000	4000	2360
chr15	48339373	48347373	48341398	8000	48343373	-4000	4000	-1975
chr15	34353737	34361737	34353854	8000	34357737	-4000	4000	-3883
chr15	52105263	52113263	52109828	8000	52109263	-4000	4000	565
chr15	59636239	59644239	59639063	8000	59640239	-4000	4000	-1176
chr15	99131593	99139593	99132736	8000	99135593	-4000	4000	-2857
chr15	65190760	65198760	65197263	8000	65194760	-4000	4000	2503
chr15	43527620	43535620	43535245	8000	43531620	-4000	4000	3625
chr15	78497453	78505453	78498340	8000	78501453	-4000	4000	-3113
chr15	40083890	40091890	40090367	8000	40087890	-4000	4000	2477
chr15	30997061	31005061	31002800	8000	31001061	-4000	4000	1739
chr15	90891776	90899776	90893657	8000	90895776	-4000	4000	-2119
chr15	65049337	65057337	65053024	8000	65053337	-4000	4000	-313
chr15	73315859	73323859	73323526	8000	73319859	-4000	4000	3667
chr15	73710514	73718514	73711325	8000	73714514	-4000	4000	-3189
chr15	23639549	23647549	23644487	8000	23643549	-4000	4000	938
chr15	34974341	34982341	34981557	8000	34978341	-4000	4000	3216
chr15	42154701	42162701	42162481	8000	42158701	-4000	4000	3780
chr15	90891776	90899776	90893810	8000	90895776	-4000	4000	-1966
chr15	101816197	101824197	101818800	8000	101820197	-4000	4000	-1397
chr15	72280727	72288727	72287283	8000	72284727	-4000	4000	2556
chr15	43695222	43703222	43698731	8000	43699222	-4000	4000	-491
chr15	83251884	83259884	83257523	8000	83255884	-4000	4000	1639
chr15	81327088	81335088	81333103	8000	81331088	-4000	4000	2015
chr15	43864412	43872412	43866202	8000	43868412	-4000	4000	-2210
chr15	22091857	22099857	22095249	8000	22095857	-4000	4000	-608
chr15	40390288	40398288	40391525	8000	40394288	-4000	4000	-2763
chr15	43769279	43777279	43771315	8000	43773279	-4000	4000	-1964
chr15	77609027	77617027	77613695	8000	77613027	-4000	4000	668
chr15	45088650	45096650	45094940	8000	45092650	-4000	4000	2290
chr15	64068565	64076565	64073016	8000	64072565	-4000	4000	451
chr15	54624707	54632707	54627036	8000	54628707	-4000	4000	-1671
chr15	75291807	75299807	75293988	8000	75295807	-4000	4000	-1819
chr15	47770228	47778228	47771673	8000	47774228	-4000	4000	-2555
chr15	42716998	42724998	42717786	8000	42720998	-4000	4000	-3212
chr15	74715542	74723542	74723008	8000	74719542	-4000	4000	3466
chr15	78273835	78281835	78275537	8000	78277835	-4000	4000	-2298
chr15	65049337	65057337	65054168	8000	65053337	-4000	4000	831
chr15	100912626	100920626	100914700	8000	100916626	-4000	4000	-1926
chr15	51443711	51451711	51450274	8000	51447711	-4000	4000	2563
chr15	23639549	23647549	23645018	8000	23643549	-4000	4000	1469
chr15	42716998	42724998	42718062	8000	42720998	-4000	4000	-2936
chr15	41499551	41507551	41505452	8000	41503551	-4000	4000	1901
chr15	43695222	43703222	43699164	8000	43699222	-4000	4000	-58
chr15	24679393	24687393	24683345	8000	24683393	-4000	4000	-48
chr15	55822922	55830922	55829726	8000	55826922	-4000	4000	2804
chr15	99131593	99139593	99132643	8000	99135593	-4000	4000	-2950
chr15	84035842	84043842	84037779	8000	84039842	-4000	4000	-2063
chr15	90891776	90899776	90892741	8000	90895776	-4000	4000	-3035
chr15	43866761	43874761	43874432	8000	43870761	-4000	4000	3671
chr15	59093419	59101419	59095228	8000	59097419	-4000	4000	-2191
chr15	78273835	78281835	78275463	8000	78277835	-4000	4000	-2372
chr15	23639549	23647549	23644848	8000	23643549	-4000	4000	1299
chr15	89627056	89635056	89630454	8000	89631056	-4000	4000	-602
chr15	34354633	34362633	34359129	8000	34358633	-4000	4000	496
chr15	75670322	75678322	75676024	8000	75674322	-4000	4000	1702
chr15	42063009	42071009	42068821	8000	42067009	-4000	4000	1812
chr15	20527856	20535856	20534995	8000	20531856	-4000	4000	3139
chr15	89627056	89635056	89630324	8000	89631056	-4000	4000	-732
chr15	78620111	78628111	78624962	8000	78624111	-4000	4000	851
chr15	66778849	66786849	66781069	8000	66782849	-4000	4000	-1780
chr15	80182946	80190946	80186280	8000	80186946	-4000	4000	-666
chr15	74752607	74760607	74754984	8000	74756607	-4000	4000	-1623
chr15	40031690	40039690	40036232	8000	40035690	-4000	4000	542
chr15	66332191	66340191	66337083	8000	66336191	-4000	4000	892
chr15	74172872	74180872	74175896	8000	74176872	-4000	4000	-976
chr15	78497453	78505453	78498078	8000	78501453	-4000	4000	-3375
chr15	57710745	57718745	57712007	8000	57714745	-4000	4000	-2738
chr15	74172872	74180872	74175245	8000	74176872	-4000	4000	-1627
chr15	20527856	20535856	20534396	8000	20531856	-4000	4000	2540
chr15	89313261	89321261	89317437	8000	89317261	-4000	4000	176
chr15	25673273	25681273	25680187	8000	25677273	-4000	4000	2914
chr15	73556014	73564014	73559907	8000	73560014	-4000	4000	-107
chr15	74898219	74906219	74905188	8000	74902219	-4000	4000	2969
chr15	84941798	84949798	84945153	8000	84945798	-4000	4000	-645
chr15	34747032	34755032	34752760	8000	34751032	-4000	4000	1728
chr15	55336032	55344032	55340812	8000	55340032	-4000	4000	780
chr15	101649596	101657596	101650277	8000	101653596	-4000	4000	-3319
chr15	65377484	65385484	65384368	8000	65381484	-4000	4000	2884
chr15	74715542	74723542	74722291	8000	74719542	-4000	4000	2749
chr15	83012423	83020423	83018096	8000	83016423	-4000	4000	1673
chr15	34974341	34982341	34981352	8000	34978341	-4000	4000	3011
chr15	72734475	72742475	72736775	8000	72738475	-4000	4000	-1700
chr15	74332472	74340472	74335853	8000	74336472	-4000	4000	-619
chr15	78100370	78108370	78105880	8000	78104370	-4000	4000	1510
chr15	74065857	74073857	74070838	8000	74069857	-4000	4000	981
chr15	23639549	23647549	23645490	8000	23643549	-4000	4000	1941
chr15	89467398	89475398	89472790	8000	89471398	-4000	4000	1392
chr15	74715542	74723542	74721827	8000	74719542	-4000	4000	2285
chr15	40728340	40736340	40731253	8000	40732340	-4000	4000	-1087
chr15	42938897	42946897	42944238	8000	42942897	-4000	4000	1341
chr15	45088650	45096650	45094184	8000	45092650	-4000	4000	1534
chr15	66487656	66495656	66489260	8000	66491656	-4000	4000	-2396
chr15	69268217	69276217	69268796	8000	69272217	-4000	4000	-3421
chr15	84941798	84949798	84945295	8000	84945798	-4000	4000	-503
chr15	56441997	56449997	56443509	8000	56445997	-4000	4000	-2488
chr16	31127393	31135393	31132438	8000	31131393	-4000	4000	1045
chr16	27217768	27225768	27225155	8000	27221768	-4000	4000	3387
chr16	162764	170764	166611	8000	166764	-4000	4000	-153
chr16	20024239	20032239	20032033	8000	20028239	-4000	4000	3794
chr16	52432417	52440417	52439733	8000	52436417	-4000	4000	3316
chr16	50730041	50738041	50732227	8000	50734041	-4000	4000	-1814
chr16	66971149	66979149	66972893	8000	66975149	-4000	4000	-2256
chr16	3010505	3018505	3015371	8000	3014505	-4000	4000	866
chr16	56587088	56595088	56589959	8000	56591088	-4000	4000	-1129
chr16	56680196	56688196	56684048	8000	56684196	-4000	4000	-148
chr16	26133685	26141685	26135946	8000	26137685	-4000	4000	-1739
chr16	3238027	3246027	3243879	8000	3242027	-4000	4000	1852
chr16	20024239	20032239	20032098	8000	20028239	-4000	4000	3859
chr16	27776344	27784344	27777617	8000	27780344	-4000	4000	-2727
chr16	57753244	57761244	57761146	8000	57757244	-4000	4000	3902
chr16	57984116	57992116	57984701	8000	57988116	-4000	4000	-3415
chr16	66584275	66592275	66587089	8000	66588275	-4000	4000	-1186
chr16	67971663	67979663	67978300	8000	67975663	-4000	4000	2637
chr16	69737871	69745871	69742491	8000	69741871	-4000	4000	620
chr16	66904122	66912122	66908450	8000	66908122	-4000	4000	328
chr16	4773606	4781606	4779717	8000	4777606	-4000	4000	2111
chr16	3218325	3226325	3224067	8000	3222325	-4000	4000	1742
chr16	10939021	10947021	10941850	8000	10943021	-4000	4000	-1171
chr16	28494964	28502964	28496532	8000	28498964	-4000	4000	-2432
chr16	28494964	28502964	28496983	8000	28498964	-4000	4000	-1981
chr16	28494964	28502964	28497242	8000	28498964	-4000	4000	-1722
chr16	28494964	28502964	28497990	8000	28498964	-4000	4000	-974
chr16	31913357	31921357	31915464	8000	31917357	-4000	4000	-1893
chr16	31913357	31921357	31915658	8000	31917357	-4000	4000	-1699
chr16	51131982	51139982	51138889	8000	51135982	-4000	4000	2907
chr16	84561596	84569596	84566782	8000	84565596	-4000	4000	1186
chr16	31913357	31921357	31916224	8000	31917357	-4000	4000	-1133
chr16	3218325	3226325	3224435	8000	3222325	-4000	4000	2110
chr16	48359122	48367122	48361368	8000	48363122	-4000	4000	-1754
chr16	3535033	3543033	3541705	8000	3539033	-4000	4000	2672
chr16	28494964	28502964	28498525	8000	28498964	-4000	4000	-439
chr16	26133685	26141685	26136429	8000	26137685	-4000	4000	-1256
chr16	27065166	27073166	27067432	8000	27069166	-4000	4000	-1734
chr16	4452775	4460775	4456631	8000	4456775	-4000	4000	-144
chr16	4799203	4807203	4801425	8000	4803203	-4000	4000	-1778
chr16	48076882	48084882	48083943	8000	48080882	-4000	4000	3061
chr16	2848730	2856730	2856138	8000	2852730	-4000	4000	3408
chr16	25224932	25232932	25228660	8000	25228932	-4000	4000	-272
chr16	27360778	27368778	27363495	8000	27364778	-4000	4000	-1283
chr16	20355175	20363175	20359371	8000	20359175	-4000	4000	196
chr16	90040975	90048975	90043066	8000	90044975	-4000	4000	-1909
chr16	29867159	29875159	29873577	8000	29871159	-4000	4000	2418
chr16	30757176	30765176	30761604	8000	30761176	-4000	4000	428
chr16	48359122	48367122	48362419	8000	48363122	-4000	4000	-703
chr16	50730041	50738041	50731843	8000	50734041	-4000	4000	-2198
chr16	70656682	70664682	70661628	8000	70660682	-4000	4000	946
chr16	2779953	2787953	2786553	8000	2783953	-4000	4000	2600
chr16	68297823	68305823	68304042	8000	68301823	-4000	4000	2219
chr16	64939753	64947753	64947187	8000	64943753	-4000	4000	3434
chr16	20024239	20032239	20032115	8000	20028239	-4000	4000	3876
chr16	764865	772865	766661	8000	768865	-4000	4000	-2204
chr16	28533040	28541040	28538997	8000	28537040	-4000	4000	1957
chr16	67285428	67293428	67286809	8000	67289428	-4000	4000	-2619
chr16	51131982	51139982	51139735	8000	51135982	-4000	4000	3753
chr16	764865	772865	770069	8000	768865	-4000	4000	1204
chr16	20024239	20032239	20031782	8000	20028239	-4000	4000	3543
chr16	46698282	46706282	46703892	8000	46702282	-4000	4000	1610
chr16	24358412	24366412	24361815	8000	24362412	-4000	4000	-597
chr16	1934229	1942229	1938908	8000	1938229	-4000	4000	679
chr16	89934761	89942761	89935424	8000	89938761	-4000	4000	-3337
chr16	27360778	27368778	27363761	8000	27364778	-4000	4000	-1017
chr16	268183	276183	271298	8000	272183	-4000	4000	-885
chr16	3314852	3322852	3317335	8000	3318852	-4000	4000	-1517
chr16	4596758	4604758	4600296	8000	4600758	-4000	4000	-462
chr16	28494964	28502964	28496384	8000	28498964	-4000	4000	-2580
chr16	28963092	28971092	28963883	8000	28967092	-4000	4000	-3209
chr16	57424187	57432187	57429268	8000	57428187	-4000	4000	1081
chr16	58402147	58410147	58404668	8000	58406147	-4000	4000	-1479
chr16	68831537	68839537	68833300	8000	68835537	-4000	4000	-2237
chr16	71927199	71935199	71929644	8000	71931199	-4000	4000	-1555
chr16	31328892	31336892	31329252	8000	31332892	-4000	4000	-3640
chr16	550636	558636	552903	8000	554636	-4000	4000	-1733
chr16	67971663	67979663	67975913	8000	67975663	-4000	4000	250
chr16	69937741	69945741	69940836	8000	69941741	-4000	4000	-905
chr16	21979865	21987865	21984465	8000	21983865	-4000	4000	600
chr16	23377294	23385294	23380482	8000	23381294	-4000	4000	-812
chr16	27360778	27368778	27363801	8000	27364778	-4000	4000	-977
chr16	30985256	30993256	30988185	8000	30989256	-4000	4000	-1071
chr16	31328892	31336892	31331246	8000	31332892	-4000	4000	-1646
chr16	67670531	67678531	67675427	8000	67674531	-4000	4000	896
chr16	84193168	84201168	84194503	8000	84197168	-4000	4000	-2665
chr16	57685378	57693378	57685728	8000	57689378	-4000	4000	-3650
chr16	71277389	71285389	71285127	8000	71281389	-4000	4000	3738
chr16	24358412	24366412	24361553	8000	24362412	-4000	4000	-859
chr16	28980548	28988548	28981459	8000	28984548	-4000	4000	-3089
chr16	51131982	51139982	51139142	8000	51135982	-4000	4000	3160
chr16	66584275	66592275	66587981	8000	66588275	-4000	4000	-294
chr16	89964060	89972060	89971747	8000	89968060	-4000	4000	3687
chr16	30757176	30765176	30763164	8000	30761176	-4000	4000	1988
chr16	46951362	46959362	46957198	8000	46955362	-4000	4000	1836
chr16	56353444	56361444	56354997	8000	56357444	-4000	4000	-2447
chr16	84193168	84201168	84194108	8000	84197168	-4000	4000	-3060
chr16	29969050	29977050	29974270	8000	29973050	-4000	4000	1220
chr16	28494964	28502964	28495761	8000	28498964	-4000	4000	-3203
chr16	16145565	16153565	16150717	8000	16149565	-4000	4000	1152
chr16	70183361	70191361	70185937	8000	70187361	-4000	4000	-1424
chr16	85090230	85098230	85093407	8000	85094230	-4000	4000	-823
chr16	2599188	2607188	2601307	8000	2603188	-4000	4000	-1881
chr16	47150387	47158387	47155679	8000	47154387	-4000	4000	1292
chr16	28900421	28908421	28904344	8000	28904421	-4000	4000	-77
chr16	29801385	29809385	29808593	8000	29805385	-4000	4000	3208
chr16	56623112	56631112	56626616	8000	56627112	-4000	4000	-496
chr16	56629981	56637981	56636920	8000	56633981	-4000	4000	2939
chr16	80271	88271	86810	8000	84271	-4000	4000	2539
chr16	84561596	84569596	84566869	8000	84565596	-4000	4000	1273
chr16	31378999	31386999	31380015	8000	31382999	-4000	4000	-2984
chr16	70798084	70806084	70800941	8000	70802084	-4000	4000	-1143
chr16	23754935	23762935	23756167	8000	23758935	-4000	4000	-2768
chr16	406367	414367	407323	8000	410367	-4000	4000	-3044
chr16	1077454	1085454	1079135	8000	1081454	-4000	4000	-2319
chr16	24907628	24915628	24910367	8000	24911628	-4000	4000	-1261
chr16	28494964	28502964	28496534	8000	28498964	-4000	4000	-2430
chr16	3010505	3018505	3015757	8000	3014505	-4000	4000	1252
chr16	1238554	1246554	1241280	8000	1242554	-4000	4000	-1274
chr16	3489484	3497484	3493937	8000	3493484	-4000	4000	453
chr16	58279836	58287836	58284670	8000	58283836	-4000	4000	834
chr16	10524422	10532422	10530616	8000	10528422	-4000	4000	2194
chr16	20024239	20032239	20031926	8000	20028239	-4000	4000	3687
chr16	50033088	50041088	50036680	8000	50037088	-4000	4000	-408
chr16	75532741	75540741	75539963	8000	75536741	-4000	4000	3222
chr16	22912338	22920338	22915053	8000	22916338	-4000	4000	-1285
chr16	67390152	67398152	67390293	8000	67394152	-4000	4000	-3859
chr16	3238027	3246027	3243331	8000	3242027	-4000	4000	1304
chr16	22532521	22540521	22534410	8000	22536521	-4000	4000	-2111
chr16	50103272	50111272	50105163	8000	50107272	-4000	4000	-2109
chr16	66941096	66949096	66941211	8000	66945096	-4000	4000	-3885
chr16	4799203	4807203	4801351	8000	4803203	-4000	4000	-1852
chr16	3010505	3018505	3015516	8000	3014505	-4000	4000	1011
chr16	85918606	85926606	85918781	8000	85922606	-4000	4000	-3825
chr16	2895382	2903382	2896578	8000	2899382	-4000	4000	-2804
chr16	55502691	55510691	55502866	8000	55506691	-4000	4000	-3825
chr16	765428	773428	772979	8000	769428	-4000	4000	3551
chr16	24568863	24576863	24568910	8000	24572863	-4000	4000	-3953
chr16	21979865	21987865	21983096	8000	21983865	-4000	4000	-769
chr16	31328892	31336892	31330165	8000	31332892	-4000	4000	-2727
chr16	55326756	55334756	55328843	8000	55330756	-4000	4000	-1913
chr16	56629981	56637981	56632735	8000	56633981	-4000	4000	-1246
chr16	15699135	15707135	15703890	8000	15703135	-4000	4000	755
chr16	23673472	23681472	23679271	8000	23677472	-4000	4000	1799
chr16	50314135	50322135	50315394	8000	50318135	-4000	4000	-2741
chr16	58515951	58523951	58520916	8000	58519951	-4000	4000	965
chr16	84118141	84126141	84123738	8000	84122141	-4000	4000	1597
chr16	84118141	84126141	84124593	8000	84122141	-4000	4000	2452
chr16	89634456	89642456	89638142	8000	89638456	-4000	4000	-314
chr16	57457270	57465270	57460642	8000	57461270	-4000	4000	-628
chr16	4878507	4886507	4880219	8000	4882507	-4000	4000	-2288
chr16	31913357	31921357	31915156	8000	31917357	-4000	4000	-2201
chr16	28494964	28502964	28495444	8000	28498964	-4000	4000	-3520
chr16	89964060	89972060	89971913	8000	89968060	-4000	4000	3853
chr16	1238554	1246554	1242186	8000	1242554	-4000	4000	-368
chr16	67971663	67979663	67977773	8000	67975663	-4000	4000	2110
chr16	23384493	23392493	23392426	8000	23388493	-4000	4000	3933
chr16	67971663	67979663	67976111	8000	67975663	-4000	4000	448
chr16	90052566	90060566	90060528	8000	90056566	-4000	4000	3962
chr16	3238027	3246027	3243384	8000	3242027	-4000	4000	1357
chr16	31134926	31142926	31140538	8000	31138926	-4000	4000	1612
chr16	46694394	46702394	46696140	8000	46698394	-4000	4000	-2254
chr16	22912338	22920338	22915087	8000	22916338	-4000	4000	-1251
chr16	48359122	48367122	48362464	8000	48363122	-4000	4000	-658
chr16	2779953	2787953	2784662	8000	2783953	-4000	4000	709
chr16	1255008	1263008	1257050	8000	1259008	-4000	4000	-1958
chr16	56629981	56637981	56633350	8000	56633981	-4000	4000	-631
chr16	23686310	23694310	23691368	8000	23690310	-4000	4000	1058
chr16	26133685	26141685	26135927	8000	26137685	-4000	4000	-1758
chr16	71561660	71569660	71568729	8000	71565660	-4000	4000	3069
chr16	3084890	3092890	3090510	8000	3088890	-4000	4000	1620
chr16	57148466	57156466	57154462	8000	57152466	-4000	4000	1996
chr16	561529	569529	563283	8000	565529	-4000	4000	-2246
chr16	184969	192969	190111	8000	188969	-4000	4000	1142
chr16	24568863	24576863	24569329	8000	24572863	-4000	4000	-3534
chr16	30757176	30765176	30760358	8000	30761176	-4000	4000	-818
chr16	31328892	31336892	31330078	8000	31332892	-4000	4000	-2814
chr16	53487648	53495648	53492496	8000	53491648	-4000	4000	848
chr16	19117629	19125629	19118320	8000	19121629	-4000	4000	-3309
chr16	67150185	67158185	67156563	8000	67154185	-4000	4000	2378
chr16	89964060	89972060	89964503	8000	89968060	-4000	4000	-3557
chr16	88436757	88444757	88438425	8000	88440757	-4000	4000	-2332
chr16	88673688	88681688	88681197	8000	88677688	-4000	4000	3509
chr16	55842154	55850154	55846635	8000	55846154	-4000	4000	481
chr16	4878507	4886507	4883761	8000	4882507	-4000	4000	1254
chr16	56353444	56361444	56354885	8000	56357444	-4000	4000	-2559
chr16	28533040	28541040	28538114	8000	28537040	-4000	4000	1074
chr16	56629981	56637981	56636239	8000	56633981	-4000	4000	2258
chr16	21193450	21201450	21201442	8000	21197450	-4000	4000	3992
chr16	19549408	19557408	19555613	8000	19553408	-4000	4000	2205
chr16	58515951	58523951	58520829	8000	58519951	-4000	4000	878
chr16	849634	857634	854580	8000	853634	-4000	4000	946
chr16	561529	569529	563320	8000	565529	-4000	4000	-2209
chr16	88673688	88681688	88681178	8000	88677688	-4000	4000	3490
chr16	56605497	56613497	56608615	8000	56609497	-4000	4000	-882
chr16	1238554	1246554	1241517	8000	1242554	-4000	4000	-1037
chr16	4878507	4886507	4885678	8000	4882507	-4000	4000	3171
chr16	7709340	7717340	7711118	8000	7713340	-4000	4000	-2222
chr16	14665236	14673236	14672623	8000	14669236	-4000	4000	3387
chr16	27065166	27073166	27067199	8000	27069166	-4000	4000	-1967
chr16	3314852	3322852	3316955	8000	3318852	-4000	4000	-1897
chr16	85918606	85926606	85921207	8000	85922606	-4000	4000	-1399
chr16	22532521	22540521	22533972	8000	22536521	-4000	4000	-2549
chr16	23570389	23578389	23571768	8000	23574389	-4000	4000	-2621
chr16	57244547	57252547	57252171	8000	57248547	-4000	4000	3624
chr16	90052566	90060566	90058302	8000	90056566	-4000	4000	1736
chr16	29778973	29786973	29779634	8000	29782973	-4000	4000	-3339
chr16	20793581	20801581	20801289	8000	20797581	-4000	4000	3708
chr16	27065166	27073166	27066982	8000	27069166	-4000	4000	-2184
chr16	22912338	22920338	22915542	8000	22916338	-4000	4000	-796
chr16	46698282	46706282	46703892	8000	46702282	-4000	4000	1610
chr16	50314135	50322135	50319918	8000	50318135	-4000	4000	1783
chr16	5083379	5091379	5083740	8000	5087379	-4000	4000	-3639
chr16	56629981	56637981	56635989	8000	56633981	-4000	4000	2008
chr16	29867159	29875159	29873541	8000	29871159	-4000	4000	2382
chr16	1255008	1263008	1256930	8000	1259008	-4000	4000	-2078
chr16	21757935	21765935	21760508	8000	21761935	-4000	4000	-1427
chr16	21757935	21765935	21760509	8000	21761935	-4000	4000	-1426
chr16	89964060	89972060	89969938	8000	89968060	-4000	4000	1878
chr16	29854357	29862357	29861141	8000	29858357	-4000	4000	2784
chr16	46951362	46959362	46957148	8000	46955362	-4000	4000	1786
chr16	15359628	15367628	15363951	8000	15363628	-4000	4000	323
chr16	88436757	88444757	88439246	8000	88440757	-4000	4000	-1511
chr16	7709340	7717340	7710714	8000	7713340	-4000	4000	-2626
chr16	69114010	69122010	69116457	8000	69118010	-4000	4000	-1553
chr16	49395431	49403431	49396664	8000	49399431	-4000	4000	-2767
chr16	1255008	1263008	1258495	8000	1259008	-4000	4000	-513
chr16	20793581	20801581	20796796	8000	20797581	-4000	4000	-785
chr16	28980548	28988548	28984469	8000	28984548	-4000	4000	-79
chr16	66716893	66724893	66720935	8000	66720893	-4000	4000	42
chr16	56979845	56987845	56981185	8000	56983845	-4000	4000	-2660
chr16	67390152	67398152	67395027	8000	67394152	-4000	4000	875
chr16	4596758	4604758	4600213	8000	4600758	-4000	4000	-545
chr16	27360778	27368778	27363157	8000	27364778	-4000	4000	-1621
chr16	27776344	27784344	27776896	8000	27780344	-4000	4000	-3448
chr16	57685378	57693378	57685893	8000	57689378	-4000	4000	-3485
chr16	28494964	28502964	28496815	8000	28498964	-4000	4000	-2149
chr16	53669	61669	59810	8000	57669	-4000	4000	2141
chr16	982979	990979	984797	8000	986979	-4000	4000	-2182
chr16	13948348	13956348	13948374	8000	13952348	-4000	4000	-3974
chr16	89634456	89642456	89637338	8000	89638456	-4000	4000	-1118
chr16	184969	192969	189161	8000	188969	-4000	4000	192
chr16	71927199	71935199	71933458	8000	71931199	-4000	4000	2259
chr16	84460187	84468187	84463661	8000	84464187	-4000	4000	-526
chr16	30569740	30577740	30571928	8000	30573740	-4000	4000	-1812
chr16	30569740	30577740	30571929	8000	30573740	-4000	4000	-1811
chr16	26133685	26141685	26136224	8000	26137685	-4000	4000	-1461
chr16	27360778	27368778	27363612	8000	27364778	-4000	4000	-1166
chr16	29738463	29746463	29744351	8000	29742463	-4000	4000	1888
chr16	30020427	30028427	30023810	8000	30024427	-4000	4000	-617
chr16	51131982	51139982	51139782	8000	51135982	-4000	4000	3800
chr16	57661580	57669580	57661820	8000	57665580	-4000	4000	-3760
chr16	58703131	58711131	58708155	8000	58707131	-4000	4000	1024
chr16	68225259	68233259	68226417	8000	68229259	-4000	4000	-2842
chr16	67880499	67888499	67882967	8000	67884499	-4000	4000	-1532
chr16	1238554	1246554	1242349	8000	1242554	-4000	4000	-205
chr16	80271	88271	85463	8000	84271	-4000	4000	1192
chr16	2249116	2257116	2253253	8000	2253116	-4000	4000	137
chr16	3010505	3018505	3014272	8000	3014505	-4000	4000	-233
chr16	4878507	4886507	4884663	8000	4882507	-4000	4000	2156
chr16	18800860	18808860	18805890	8000	18804860	-4000	4000	1030
chr16	22083534	22091534	22083926	8000	22087534	-4000	4000	-3608
chr16	28494964	28502964	28497832	8000	28498964	-4000	4000	-1132
chr16	30569740	30577740	30569858	8000	30573740	-4000	4000	-3882
chr16	66917679	66925679	66924913	8000	66921679	-4000	4000	3234
chr16	71927199	71935199	71933951	8000	71931199	-4000	4000	2752
chr16	87402246	87410246	87409074	8000	87406246	-4000	4000	2828
chr16	57753244	57761244	57760385	8000	57757244	-4000	4000	3141
chr16	68257058	68265058	68259152	8000	68261058	-4000	4000	-1906
chr16	4452775	4460775	4454877	8000	4456775	-4000	4000	-1898
chr16	21653471	21661471	21655257	8000	21657471	-4000	4000	-2214
chr16	23577014	23585014	23581104	8000	23581014	-4000	4000	90
chr16	51131982	51139982	51139515	8000	51135982	-4000	4000	3533
chr16	68831537	68839537	68833355	8000	68835537	-4000	4000	-2182
chr16	10939021	10947021	10941619	8000	10943021	-4000	4000	-1402
chr16	3353306	3361306	3356243	8000	3357306	-4000	4000	-1063
chr16	3535033	3543033	3536146	8000	3539033	-4000	4000	-2887
chr16	30353102	30361102	30354815	8000	30357102	-4000	4000	-2287
chr16	56649204	56657204	56653138	8000	56653204	-4000	4000	-66
chr16	67884855	67892855	67886101	8000	67888855	-4000	4000	-2754
chr16	28093976	28101976	28101635	8000	28097976	-4000	4000	3659
chr16	49273917	49281917	49281235	8000	49277917	-4000	4000	3318
chr16	550636	558636	553616	8000	554636	-4000	4000	-1020
chr16	550636	558636	554479	8000	554636	-4000	4000	-157
chr16	764865	772865	766765	8000	768865	-4000	4000	-2100
chr16	7709340	7717340	7710840	8000	7713340	-4000	4000	-2500
chr16	10524422	10532422	10531827	8000	10528422	-4000	4000	3405
chr16	20355175	20363175	20360576	8000	20359175	-4000	4000	1401
chr16	28494964	28502964	28497520	8000	28498964	-4000	4000	-1444
chr16	28494964	28502964	28497841	8000	28498964	-4000	4000	-1123
chr16	28494964	28502964	28498334	8000	28498964	-4000	4000	-630
chr16	48076882	48084882	48083945	8000	48080882	-4000	4000	3063
chr16	49483524	49491524	49490938	8000	49487524	-4000	4000	3414
chr16	66716893	66724893	66722166	8000	66720893	-4000	4000	1273
chr16	71277389	71285389	71285091	8000	71281389	-4000	4000	3702
chr16	4185374	4193374	4192566	8000	4189374	-4000	4000	3192
chr16	86565728	86573728	86567790	8000	86569728	-4000	4000	-1938
chr16	24823632	24831632	24824442	8000	24827632	-4000	4000	-3190
chr16	28494964	28502964	28495164	8000	28498964	-4000	4000	-3800
chr16	20355175	20363175	20362530	8000	20359175	-4000	4000	3355
chr16	71561660	71569660	71568798	8000	71565660	-4000	4000	3138
chr16	4799203	4807203	4801387	8000	4803203	-4000	4000	-1816
chr16	22912338	22920338	22915613	8000	22916338	-4000	4000	-725
chr16	57144369	57152369	57146176	8000	57148369	-4000	4000	-2193
chr16	84460187	84468187	84463916	8000	84464187	-4000	4000	-271
chr16	55582666	55590666	55582911	8000	55586666	-4000	4000	-3755
chr16	46574591	46582591	46581625	8000	46578591	-4000	4000	3034
chr16	20532226	20540226	20537264	8000	20536226	-4000	4000	1038
chr16	67097058	67105058	67099105	8000	67101058	-4000	4000	-1953
chr16	1481886	1489886	1485985	8000	1485886	-4000	4000	99
chr16	46698282	46706282	46703737	8000	46702282	-4000	4000	1455
chr16	57457270	57465270	57458242	8000	57461270	-4000	4000	-3028
chr16	19076095	19084095	19078133	8000	19080095	-4000	4000	-1962
chr16	26133685	26141685	26135949	8000	26137685	-4000	4000	-1736
chr16	57984116	57992116	57984764	8000	57988116	-4000	4000	-3352
chr16	66798875	66806875	66802956	8000	66802875	-4000	4000	81
chr16	67868567	67876567	67870783	8000	67872567	-4000	4000	-1784
chr16	3010505	3018505	3014147	8000	3014505	-4000	4000	-358
chr16	52432417	52440417	52439437	8000	52436417	-4000	4000	3020
chr16	85672204	85680204	85673208	8000	85676204	-4000	4000	-2996
chr16	30020427	30028427	30023372	8000	30024427	-4000	4000	-1055
chr16	22912338	22920338	22915275	8000	22916338	-4000	4000	-1063
chr16	46694394	46702394	46698129	8000	46698394	-4000	4000	-265
chr16	56629981	56637981	56632726	8000	56633981	-4000	4000	-1255
chr16	67880499	67888499	67883297	8000	67884499	-4000	4000	-1202
chr16	88436757	88444757	88439367	8000	88440757	-4000	4000	-1390
chr16	28494964	28502964	28495440	8000	28498964	-4000	4000	-3524
chr16	71725000	71733000	71729639	8000	71729000	-4000	4000	639
chr16	23754935	23762935	23757309	8000	23758935	-4000	4000	-1626
chr16	10479638	10487638	10482276	8000	10483638	-4000	4000	-1362
chr16	561529	569529	564348	8000	565529	-4000	4000	-1181
chr16	2779953	2787953	2784883	8000	2783953	-4000	4000	930
chr16	33840784	33848784	33845074	8000	33844784	-4000	4000	290
chr16	31378999	31386999	31380040	8000	31382999	-4000	4000	-2959
chr16	19497693	19505693	19503518	8000	19501693	-4000	4000	1825
chr16	69462264	69470264	69462582	8000	69466264	-4000	4000	-3682
chr16	31463166	31471166	31465157	8000	31467166	-4000	4000	-2009
chr16	57079531	57087531	57079578	8000	57083531	-4000	4000	-3953
chr16	21979865	21987865	21984409	8000	21983865	-4000	4000	544
chr16	15699135	15707135	15704009	8000	15703135	-4000	4000	874
chr16	53487648	53495648	53492393	8000	53491648	-4000	4000	745
chr16	3084890	3092890	3090479	8000	3088890	-4000	4000	1589
chr16	10623501	10631501	10627604	8000	10627501	-4000	4000	103
chr16	53669	61669	55793	8000	57669	-4000	4000	-1876
chr16	22912338	22920338	22915307	8000	22916338	-4000	4000	-1031
chr16	23673472	23681472	23679256	8000	23677472	-4000	4000	1784
chr16	3535033	3543033	3536052	8000	3539033	-4000	4000	-2981
chr16	89634456	89642456	89636550	8000	89638456	-4000	4000	-1906
chr16	3297401	3305401	3299850	8000	3301401	-4000	4000	-1551
chr16	46698282	46706282	46703892	8000	46702282	-4000	4000	1610
chr16	57381044	57389044	57383060	8000	57385044	-4000	4000	-1984
chr16	58042901	58050901	58046784	8000	58046901	-4000	4000	-117
chr16	15861719	15869719	15867462	8000	15865719	-4000	4000	1743
chr16	31378999	31386999	31380898	8000	31382999	-4000	4000	-2101
chr16	17097769	17105769	17102337	8000	17101769	-4000	4000	568
chr16	30985256	30993256	30991048	8000	30989256	-4000	4000	1792
chr16	1238554	1246554	1242332	8000	1242554	-4000	4000	-222
chr16	3297401	3305401	3299173	8000	3301401	-4000	4000	-2228
chr16	27360778	27368778	27363814	8000	27364778	-4000	4000	-964
chr16	42407	50407	47531	8000	46407	-4000	4000	1124
chr16	1673908	1681908	1673943	8000	1677908	-4000	4000	-3965
chr16	3010505	3018505	3015665	8000	3014505	-4000	4000	1160
chr16	3218325	3226325	3224081	8000	3222325	-4000	4000	1756
chr16	3535033	3543033	3541874	8000	3539033	-4000	4000	2841
chr16	11746586	11754586	11752746	8000	11750586	-4000	4000	2160
chr16	20793581	20801581	20798407	8000	20797581	-4000	4000	826
chr16	21193450	21201450	21199605	8000	21197450	-4000	4000	2155
chr16	28494964	28502964	28497145	8000	28498964	-4000	4000	-1819
chr16	29801385	29809385	29808682	8000	29805385	-4000	4000	3297
chr16	30757176	30765176	30764325	8000	30761176	-4000	4000	3149
chr16	30985256	30993256	30992849	8000	30989256	-4000	4000	3593
chr16	31134926	31142926	31141879	8000	31138926	-4000	4000	2953
chr16	50103272	50111272	50105052	8000	50107272	-4000	4000	-2220
chr16	53487648	53495648	53494823	8000	53491648	-4000	4000	3175
chr16	56605497	56613497	56609427	8000	56609497	-4000	4000	-70
chr16	56629981	56637981	56636124	8000	56633981	-4000	4000	2143
chr16	57381044	57389044	57382413	8000	57385044	-4000	4000	-2631
chr16	58109592	58117592	58114918	8000	58113592	-4000	4000	1326
chr16	58279836	58287836	58280165	8000	58283836	-4000	4000	-3671
chr16	66917679	66925679	66922316	8000	66921679	-4000	4000	637
chr16	67285428	67293428	67291683	8000	67289428	-4000	4000	2255
chr16	67381204	67389204	67385010	8000	67385204	-4000	4000	-194
chr16	75592868	75600868	75600293	8000	75596868	-4000	4000	3425
chr16	84193168	84201168	84195054	8000	84197168	-4000	4000	-2114
chr16	84775922	84783922	84779211	8000	84779922	-4000	4000	-711
chr16	88436757	88444757	88438862	8000	88440757	-4000	4000	-1895
chr16	89733549	89741549	89737822	8000	89737549	-4000	4000	273
chr16	27360778	27368778	27363407	8000	27364778	-4000	4000	-1371
chr16	3010505	3018505	3014070	8000	3014505	-4000	4000	-435
chr16	32251922	32259922	32254641	8000	32255922	-4000	4000	-1281
chr16	20024239	20032239	20032032	8000	20028239	-4000	4000	3793
chr16	20024239	20032239	20031792	8000	20028239	-4000	4000	3553
chr16	52432417	52440417	52439167	8000	52436417	-4000	4000	2750
chr16	20532226	20540226	20537100	8000	20536226	-4000	4000	874
chr16	67880499	67888499	67884098	8000	67884499	-4000	4000	-401
chr16	3010505	3018505	3015803	8000	3014505	-4000	4000	1298
chr16	31524803	31532803	31528675	8000	31528803	-4000	4000	-128
chr16	69114010	69122010	69119010	8000	69118010	-4000	4000	1000
chr16	53669	61669	58990	8000	57669	-4000	4000	1321
chr16	1939974	1947974	1945839	8000	1943974	-4000	4000	1865
chr16	3218325	3226325	3224113	8000	3222325	-4000	4000	1788
chr16	3314852	3322852	3317200	8000	3318852	-4000	4000	-1652
chr16	4799203	4807203	4801526	8000	4803203	-4000	4000	-1677
chr16	10623501	10631501	10627577	8000	10627501	-4000	4000	76
chr16	20024239	20032239	20032059	8000	20028239	-4000	4000	3820
chr16	20532226	20540226	20537168	8000	20536226	-4000	4000	942
chr16	23754935	23762935	23757248	8000	23758935	-4000	4000	-1687
chr16	24216611	24224611	24220178	8000	24220611	-4000	4000	-433
chr16	28338555	28346555	28342603	8000	28342555	-4000	4000	48
chr16	28980548	28988548	28982010	8000	28984548	-4000	4000	-2538
chr16	31378999	31386999	31379639	8000	31382999	-4000	4000	-3360
chr16	31378999	31386999	31382004	8000	31382999	-4000	4000	-995
chr16	31913357	31921357	31915532	8000	31917357	-4000	4000	-1825
chr16	33840784	33848784	33844827	8000	33844784	-4000	4000	43
chr16	48359122	48367122	48361707	8000	48363122	-4000	4000	-1415
chr16	56587088	56595088	56590727	8000	56591088	-4000	4000	-361
chr16	56940864	56948864	56943282	8000	56944864	-4000	4000	-1582
chr16	57753244	57761244	57760326	8000	57757244	-4000	4000	3082
chr16	58279836	58287836	58280277	8000	58283836	-4000	4000	-3559
chr16	58402147	58410147	58404517	8000	58406147	-4000	4000	-1630
chr16	74388115	74396115	74392052	8000	74392115	-4000	4000	-63
chr16	77738260	77746260	77741879	8000	77742260	-4000	4000	-381
chr16	81287142	81295142	81287336	8000	81291142	-4000	4000	-3806
chr16	81287142	81295142	81290610	8000	81291142	-4000	4000	-532
chr16	82143798	82151798	82149394	8000	82147798	-4000	4000	1596
chr16	89964060	89972060	89971398	8000	89968060	-4000	4000	3338
chr16	22532521	22540521	22534041	8000	22536521	-4000	4000	-2480
chr16	29969050	29977050	29971544	8000	29973050	-4000	4000	-1506
chr16	58703131	58711131	58708137	8000	58707131	-4000	4000	1006
chr16	67670531	67678531	67675868	8000	67674531	-4000	4000	1337
chr16	74388115	74396115	74389847	8000	74392115	-4000	4000	-2268
chr16	3353306	3361306	3356666	8000	3357306	-4000	4000	-640
chr16	268183	276183	274238	8000	272183	-4000	4000	2055
chr16	29738463	29746463	29744739	8000	29742463	-4000	4000	2276
chr16	74388115	74396115	74392017	8000	74392115	-4000	4000	-98
chr16	4773606	4781606	4779724	8000	4777606	-4000	4000	2118
chr16	30193561	30201561	30194606	8000	30197561	-4000	4000	-2955
chr16	56605497	56613497	56608672	8000	56609497	-4000	4000	-825
chr16	20532226	20540226	20537285	8000	20536226	-4000	4000	1059
chr16	71725000	71733000	71731674	8000	71729000	-4000	4000	2674
chr16	51131982	51139982	51139059	8000	51135982	-4000	4000	3077
chr16	24358412	24366412	24361887	8000	24362412	-4000	4000	-525
chr16	22912338	22920338	22915484	8000	22916338	-4000	4000	-854
chr16	58703131	58711131	58708251	8000	58707131	-4000	4000	1120
chr16	49395431	49403431	49396472	8000	49399431	-4000	4000	-2959
chr16	31913357	31921357	31915294	8000	31917357	-4000	4000	-2063
chr16	57148466	57156466	57154323	8000	57152466	-4000	4000	1857
chr16	3218325	3226325	3224374	8000	3222325	-4000	4000	2049
chr16	67180379	67188379	67180584	8000	67184379	-4000	4000	-3795
chr16	66575135	66583135	66579670	8000	66579135	-4000	4000	535
chr16	58402147	58410147	58404653	8000	58406147	-4000	4000	-1494
chr16	31913357	31921357	31915761	8000	31917357	-4000	4000	-1596
chr16	3314852	3322852	3317403	8000	3318852	-4000	4000	-1449
chr16	3084890	3092890	3092212	8000	3088890	-4000	4000	3322
chr16	10939021	10947021	10941772	8000	10943021	-4000	4000	-1249
chr16	13948348	13956348	13948370	8000	13952348	-4000	4000	-3978
chr16	30569740	30577740	30570424	8000	30573740	-4000	4000	-3316
chr16	30944783	30952783	30946758	8000	30948783	-4000	4000	-2025
chr16	74617399	74625399	74624049	8000	74621399	-4000	4000	2650
chr16	75168236	75176236	75170124	8000	75172236	-4000	4000	-2112
chr16	56587088	56595088	56589556	8000	56591088	-4000	4000	-1532
chr16	66917679	66925679	66923910	8000	66921679	-4000	4000	2231
chr16	67971663	67979663	67978561	8000	67975663	-4000	4000	2898
chr16	31378999	31386999	31381866	8000	31382999	-4000	4000	-1133
chr16	1673908	1681908	1674027	8000	1677908	-4000	4000	-3881
chr16	28494964	28502964	28495962	8000	28498964	-4000	4000	-3002
chr16	1077454	1085454	1079387	8000	1081454	-4000	4000	-2067
chr16	69700666	69708666	69702128	8000	69704666	-4000	4000	-2538
chr16	20929111	20937111	20933266	8000	20933111	-4000	4000	155
chr16	27065166	27073166	27067032	8000	27069166	-4000	4000	-2134
chr16	1673908	1681908	1673936	8000	1677908	-4000	4000	-3972
chr16	46694394	46702394	46698115	8000	46698394	-4000	4000	-279
chr16	51131982	51139982	51137217	8000	51135982	-4000	4000	1235
chr16	26133685	26141685	26136010	8000	26137685	-4000	4000	-1675
chr16	31328892	31336892	31329830	8000	31332892	-4000	4000	-3062
chr16	4878507	4886507	4885559	8000	4882507	-4000	4000	3052
chr16	26133685	26141685	26136038	8000	26137685	-4000	4000	-1647
chr16	51131982	51139982	51139353	8000	51135982	-4000	4000	3371
chr16	3297401	3305401	3300458	8000	3301401	-4000	4000	-943
chr16	22532521	22540521	22534764	8000	22536521	-4000	4000	-1757
chr16	23686310	23694310	23690112	8000	23690310	-4000	4000	-198
chr16	23686310	23694310	23690905	8000	23690310	-4000	4000	595
chr16	31328892	31336892	31330321	8000	31332892	-4000	4000	-2571
chr16	31127393	31135393	31132469	8000	31131393	-4000	4000	1076
chr16	90040975	90048975	90042389	8000	90044975	-4000	4000	-2586
chr16	50730041	50738041	50731829	8000	50734041	-4000	4000	-2212
chr16	89934761	89942761	89935435	8000	89938761	-4000	4000	-3326
chr16	268183	276183	271085	8000	272183	-4000	4000	-1098
chr16	28494964	28502964	28499731	8000	28498964	-4000	4000	767
chr16	1255008	1263008	1256821	8000	1259008	-4000	4000	-2187
chr16	3535033	3543033	3542723	8000	3539033	-4000	4000	3690
chr16	23673472	23681472	23680975	8000	23677472	-4000	4000	3503
chr16	56911850	56919850	56913357	8000	56915850	-4000	4000	-2493
chr16	69737871	69745871	69742256	8000	69741871	-4000	4000	385
chr16	3201188	3209188	3205059	8000	3205188	-4000	4000	-129
chr16	23673472	23681472	23679229	8000	23677472	-4000	4000	1757
chr16	23673472	23681472	23680994	8000	23677472	-4000	4000	3522
chr16	3238027	3246027	3243864	8000	3242027	-4000	4000	1837
chr16	46698282	46706282	46703892	8000	46702282	-4000	4000	1610
chr16	68831537	68839537	68833450	8000	68835537	-4000	4000	-2087
chr16	24568863	24576863	24568947	8000	24572863	-4000	4000	-3916
chr16	32251922	32259922	32253836	8000	32255922	-4000	4000	-2086
chr16	51131982	51139982	51137368	8000	51135982	-4000	4000	1386
chr16	19264332	19272332	19267065	8000	19268332	-4000	4000	-1267
chr16	49395431	49403431	49399339	8000	49399431	-4000	4000	-92
chr16	30569740	30577740	30569980	8000	30573740	-4000	4000	-3760
chr16	21979865	21987865	21980658	8000	21983865	-4000	4000	-3207
chr16	2705030	2713030	2708257	8000	2709030	-4000	4000	-773
chr16	7709340	7717340	7712449	8000	7713340	-4000	4000	-891
chr16	19497693	19505693	19505077	8000	19501693	-4000	4000	3384
chr16	173522	181522	180684	8000	177522	-4000	4000	3162
chr16	30373991	30381991	30377862	8000	30377991	-4000	4000	-129
chr16	23686310	23694310	23689321	8000	23690310	-4000	4000	-989
chr16	1077454	1085454	1079206	8000	1081454	-4000	4000	-2248
chr16	30110105	30118105	30117767	8000	30114105	-4000	4000	3662
chr16	58109592	58117592	58115435	8000	58113592	-4000	4000	1843
chr16	20929111	20937111	20935458	8000	20933111	-4000	4000	2347
chr16	30110105	30118105	30116871	8000	30114105	-4000	4000	2766
chr16	30110105	30118105	30116872	8000	30114105	-4000	4000	2767
chr16	69702996	69710996	69710836	8000	69706996	-4000	4000	3840
chr16	14948060	14956060	14951956	8000	14952060	-4000	4000	-104
chr16	67840195	67848195	67842955	8000	67844195	-4000	4000	-1240
chr16	71277389	71285389	71285179	8000	71281389	-4000	4000	3790
chr16	56629981	56637981	56636930	8000	56633981	-4000	4000	2949
chr16	30020427	30028427	30025757	8000	30024427	-4000	4000	1330
chr16	4878507	4886507	4884650	8000	4882507	-4000	4000	2143
chr16	57685378	57693378	57685652	8000	57689378	-4000	4000	-3726
chr16	70656682	70664682	70657030	8000	70660682	-4000	4000	-3652
chr16	53487648	53495648	53490360	8000	53491648	-4000	4000	-1288
chr16	71927199	71935199	71927616	8000	71931199	-4000	4000	-3583
chr16	26133685	26141685	26135773	8000	26137685	-4000	4000	-1912
chr16	75592868	75600868	75599502	8000	75596868	-4000	4000	2634
chr16	20532226	20540226	20537222	8000	20536226	-4000	4000	996
chr16	23384493	23392493	23392398	8000	23388493	-4000	4000	3905
chr16	31378999	31386999	31379789	8000	31382999	-4000	4000	-3210
chr16	31524803	31532803	31528529	8000	31528803	-4000	4000	-274
chr16	7709340	7717340	7712047	8000	7713340	-4000	4000	-1293
chr16	11178186	11186186	11178497	8000	11182186	-4000	4000	-3689
chr16	20329051	20337051	20335501	8000	20333051	-4000	4000	2450
chr16	31913357	31921357	31915284	8000	31917357	-4000	4000	-2073
chr16	31913357	31921357	31916562	8000	31917357	-4000	4000	-795
chr16	46951362	46959362	46959089	8000	46955362	-4000	4000	3727
chr16	56461640	56469640	56467195	8000	56465640	-4000	4000	1555
chr16	89553766	89561766	89556938	8000	89557766	-4000	4000	-828
chr16	71927199	71935199	71933924	8000	71931199	-4000	4000	2725
chr16	1077454	1085454	1079033	8000	1081454	-4000	4000	-2421
chr16	20329051	20337051	20335486	8000	20333051	-4000	4000	2435
chr16	24358412	24366412	24361411	8000	24362412	-4000	4000	-1001
chr16	28494964	28502964	28495307	8000	28498964	-4000	4000	-3657
chr16	67285428	67293428	67291444	8000	67289428	-4000	4000	2016
chr16	10524422	10532422	10532232	8000	10528422	-4000	4000	3810
chr16	19854467	19862467	19859858	8000	19858467	-4000	4000	1391
chr16	24823632	24831632	24825331	8000	24827632	-4000	4000	-2301
chr16	20929111	20937111	20933507	8000	20933111	-4000	4000	396
chr16	27065166	27073166	27067347	8000	27069166	-4000	4000	-1819
chr16	46694394	46702394	46698212	8000	46698394	-4000	4000	-182
chr16	57984116	57992116	57987397	8000	57988116	-4000	4000	-719
chr16	31428593	31436593	31436243	8000	31432593	-4000	4000	3650
chr16	30020427	30028427	30025635	8000	30024427	-4000	4000	1208
chr17	30891869	30899869	30893837	8000	30895869	-4000	4000	-2032
chr17	8386702	8394702	8393278	8000	8390702	-4000	4000	2576
chr17	63868012	63876012	63872269	8000	63872012	-4000	4000	257
chr17	76034775	76042775	76039673	8000	76038775	-4000	4000	898
chr17	41135433	41143433	41140274	8000	41139433	-4000	4000	841
chr17	79788132	79796132	79795557	8000	79792132	-4000	4000	3425
chr17	7510616	7518616	7514401	8000	7514616	-4000	4000	-215
chr17	19413276	19421276	19413387	8000	19417276	-4000	4000	-3889
chr17	38526031	38534031	38533171	8000	38530031	-4000	4000	3140
chr17	63934554	63942554	63941893	8000	63938554	-4000	4000	3339
chr17	61938605	61946605	61944389	8000	61942605	-4000	4000	1784
chr17	80462834	80470834	80470789	8000	80466834	-4000	4000	3955
chr17	35188520	35196520	35193521	8000	35192520	-4000	4000	1001
chr17	36009056	36017056	36013761	8000	36013056	-4000	4000	705
chr17	50688253	50696253	50696143	8000	50692253	-4000	4000	3890
chr17	8045134	8053134	8047852	8000	8049134	-4000	4000	-1282
chr17	45843067	45851067	45846802	8000	45847067	-4000	4000	-265
chr17	4626919	4634919	4631951	8000	4630919	-4000	4000	1032
chr17	5092374	5100374	5093047	8000	5096374	-4000	4000	-3327
chr17	7415860	7423860	7416056	8000	7419860	-4000	4000	-3804
chr17	50470845	50478845	50473901	8000	50474845	-4000	4000	-944
chr17	50858223	50866223	50863395	8000	50862223	-4000	4000	1172
chr17	68043364	68051364	68044031	8000	68047364	-4000	4000	-3333
chr17	82373458	82381458	82374779	8000	82377458	-4000	4000	-2679
chr17	12139830	12147830	12141213	8000	12143830	-4000	4000	-2617
chr17	34284334	34292334	34287607	8000	34288334	-4000	4000	-727
chr17	35972493	35980493	35977683	8000	35976493	-4000	4000	1190
chr17	48603232	48611232	48607818	8000	48607232	-4000	4000	586
chr17	79788132	79796132	79795251	8000	79792132	-4000	4000	3119
chr17	34356328	34364328	34357536	8000	34360328	-4000	4000	-2792
chr17	49219225	49227225	49222144	8000	49223225	-4000	4000	-1081
chr17	59211239	59219239	59213237	8000	59215239	-4000	4000	-2002
chr17	59211239	59219239	59215171	8000	59215239	-4000	4000	-68
chr17	4626919	4634919	4632201	8000	4630919	-4000	4000	1282
chr17	44005068	44013068	44013045	8000	44009068	-4000	4000	3977
chr17	10439290	10447290	10443465	8000	10443290	-4000	4000	175
chr17	44845948	44853948	44851778	8000	44849948	-4000	4000	1830
chr17	55388622	55396622	55394319	8000	55392622	-4000	4000	1697
chr17	41102488	41110488	41105888	8000	41106488	-4000	4000	-600
chr17	60173327	60181327	60179153	8000	60177327	-4000	4000	1826
chr17	63890909	63898909	63895505	8000	63894909	-4000	4000	596
chr17	74873302	74881302	74879444	8000	74877302	-4000	4000	2142
chr17	7013520	7021520	7017264	8000	7017520	-4000	4000	-256
chr17	40384525	40392525	40389239	8000	40388525	-4000	4000	714
chr17	7026290	7034290	7026789	8000	7030290	-4000	4000	-3501
chr17	35188520	35196520	35194070	8000	35192520	-4000	4000	1550
chr17	41389721	41397721	41395534	8000	41393721	-4000	4000	1813
chr17	81914270	81922270	81914410	8000	81918270	-4000	4000	-3860
chr17	43212941	43220941	43216574	8000	43216941	-4000	4000	-367
chr17	47833719	47841719	47834612	8000	47837719	-4000	4000	-3107
chr17	63868012	63876012	63872091	8000	63872012	-4000	4000	79
chr17	12987643	12995643	12990273	8000	12991643	-4000	4000	-1370
chr17	58485529	58493529	58492521	8000	58489529	-4000	4000	2992
chr17	41102488	41110488	41105680	8000	41106488	-4000	4000	-808
chr17	67980378	67988378	67983691	8000	67984378	-4000	4000	-687
chr17	7510616	7518616	7511431	8000	7514616	-4000	4000	-3185
chr17	67052797	67060797	67056208	8000	67056797	-4000	4000	-589
chr17	1751265	1759265	1754369	8000	1755265	-4000	4000	-896
chr17	73203353	73211353	73209334	8000	73207353	-4000	4000	1981
chr17	7415860	7423860	7417129	8000	7419860	-4000	4000	-2731
chr17	58731611	58739611	58734290	8000	58735611	-4000	4000	-1321
chr17	3214896	3222896	3215917	8000	3218896	-4000	4000	-2979
chr17	44557262	44565262	44559070	8000	44561262	-4000	4000	-2192
chr17	30465989	30473989	30468415	8000	30469989	-4000	4000	-1574
chr17	79045788	79053788	79046661	8000	79049788	-4000	4000	-3127
chr17	41373669	41381669	41379373	8000	41377669	-4000	4000	1704
chr17	3214896	3222896	3216474	8000	3218896	-4000	4000	-2422
chr17	9767434	9775434	9771580	8000	9771434	-4000	4000	146
chr17	4484208	4492208	4487974	8000	4488208	-4000	4000	-234
chr17	36940612	36948612	36940986	8000	36944612	-4000	4000	-3626
chr17	29067122	29075122	29074774	8000	29071122	-4000	4000	3652
chr17	6771647	6779647	6773122	8000	6775647	-4000	4000	-2525
chr17	17343663	17351663	17344901	8000	17347663	-4000	4000	-2762
chr17	41135433	41143433	41140171	8000	41139433	-4000	4000	738
chr17	48544870	48552870	48549177	8000	48548870	-4000	4000	307
chr17	75821799	75829799	75825477	8000	75825799	-4000	4000	-322
chr17	82747196	82755196	82748899	8000	82751196	-4000	4000	-2297
chr17	18205954	18213954	18206834	8000	18209954	-4000	4000	-3120
chr17	32993877	33001877	32996997	8000	32997877	-4000	4000	-880
chr17	3033741	3041741	3037034	8000	3037741	-4000	4000	-707
chr17	40015097	40023097	40016933	8000	40019097	-4000	4000	-2164
chr17	51167744	51175744	51171640	8000	51171744	-4000	4000	-104
chr17	58155585	58163585	58157718	8000	58159585	-4000	4000	-1867
chr17	62697314	62705314	62701675	8000	62701314	-4000	4000	361
chr17	68043364	68051364	68046771	8000	68047364	-4000	4000	-593
chr17	76708832	76716832	76716634	8000	76712832	-4000	4000	3802
chr17	21415870	21423870	21419619	8000	21419870	-4000	4000	-251
chr17	41578279	41586279	41583863	8000	41582279	-4000	4000	1584
chr17	12139830	12147830	12139885	8000	12143830	-4000	4000	-3945
chr17	35979656	35987656	35986656	8000	35983656	-4000	4000	3000
chr17	36190869	36198869	36196749	8000	36194869	-4000	4000	1880
chr17	47945308	47953308	47946380	8000	47949308	-4000	4000	-2928
chr17	63868012	63876012	63872555	8000	63872012	-4000	4000	543
chr17	50481974	50489974	50482151	8000	50485974	-4000	4000	-3823
chr17	50838353	50846353	50840634	8000	50842353	-4000	4000	-1719
chr17	59946574	59954574	59948454	8000	59950574	-4000	4000	-2120
chr17	67740531	67748531	67743922	8000	67744531	-4000	4000	-609
chr17	78138968	78146968	78139235	8000	78142968	-4000	4000	-3733
chr17	50371059	50379059	50375896	8000	50375059	-4000	4000	837
chr17	30995911	31003911	30998871	8000	30999911	-4000	4000	-1040
chr17	53821193	53829193	53823764	8000	53825193	-4000	4000	-1429
chr17	63913203	63921203	63917390	8000	63917203	-4000	4000	187
chr17	68531113	68539113	68537654	8000	68535113	-4000	4000	2541
chr17	63905597	63913597	63910609	8000	63909597	-4000	4000	1012
chr17	20315026	20323026	20321413	8000	20319026	-4000	4000	2387
chr17	42854130	42862130	42856364	8000	42858130	-4000	4000	-1766
chr17	35739521	35747521	35740493	8000	35743521	-4000	4000	-3028
chr17	39743291	39751291	39744135	8000	39747291	-4000	4000	-3156
chr17	39973768	39981768	39974375	8000	39977768	-4000	4000	-3393
chr17	41173446	41181446	41178133	8000	41177446	-4000	4000	687
chr17	63604347	63612347	63608105	8000	63608347	-4000	4000	-242
chr17	72122416	72130416	72124386	8000	72126416	-4000	4000	-2030
chr17	40762238	40770238	40766460	8000	40766238	-4000	4000	222
chr17	41025351	41033351	41027089	8000	41029351	-4000	4000	-2262
chr17	76620761	76628761	76627222	8000	76624761	-4000	4000	2461
chr17	435978	443978	443448	8000	439978	-4000	4000	3470
chr17	1629858	1637858	1635362	8000	1633858	-4000	4000	1504
chr17	3393104	3401104	3398157	8000	3397104	-4000	4000	1053
chr17	3428870	3436870	3432999	8000	3432870	-4000	4000	129
chr17	7829742	7837742	7830679	8000	7833742	-4000	4000	-3063
chr17	19379544	19387544	19380880	8000	19383544	-4000	4000	-2664
chr17	29569157	29577157	29574869	8000	29573157	-4000	4000	1712
chr17	41389721	41397721	41397362	8000	41393721	-4000	4000	3641
chr17	42398449	42406449	42405063	8000	42402449	-4000	4000	2614
chr17	49696934	49704934	49704098	8000	49700934	-4000	4000	3164
chr17	63890909	63898909	63895520	8000	63894909	-4000	4000	611
chr17	63998594	64006594	64001773	8000	64002594	-4000	4000	-821
chr17	65223703	65231703	65225329	8000	65227703	-4000	4000	-2374
chr17	41223652	41231652	41227061	8000	41227652	-4000	4000	-591
chr17	4953131	4961131	4957069	8000	4957131	-4000	4000	-62
chr17	36190869	36198869	36195312	8000	36194869	-4000	4000	443
chr17	32487253	32495253	32494829	8000	32491253	-4000	4000	3576
chr17	36084256	36092256	36088693	8000	36088256	-4000	4000	437
chr17	4953131	4961131	4955436	8000	4957131	-4000	4000	-1695
chr17	4984130	4992130	4989511	8000	4988130	-4000	4000	1381
chr17	10488307	10496307	10494644	8000	10492307	-4000	4000	2337
chr17	19018595	19026595	19020322	8000	19022595	-4000	4000	-2273
chr17	41416547	41424547	41424190	8000	41420547	-4000	4000	3643
chr17	58201174	58209174	58207105	8000	58205174	-4000	4000	1931
chr17	59105857	59113857	59112124	8000	59109857	-4000	4000	2267
chr17	59271970	59279970	59273788	8000	59275970	-4000	4000	-2182
chr17	61861367	61869367	61867917	8000	61865367	-4000	4000	2550
chr17	62689597	62697597	62690651	8000	62693597	-4000	4000	-2946
chr17	63876215	63884215	63880273	8000	63880215	-4000	4000	58
chr17	63934554	63942554	63941725	8000	63938554	-4000	4000	3171
chr17	68043364	68051364	68044004	8000	68047364	-4000	4000	-3360
chr17	75102162	75110162	75104193	8000	75106162	-4000	4000	-1969
chr17	76620761	76628761	76627482	8000	76624761	-4000	4000	2721
chr17	76946393	76954393	76947869	8000	76950393	-4000	4000	-2524
chr17	81810008	81818008	81811070	8000	81814008	-4000	4000	-2938
chr17	82373458	82381458	82374569	8000	82377458	-4000	4000	-2889
chr17	53821193	53829193	53823306	8000	53825193	-4000	4000	-1887
chr17	64464643	64472643	64467640	8000	64468643	-4000	4000	-1003
chr17	3214896	3222896	3216427	8000	3218896	-4000	4000	-2469
chr17	30891869	30899869	30894863	8000	30895869	-4000	4000	-1006
chr17	76620761	76628761	76627479	8000	76624761	-4000	4000	2718
chr17	50858223	50866223	50863719	8000	50862223	-4000	4000	1496
chr17	55715627	55723627	55720855	8000	55719627	-4000	4000	1228
chr17	47833719	47841719	47839567	8000	47837719	-4000	4000	1848
chr17	70131608	70139608	70132130	8000	70135608	-4000	4000	-3478
chr17	67980378	67988378	67983183	8000	67984378	-4000	4000	-1195
chr17	43859639	43867639	43861825	8000	43863639	-4000	4000	-1814
chr17	58265855	58273855	58270720	8000	58269855	-4000	4000	865
chr17	4484208	4492208	4486555	8000	4488208	-4000	4000	-1653
chr17	47437312	47445312	47440584	8000	47441312	-4000	4000	-728
chr17	43040295	43048295	43047678	8000	43044295	-4000	4000	3383
chr17	36208878	36216878	36212486	8000	36212878	-4000	4000	-392
chr17	4265259	4273259	4270303	8000	4269259	-4000	4000	1044
chr17	80462834	80470834	80467481	8000	80466834	-4000	4000	647
chr17	63913203	63921203	63917423	8000	63917203	-4000	4000	220
chr17	48544870	48552870	48552294	8000	48548870	-4000	4000	3424
chr17	50371059	50379059	50378681	8000	50375059	-4000	4000	3622
chr17	68253712	68261712	68256900	8000	68257712	-4000	4000	-812
chr17	1646629	1654629	1650803	8000	1650629	-4000	4000	174
chr17	38320571	38328571	38326704	8000	38324571	-4000	4000	2133
chr17	74929912	74937912	74930667	8000	74933912	-4000	4000	-3245
chr17	44557262	44565262	44558897	8000	44561262	-4000	4000	-2365
chr17	41482136	41490136	41489486	8000	41486136	-4000	4000	3350
chr17	3194448	3202448	3198376	8000	3198448	-4000	4000	-72
chr17	41615442	41623442	41619520	8000	41619442	-4000	4000	78
chr17	7574715	7582715	7574745	8000	7578715	-4000	4000	-3970
chr17	63868012	63876012	63872304	8000	63872012	-4000	4000	292
chr17	61861367	61869367	61867696	8000	61865367	-4000	4000	2329
chr17	5175535	5183535	5181286	8000	5179535	-4000	4000	1751
chr17	51626313	51634313	51631377	8000	51630313	-4000	4000	1064
chr17	58155585	58163585	58157368	8000	58159585	-4000	4000	-2217
chr17	61938605	61946605	61946480	8000	61942605	-4000	4000	3875
chr17	49511008	49519008	49512004	8000	49515008	-4000	4000	-3004
chr17	9888099	9896099	9889422	8000	9892099	-4000	4000	-2677
chr17	19674288	19682288	19679971	8000	19678288	-4000	4000	1683
chr17	28644346	28652346	28648947	8000	28648346	-4000	4000	601
chr17	83091122	83099122	83094309	8000	83095122	-4000	4000	-813
chr17	35188520	35196520	35194181	8000	35192520	-4000	4000	1661
chr17	53821193	53829193	53824786	8000	53825193	-4000	4000	-407
chr17	58167411	58175411	58170020	8000	58171411	-4000	4000	-1391
chr17	30523592	30531592	30526779	8000	30527592	-4000	4000	-813
chr17	82650973	82658973	82658099	8000	82654973	-4000	4000	3126
chr17	3436019	3444019	3443263	8000	3440019	-4000	4000	3244
chr17	42097404	42105404	42105097	8000	42101404	-4000	4000	3693
chr17	63890909	63898909	63895580	8000	63894909	-4000	4000	671
chr17	45843067	45851067	45846008	8000	45847067	-4000	4000	-1059
chr17	76270049	76278049	76278034	8000	76274049	-4000	4000	3985
chr17	18175802	18183802	18178822	8000	18179802	-4000	4000	-980
chr17	63517848	63525848	63524206	8000	63521848	-4000	4000	2358
chr17	34635318	34643318	34636045	8000	34639318	-4000	4000	-3273
chr17	58265855	58273855	58268013	8000	58269855	-4000	4000	-1842
chr17	45843067	45851067	45845277	8000	45847067	-4000	4000	-1790
chr17	57117346	57125346	57120312	8000	57121346	-4000	4000	-1034
chr17	39206541	39214541	39213049	8000	39210541	-4000	4000	2508
chr17	40549769	40557769	40555263	8000	40553769	-4000	4000	1494
chr17	75001800	75009800	75002063	8000	75005800	-4000	4000	-3737
chr17	33009087	33017087	33013971	8000	33013087	-4000	4000	884
chr17	62697314	62705314	62701671	8000	62701314	-4000	4000	357
chr17	63998594	64006594	64003535	8000	64002594	-4000	4000	941
chr17	50470845	50478845	50473945	8000	50474845	-4000	4000	-900
chr17	81810008	81818008	81812838	8000	81814008	-4000	4000	-1170
chr17	39599536	39607536	39603941	8000	39603536	-4000	4000	405
chr17	62689597	62697597	62693436	8000	62693597	-4000	4000	-161
chr17	4931023	4939023	4939009	8000	4935023	-4000	4000	3986
chr17	39632626	39640626	39635685	8000	39636626	-4000	4000	-941
chr17	19379544	19387544	19386393	8000	19383544	-4000	4000	2849
chr17	55715627	55723627	55720863	8000	55719627	-4000	4000	1236
chr17	57117346	57125346	57120416	8000	57121346	-4000	4000	-930
chr17	30995911	31003911	30998821	8000	30999911	-4000	4000	-1090
chr17	44030328	44038328	44037474	8000	44034328	-4000	4000	3146
chr17	8091900	8099900	8096650	8000	8095900	-4000	4000	750
chr17	12139830	12147830	12141146	8000	12143830	-4000	4000	-2684
chr17	63905597	63913597	63910847	8000	63909597	-4000	4000	1250
chr17	63934554	63942554	63941376	8000	63938554	-4000	4000	2822
chr17	10695015	10703015	10697471	8000	10699015	-4000	4000	-1544
chr17	72122416	72130416	72126126	8000	72126416	-4000	4000	-290
chr17	53821193	53829193	53823367	8000	53825193	-4000	4000	-1826
chr17	12987643	12995643	12991533	8000	12991643	-4000	4000	-110
chr17	41432154	41440154	41438273	8000	41436154	-4000	4000	2119
chr17	41605778	41613778	41610957	8000	41609778	-4000	4000	1179
chr17	78138968	78146968	78146405	8000	78142968	-4000	4000	3437
chr17	47840908	47848908	47848002	8000	47844908	-4000	4000	3094
chr17	4552927	4560927	4560579	8000	4556927	-4000	4000	3652
chr17	7070537	7078537	7076101	8000	7074537	-4000	4000	1564
chr17	7221342	7229342	7229213	8000	7225342	-4000	4000	3871
chr17	40088793	40096793	40089230	8000	40092793	-4000	4000	-3563
chr17	61405466	61413466	61405755	8000	61409466	-4000	4000	-3711
chr17	58264518	58272518	58264902	8000	58268518	-4000	4000	-3616
chr17	60037008	60045008	60043629	8000	60041008	-4000	4000	2621
chr17	43028041	43036041	43028641	8000	43032041	-4000	4000	-3400
chr17	8283763	8291763	8289134	8000	8287763	-4000	4000	1371
chr17	17343663	17351663	17344915	8000	17347663	-4000	4000	-2748
chr17	40788196	40796196	40793932	8000	40792196	-4000	4000	1736
chr17	16025157	16033157	16026880	8000	16029157	-4000	4000	-2277
chr17	3892592	3900592	3897781	8000	3896592	-4000	4000	1189
chr17	75102162	75110162	75104037	8000	75106162	-4000	4000	-2125
chr17	40954417	40962417	40960316	8000	40958417	-4000	4000	1899
chr17	49696934	49704934	49702951	8000	49700934	-4000	4000	2017
chr17	81810008	81818008	81812956	8000	81814008	-4000	4000	-1052
chr17	43207689	43215689	43213200	8000	43211689	-4000	4000	1511
chr17	74929912	74937912	74930902	8000	74933912	-4000	4000	-3010
chr17	38796441	38804441	38801943	8000	38800441	-4000	4000	1502
chr17	48720758	48728758	48724625	8000	48724758	-4000	4000	-133
chr17	50688253	50696253	50691206	8000	50692253	-4000	4000	-1047
chr17	12139830	12147830	12141214	8000	12143830	-4000	4000	-2616
chr17	41113181	41121181	41118042	8000	41117181	-4000	4000	861
chr17	74368600	74376600	74372503	8000	74372600	-4000	4000	-97
chr17	16025157	16033157	16026796	8000	16029157	-4000	4000	-2361
chr17	58201174	58209174	58208142	8000	58205174	-4000	4000	2968
chr17	45431900	45439900	45437788	8000	45435900	-4000	4000	1888
chr17	48720758	48728758	48726689	8000	48724758	-4000	4000	1931
chr17	13490032	13498032	13496635	8000	13494032	-4000	4000	2603
chr17	29569157	29577157	29574509	8000	29573157	-4000	4000	1352
chr17	34284334	34292334	34285760	8000	34288334	-4000	4000	-2574
chr17	34284334	34292334	34287643	8000	34288334	-4000	4000	-691
chr17	34317402	34325402	34319477	8000	34321402	-4000	4000	-1925
chr17	35739521	35747521	35745156	8000	35743521	-4000	4000	1635
chr17	36161683	36169683	36165757	8000	36165683	-4000	4000	74
chr17	40384525	40392525	40391635	8000	40388525	-4000	4000	3110
chr17	44557262	44565262	44558052	8000	44561262	-4000	4000	-3210
chr17	48536894	48544894	48542946	8000	48540894	-4000	4000	2052
chr17	51293936	51301936	51293964	8000	51297936	-4000	4000	-3972
chr17	59211239	59219239	59211332	8000	59215239	-4000	4000	-3907
chr17	59838255	59846255	59840060	8000	59842255	-4000	4000	-2195
chr17	64143227	64151227	64148729	8000	64147227	-4000	4000	1502
chr17	67980378	67988378	67983487	8000	67984378	-4000	4000	-891
chr17	36101621	36109621	36104625	8000	36105621	-4000	4000	-996
chr17	8045134	8053134	8048434	8000	8049134	-4000	4000	-700
chr17	70131608	70139608	70132618	8000	70135608	-4000	4000	-2990
chr17	21415870	21423870	21418864	8000	21419870	-4000	4000	-1006
chr17	59946574	59954574	59953080	8000	59950574	-4000	4000	2506
chr17	44845948	44853948	44851311	8000	44849948	-4000	4000	1363
chr17	45843067	45851067	45845635	8000	45847067	-4000	4000	-1432
chr17	58201174	58209174	58204292	8000	58205174	-4000	4000	-882
chr17	44845948	44853948	44850805	8000	44849948	-4000	4000	857
chr17	28610446	28618446	28611643	8000	28614446	-4000	4000	-2803
chr17	3214896	3222896	3215975	8000	3218896	-4000	4000	-2921
chr17	62689597	62697597	62690973	8000	62693597	-4000	4000	-2624
chr17	13490032	13498032	13496758	8000	13494032	-4000	4000	2726
chr17	47742122	47750122	47744773	8000	47746122	-4000	4000	-1349
chr17	47840908	47848908	47848238	8000	47844908	-4000	4000	3330
chr17	76729936	76737936	76733715	8000	76733936	-4000	4000	-221
chr17	48544870	48552870	48550445	8000	48548870	-4000	4000	1575
chr17	6574147	6582147	6579711	8000	6578147	-4000	4000	1564
chr17	41373669	41381669	41381146	8000	41377669	-4000	4000	3477
chr17	70131608	70139608	70132147	8000	70135608	-4000	4000	-3461
chr17	70131608	70139608	70132369	8000	70135608	-4000	4000	-3239
chr17	40995193	41003193	40999601	8000	40999193	-4000	4000	408
chr17	63698845	63706845	63703565	8000	63702845	-4000	4000	720
chr17	67029398	67037398	67030799	8000	67033398	-4000	4000	-2599
chr17	1930677	1938677	1936559	8000	1934677	-4000	4000	1882
chr17	58731611	58739611	58732657	8000	58735611	-4000	4000	-2954
chr17	58731611	58739611	58734169	8000	58735611	-4000	4000	-1442
chr17	41472710	41480710	41477646	8000	41476710	-4000	4000	936
chr17	3420070	3428070	3421082	8000	3424070	-4000	4000	-2988
chr17	3428870	3436870	3433791	8000	3432870	-4000	4000	921
chr17	74929912	74937912	74933374	8000	74933912	-4000	4000	-538
chr17	53821193	53829193	53824740	8000	53825193	-4000	4000	-453
chr17	1296978	1304978	1298423	8000	1300978	-4000	4000	-2555
chr17	8116592	8124592	8116851	8000	8120592	-4000	4000	-3741
chr17	42846707	42854707	42854543	8000	42850707	-4000	4000	3836
chr17	15972560	15980560	15974697	8000	15976560	-4000	4000	-1863
chr17	38917770	38925770	38918642	8000	38921770	-4000	4000	-3128
chr17	79788132	79796132	79794861	8000	79792132	-4000	4000	2729
chr17	76620761	76628761	76627460	8000	76624761	-4000	4000	2699
chr17	5092374	5100374	5092942	8000	5096374	-4000	4000	-3432
chr17	67980378	67988378	67982482	8000	67984378	-4000	4000	-1896
chr17	48524526	48532526	48530467	8000	48528526	-4000	4000	1941
chr17	58201174	58209174	58206370	8000	58205174	-4000	4000	1196
chr17	62412480	62420480	62413813	8000	62416480	-4000	4000	-2667
chr17	74537073	74545073	74542881	8000	74541073	-4000	4000	1808
chr17	30891869	30899869	30894069	8000	30895869	-4000	4000	-1800
chr17	30891869	30899869	30899388	8000	30895869	-4000	4000	3519
chr17	34253203	34261203	34256727	8000	34257203	-4000	4000	-476
chr17	35739521	35747521	35745519	8000	35743521	-4000	4000	1998
chr17	40015097	40023097	40015517	8000	40019097	-4000	4000	-3580
chr17	43936804	43944804	43941525	8000	43940804	-4000	4000	721
chr17	46753464	46761464	46755833	8000	46757464	-4000	4000	-1631
chr17	50527501	50535501	50529186	8000	50531501	-4000	4000	-2315
chr17	50623474	50631474	50626706	8000	50627474	-4000	4000	-768
chr17	63890909	63898909	63894972	8000	63894909	-4000	4000	63
chr17	73279624	73287624	73285218	8000	73283624	-4000	4000	1594
chr17	41036541	41044541	41041052	8000	41040541	-4000	4000	511
chr17	41373669	41381669	41379567	8000	41377669	-4000	4000	1898
chr17	41102488	41110488	41105534	8000	41106488	-4000	4000	-954
chr17	8743524	8751524	8744614	8000	8747524	-4000	4000	-2910
chr17	74873302	74881302	74879541	8000	74877302	-4000	4000	2239
chr17	82747196	82755196	82750529	8000	82751196	-4000	4000	-667
chr17	39973768	39981768	39974998	8000	39977768	-4000	4000	-2770
chr17	39666475	39674475	39670249	8000	39670475	-4000	4000	-226
chr17	42991142	42999142	42998791	8000	42995142	-4000	4000	3649
chr17	35979656	35987656	35985780	8000	35983656	-4000	4000	2124
chr17	63905597	63913597	63909942	8000	63909597	-4000	4000	345
chr17	75131248	75139248	75136170	8000	75135248	-4000	4000	922
chr17	9725687	9733687	9729100	8000	9729687	-4000	4000	-587
chr17	63934554	63942554	63941665	8000	63938554	-4000	4000	3111
chr17	40015097	40023097	40019851	8000	40019097	-4000	4000	754
chr17	3393104	3401104	3397685	8000	3397104	-4000	4000	581
chr17	7006754	7014754	7010463	8000	7010754	-4000	4000	-291
chr17	8091900	8099900	8096807	8000	8095900	-4000	4000	907
chr17	35930518	35938518	35937767	8000	35934518	-4000	4000	3249
chr17	39632626	39640626	39635871	8000	39636626	-4000	4000	-755
chr17	68970488	68978488	68975811	8000	68974488	-4000	4000	1323
chr17	76620761	76628761	76627238	8000	76624761	-4000	4000	2477
chr17	42309324	42317324	42316859	8000	42313324	-4000	4000	3535
chr17	73330384	73338384	73335955	8000	73334384	-4000	4000	1571
chr17	43871357	43879357	43877738	8000	43875357	-4000	4000	2381
chr17	13490032	13498032	13496320	8000	13494032	-4000	4000	2288
chr17	41389721	41397721	41397474	8000	41393721	-4000	4000	3753
chr17	41482136	41490136	41489442	8000	41486136	-4000	4000	3306
chr17	49219225	49227225	49219933	8000	49223225	-4000	4000	-3292
chr17	63876215	63884215	63880755	8000	63880215	-4000	4000	540
chr17	30465989	30473989	30468218	8000	30469989	-4000	4000	-1771
chr17	50470845	50478845	50474585	8000	50474845	-4000	4000	-260
chr17	53821193	53829193	53824526	8000	53825193	-4000	4000	-667
chr17	41155649	41163649	41160248	8000	41159649	-4000	4000	599
chr17	44244390	44252390	44251189	8000	44248390	-4000	4000	2799
chr17	8798722	8806722	8803229	8000	8802722	-4000	4000	507
chr17	1930677	1938677	1937221	8000	1934677	-4000	4000	2544
chr17	3272942	3280942	3278744	8000	3276942	-4000	4000	1802
chr17	7070537	7078537	7075386	8000	7074537	-4000	4000	849
chr17	47045932	47053932	47049972	8000	47049932	-4000	4000	40
chr17	46753464	46761464	46755887	8000	46757464	-4000	4000	-1577
chr17	48720758	48728758	48728060	8000	48724758	-4000	4000	3302
chr17	61586421	61594421	61591048	8000	61590421	-4000	4000	627
chr17	7587230	7595230	7591914	8000	7591230	-4000	4000	684
chr17	44777846	44785846	44780949	8000	44781846	-4000	4000	-897
chr17	47833719	47841719	47840255	8000	47837719	-4000	4000	2536
chr17	50180101	50188101	50180707	8000	50184101	-4000	4000	-3394
chr17	63913203	63921203	63917762	8000	63917203	-4000	4000	559
chr17	76620761	76628761	76625472	8000	76624761	-4000	4000	711
chr17	10296865	10304865	10303222	8000	10300865	-4000	4000	2357
chr17	7440937	7448937	7447082	8000	7444937	-4000	4000	2145
chr17	58167411	58175411	58170484	8000	58171411	-4000	4000	-927
chr17	65223703	65231703	65225505	8000	65227703	-4000	4000	-2198
chr17	29250494	29258494	29254381	8000	29254494	-4000	4000	-113
chr17	10386322	10394322	10394290	8000	10390322	-4000	4000	3968
chr17	7909339	7917339	7910901	8000	7913339	-4000	4000	-2438
chr17	39873896	39881896	39875253	8000	39877896	-4000	4000	-2643
chr17	40744021	40752021	40749326	8000	40748021	-4000	4000	1305
chr17	38320571	38328571	38322753	8000	38324571	-4000	4000	-1818
chr17	40772808	40780808	40777116	8000	40776808	-4000	4000	308
chr17	76466891	76474891	76471537	8000	76470891	-4000	4000	646
chr17	19018595	19026595	19020406	8000	19022595	-4000	4000	-2189
chr17	64473785	64481785	64477980	8000	64477785	-4000	4000	195
chr17	82031136	82039136	82033856	8000	82035136	-4000	4000	-1280
chr17	50623474	50631474	50624048	8000	50627474	-4000	4000	-3426
chr17	82941914	82949914	82942311	8000	82945914	-4000	4000	-3603
chr17	41561836	41569836	41568200	8000	41565836	-4000	4000	2364
chr17	41416547	41424547	41423395	8000	41420547	-4000	4000	2848
chr17	49594884	49602884	49599728	8000	49598884	-4000	4000	844
chr17	3194448	3202448	3197828	8000	3198448	-4000	4000	-620
chr17	41163231	41171231	41167576	8000	41167231	-4000	4000	345
chr17	41615442	41623442	41620807	8000	41619442	-4000	4000	1365
chr17	42569239	42577239	42572810	8000	42573239	-4000	4000	-429
chr17	59211239	59219239	59213369	8000	59215239	-4000	4000	-1870
chr17	5175535	5183535	5181286	8000	5179535	-4000	4000	1751
chr17	7423568	7431568	7426506	8000	7427568	-4000	4000	-1062
chr17	41155649	41163649	41160261	8000	41159649	-4000	4000	612
chr17	68418731	68426731	68424475	8000	68422731	-4000	4000	1744
chr17	41055240	41063240	41059712	8000	41059240	-4000	4000	472
chr17	28192381	28200381	28196295	8000	28196381	-4000	4000	-86
chr17	41081141	41089141	41084984	8000	41085141	-4000	4000	-157
chr17	63934554	63942554	63941178	8000	63938554	-4000	4000	2624
chr17	69074702	69082702	69079227	8000	69078702	-4000	4000	525
chr17	74368600	74376600	74372142	8000	74372600	-4000	4000	-458
chr17	76620761	76628761	76626762	8000	76624761	-4000	4000	2001
chr17	40995193	41003193	40999619	8000	40999193	-4000	4000	426
chr17	7347477	7355477	7352680	8000	7351477	-4000	4000	1203
chr17	40015097	40023097	40016511	8000	40019097	-4000	4000	-2586
chr17	41455513	41463513	41460169	8000	41459513	-4000	4000	656
chr17	61938605	61946605	61944268	8000	61942605	-4000	4000	1663
chr17	67980378	67988378	67982577	8000	67984378	-4000	4000	-1801
chr17	29250494	29258494	29253670	8000	29254494	-4000	4000	-824
chr17	76620761	76628761	76627167	8000	76624761	-4000	4000	2406
chr17	8373516	8381516	8377625	8000	8377516	-4000	4000	109
chr17	35188520	35196520	35193459	8000	35192520	-4000	4000	939
chr17	7587230	7595230	7591486	8000	7591230	-4000	4000	256
chr17	42846707	42854707	42852921	8000	42850707	-4000	4000	2214
chr17	49511008	49519008	49513267	8000	49515008	-4000	4000	-1741
chr17	49594884	49602884	49599139	8000	49598884	-4000	4000	255
chr17	49594884	49602884	49599638	8000	49598884	-4000	4000	754
chr17	49594884	49602884	49600185	8000	49598884	-4000	4000	1301
chr17	58516250	58524250	58520337	8000	58520250	-4000	4000	87
chr17	58516250	58524250	58520914	8000	58520250	-4000	4000	664
chr17	65223703	65231703	65225300	8000	65227703	-4000	4000	-2403
chr17	76729936	76737936	76734643	8000	76733936	-4000	4000	707
chr17	76729936	76737936	76735802	8000	76733936	-4000	4000	1866
chr17	8136472	8144472	8141051	8000	8140472	-4000	4000	579
chr17	29250494	29258494	29252145	8000	29254494	-4000	4000	-2349
chr17	41050498	41058498	41055058	8000	41054498	-4000	4000	560
chr17	82317024	82325024	82322330	8000	82321024	-4000	4000	1306
chr17	7622234	7630234	7627581	8000	7626234	-4000	4000	1347
chr17	62689597	62697597	62690639	8000	62693597	-4000	4000	-2958
chr17	40300657	40308657	40300902	8000	40304657	-4000	4000	-3755
chr17	40300657	40308657	40301957	8000	40304657	-4000	4000	-2700
chr17	43212941	43220941	43217945	8000	43216941	-4000	4000	1004
chr17	30995911	31003911	30999145	8000	30999911	-4000	4000	-766
chr17	74368600	74376600	74370558	8000	74372600	-4000	4000	-2042
chr17	80462834	80470834	80470730	8000	80466834	-4000	4000	3896
chr17	10517148	10525148	10521337	8000	10521148	-4000	4000	189
chr17	18775349	18783349	18778501	8000	18779349	-4000	4000	-848
chr17	30891869	30899869	30899250	8000	30895869	-4000	4000	3381
chr17	35739521	35747521	35744841	8000	35743521	-4000	4000	1320
chr17	41055240	41063240	41059484	8000	41059240	-4000	4000	244
chr17	28610446	28618446	28611398	8000	28614446	-4000	4000	-3048
chr17	59838255	59846255	59839806	8000	59842255	-4000	4000	-2449
chr17	74929912	74937912	74930981	8000	74933912	-4000	4000	-2931
chr17	34356328	34364328	34361879	8000	34360328	-4000	4000	1551
chr17	34356328	34364328	34361880	8000	34360328	-4000	4000	1552
chr17	47708052	47716052	47708449	8000	47712052	-4000	4000	-3603
chr17	5171034	5179034	5174796	8000	5175034	-4000	4000	-238
chr17	39400285	39408285	39405161	8000	39404285	-4000	4000	876
chr17	39599536	39607536	39606084	8000	39603536	-4000	4000	2548
chr17	49594884	49602884	49601872	8000	49598884	-4000	4000	2988
chr17	74310884	74318884	74314159	8000	74314884	-4000	4000	-725
chr17	40191656	40199656	40192947	8000	40195656	-4000	4000	-2709
chr17	65223703	65231703	65227587	8000	65227703	-4000	4000	-116
chr17	76466891	76474891	76471822	8000	76470891	-4000	4000	931
chr17	74368600	74376600	74370558	8000	74372600	-4000	4000	-2042
chr17	45843067	45851067	45845521	8000	45847067	-4000	4000	-1546
chr17	7622234	7630234	7626996	8000	7626234	-4000	4000	762
chr17	15972560	15980560	15975382	8000	15976560	-4000	4000	-1178
chr17	32993877	33001877	32995469	8000	32997877	-4000	4000	-2408
chr17	34284334	34292334	34285753	8000	34288334	-4000	4000	-2581
chr17	35346305	35354305	35352993	8000	35350305	-4000	4000	2688
chr17	40772808	40780808	40780406	8000	40776808	-4000	4000	3598
chr17	41482136	41490136	41489629	8000	41486136	-4000	4000	3493
chr17	41844384	41852384	41845709	8000	41848384	-4000	4000	-2675
chr17	44557262	44565262	44558556	8000	44561262	-4000	4000	-2706
chr17	44748264	44756264	44751268	8000	44752264	-4000	4000	-996
chr17	47833719	47841719	47840351	8000	47837719	-4000	4000	2632
chr17	59211239	59219239	59211589	8000	59215239	-4000	4000	-3650
chr17	64143227	64151227	64148792	8000	64147227	-4000	4000	1565
chr17	68043364	68051364	68044051	8000	68047364	-4000	4000	-3313
chr17	68418731	68426731	68420537	8000	68422731	-4000	4000	-2194
chr17	8793110	8801110	8798699	8000	8797110	-4000	4000	1589
chr17	58516250	58524250	58521900	8000	58520250	-4000	4000	1650
chr17	50180101	50188101	50185640	8000	50184101	-4000	4000	1539
chr17	7852685	7860685	7859419	8000	7856685	-4000	4000	2734
chr17	8116592	8124592	8120921	8000	8120592	-4000	4000	329
chr17	19766829	19774829	19774122	8000	19770829	-4000	4000	3293
chr17	29621938	29629938	29626507	8000	29625938	-4000	4000	569
chr17	35867491	35875491	35872296	8000	35871491	-4000	4000	805
chr17	40191656	40199656	40195067	8000	40195656	-4000	4000	-589
chr17	49970959	49978959	49972855	8000	49974959	-4000	4000	-2104
chr17	57967547	57975547	57973539	8000	57971547	-4000	4000	1992
chr17	59397729	59405729	59399670	8000	59401729	-4000	4000	-2059
chr17	59397729	59405729	59399829	8000	59401729	-4000	4000	-1900
chr17	61405466	61413466	61409020	8000	61409466	-4000	4000	-446
chr17	63698845	63706845	63704858	8000	63702845	-4000	4000	2013
chr17	64143227	64151227	64148733	8000	64147227	-4000	4000	1506
chr17	64850130	64858130	64854545	8000	64854130	-4000	4000	415
chr17	74351820	74359820	74352922	8000	74355820	-4000	4000	-2898
chr17	75821799	75829799	75825449	8000	75825799	-4000	4000	-350
chr17	76729936	76737936	76734405	8000	76733936	-4000	4000	469
chr17	74765353	74773353	74768652	8000	74769353	-4000	4000	-701
chr17	38508385	38516385	38511202	8000	38512385	-4000	4000	-1183
chr17	6785133	6793133	6786822	8000	6789133	-4000	4000	-2311
chr17	36161683	36169683	36169146	8000	36165683	-4000	4000	3463
chr17	36009056	36017056	36013286	8000	36013056	-4000	4000	230
chr17	18175802	18183802	18179114	8000	18179802	-4000	4000	-688
chr17	76270049	76278049	76277239	8000	76274049	-4000	4000	3190
chr17	81810008	81818008	81811032	8000	81814008	-4000	4000	-2976
chr17	62689597	62697597	62691083	8000	62693597	-4000	4000	-2514
chr17	36424618	36432618	36430628	8000	36428618	-4000	4000	2010
chr17	39900595	39908595	39906963	8000	39904595	-4000	4000	2368
chr17	43028041	43036041	43028584	8000	43032041	-4000	4000	-3457
chr17	44368180	44376180	44376093	8000	44372180	-4000	4000	3913
chr17	48536894	48544894	48543219	8000	48540894	-4000	4000	2325
chr17	48544870	48552870	48551025	8000	48548870	-4000	4000	2155
chr17	8068636	8076636	8072876	8000	8072636	-4000	4000	240
chr17	16025157	16033157	16027356	8000	16029157	-4000	4000	-1801
chr17	36084256	36092256	36090125	8000	36088256	-4000	4000	1869
chr17	48536894	48544894	48543006	8000	48540894	-4000	4000	2112
chr17	50858223	50866223	50863735	8000	50862223	-4000	4000	1512
chr17	50858223	50866223	50864008	8000	50862223	-4000	4000	1785
chr17	62689597	62697597	62689647	8000	62693597	-4000	4000	-3950
chr17	65223703	65231703	65227572	8000	65227703	-4000	4000	-131
chr17	74945992	74953992	74947098	8000	74949992	-4000	4000	-2894
chr17	76270049	76278049	76275883	8000	76274049	-4000	4000	1834
chr17	41155649	41163649	41160175	8000	41159649	-4000	4000	526
chr17	20445395	20453395	20446901	8000	20449395	-4000	4000	-2494
chr17	41223652	41231652	41226983	8000	41227652	-4000	4000	-669
chr17	58167411	58175411	58170337	8000	58171411	-4000	4000	-1074
chr17	72122416	72130416	72123691	8000	72126416	-4000	4000	-2725
chr17	80130369	80138369	80136259	8000	80134369	-4000	4000	1890
chr17	4484208	4492208	4486492	8000	4488208	-4000	4000	-1716
chr17	4626919	4634919	4633466	8000	4630919	-4000	4000	2547
chr17	7311628	7319628	7315141	8000	7315628	-4000	4000	-487
chr17	9906606	9914606	9910880	8000	9910606	-4000	4000	274
chr17	12139830	12147830	12143327	8000	12143830	-4000	4000	-503
chr17	30523592	30531592	30526593	8000	30527592	-4000	4000	-999
chr17	35739521	35747521	35746019	8000	35743521	-4000	4000	2498
chr17	40744021	40752021	40751288	8000	40748021	-4000	4000	3267
chr17	41036541	41044541	41041123	8000	41040541	-4000	4000	582
chr17	41342092	41350092	41346935	8000	41346092	-4000	4000	843
chr17	42575513	42583513	42581808	8000	42579513	-4000	4000	2295
chr17	43207689	43215689	43211378	8000	43211689	-4000	4000	-311
chr17	43948733	43956733	43953158	8000	43952733	-4000	4000	425
chr17	44005068	44013068	44011887	8000	44009068	-4000	4000	2819
chr17	45250393	45258393	45255774	8000	45254393	-4000	4000	1381
chr17	49052145	49060145	49054882	8000	49056145	-4000	4000	-1263
chr17	60439158	60447158	60446844	8000	60443158	-4000	4000	3686
chr17	60662280	60670280	60663137	8000	60666280	-4000	4000	-3143
chr17	64464643	64472643	64465462	8000	64468643	-4000	4000	-3181
chr17	70131608	70139608	70133030	8000	70135608	-4000	4000	-2578
chr17	80462834	80470834	80467577	8000	80466834	-4000	4000	743
chr17	81224277	81232277	81230661	8000	81228277	-4000	4000	2384
chr17	7829742	7837742	7830823	8000	7833742	-4000	4000	-2919
chr17	35406922	35414922	35411411	8000	35410922	-4000	4000	489
chr17	43010607	43018607	43016352	8000	43014607	-4000	4000	1745
chr17	48066052	48074052	48071432	8000	48070052	-4000	4000	1380
chr17	48720758	48728758	48728029	8000	48724758	-4000	4000	3271
chr17	51626313	51634313	51633545	8000	51630313	-4000	4000	3232
chr17	63604347	63612347	63607933	8000	63608347	-4000	4000	-414
chr17	70176044	70184044	70176160	8000	70180044	-4000	4000	-3884
chr17	78203702	78211702	78206987	8000	78207702	-4000	4000	-715
chr17	4626919	4634919	4632271	8000	4630919	-4000	4000	1352
chr17	19413276	19421276	19415035	8000	19417276	-4000	4000	-2241
chr17	70131608	70139608	70132318	8000	70135608	-4000	4000	-3290
chr17	53821193	53829193	53823174	8000	53825193	-4000	4000	-2019
chr17	45843067	45851067	45846867	8000	45847067	-4000	4000	-200
chr17	41102488	41110488	41105991	8000	41106488	-4000	4000	-497
chr17	41561836	41569836	41568160	8000	41565836	-4000	4000	2324
chr17	42846707	42854707	42852597	8000	42850707	-4000	4000	1890
chr17	61388838	61396838	61392156	8000	61392838	-4000	4000	-682
chr17	28710281	28718281	28714688	8000	28714281	-4000	4000	407
chr17	40549769	40557769	40555464	8000	40553769	-4000	4000	1695
chr17	58265855	58273855	58267797	8000	58269855	-4000	4000	-2058
chr17	58265855	58273855	58267798	8000	58269855	-4000	4000	-2057
chr17	59838255	59846255	59839863	8000	59842255	-4000	4000	-2392
chr17	29610761	29618761	29616760	8000	29614761	-4000	4000	1999
chr17	78848977	78856977	78853265	8000	78852977	-4000	4000	288
chr17	36068032	36076032	36071113	8000	36072032	-4000	4000	-919
chr17	74258020	74266020	74260330	8000	74262020	-4000	4000	-1690
chr17	65223703	65231703	65225587	8000	65227703	-4000	4000	-2116
chr17	68253712	68261712	68257019	8000	68257712	-4000	4000	-693
chr17	36424618	36432618	36431619	8000	36428618	-4000	4000	3001
chr17	435978	443978	443449	8000	439978	-4000	4000	3471
chr17	50623474	50631474	50627018	8000	50627474	-4000	4000	-456
chr17	67029398	67037398	67030778	8000	67033398	-4000	4000	-2620
chr17	76729936	76737936	76733648	8000	76733936	-4000	4000	-288
chr17	34635318	34643318	34637307	8000	34639318	-4000	4000	-2011
chr17	63876215	63884215	63881051	8000	63880215	-4000	4000	836
chr17	47840908	47848908	47848052	8000	47844908	-4000	4000	3144
chr17	7385734	7393734	7392878	8000	7389734	-4000	4000	3144
chr17	48720758	48728758	48728456	8000	48724758	-4000	4000	3698
chr17	62412480	62420480	62416071	8000	62416480	-4000	4000	-409
chr17	17973409	17981409	17977594	8000	17977409	-4000	4000	185
chr17	53821193	53829193	53825155	8000	53825193	-4000	4000	-38
chr17	50958174	50966174	50966147	8000	50962174	-4000	4000	3973
chr17	78967238	78975238	78972113	8000	78971238	-4000	4000	875
chr17	79788132	79796132	79794650	8000	79792132	-4000	4000	2518
chr17	30891869	30899869	30893872	8000	30895869	-4000	4000	-1997
chr17	42398449	42406449	42404800	8000	42402449	-4000	4000	2351
chr17	30893336	30901336	30900348	8000	30897336	-4000	4000	3012
chr17	36101621	36109621	36103840	8000	36105621	-4000	4000	-1781
chr17	36161683	36169683	36165845	8000	36165683	-4000	4000	162
chr17	42569239	42577239	42572810	8000	42573239	-4000	4000	-429
chr17	5175535	5183535	5182720	8000	5179535	-4000	4000	3185
chr17	74537073	74545073	74541460	8000	74541073	-4000	4000	387
chr17	40871889	40879889	40878274	8000	40875889	-4000	4000	2385
chr17	9767434	9775434	9772920	8000	9771434	-4000	4000	1486
chr17	15432021	15440021	15437921	8000	15436021	-4000	4000	1900
chr17	8168457	8176457	8174591	8000	8172457	-4000	4000	2134
chr17	58552678	58560678	58559495	8000	58556678	-4000	4000	2817
chr17	74351820	74359820	74356736	8000	74355820	-4000	4000	916
chr17	76729936	76737936	76733622	8000	76733936	-4000	4000	-314
chr17	7622234	7630234	7628059	8000	7626234	-4000	4000	1825
chr17	63876215	63884215	63880296	8000	63880215	-4000	4000	81
chr17	8116592	8124592	8122382	8000	8120592	-4000	4000	1790
chr17	36940612	36948612	36940717	8000	36944612	-4000	4000	-3895
chr17	7622234	7630234	7626405	8000	7626234	-4000	4000	171
chr17	29053216	29061216	29053423	8000	29057216	-4000	4000	-3793
chr17	40772808	40780808	40779724	8000	40776808	-4000	4000	2916
chr17	39900595	39908595	39906221	8000	39904595	-4000	4000	1626
chr17	16616734	16624734	16623653	8000	16620734	-4000	4000	2919
chr17	45431900	45439900	45439499	8000	45435900	-4000	4000	3599
chr17	63913203	63921203	63917436	8000	63917203	-4000	4000	233
chr17	3214896	3222896	3215839	8000	3218896	-4000	4000	-3057
chr17	58201174	58209174	58208543	8000	58205174	-4000	4000	3369
chr17	81810008	81818008	81811941	8000	81814008	-4000	4000	-2067
chr17	61586421	61594421	61591184	8000	61590421	-4000	4000	763
chr17	40973715	40981715	40980884	8000	40977715	-4000	4000	3169
chr17	41455513	41463513	41460181	8000	41459513	-4000	4000	668
chr17	63934554	63942554	63941931	8000	63938554	-4000	4000	3377
chr17	74743335	74751335	74744386	8000	74747335	-4000	4000	-2949
chr17	76708832	76716832	76716508	8000	76712832	-4000	4000	3676
chr17	80130369	80138369	80136063	8000	80134369	-4000	4000	1694
chr17	1773565	1781565	1781354	8000	1777565	-4000	4000	3789
chr17	35979656	35987656	35985780	8000	35983656	-4000	4000	2124
chr17	41472710	41480710	41479755	8000	41476710	-4000	4000	3045
chr17	63698845	63706845	63703826	8000	63702845	-4000	4000	981
chr17	63868012	63876012	63872548	8000	63872012	-4000	4000	536
chr17	63876215	63884215	63880350	8000	63880215	-4000	4000	135
chr17	63905597	63913597	63909740	8000	63909597	-4000	4000	143
chr17	63913203	63921203	63917338	8000	63917203	-4000	4000	135
chr17	29610761	29618761	29614173	8000	29614761	-4000	4000	-588
chr17	44845948	44853948	44851324	8000	44849948	-4000	4000	1376
chr17	30765388	30773388	30766564	8000	30769388	-4000	4000	-2824
chr17	34317402	34325402	34319471	8000	34321402	-4000	4000	-1931
chr17	36009056	36017056	36013296	8000	36013056	-4000	4000	240
chr17	59211239	59219239	59214853	8000	59215239	-4000	4000	-386
chr17	40772808	40780808	40776986	8000	40776808	-4000	4000	178
chr17	40788196	40796196	40793908	8000	40792196	-4000	4000	1712
chr17	62689597	62697597	62690269	8000	62693597	-4000	4000	-3328
chr17	7707372	7715372	7709585	8000	7711372	-4000	4000	-1787
chr17	42398449	42406449	42404885	8000	42402449	-4000	4000	2436
chr17	48066052	48074052	48071510	8000	48070052	-4000	4000	1458
chr17	58516250	58524250	58520908	8000	58520250	-4000	4000	658
chr17	50623474	50631474	50626485	8000	50627474	-4000	4000	-989
chr17	61586421	61594421	61591043	8000	61590421	-4000	4000	622
chr17	3058669	3066669	3062689	8000	3062669	-4000	4000	20
chr17	63905597	63913597	63910799	8000	63909597	-4000	4000	1202
chr17	34356328	34364328	34358034	8000	34360328	-4000	4000	-2294
chr17	41373669	41381669	41381157	8000	41377669	-4000	4000	3488
chr17	1460186	1468186	1465650	8000	1464186	-4000	4000	1464
chr17	47833719	47841719	47834652	8000	47837719	-4000	4000	-3067
chr17	82317024	82325024	82322297	8000	82321024	-4000	4000	1273
chr17	40280136	40288136	40287965	8000	40284136	-4000	4000	3829
chr17	35346305	35354305	35352906	8000	35350305	-4000	4000	2601
chr17	59946574	59954574	59952896	8000	59950574	-4000	4000	2322
chr17	60662280	60670280	60663168	8000	60666280	-4000	4000	-3112
chr17	32993877	33001877	32995680	8000	32997877	-4000	4000	-2197
chr17	50371059	50379059	50375846	8000	50375059	-4000	4000	787
chr17	65223703	65231703	65225137	8000	65227703	-4000	4000	-2566
chr17	48544870	48552870	48550676	8000	48548870	-4000	4000	1806
chr17	58201174	58209174	58208515	8000	58205174	-4000	4000	3341
chr17	42398449	42406449	42405196	8000	42402449	-4000	4000	2747
chr17	41496981	41504981	41503040	8000	41500981	-4000	4000	2059
chr17	3428870	3436870	3432998	8000	3432870	-4000	4000	128
chr17	29621938	29629938	29622742	8000	29625938	-4000	4000	-3196
chr17	80462834	80470834	80467400	8000	80466834	-4000	4000	566
chr17	28610446	28618446	28611165	8000	28614446	-4000	4000	-3281
chr17	41962503	41970503	41965609	8000	41966503	-4000	4000	-894
chr17	69074702	69082702	69081086	8000	69078702	-4000	4000	2384
chr17	28610446	28618446	28612633	8000	28614446	-4000	4000	-1813
chr17	39917041	39925041	39923217	8000	39921041	-4000	4000	2176
chr17	35722413	35730413	35723861	8000	35726413	-4000	4000	-2552
chr17	41389721	41397721	41394025	8000	41393721	-4000	4000	304
chr17	82486537	82494537	82487977	8000	82490537	-4000	4000	-2560
chr17	75131248	75139248	75136168	8000	75135248	-4000	4000	920
chr17	76729936	76737936	76733042	8000	76733936	-4000	4000	-894
chr17	80130369	80138369	80136321	8000	80134369	-4000	4000	1952
chr17	32320659	32328659	32321076	8000	32324659	-4000	4000	-3583
chr17	35867491	35875491	35872343	8000	35871491	-4000	4000	852
chr17	738968	746968	745962	8000	742968	-4000	4000	2994
chr17	3058669	3066669	3063359	8000	3062669	-4000	4000	690
chr17	3122610	3130610	3126752	8000	3126610	-4000	4000	142
chr17	3393104	3401104	3397626	8000	3397104	-4000	4000	522
chr17	4781285	4789285	4785953	8000	4785285	-4000	4000	668
chr17	5092374	5100374	5092495	8000	5096374	-4000	4000	-3879
chr17	5495427	5503427	5501674	8000	5499427	-4000	4000	2247
chr17	7013520	7021520	7016966	8000	7017520	-4000	4000	-554
chr17	7440937	7448937	7447386	8000	7444937	-4000	4000	2449
chr17	8184345	8192345	8189156	8000	8188345	-4000	4000	811
chr17	8283763	8291763	8289380	8000	8287763	-4000	4000	1617
chr17	8318514	8326514	8318908	8000	8322514	-4000	4000	-3606
chr17	8318514	8326514	8319335	8000	8322514	-4000	4000	-3179
chr17	10488307	10496307	10496033	8000	10492307	-4000	4000	3726
chr17	10624526	10632526	10632005	8000	10628526	-4000	4000	3479
chr17	14231673	14239673	14236587	8000	14235673	-4000	4000	914
chr17	14345404	14353404	14345451	8000	14349404	-4000	4000	-3953
chr17	18205954	18213954	18206840	8000	18209954	-4000	4000	-3114
chr17	18775349	18783349	18778749	8000	18779349	-4000	4000	-600
chr17	19018595	19026595	19019498	8000	19022595	-4000	4000	-3097
chr17	30891869	30899869	30893527	8000	30895869	-4000	4000	-2342
chr17	30891869	30899869	30899568	8000	30895869	-4000	4000	3699
chr17	34923859	34931859	34931040	8000	34927859	-4000	4000	3181
chr17	38843860	38851860	38850407	8000	38847860	-4000	4000	2547
chr17	39599536	39607536	39605673	8000	39603536	-4000	4000	2137
chr17	39900595	39908595	39905892	8000	39904595	-4000	4000	1297
chr17	41102488	41110488	41105925	8000	41106488	-4000	4000	-563
chr17	41482136	41490136	41486279	8000	41486136	-4000	4000	143
chr17	41496981	41504981	41503364	8000	41500981	-4000	4000	2383
chr17	41561836	41569836	41568621	8000	41565836	-4000	4000	2785
chr17	41605778	41613778	41609856	8000	41609778	-4000	4000	78
chr17	46753464	46761464	46755313	8000	46757464	-4000	4000	-2151
chr17	47819272	47827272	47820058	8000	47823272	-4000	4000	-3214
chr17	47819272	47827272	47824089	8000	47823272	-4000	4000	817
chr17	47833719	47841719	47838641	8000	47837719	-4000	4000	922
chr17	48119601	48127601	48121776	8000	48123601	-4000	4000	-1825
chr17	48536894	48544894	48543148	8000	48540894	-4000	4000	2254
chr17	48536894	48544894	48544572	8000	48540894	-4000	4000	3678
chr17	48536894	48544894	48544805	8000	48540894	-4000	4000	3911
chr17	48544870	48552870	48550291	8000	48548870	-4000	4000	1421
chr17	48603232	48611232	48607877	8000	48607232	-4000	4000	645
chr17	48954554	48962554	48958676	8000	48958554	-4000	4000	122
chr17	50481974	50489974	50482163	8000	50485974	-4000	4000	-3811
chr17	50623474	50631474	50624377	8000	50627474	-4000	4000	-3097
chr17	50623474	50631474	50626644	8000	50627474	-4000	4000	-830
chr17	50858223	50866223	50863771	8000	50862223	-4000	4000	1548
chr17	50858223	50866223	50864044	8000	50862223	-4000	4000	1821
chr17	51167744	51175744	51171631	8000	51171744	-4000	4000	-113
chr17	51173425	51181425	51180577	8000	51177425	-4000	4000	3152
chr17	51293936	51301936	51294008	8000	51297936	-4000	4000	-3928
chr17	53821193	53829193	53824494	8000	53825193	-4000	4000	-699
chr17	54957956	54965956	54961339	8000	54961956	-4000	4000	-617
chr17	54957956	54965956	54963262	8000	54961956	-4000	4000	1306
chr17	58167411	58175411	58169692	8000	58171411	-4000	4000	-1719
chr17	59202709	59210709	59210231	8000	59206709	-4000	4000	3522
chr17	59211239	59219239	59211350	8000	59215239	-4000	4000	-3889
chr17	59211239	59219239	59212454	8000	59215239	-4000	4000	-2785
chr17	59211239	59219239	59213007	8000	59215239	-4000	4000	-2232
chr17	59604345	59612345	59605470	8000	59608345	-4000	4000	-2875
chr17	59838255	59846255	59839871	8000	59842255	-4000	4000	-2384
chr17	59855479	59863479	59860408	8000	59859479	-4000	4000	929
chr17	59946574	59954574	59946896	8000	59950574	-4000	4000	-3678
chr17	61586421	61594421	61591093	8000	61590421	-4000	4000	672
chr17	61938605	61946605	61946500	8000	61942605	-4000	4000	3895
chr17	62689597	62697597	62692446	8000	62693597	-4000	4000	-1151
chr17	63998594	64006594	64005052	8000	64002594	-4000	4000	2458
chr17	68418731	68426731	68420268	8000	68422731	-4000	4000	-2463
chr17	68863289	68871289	68868141	8000	68867289	-4000	4000	852
chr17	75102162	75110162	75104025	8000	75106162	-4000	4000	-2137
chr17	76729936	76737936	76733192	8000	76733936	-4000	4000	-744
chr17	77213101	77221101	77216685	8000	77217101	-4000	4000	-416
chr17	78236987	78244987	78239194	8000	78240987	-4000	4000	-1793
chr17	61481110	61489110	61482932	8000	61485110	-4000	4000	-2178
chr17	67980378	67988378	67984345	8000	67984378	-4000	4000	-33
chr17	30182475	30190475	30184865	8000	30186475	-4000	4000	-1610
chr17	41389721	41397721	41394089	8000	41393721	-4000	4000	368
chr17	41025351	41033351	41026720	8000	41029351	-4000	4000	-2631
chr17	48524526	48532526	48529604	8000	48528526	-4000	4000	1078
chr17	42910438	42918438	42910946	8000	42914438	-4000	4000	-3492
chr17	42910438	42918438	42911363	8000	42914438	-4000	4000	-3075
chr17	53821193	53829193	53823843	8000	53825193	-4000	4000	-1350
chr17	43948733	43956733	43953852	8000	43952733	-4000	4000	1119
chr17	3194448	3202448	3198323	8000	3198448	-4000	4000	-125
chr17	30891869	30899869	30899304	8000	30895869	-4000	4000	3435
chr17	41025351	41033351	41026822	8000	41029351	-4000	4000	-2529
chr17	50858223	50866223	50863578	8000	50862223	-4000	4000	1355
chr17	16616734	16624734	16624563	8000	16620734	-4000	4000	3829
chr17	61586421	61594421	61590800	8000	61590421	-4000	4000	379
chr17	63868012	63876012	63872139	8000	63872012	-4000	4000	127
chr17	41180100	41188100	41184421	8000	41184100	-4000	4000	321
chr17	7707372	7715372	7708175	8000	7711372	-4000	4000	-3197
chr17	63604347	63612347	63607921	8000	63608347	-4000	4000	-426
chr17	35739521	35747521	35745724	8000	35743521	-4000	4000	2203
chr17	47977781	47985781	47980604	8000	47981781	-4000	4000	-1177
chr17	62611481	62619481	62613450	8000	62615481	-4000	4000	-2031
chr17	82359775	82367775	82363505	8000	82363775	-4000	4000	-270
chr17	5092374	5100374	5093113	8000	5096374	-4000	4000	-3261
chr17	41342092	41350092	41346929	8000	41346092	-4000	4000	837
chr17	53821193	53829193	53823628	8000	53825193	-4000	4000	-1565
chr17	7070537	7078537	7075213	8000	7074537	-4000	4000	676
chr17	3581149	3589149	3585855	8000	3585149	-4000	4000	706
chr17	3710628	3718628	3714853	8000	3714628	-4000	4000	225
chr17	8091900	8099900	8096378	8000	8095900	-4000	4000	478
chr17	8116592	8124592	8118766	8000	8120592	-4000	4000	-1826
chr17	9767434	9775434	9772921	8000	9771434	-4000	4000	1487
chr17	10386322	10394322	10390410	8000	10390322	-4000	4000	88
chr17	19575034	19583034	19577358	8000	19579034	-4000	4000	-1676
chr17	28359683	28367683	28364512	8000	28363683	-4000	4000	829
chr17	29053216	29061216	29056390	8000	29057216	-4000	4000	-826
chr17	30893336	30901336	30900310	8000	30897336	-4000	4000	2974
chr17	30955322	30963322	30956249	8000	30959322	-4000	4000	-3073
chr17	30995911	31003911	30999176	8000	30999911	-4000	4000	-735
chr17	34268242	34276242	34271915	8000	34272242	-4000	4000	-327
chr17	34356328	34364328	34360505	8000	34360328	-4000	4000	177
chr17	36068032	36076032	36071072	8000	36072032	-4000	4000	-960
chr17	39873896	39881896	39875264	8000	39877896	-4000	4000	-2632
chr17	40772808	40780808	40777663	8000	40776808	-4000	4000	855
chr17	40814117	40822117	40822093	8000	40818117	-4000	4000	3976
chr17	41092981	41100981	41097300	8000	41096981	-4000	4000	319
chr17	41578279	41586279	41582485	8000	41582279	-4000	4000	206
chr17	42793066	42801066	42793623	8000	42797066	-4000	4000	-3443
chr17	42846707	42854707	42852806	8000	42850707	-4000	4000	2099
chr17	43010607	43018607	43015902	8000	43014607	-4000	4000	1295
chr17	43936804	43944804	43941520	8000	43940804	-4000	4000	716
chr17	44777846	44785846	44778003	8000	44781846	-4000	4000	-3843
chr17	45250393	45258393	45255708	8000	45254393	-4000	4000	1315
chr17	47219679	47227679	47223058	8000	47223679	-4000	4000	-621
chr17	47620665	47628665	47622130	8000	47624665	-4000	4000	-2535
chr17	49219225	49227225	49224770	8000	49223225	-4000	4000	1545
chr17	50689198	50697198	50697002	8000	50693198	-4000	4000	3804
chr17	54957956	54965956	54963207	8000	54961956	-4000	4000	1251
chr17	58485529	58493529	58492859	8000	58489529	-4000	4000	3330
chr17	58516250	58524250	58521415	8000	58520250	-4000	4000	1165
chr17	59211239	59219239	59215185	8000	59215239	-4000	4000	-54
chr17	60662280	60670280	60663583	8000	60666280	-4000	4000	-2697
chr17	76729936	76737936	76733292	8000	76733936	-4000	4000	-644
chr17	76946393	76954393	76947880	8000	76950393	-4000	4000	-2513
chr17	77213101	77221101	77216530	8000	77217101	-4000	4000	-571
chr17	79788132	79796132	79794644	8000	79792132	-4000	4000	2512
chr17	27645560	27653560	27647065	8000	27649560	-4000	4000	-2495
chr17	39993959	40001959	39997555	8000	39997959	-4000	4000	-404
chr17	41235004	41243004	41238108	8000	41239004	-4000	4000	-896
chr17	59604345	59612345	59605542	8000	59608345	-4000	4000	-2803
chr17	60662280	60670280	60663281	8000	60666280	-4000	4000	-2999
chr17	67987099	67995099	67993222	8000	67991099	-4000	4000	2123
chr17	73279624	73287624	73286038	8000	73283624	-4000	4000	2414
chr17	50371059	50379059	50375448	8000	50375059	-4000	4000	389
chr17	59211239	59219239	59212425	8000	59215239	-4000	4000	-2814
chr17	59211239	59219239	59212870	8000	59215239	-4000	4000	-2369
chr17	78848977	78856977	78855715	8000	78852977	-4000	4000	2738
chr17	29067122	29075122	29074106	8000	29071122	-4000	4000	2984
chr17	74258020	74266020	74260307	8000	74262020	-4000	4000	-1713
chr17	6689202	6697202	6690849	8000	6693202	-4000	4000	-2353
chr17	40788196	40796196	40793988	8000	40792196	-4000	4000	1792
chr17	58155585	58163585	58157545	8000	58159585	-4000	4000	-2040
chr17	50180101	50188101	50185881	8000	50184101	-4000	4000	1780
chr17	50180101	50188101	50187086	8000	50184101	-4000	4000	2985
chr17	38796441	38804441	38802125	8000	38800441	-4000	4000	1684
chr17	61586421	61594421	61590906	8000	61590421	-4000	4000	485
chr17	41615442	41623442	41621613	8000	41619442	-4000	4000	2171
chr17	63876215	63884215	63881086	8000	63880215	-4000	4000	871
chr17	33009087	33017087	33014013	8000	33013087	-4000	4000	926
chr17	50481974	50489974	50482666	8000	50485974	-4000	4000	-3308
chr17	42021576	42029576	42027088	8000	42025576	-4000	4000	1512
chr17	41713742	41721742	41715532	8000	41717742	-4000	4000	-2210
chr17	48536894	48544894	48543262	8000	48540894	-4000	4000	2368
chr17	74368600	74376600	74372142	8000	74372600	-4000	4000	-458
chr17	36940612	36948612	36943158	8000	36944612	-4000	4000	-1454
chr17	29053216	29061216	29053567	8000	29057216	-4000	4000	-3649
chr17	10488307	10496307	10496080	8000	10492307	-4000	4000	3773
chr17	47840908	47848908	47847545	8000	47844908	-4000	4000	2637
chr17	48720758	48728758	48722504	8000	48724758	-4000	4000	-2254
chr17	59946574	59954574	59952703	8000	59950574	-4000	4000	2129
chr17	63934554	63942554	63941976	8000	63938554	-4000	4000	3422
chr17	55388622	55396622	55394490	8000	55392622	-4000	4000	1868
chr17	15225773	15233773	15231016	8000	15229773	-4000	4000	1243
chr17	50838353	50846353	50839948	8000	50842353	-4000	4000	-2405
chr17	74368600	74376600	74372331	8000	74372600	-4000	4000	-269
chr17	48954554	48962554	48960985	8000	48958554	-4000	4000	2431
chr17	16800453	16808453	16803362	8000	16804453	-4000	4000	-1091
chr17	45431900	45439900	45437088	8000	45435900	-4000	4000	1188
chr17	63934554	63942554	63940990	8000	63938554	-4000	4000	2436
chr17	41135433	41143433	41140247	8000	41139433	-4000	4000	814
chr17	10488307	10496307	10494607	8000	10492307	-4000	4000	2300
chr17	69074702	69082702	69078994	8000	69078702	-4000	4000	292
chr17	1296978	1304978	1298409	8000	1300978	-4000	4000	-2569
chr17	3710628	3718628	3716709	8000	3714628	-4000	4000	2081
chr17	8116592	8124592	8121298	8000	8120592	-4000	4000	706
chr17	19674288	19682288	19681567	8000	19678288	-4000	4000	3279
chr17	48536894	48544894	48543542	8000	48540894	-4000	4000	2648
chr17	66208033	66216033	66214484	8000	66212033	-4000	4000	2451
chr17	63544977	63552977	63550655	8000	63548977	-4000	4000	1678
chr17	49986005	49994005	49993574	8000	49990005	-4000	4000	3569
chr17	3214896	3222896	3216390	8000	3218896	-4000	4000	-2506
chr17	8116592	8124592	8116774	8000	8120592	-4000	4000	-3818
chr17	39666475	39674475	39669741	8000	39670475	-4000	4000	-734
chr17	41862917	41870917	41869529	8000	41866917	-4000	4000	2612
chr17	9639447	9647447	9643266	8000	9643447	-4000	4000	-181
chr17	41578279	41586279	41584411	8000	41582279	-4000	4000	2132
chr17	8743524	8751524	8744528	8000	8747524	-4000	4000	-2996
chr17	82747196	82755196	82750427	8000	82751196	-4000	4000	-769
chr17	7070537	7078537	7074923	8000	7074537	-4000	4000	386
chr17	7070537	7078537	7076917	8000	7074537	-4000	4000	2380
chr17	7353219	7361219	7356423	8000	7357219	-4000	4000	-796
chr17	10818470	10826470	10825116	8000	10822470	-4000	4000	2646
chr17	35188520	35196520	35193740	8000	35192520	-4000	4000	1220
chr17	41180100	41188100	41184487	8000	41184100	-4000	4000	387
chr17	41482136	41490136	41487420	8000	41486136	-4000	4000	1284
chr17	42309324	42317324	42316875	8000	42313324	-4000	4000	3551
chr17	45843067	45851067	45846405	8000	45847067	-4000	4000	-662
chr17	47833719	47841719	47840256	8000	47837719	-4000	4000	2537
chr17	74517174	74525174	74522716	8000	74521174	-4000	4000	1542
chr17	75102162	75110162	75104189	8000	75106162	-4000	4000	-1973
chr17	81224277	81232277	81231629	8000	81228277	-4000	4000	3352
chr17	59838255	59846255	59838355	8000	59842255	-4000	4000	-3900
chr17	15299811	15307811	15303863	8000	15303811	-4000	4000	52
chr17	7423568	7431568	7427010	8000	7427568	-4000	4000	-558
chr17	76946393	76954393	76948877	8000	76950393	-4000	4000	-1516
chr17	41389721	41397721	41394991	8000	41393721	-4000	4000	1270
chr17	78162297	78170297	78165899	8000	78166297	-4000	4000	-398
chr17	50689198	50697198	50697006	8000	50693198	-4000	4000	3808
chr17	40744021	40752021	40751305	8000	40748021	-4000	4000	3284
chr17	40973715	40981715	40978209	8000	40977715	-4000	4000	494
chr17	42021576	42029576	42028133	8000	42025576	-4000	4000	2557
chr17	79788132	79796132	79794819	8000	79792132	-4000	4000	2687
chr17	79788132	79796132	79795158	8000	79792132	-4000	4000	3026
chr17	61938605	61946605	61945994	8000	61942605	-4000	4000	3389
chr17	64143227	64151227	64148324	8000	64147227	-4000	4000	1097
chr17	62412480	62420480	62416136	8000	62416480	-4000	4000	-344
chr17	10488307	10496307	10495962	8000	10492307	-4000	4000	3655
chr17	40015097	40023097	40015765	8000	40019097	-4000	4000	-3332
chr17	48720758	48728758	48726980	8000	48724758	-4000	4000	2222
chr17	7097322	7105322	7101559	8000	7101322	-4000	4000	237
chr17	61938605	61946605	61946563	8000	61942605	-4000	4000	3958
chr17	44748264	44756264	44748573	8000	44752264	-4000	4000	-3691
chr17	58516250	58524250	58521205	8000	58520250	-4000	4000	955
chr17	58981179	58989179	58982846	8000	58985179	-4000	4000	-2333
chr17	48119601	48127601	48122284	8000	48123601	-4000	4000	-1317
chr17	3194448	3202448	3197567	8000	3198448	-4000	4000	-881
chr17	16616734	16624734	16622898	8000	16620734	-4000	4000	2164
chr17	63868012	63876012	63873608	8000	63872012	-4000	4000	1596
chr17	40814117	40822117	40819620	8000	40818117	-4000	4000	1503
chr17	41135433	41143433	41140378	8000	41139433	-4000	4000	945
chr17	58265855	58273855	58272904	8000	58269855	-4000	4000	3049
chr17	1490577	1498577	1497985	8000	1494577	-4000	4000	3408
chr17	36084256	36092256	36090075	8000	36088256	-4000	4000	1819
chr17	41173446	41181446	41178022	8000	41177446	-4000	4000	576
chr17	41972421	41980421	41977439	8000	41976421	-4000	4000	1018
chr17	73203353	73211353	73209521	8000	73207353	-4000	4000	2168
chr17	41496981	41504981	41503364	8000	41500981	-4000	4000	2383
chr17	39900595	39908595	39906233	8000	39904595	-4000	4000	1638
chr17	50858223	50866223	50863306	8000	50862223	-4000	4000	1083
chr17	74537073	74545073	74541306	8000	74541073	-4000	4000	233
chr17	58265855	58273855	58267443	8000	58269855	-4000	4000	-2412
chr17	35930518	35938518	35937771	8000	35934518	-4000	4000	3253
chr17	40772808	40780808	40780400	8000	40776808	-4000	4000	3592
chr17	7829742	7837742	7831309	8000	7833742	-4000	4000	-2433
chr17	41163231	41171231	41167572	8000	41167231	-4000	4000	341
chr17	47708052	47716052	47708401	8000	47712052	-4000	4000	-3651
chr17	5092374	5100374	5092388	8000	5096374	-4000	4000	-3986
chr17	36208878	36216878	36212657	8000	36212878	-4000	4000	-221
chr17	81914270	81922270	81914348	8000	81918270	-4000	4000	-3922
chr17	41113181	41121181	41118203	8000	41117181	-4000	4000	1022
chr17	63890909	63898909	63895046	8000	63894909	-4000	4000	137
chr17	30891869	30899869	30894029	8000	30895869	-4000	4000	-1840
chr17	41246653	41254653	41250579	8000	41250653	-4000	4000	-74
chr17	63544977	63552977	63545082	8000	63548977	-4000	4000	-3895
chr17	67740531	67748531	67743979	8000	67744531	-4000	4000	-552
chr17	39206541	39214541	39213019	8000	39210541	-4000	4000	2478
chr17	795310	803310	801092	8000	799310	-4000	4000	1782
chr17	44686308	44694308	44689570	8000	44690308	-4000	4000	-738
chr17	63890909	63898909	63894992	8000	63894909	-4000	4000	83
chr17	54957956	54965956	54963167	8000	54961956	-4000	4000	1211
chr17	36940612	36948612	36940727	8000	36944612	-4000	4000	-3885
chr17	44899159	44907159	44901098	8000	44903159	-4000	4000	-2061
chr17	48603232	48611232	48610863	8000	48607232	-4000	4000	3631
chr17	69143214	69151214	69149050	8000	69147214	-4000	4000	1836
chr17	7070537	7078537	7076988	8000	7074537	-4000	4000	2451
chr17	5382340	5390340	5386232	8000	5386340	-4000	4000	-108
chr17	37475725	37483725	37476913	8000	37479725	-4000	4000	-2812
chr17	41036541	41044541	41041054	8000	41040541	-4000	4000	513
chr17	68418731	68426731	68420486	8000	68422731	-4000	4000	-2245
chr17	68418731	68426731	68420652	8000	68422731	-4000	4000	-2079
chr17	47840908	47848908	47848073	8000	47844908	-4000	4000	3165
chr17	42846707	42854707	42851845	8000	42850707	-4000	4000	1138
chr17	62697314	62705314	62701557	8000	62701314	-4000	4000	243
chr17	53821193	53829193	53824834	8000	53825193	-4000	4000	-359
chr17	7026290	7034290	7026534	8000	7030290	-4000	4000	-3756
chr17	28698679	28706679	28700173	8000	28702679	-4000	4000	-2506
chr17	4781285	4789285	4783190	8000	4785285	-4000	4000	-2095
chr17	6785133	6793133	6787333	8000	6789133	-4000	4000	-1800
chr17	8743524	8751524	8744588	8000	8747524	-4000	4000	-2936
chr17	30893336	30901336	30900267	8000	30897336	-4000	4000	2931
chr17	41561836	41569836	41567623	8000	41565836	-4000	4000	1787
chr17	41561836	41569836	41568209	8000	41565836	-4000	4000	2373
chr17	41561836	41569836	41568269	8000	41565836	-4000	4000	2433
chr17	41561836	41569836	41568350	8000	41565836	-4000	4000	2514
chr17	41561836	41569836	41568571	8000	41565836	-4000	4000	2735
chr17	44845948	44853948	44852490	8000	44849948	-4000	4000	2542
chr17	59946574	59954574	59954123	8000	59950574	-4000	4000	3549
chr17	61938605	61946605	61946532	8000	61942605	-4000	4000	3927
chr17	64850130	64858130	64854400	8000	64854130	-4000	4000	270
chr17	81185593	81193593	81191244	8000	81189593	-4000	4000	1651
chr17	44368180	44376180	44376092	8000	44372180	-4000	4000	3912
chr17	63876215	63884215	63881042	8000	63880215	-4000	4000	827
chr17	81240811	81248811	81246310	8000	81244811	-4000	4000	1499
chr17	61586421	61594421	61590641	8000	61590421	-4000	4000	220
chr17	74929912	74937912	74933462	8000	74933912	-4000	4000	-450
chr17	6639311	6647311	6644421	8000	6643311	-4000	4000	1110
chr17	16025157	16033157	16032429	8000	16029157	-4000	4000	3272
chr17	78203702	78211702	78205706	8000	78207702	-4000	4000	-1996
chr17	41036541	41044541	41041052	8000	41040541	-4000	4000	511
chr17	46753464	46761464	46755916	8000	46757464	-4000	4000	-1548
chr17	47045932	47053932	47050469	8000	47049932	-4000	4000	537
chr17	50688253	50696253	50695946	8000	50692253	-4000	4000	3693
chr17	7423568	7431568	7426051	8000	7427568	-4000	4000	-1517
chr17	74351820	74359820	74354787	8000	74355820	-4000	4000	-1033
chr17	76777449	76785449	76778247	8000	76781449	-4000	4000	-3202
chr17	41844384	41852384	41848012	8000	41848384	-4000	4000	-372
chr17	35752249	35760249	35752504	8000	35756249	-4000	4000	-3745
chr17	28192381	28200381	28196036	8000	28196381	-4000	4000	-345
chr17	62611481	62619481	62612668	8000	62615481	-4000	4000	-2813
chr17	1460186	1468186	1465704	8000	1464186	-4000	4000	1518
chr17	34356328	34364328	34358029	8000	34360328	-4000	4000	-2299
chr17	38320571	38328571	38327070	8000	38324571	-4000	4000	2499
chr17	41135433	41143433	41139792	8000	41139433	-4000	4000	359
chr17	60037008	60045008	60043519	8000	60041008	-4000	4000	2511
chr17	61481110	61489110	61483528	8000	61485110	-4000	4000	-1582
chr17	74945992	74953992	74949297	8000	74949992	-4000	4000	-695
chr17	20445395	20453395	20453060	8000	20449395	-4000	4000	3665
chr17	3272942	3280942	3278290	8000	3276942	-4000	4000	1348
chr17	8045134	8053134	8047796	8000	8049134	-4000	4000	-1338
chr17	8318514	8326514	8319042	8000	8322514	-4000	4000	-3472
chr17	16616734	16624734	16622796	8000	16620734	-4000	4000	2062
chr17	19379544	19387544	19380924	8000	19383544	-4000	4000	-2620
chr17	35346305	35354305	35353905	8000	35350305	-4000	4000	3600
chr17	35346305	35354305	35354042	8000	35350305	-4000	4000	3737
chr17	40772808	40780808	40779715	8000	40776808	-4000	4000	2907
chr17	41235004	41243004	41238276	8000	41239004	-4000	4000	-728
chr17	44244390	44252390	44250472	8000	44248390	-4000	4000	2082
chr17	50371059	50379059	50375952	8000	50375059	-4000	4000	893
chr17	55715627	55723627	55720806	8000	55719627	-4000	4000	1179
chr17	59211239	59219239	59211707	8000	59215239	-4000	4000	-3532
chr17	70131608	70139608	70133000	8000	70135608	-4000	4000	-2608
chr17	74517174	74525174	74523179	8000	74521174	-4000	4000	2005
chr17	75102162	75110162	75104109	8000	75106162	-4000	4000	-2053
chr17	76620761	76628761	76626390	8000	76624761	-4000	4000	1629
chr17	7070537	7078537	7075257	8000	7074537	-4000	4000	720
chr17	78236987	78244987	78239818	8000	78240987	-4000	4000	-1169
chr17	3272942	3280942	3278305	8000	3276942	-4000	4000	1363
chr17	49594884	49602884	49600444	8000	49598884	-4000	4000	1560
chr17	74310884	74318884	74312092	8000	74314884	-4000	4000	-2792
chr17	8283763	8291763	8289841	8000	8287763	-4000	4000	2078
chr17	17343663	17351663	17346969	8000	17347663	-4000	4000	-694
chr17	29067122	29075122	29074786	8000	29071122	-4000	4000	3664
chr17	39632626	39640626	39636374	8000	39636626	-4000	4000	-252
chr17	40168171	40176171	40169633	8000	40172171	-4000	4000	-2538
chr17	41482136	41490136	41489418	8000	41486136	-4000	4000	3282
chr17	48536894	48544894	48543525	8000	48540894	-4000	4000	2631
chr17	80462834	80470834	80468146	8000	80466834	-4000	4000	1312
chr17	3058669	3066669	3063217	8000	3062669	-4000	4000	548
chr17	3214896	3222896	3216168	8000	3218896	-4000	4000	-2728
chr17	48536894	48544894	48544697	8000	48540894	-4000	4000	3803
chr17	48544870	48552870	48552059	8000	48548870	-4000	4000	3189
chr17	82317024	82325024	82324765	8000	82321024	-4000	4000	3741
chr18	7228044	7236044	7232023	8000	7232044	-4000	4000	-21
chr18	24157600	24165600	24165067	8000	24161600	-4000	4000	3467
chr18	63932111	63940111	63934884	8000	63936111	-4000	4000	-1227
chr18	666318	674318	674213	8000	670318	-4000	4000	3895
chr18	13659347	13667347	13666383	8000	13663347	-4000	4000	3036
chr18	26189355	26197355	26192465	8000	26193355	-4000	4000	-890
chr18	60367062	60375062	60371606	8000	60371062	-4000	4000	544
chr18	24157600	24165600	24159717	8000	24161600	-4000	4000	-1883
chr18	3252236	3260236	3253330	8000	3256236	-4000	4000	-2906
chr18	26012253	26020253	26018233	8000	26016253	-4000	4000	1980
chr18	63633259	63641259	63637615	8000	63637259	-4000	4000	356
chr18	63633259	63641259	63637693	8000	63637259	-4000	4000	434
chr18	46472972	46480972	46477772	8000	46476972	-4000	4000	800
chr18	9130345	9138345	9134272	8000	9134345	-4000	4000	-73
chr18	6937742	6945742	6942215	8000	6941742	-4000	4000	473
chr18	75061671	75069671	75063386	8000	75065671	-4000	4000	-2285
chr18	5388381	5396381	5392979	8000	5392381	-4000	4000	598
chr18	8635383	8643383	8638655	8000	8639383	-4000	4000	-728
chr18	31755584	31763584	31760859	8000	31759584	-4000	4000	1275
chr18	11606612	11614612	11609809	8000	11610612	-4000	4000	-803
chr18	54897509	54905509	54904323	8000	54901509	-4000	4000	2814
chr18	75285950	75293950	75287416	8000	75289950	-4000	4000	-2534
chr18	36104531	36112531	36111127	8000	36108531	-4000	4000	2596
chr18	63633259	63641259	63637948	8000	63637259	-4000	4000	689
chr18	21522112	21530112	21529819	8000	21526112	-4000	4000	3707
chr18	51170550	51178550	51177121	8000	51174550	-4000	4000	2571
chr18	63565329	63573329	63566618	8000	63569329	-4000	4000	-2711
chr18	9885275	9893275	9887866	8000	9889275	-4000	4000	-1409
chr18	11881685	11889685	11885732	8000	11885685	-4000	4000	47
chr18	35707834	35715834	35709769	8000	35711834	-4000	4000	-2065
chr18	22409599	22417599	22415474	8000	22413599	-4000	4000	1875
chr18	75285950	75293950	75288367	8000	75289950	-4000	4000	-1583
chr18	59323823	59331823	59330674	8000	59327823	-4000	4000	2851
chr18	74430775	74438775	74436684	8000	74434775	-4000	4000	1909
chr18	75061671	75069671	75063940	8000	75065671	-4000	4000	-1731
chr18	12026877	12034877	12028957	8000	12030877	-4000	4000	-1920
chr18	26189355	26197355	26192472	8000	26193355	-4000	4000	-883
chr18	50727826	50735826	50729789	8000	50731826	-4000	4000	-2037
chr18	11881685	11889685	11886745	8000	11885685	-4000	4000	1060
chr18	20942906	20950906	20950686	8000	20946906	-4000	4000	3780
chr18	26012253	26020253	26016783	8000	26016253	-4000	4000	530
chr18	21522112	21530112	21529933	8000	21526112	-4000	4000	3821
chr18	20942906	20950906	20950826	8000	20946906	-4000	4000	3920
chr18	24475961	24483961	24477378	8000	24479961	-4000	4000	-2583
chr18	31410912	31418912	31412915	8000	31414912	-4000	4000	-1997
chr18	74069353	74077353	74073512	8000	74073353	-4000	4000	159
chr18	5138911	5146911	5145613	8000	5142911	-4000	4000	2702
chr18	24475961	24483961	24477381	8000	24479961	-4000	4000	-2580
chr18	63633259	63641259	63637941	8000	63637259	-4000	4000	682
chr18	63722432	63730432	63723320	8000	63726432	-4000	4000	-3112
chr18	7228044	7236044	7231364	8000	7232044	-4000	4000	-680
chr18	13878044	13886044	13885540	8000	13882044	-4000	4000	3496
chr18	9885275	9893275	9887586	8000	9889275	-4000	4000	-1689
chr18	75285950	75293950	75287798	8000	75289950	-4000	4000	-2152
chr18	50727826	50735826	50729178	8000	50731826	-4000	4000	-2648
chr18	61551779	61559779	61554508	8000	61555779	-4000	4000	-1271
chr18	22409599	22417599	22415596	8000	22413599	-4000	4000	1997
chr18	13878044	13886044	13885461	8000	13882044	-4000	4000	3417
chr18	36104531	36112531	36111127	8000	36108531	-4000	4000	2596
chr18	13878044	13886044	13884765	8000	13882044	-4000	4000	2721
chr18	23952222	23960222	23954716	8000	23956222	-4000	4000	-1506
chr18	50727826	50735826	50729251	8000	50731826	-4000	4000	-2575
chr18	50262882	50270882	50270073	8000	50266882	-4000	4000	3191
chr18	10485949	10493949	10487620	8000	10489949	-4000	4000	-2329
chr18	36104531	36112531	36112504	8000	36108531	-4000	4000	3973
chr18	50727826	50735826	50729680	8000	50731826	-4000	4000	-2146
chr18	12125764	12133764	12125780	8000	12129764	-4000	4000	-3984
chr18	32668673	32676673	32674533	8000	32672673	-4000	4000	1860
chr18	61551779	61559779	61554399	8000	61555779	-4000	4000	-1380
chr18	5950706	5958706	5956252	8000	5954706	-4000	4000	1546
chr18	58982480	58990480	58985799	8000	58986480	-4000	4000	-681
chr18	35975286	35983286	35977459	8000	35979286	-4000	4000	-1827
chr18	2912994	2920994	2920358	8000	2916994	-4000	4000	3364
chr18	69999031	70007031	70006386	8000	70003031	-4000	4000	3355
chr18	70326199	70334199	70327225	8000	70330199	-4000	4000	-2974
chr18	6937742	6945742	6942105	8000	6941742	-4000	4000	363
chr18	75285950	75293950	75286120	8000	75289950	-4000	4000	-3830
chr18	7228044	7236044	7231526	8000	7232044	-4000	4000	-518
chr18	60367062	60375062	60371986	8000	60371062	-4000	4000	924
chr18	36776220	36784220	36779451	8000	36780220	-4000	4000	-769
chr18	24157600	24165600	24161515	8000	24161600	-4000	4000	-85
chr18	75285950	75293950	75288009	8000	75289950	-4000	4000	-1941
chr18	58477247	58485247	58481892	8000	58481247	-4000	4000	645
chr18	22409599	22417599	22416431	8000	22413599	-4000	4000	2832
chr18	666318	674318	674229	8000	670318	-4000	4000	3911
chr18	12026877	12034877	12030414	8000	12030877	-4000	4000	-463
chr18	68669688	68677688	68677157	8000	68673688	-4000	4000	3469
chr18	63801376	63809376	63804273	8000	63805376	-4000	4000	-1103
chr18	9956021	9964021	9956794	8000	9960021	-4000	4000	-3227
chr18	32933402	32941402	32937696	8000	32937402	-4000	4000	294
chr18	2912003	2920003	2913123	8000	2916003	-4000	4000	-2880
chr18	13878044	13886044	13884724	8000	13882044	-4000	4000	2680
chr18	54147606	54155606	54155107	8000	54151606	-4000	4000	3501
chr18	210629	218629	211389	8000	214629	-4000	4000	-3240
chr18	47104188	47112188	47108624	8000	47108188	-4000	4000	436
chr18	35707834	35715834	35709656	8000	35711834	-4000	4000	-2178
chr18	58477247	58485247	58481365	8000	58481247	-4000	4000	118
chr18	74583212	74591212	74584645	8000	74587212	-4000	4000	-2567
chr18	2801017	2809017	2802573	8000	2805017	-4000	4000	-2444
chr18	35362694	35370694	35369343	8000	35366694	-4000	4000	2649
chr18	3455978	3463978	3458339	8000	3459978	-4000	4000	-1639
chr18	24157600	24165600	24159812	8000	24161600	-4000	4000	-1788
chr18	24157600	24165600	24159969	8000	24161600	-4000	4000	-1631
chr18	51170550	51178550	51176597	8000	51174550	-4000	4000	2047
chr18	13878044	13886044	13885178	8000	13882044	-4000	4000	3134
chr18	49818789	49826789	49826521	8000	49822789	-4000	4000	3732
chr18	22409599	22417599	22415710	8000	22413599	-4000	4000	2111
chr18	31410912	31418912	31411186	8000	31414912	-4000	4000	-3726
chr18	11881685	11889685	11884161	8000	11885685	-4000	4000	-1524
chr18	3062807	3070807	3067228	8000	3066807	-4000	4000	421
chr18	74069353	74077353	74073521	8000	74073353	-4000	4000	168
chr18	24131610	24139610	24132532	8000	24135610	-4000	4000	-3078
chr18	26450910	26458910	26455846	8000	26454910	-4000	4000	936
chr18	59900305	59908305	59903296	8000	59904305	-4000	4000	-1009
chr18	210629	218629	213498	8000	214629	-4000	4000	-1131
chr18	12125764	12133764	12126075	8000	12129764	-4000	4000	-3689
chr18	80153232	80161232	80159825	8000	80157232	-4000	4000	2593
chr18	54897509	54905509	54904224	8000	54901509	-4000	4000	2715
chr18	24475961	24483961	24476841	8000	24479961	-4000	4000	-3120
chr18	80153232	80161232	80160129	8000	80157232	-4000	4000	2897
chr18	75061671	75069671	75064000	8000	75065671	-4000	4000	-1671
chr18	63119346	63127346	63124915	8000	63123346	-4000	4000	1569
chr18	22409599	22417599	22415897	8000	22413599	-4000	4000	2298
chr18	75285950	75293950	75288363	8000	75289950	-4000	4000	-1587
chr18	31474702	31482702	31475724	8000	31478702	-4000	4000	-2978
chr18	31594833	31602833	31598585	8000	31598833	-4000	4000	-248
chr18	42739227	42747227	42743557	8000	42743227	-4000	4000	330
chr18	63722432	63730432	63723648	8000	63726432	-4000	4000	-2784
chr18	11881685	11889685	11884559	8000	11885685	-4000	4000	-1126
chr18	31410912	31418912	31411157	8000	31414912	-4000	4000	-3755
chr18	60367062	60375062	60371709	8000	60371062	-4000	4000	647
chr18	63722432	63730432	63723432	8000	63726432	-4000	4000	-3000
chr18	58982480	58990480	58984589	8000	58986480	-4000	4000	-1891
chr18	63932111	63940111	63934997	8000	63936111	-4000	4000	-1114
chr18	23952222	23960222	23954547	8000	23956222	-4000	4000	-1675
chr18	54147606	54155606	54154825	8000	54151606	-4000	4000	3219
chr18	9885275	9893275	9887954	8000	9889275	-4000	4000	-1321
chr18	51054144	51062144	51058190	8000	51058144	-4000	4000	46
chr18	63501085	63509085	63503375	8000	63505085	-4000	4000	-1710
chr18	75061671	75069671	75064100	8000	75065671	-4000	4000	-1571
chr18	33847100	33855100	33852932	8000	33851100	-4000	4000	1832
chr18	9534114	9542114	9535713	8000	9538114	-4000	4000	-2401
chr18	21866953	21874953	21869714	8000	21870953	-4000	4000	-1239
chr18	22198528	22206528	22201375	8000	22202528	-4000	4000	-1153
chr18	34887844	34895844	34891321	8000	34891844	-4000	4000	-523
chr18	75405476	75413476	75410282	8000	75409476	-4000	4000	806
chr18	31474702	31482702	31475721	8000	31478702	-4000	4000	-2981
chr18	11881685	11889685	11886610	8000	11885685	-4000	4000	925
chr18	12026877	12034877	12030416	8000	12030877	-4000	4000	-461
chr18	43263892	43271892	43270325	8000	43267892	-4000	4000	2433
chr18	72532680	72540680	72538678	8000	72536680	-4000	4000	1998
chr18	74430775	74438775	74436509	8000	74434775	-4000	4000	1734
chr18	5388381	5396381	5395095	8000	5392381	-4000	4000	2714
chr18	50727826	50735826	50729222	8000	50731826	-4000	4000	-2604
chr18	11881685	11889685	11885691	8000	11885685	-4000	4000	6
chr18	24157600	24165600	24165079	8000	24161600	-4000	4000	3479
chr18	5285019	5293019	5290726	8000	5289019	-4000	4000	1707
chr18	13878044	13886044	13884466	8000	13882044	-4000	4000	2422
chr18	12983536	12991536	12985312	8000	12987536	-4000	4000	-2224
chr18	12781478	12789478	12785901	8000	12785478	-4000	4000	423
chr18	3062807	3070807	3067398	8000	3066807	-4000	4000	591
chr18	75285950	75293950	75287723	8000	75289950	-4000	4000	-2227
chr18	47099478	47107478	47101095	8000	47103478	-4000	4000	-2383
chr18	3252236	3260236	3253903	8000	3256236	-4000	4000	-2333
chr18	3252236	3260236	3254035	8000	3256236	-4000	4000	-2201
chr18	12983536	12991536	12984037	8000	12987536	-4000	4000	-3499
chr18	35247058	35255058	35253367	8000	35251058	-4000	4000	2309
chr18	75061671	75069671	75063271	8000	75065671	-4000	4000	-2400
chr18	46262992	46270992	46264892	8000	46266992	-4000	4000	-2100
chr18	646334	654334	649917	8000	650334	-4000	4000	-417
chr18	50727826	50735826	50730599	8000	50731826	-4000	4000	-1227
chr18	47104188	47112188	47108660	8000	47108188	-4000	4000	472
chr18	50727826	50735826	50729282	8000	50731826	-4000	4000	-2544
chr18	75285950	75293950	75288256	8000	75289950	-4000	4000	-1694
chr18	75285950	75293950	75288448	8000	75289950	-4000	4000	-1502
chr18	210629	218629	216572	8000	214629	-4000	4000	1943
chr18	3455978	3463978	3458002	8000	3459978	-4000	4000	-1976
chr18	8635383	8643383	8638173	8000	8639383	-4000	4000	-1210
chr18	32120877	32128877	32124831	8000	32124877	-4000	4000	-46
chr18	35975286	35983286	35979026	8000	35979286	-4000	4000	-260
chr18	36104531	36112531	36109739	8000	36108531	-4000	4000	1208
chr18	51170550	51178550	51177533	8000	51174550	-4000	4000	2983
chr18	54595493	54603493	54597984	8000	54599493	-4000	4000	-1509
chr18	62976433	62984433	62979185	8000	62980433	-4000	4000	-1248
chr18	63565329	63573329	63566948	8000	63569329	-4000	4000	-2381
chr18	63633259	63641259	63639715	8000	63637259	-4000	4000	2456
chr18	79525325	79533325	79527246	8000	79529325	-4000	4000	-2079
chr18	36104531	36112531	36111113	8000	36108531	-4000	4000	2582
chr18	578114	586114	580508	8000	582114	-4000	4000	-1606
chr18	666318	674318	673017	8000	670318	-4000	4000	2699
chr18	2801017	2809017	2802694	8000	2805017	-4000	4000	-2323
chr18	3455978	3463978	3457417	8000	3459978	-4000	4000	-2561
chr18	6911716	6919716	6912104	8000	6915716	-4000	4000	-3612
chr18	13878044	13886044	13884452	8000	13882044	-4000	4000	2408
chr18	14850667	14858667	14852067	8000	14854667	-4000	4000	-2600
chr18	21646901	21654901	21651752	8000	21650901	-4000	4000	851
chr18	22409599	22417599	22415792	8000	22413599	-4000	4000	2193
chr18	23193144	23201144	23194453	8000	23197144	-4000	4000	-2691
chr18	24449531	24457531	24450802	8000	24453531	-4000	4000	-2729
chr18	31755584	31763584	31760124	8000	31759584	-4000	4000	540
chr18	45679688	45687688	45682508	8000	45683688	-4000	4000	-1180
chr18	45679688	45687688	45682671	8000	45683688	-4000	4000	-1017
chr18	57025811	57033811	57027030	8000	57029811	-4000	4000	-2781
chr18	57146410	57154410	57147583	8000	57150410	-4000	4000	-2827
chr18	59154832	59162832	59155885	8000	59158832	-4000	4000	-2947
chr18	63633259	63641259	63637784	8000	63637259	-4000	4000	525
chr18	63801376	63809376	63804651	8000	63805376	-4000	4000	-725
chr18	75285950	75293950	75287903	8000	75289950	-4000	4000	-2047
chr18	578114	586114	580977	8000	582114	-4000	4000	-1137
chr18	666318	674318	672986	8000	670318	-4000	4000	2668
chr18	58477247	58485247	58481821	8000	58481247	-4000	4000	574
chr18	13878044	13886044	13885000	8000	13882044	-4000	4000	2956
chr18	43263892	43271892	43270077	8000	43267892	-4000	4000	2185
chr18	8402861	8410861	8406135	8000	8406861	-4000	4000	-726
chr18	46262992	46270992	46266412	8000	46266992	-4000	4000	-580
chr18	57146410	57154410	57147517	8000	57150410	-4000	4000	-2893
chr18	7228044	7236044	7231501	8000	7232044	-4000	4000	-543
chr18	9130345	9138345	9134324	8000	9134345	-4000	4000	-21
chr18	24475961	24483961	24477522	8000	24479961	-4000	4000	-2439
chr18	47099478	47107478	47101049	8000	47103478	-4000	4000	-2429
chr18	54595493	54603493	54598129	8000	54599493	-4000	4000	-1364
chr18	13823323	13831323	13826449	8000	13827323	-4000	4000	-874
chr18	6911716	6919716	6912069	8000	6915716	-4000	4000	-3647
chr18	24131610	24139610	24132595	8000	24135610	-4000	4000	-3015
chr18	36268157	36276157	36268691	8000	36272157	-4000	4000	-3466
chr18	21525284	21533284	21530275	8000	21529284	-4000	4000	991
chr18	31545008	31553008	31546233	8000	31549008	-4000	4000	-2775
chr18	14850667	14858667	14852312	8000	14854667	-4000	4000	-2355
chr18	60367062	60375062	60371548	8000	60371062	-4000	4000	486
chr18	55218185	55226185	55225306	8000	55222185	-4000	4000	3121
chr18	75285950	75293950	75286655	8000	75289950	-4000	4000	-3295
chr18	60367062	60375062	60372131	8000	60371062	-4000	4000	1069
chr18	31755584	31763584	31760117	8000	31759584	-4000	4000	533
chr18	3274461	3282461	3277360	8000	3278461	-4000	4000	-1101
chr18	75405476	75413476	75410580	8000	75409476	-4000	4000	1104
chr18	5388381	5396381	5393275	8000	5392381	-4000	4000	894
chr18	69051189	69059189	69054074	8000	69055189	-4000	4000	-1115
chr18	12442512	12450512	12449607	8000	12446512	-4000	4000	3095
chr18	22409599	22417599	22415549	8000	22413599	-4000	4000	1950
chr18	75061671	75069671	75064002	8000	75065671	-4000	4000	-1669
chr18	62976433	62984433	62979042	8000	62980433	-4000	4000	-1391
chr18	74430775	74438775	74436602	8000	74434775	-4000	4000	1827
chr18	75285950	75293950	75287918	8000	75289950	-4000	4000	-2032
chr18	31410912	31418912	31411152	8000	31414912	-4000	4000	-3760
chr18	6937742	6945742	6943263	8000	6941742	-4000	4000	1521
chr18	36104531	36112531	36111162	8000	36108531	-4000	4000	2631
chr18	75285950	75293950	75286830	8000	75289950	-4000	4000	-3120
chr18	9885275	9893275	9888093	8000	9889275	-4000	4000	-1182
chr18	51170550	51178550	51176850	8000	51174550	-4000	4000	2300
chr18	59271156	59279156	59272499	8000	59275156	-4000	4000	-2657
chr18	57596656	57604656	57602357	8000	57600656	-4000	4000	1701
chr19	51326891	51334891	51334200	8000	51330891	-4000	4000	3309
chr19	54732632	54740632	54735283	8000	54736632	-4000	4000	-1349
chr19	35674483	35682483	35678247	8000	35678483	-4000	4000	-236
chr19	11780078	11788078	11781599	8000	11784078	-4000	4000	-2479
chr19	19508418	19516418	19516163	8000	19512418	-4000	4000	3745
chr19	37609749	37617749	37612682	8000	37613749	-4000	4000	-1067
chr19	44130822	44138822	44132903	8000	44134822	-4000	4000	-1919
chr19	44470428	44478428	44477772	8000	44474428	-4000	4000	3344
chr19	53939950	53947950	53942305	8000	53943950	-4000	4000	-1645
chr19	357747	365747	362223	8000	361747	-4000	4000	476
chr19	39266188	39274188	39268842	8000	39270188	-4000	4000	-1346
chr19	5452856	5460856	5455899	8000	5456856	-4000	4000	-957
chr19	5452856	5460856	5456088	8000	5456856	-4000	4000	-768
chr19	7724958	7732958	7729829	8000	7728958	-4000	4000	871
chr19	47516690	47524690	47521935	8000	47520690	-4000	4000	1245
chr19	22087480	22095480	22089086	8000	22091480	-4000	4000	-2394
chr19	15447624	15455624	15451808	8000	15451624	-4000	4000	184
chr19	34952354	34960354	34958450	8000	34956354	-4000	4000	2096
chr19	44325695	44333695	44328548	8000	44329695	-4000	4000	-1147
chr19	44325695	44333695	44329433	8000	44329695	-4000	4000	-262
chr19	35220800	35228800	35228074	8000	35224800	-4000	4000	3274
chr19	37692371	37700371	37698534	8000	37696371	-4000	4000	2163
chr19	52793408	52801408	52798859	8000	52797408	-4000	4000	1451
chr19	2914473	2922473	2918318	8000	2918473	-4000	4000	-155
chr19	8370370	8378370	8371373	8000	8374370	-4000	4000	-2997
chr19	18568220	18576220	18574947	8000	18572220	-4000	4000	2727
chr19	34941170	34949170	34943246	8000	34945170	-4000	4000	-1924
chr19	39294673	39302673	39298241	8000	39298673	-4000	4000	-432
chr19	43618368	43626368	43623342	8000	43622368	-4000	4000	974
chr19	43716021	43724021	43719669	8000	43720021	-4000	4000	-352
chr19	44130822	44138822	44132757	8000	44134822	-4000	4000	-2065
chr19	52414412	52422412	52416030	8000	52418412	-4000	4000	-2382
chr19	55009705	55017705	55014627	8000	55013705	-4000	4000	922
chr19	48716585	48724585	48716786	8000	48720585	-4000	4000	-3799
chr19	5452856	5460856	5455656	8000	5456856	-4000	4000	-1200
chr19	15658825	15666825	15659570	8000	15662825	-4000	4000	-3255
chr19	18203961	18211961	18211123	8000	18207961	-4000	4000	3162
chr19	56552808	56560808	56555731	8000	56556808	-4000	4000	-1077
chr19	4288232	4296232	4292538	8000	4292232	-4000	4000	306
chr19	34741378	34749378	34741520	8000	34745378	-4000	4000	-3858
chr19	38874555	38882555	38880889	8000	38878555	-4000	4000	2334
chr19	44083318	44091318	44086189	8000	44087318	-4000	4000	-1129
chr19	48633946	48641946	48640097	8000	48637946	-4000	4000	2151
chr19	52414412	52422412	52416248	8000	52418412	-4000	4000	-2164
chr19	52793408	52801408	52801145	8000	52797408	-4000	4000	3737
chr19	19248233	19256233	19248832	8000	19252233	-4000	4000	-3401
chr19	51987332	51995332	51993543	8000	51991332	-4000	4000	2211
chr19	50821289	50829289	50826682	8000	50825289	-4000	4000	1393
chr19	50902351	50910351	50909244	8000	50906351	-4000	4000	2893
chr19	11831216	11839216	11831411	8000	11835216	-4000	4000	-3805
chr19	11831216	11839216	11832199	8000	11835216	-4000	4000	-3017
chr19	41092195	41100195	41093672	8000	41096195	-4000	4000	-2523
chr19	2929218	2937218	2934683	8000	2933218	-4000	4000	1465
chr19	11805622	11813622	11807373	8000	11809622	-4000	4000	-2249
chr19	54506687	54514687	54508165	8000	54510687	-4000	4000	-2522
chr19	1035068	1043068	1041510	8000	1039068	-4000	4000	2442
chr19	35368962	35376962	35371562	8000	35372962	-4000	4000	-1400
chr19	52698813	52706813	52705377	8000	52702813	-4000	4000	2564
chr19	55177247	55185247	55181796	8000	55181247	-4000	4000	549
chr19	58453833	58461833	58454482	8000	58457833	-4000	4000	-3351
chr19	7898021	7906021	7899491	8000	7902021	-4000	4000	-2530
chr19	42194598	42202598	42199480	8000	42198598	-4000	4000	882
chr19	54506687	54514687	54508106	8000	54510687	-4000	4000	-2581
chr19	54749052	54757052	54752942	8000	54753052	-4000	4000	-110
chr19	10346529	10354529	10351107	8000	10350529	-4000	4000	578
chr19	44156313	44164313	44156627	8000	44160313	-4000	4000	-3686
chr19	41833074	41841074	41837328	8000	41837074	-4000	4000	254
chr19	8370370	8378370	8371245	8000	8374370	-4000	4000	-3125
chr19	42748686	42756686	42754393	8000	42752686	-4000	4000	1707
chr19	19706472	19714472	19712867	8000	19710472	-4000	4000	2395
chr19	43414597	43422597	43416382	8000	43418597	-4000	4000	-2215
chr19	52698813	52706813	52706565	8000	52702813	-4000	4000	3752
chr19	3590507	3598507	3591087	8000	3594507	-4000	4000	-3420
chr19	52109091	52117091	52116959	8000	52113091	-4000	4000	3868
chr19	14938448	14946448	14942064	8000	14942448	-4000	4000	-384
chr19	53062606	53070606	53070095	8000	53066606	-4000	4000	3489
chr19	57589890	57597890	57590017	8000	57593890	-4000	4000	-3873
chr19	57973076	57981076	57978313	8000	57977076	-4000	4000	1237
chr19	57973076	57981076	57979389	8000	57977076	-4000	4000	2313
chr19	49063397	49071397	49070638	8000	49067397	-4000	4000	3241
chr19	16813963	16821963	16815199	8000	16817963	-4000	4000	-2764
chr19	48440931	48448931	48441826	8000	48444931	-4000	4000	-3105
chr19	11831216	11839216	11832166	8000	11835216	-4000	4000	-3050
chr19	15725052	15733052	15729026	8000	15729052	-4000	4000	-26
chr19	57290069	57298069	57291548	8000	57294069	-4000	4000	-2521
chr19	5838888	5846888	5844130	8000	5842888	-4000	4000	1242
chr19	54634022	54642022	54636996	8000	54638022	-4000	4000	-1026
chr19	56371846	56379846	56377277	8000	56375846	-4000	4000	1431
chr19	3478804	3486804	3478911	8000	3482804	-4000	4000	-3893
chr19	8505678	8513678	8512413	8000	8509678	-4000	4000	2735
chr19	45909214	45917214	45914561	8000	45913214	-4000	4000	1347
chr19	54506687	54514687	54508119	8000	54510687	-4000	4000	-2568
chr19	49709731	49717731	49713479	8000	49713731	-4000	4000	-252
chr19	8516778	8524778	8522809	8000	8520778	-4000	4000	2031
chr19	49425401	49433401	49431382	8000	49429401	-4000	4000	1981
chr19	9110828	9118828	9114888	8000	9114828	-4000	4000	60
chr19	51708387	51716387	51714069	8000	51712387	-4000	4000	1682
chr19	35519367	35527367	35523500	8000	35523367	-4000	4000	133
chr19	57589890	57597890	57590919	8000	57593890	-4000	4000	-2971
chr19	8058660	8066660	8066098	8000	8062660	-4000	4000	3438
chr19	37126368	37134368	37128699	8000	37130368	-4000	4000	-1669
chr19	37407155	37415155	37413649	8000	37411155	-4000	4000	2494
chr19	38405051	38413051	38405380	8000	38409051	-4000	4000	-3671
chr19	49051793	49059793	49054913	8000	49055793	-4000	4000	-880
chr19	51018216	51026216	51022515	8000	51022216	-4000	4000	299
chr19	56552808	56560808	56555308	8000	56556808	-4000	4000	-1500
chr19	35900377	35908377	35904260	8000	35904377	-4000	4000	-117
chr19	51073495	51081495	51077937	8000	51077495	-4000	4000	442
chr19	8839340	8847340	8842684	8000	8843340	-4000	4000	-656
chr19	21384582	21392582	21386661	8000	21388582	-4000	4000	-1921
chr19	35165881	35173881	35169716	8000	35169881	-4000	4000	-165
chr19	41203539	41211539	41206601	8000	41207539	-4000	4000	-938
chr19	38813471	38821471	38817196	8000	38817471	-4000	4000	-275
chr19	52109091	52117091	52115458	8000	52113091	-4000	4000	2367
chr19	56552808	56560808	56555177	8000	56556808	-4000	4000	-1631
chr19	35483324	35491324	35487367	8000	35487324	-4000	4000	43
chr19	56657980	56665980	56664506	8000	56661980	-4000	4000	2526
chr19	10282615	10290615	10287604	8000	10286615	-4000	4000	989
chr19	8839340	8847340	8843250	8000	8843340	-4000	4000	-90
chr19	57589890	57597890	57591037	8000	57593890	-4000	4000	-2853
chr19	4886437	4894437	4891106	8000	4890437	-4000	4000	669
chr19	21056050	21064050	21057993	8000	21060050	-4000	4000	-2057
chr19	56057810	56065810	56058276	8000	56061810	-4000	4000	-3534
chr19	19641198	19649198	19645423	8000	19645198	-4000	4000	225
chr19	11805622	11813622	11806918	8000	11809622	-4000	4000	-2704
chr19	37880823	37888823	37886222	8000	37884823	-4000	4000	1399
chr19	5452856	5460856	5456642	8000	5456856	-4000	4000	-214
chr19	9184818	9192818	9186211	8000	9188818	-4000	4000	-2607
chr19	35368962	35376962	35371358	8000	35372962	-4000	4000	-1604
chr19	5826408	5834408	5832244	8000	5830408	-4000	4000	1836
chr19	9462355	9470355	9466699	8000	9466355	-4000	4000	344
chr19	5838888	5846888	5844449	8000	5842888	-4000	4000	1561
chr19	15693174	15701174	15696193	8000	15697174	-4000	4000	-981
chr19	15693174	15701174	15696498	8000	15697174	-4000	4000	-676
chr19	57936833	57944833	57941116	8000	57940833	-4000	4000	283
chr19	54036825	54044825	54041948	8000	54040825	-4000	4000	1123
chr19	23143221	23151221	23146560	8000	23147221	-4000	4000	-661
chr19	37692371	37700371	37698655	8000	37696371	-4000	4000	2284
chr19	46643551	46651551	46648511	8000	46647551	-4000	4000	960
chr19	6422037	6430037	6427152	8000	6426037	-4000	4000	1115
chr19	37177579	37185579	37185338	8000	37181579	-4000	4000	3759
chr19	48791062	48799062	48795235	8000	48795062	-4000	4000	173
chr19	11831216	11839216	11831808	8000	11835216	-4000	4000	-3408
chr19	54090668	54098668	54095969	8000	54094668	-4000	4000	1301
chr19	57150021	57158021	57154398	8000	57154021	-4000	4000	377
chr19	301573	309573	306631	8000	305573	-4000	4000	1058
chr19	2929218	2937218	2933702	8000	2933218	-4000	4000	484
chr19	2929218	2937218	2933849	8000	2933218	-4000	4000	631
chr19	5452856	5460856	5455975	8000	5456856	-4000	4000	-881
chr19	12754458	12762458	12755438	8000	12758458	-4000	4000	-3020
chr19	13957530	13965530	13963937	8000	13961530	-4000	4000	2407
chr19	14115512	14123512	14120465	8000	14119512	-4000	4000	953
chr19	15946350	15954350	15949639	8000	15950350	-4000	4000	-711
chr19	17245171	17253171	17251682	8000	17249171	-4000	4000	2511
chr19	19250756	19258756	19258662	8000	19254756	-4000	4000	3906
chr19	19272018	19280018	19277799	8000	19276018	-4000	4000	1781
chr19	34952354	34960354	34957801	8000	34956354	-4000	4000	1447
chr19	34952354	34960354	34957802	8000	34956354	-4000	4000	1448
chr19	38787754	38795754	38790764	8000	38791754	-4000	4000	-990
chr19	39504481	39512481	39505262	8000	39508481	-4000	4000	-3219
chr19	40389766	40397766	40395478	8000	40393766	-4000	4000	1712
chr19	43716021	43724021	43719223	8000	43720021	-4000	4000	-798
chr19	44325695	44333695	44328128	8000	44329695	-4000	4000	-1567
chr19	49522428	49530428	49524522	8000	49526428	-4000	4000	-1906
chr19	50902351	50910351	50908538	8000	50906351	-4000	4000	2187
chr19	50939303	50947303	50943572	8000	50943303	-4000	4000	269
chr19	51375909	51383909	51380220	8000	51379909	-4000	4000	311
chr19	55009705	55017705	55015063	8000	55013705	-4000	4000	1358
chr19	55759421	55767421	55763108	8000	55763421	-4000	4000	-313
chr19	56657980	56665980	56664700	8000	56661980	-4000	4000	2720
chr19	57675152	57683152	57676376	8000	57679152	-4000	4000	-2776
chr19	57973076	57981076	57974145	8000	57977076	-4000	4000	-2931
chr19	15447624	15455624	15454372	8000	15451624	-4000	4000	2748
chr19	43188702	43196702	43194444	8000	43192702	-4000	4000	1742
chr19	8318584	8326584	8321364	8000	8322584	-4000	4000	-1220
chr19	56770547	56778547	56775174	8000	56774547	-4000	4000	627
chr19	24125968	24133968	24127592	8000	24129968	-4000	4000	-2376
chr19	47516690	47524690	47521973	8000	47520690	-4000	4000	1283
chr19	51025092	51033092	51027571	8000	51029092	-4000	4000	-1521
chr19	40376439	40384439	40383885	8000	40380439	-4000	4000	3446
chr19	613221	621221	613253	8000	617221	-4000	4000	-3968
chr19	2914473	2922473	2917095	8000	2918473	-4000	4000	-1378
chr19	9184818	9192818	9186706	8000	9188818	-4000	4000	-2112
chr19	9849718	9857718	9854082	8000	9853718	-4000	4000	364
chr19	10482125	10490125	10486566	8000	10486125	-4000	4000	441
chr19	13759296	13767296	13766129	8000	13763296	-4000	4000	2833
chr19	14874203	14882203	14880514	8000	14878203	-4000	4000	2311
chr19	15658825	15666825	15659391	8000	15662825	-4000	4000	-3434
chr19	18667721	18675721	18669167	8000	18671721	-4000	4000	-2554
chr19	19248233	19256233	19249857	8000	19252233	-4000	4000	-2376
chr19	22175089	22183089	22180837	8000	22179089	-4000	4000	1748
chr19	24125968	24133968	24128024	8000	24129968	-4000	4000	-1944
chr19	34422168	34430168	34426157	8000	34426168	-4000	4000	-11
chr19	35795988	35803988	35800156	8000	35799988	-4000	4000	168
chr19	37692371	37700371	37699422	8000	37696371	-4000	4000	3051
chr19	39324353	39332353	39328621	8000	39328353	-4000	4000	268
chr19	40572464	40580464	40578163	8000	40576464	-4000	4000	1699
chr19	50617307	50625307	50625234	8000	50621307	-4000	4000	3927
chr19	52793408	52801408	52800209	8000	52797408	-4000	4000	2801
chr19	53062606	53070606	53069515	8000	53066606	-4000	4000	2909
chr19	53492255	53500255	53492901	8000	53496255	-4000	4000	-3354
chr19	53939950	53947950	53942235	8000	53943950	-4000	4000	-1715
chr19	54245421	54253421	54252522	8000	54249421	-4000	4000	3101
chr19	58079838	58087838	58086027	8000	58083838	-4000	4000	2189
chr19	58122248	58130248	58128052	8000	58126248	-4000	4000	1804
chr19	58122248	58130248	58128323	8000	58126248	-4000	4000	2075
chr19	19250756	19258756	19252153	8000	19254756	-4000	4000	-2603
chr19	53120072	53128072	53122498	8000	53124072	-4000	4000	-1574
chr19	41833074	41841074	41838094	8000	41837074	-4000	4000	1020
chr19	42898086	42906086	42903677	8000	42902086	-4000	4000	1591
chr19	51944759	51952759	51945013	8000	51948759	-4000	4000	-3746
chr19	57127926	57135926	57135906	8000	57131926	-4000	4000	3980
chr19	43908624	43916624	43914615	8000	43912624	-4000	4000	1991
chr19	8058660	8066660	8066113	8000	8062660	-4000	4000	3453
chr19	17245171	17253171	17251620	8000	17249171	-4000	4000	2449
chr19	52027378	52035378	52034272	8000	52031378	-4000	4000	2894
chr19	46616468	46624468	46621391	8000	46620468	-4000	4000	923
chr19	1776988	1784988	1783042	8000	1780988	-4000	4000	2054
chr19	4288232	4296232	4292692	8000	4292232	-4000	4000	460
chr19	19641198	19649198	19646209	8000	19645198	-4000	4000	1011
chr19	51944759	51952759	51945177	8000	51948759	-4000	4000	-3582
chr19	53352906	53360906	53353886	8000	53356906	-4000	4000	-3020
chr19	53903652	53911652	53904655	8000	53907652	-4000	4000	-2997
chr19	54810517	54818517	54814033	8000	54814517	-4000	4000	-484
chr19	47318066	47326066	47319969	8000	47322066	-4000	4000	-2097
chr19	49063397	49071397	49070259	8000	49067397	-4000	4000	2862
chr19	42082110	42090110	42089650	8000	42086110	-4000	4000	3540
chr19	49425401	49433401	49429513	8000	49429401	-4000	4000	112
chr19	36506687	36514687	36514268	8000	36510687	-4000	4000	3581
chr19	40389766	40397766	40396627	8000	40393766	-4000	4000	2861
chr19	43359172	43367172	43360321	8000	43363172	-4000	4000	-2851
chr19	51025092	51033092	51031928	8000	51029092	-4000	4000	2836
chr19	54780322	54788322	54786592	8000	54784322	-4000	4000	2270
chr19	55781397	55789397	55789327	8000	55785397	-4000	4000	3930
chr19	58122248	58130248	58128117	8000	58126248	-4000	4000	1869
chr19	58122248	58130248	58128852	8000	58126248	-4000	4000	2604
chr19	22387019	22395019	22391513	8000	22391019	-4000	4000	494
chr19	6579183	6587183	6586225	8000	6583183	-4000	4000	3042
chr19	29560551	29568551	29563897	8000	29564551	-4000	4000	-654
chr19	2507219	2515219	2514853	8000	2511219	-4000	4000	3634
chr19	18203961	18211961	18210936	8000	18207961	-4000	4000	2975
chr19	11805622	11813622	11806864	8000	11809622	-4000	4000	-2758
chr19	42424278	42432278	42426758	8000	42428278	-4000	4000	-1520
chr19	51384289	51392289	51387241	8000	51388289	-4000	4000	-1048
chr19	52414412	52422412	52415276	8000	52418412	-4000	4000	-3136
chr19	55360382	55368382	55362401	8000	55364382	-4000	4000	-1981
chr19	14049218	14057218	14054511	8000	14053218	-4000	4000	1293
chr19	35519367	35527367	35527250	8000	35523367	-4000	4000	3883
chr19	46462491	46470491	46469913	8000	46466491	-4000	4000	3422
chr19	54810517	54818517	54818401	8000	54814517	-4000	4000	3884
chr19	43359172	43367172	43362177	8000	43363172	-4000	4000	-995
chr19	47739134	47747134	47741325	8000	47743134	-4000	4000	-1809
chr19	2991179	2999179	2997729	8000	2995179	-4000	4000	2550
chr19	50821289	50829289	50826977	8000	50825289	-4000	4000	1688
chr19	22175089	22183089	22180747	8000	22179089	-4000	4000	1658
chr19	51987332	51995332	51993868	8000	51991332	-4000	4000	2536
chr19	19557707	19565707	19564986	8000	19561707	-4000	4000	3279
chr19	10508742	10516742	10514685	8000	10512742	-4000	4000	1943
chr19	44009924	44017924	44010641	8000	44013924	-4000	4000	-3283
chr19	12341944	12349944	12349508	8000	12345944	-4000	4000	3564
chr19	15946350	15954350	15949634	8000	15950350	-4000	4000	-716
chr19	24125968	24133968	24126327	8000	24129968	-4000	4000	-3641
chr19	34682397	34690397	34684637	8000	34686397	-4000	4000	-1760
chr19	39727255	39735255	39734399	8000	39731255	-4000	4000	3144
chr19	41092195	41100195	41095793	8000	41096195	-4000	4000	-402
chr19	43610498	43618498	43613603	8000	43614498	-4000	4000	-895
chr19	44105886	44113886	44107676	8000	44109886	-4000	4000	-2210
chr19	47797243	47805243	47801741	8000	47801243	-4000	4000	498
chr19	48876967	48884967	48881124	8000	48880967	-4000	4000	157
chr19	53231381	53239381	53237713	8000	53235381	-4000	4000	2332
chr19	57355898	57363898	57356783	8000	57359898	-4000	4000	-3115
chr19	11831216	11839216	11833278	8000	11835216	-4000	4000	-1938
chr19	6490319	6498319	6495383	8000	6494319	-4000	4000	1064
chr19	22387019	22395019	22392929	8000	22391019	-4000	4000	1910
chr19	36994700	37002700	36997455	8000	36998700	-4000	4000	-1245
chr19	37880823	37888823	37887039	8000	37884823	-4000	4000	2216
chr19	40389766	40397766	40394993	8000	40393766	-4000	4000	1227
chr19	41615015	41623015	41620233	8000	41619015	-4000	4000	1218
chr19	44470428	44478428	44477467	8000	44474428	-4000	4000	3039
chr19	49709731	49717731	49711877	8000	49713731	-4000	4000	-1854
chr19	52109091	52117091	52115742	8000	52113091	-4000	4000	2651
chr19	55705858	55713858	55711967	8000	55709858	-4000	4000	2109
chr19	56552808	56560808	56553783	8000	56556808	-4000	4000	-3025
chr19	54749052	54757052	54752615	8000	54753052	-4000	4000	-437
chr19	53262676	53270676	53266816	8000	53266676	-4000	4000	140
chr19	53352906	53360906	53354310	8000	53356906	-4000	4000	-2596
chr19	39705444	39713444	39706612	8000	39709444	-4000	4000	-2832
chr19	20946697	20954697	20949845	8000	20950697	-4000	4000	-852
chr19	52225518	52233518	52226046	8000	52229518	-4000	4000	-3472
chr19	9184818	9192818	9185806	8000	9188818	-4000	4000	-3012
chr19	12744323	12752323	12748024	8000	12748323	-4000	4000	-299
chr19	56657980	56665980	56664946	8000	56661980	-4000	4000	2966
chr19	7898021	7906021	7899515	8000	7902021	-4000	4000	-2506
chr19	57127926	57135926	57128886	8000	57131926	-4000	4000	-3040
chr19	50972468	50980468	50977535	8000	50976468	-4000	4000	1067
chr19	43359172	43367172	43360283	8000	43363172	-4000	4000	-2889
chr19	14049218	14057218	14053652	8000	14053218	-4000	4000	434
chr19	7724958	7732958	7730403	8000	7728958	-4000	4000	1445
chr19	51960340	51968340	51966069	8000	51964340	-4000	4000	1729
chr19	37126368	37134368	37128184	8000	37130368	-4000	4000	-2184
chr19	57973076	57981076	57978523	8000	57977076	-4000	4000	1447
chr19	30012612	30020612	30014925	8000	30016612	-4000	4000	-1687
chr19	51741172	51749172	51745898	8000	51745172	-4000	4000	726
chr19	56435325	56443325	56442645	8000	56439325	-4000	4000	3320
chr19	54269812	54277812	54274811	8000	54273812	-4000	4000	999
chr19	52793408	52801408	52799545	8000	52797408	-4000	4000	2137
chr19	54732632	54740632	54738518	8000	54736632	-4000	4000	1886
chr19	58050631	58058631	58053710	8000	58054631	-4000	4000	-921
chr19	9184818	9192818	9185859	8000	9188818	-4000	4000	-2959
chr19	2991179	2999179	2993574	8000	2995179	-4000	4000	-1605
chr19	23143221	23151221	23146697	8000	23147221	-4000	4000	-524
chr19	50815146	50823146	50820016	8000	50819146	-4000	4000	870
chr19	54997142	55005142	54997316	8000	55001142	-4000	4000	-3826
chr19	52414412	52422412	52416844	8000	52418412	-4000	4000	-1568
chr19	44470428	44478428	44476687	8000	44474428	-4000	4000	2259
chr19	48372377	48380377	48376120	8000	48376377	-4000	4000	-257
chr19	43188702	43196702	43194996	8000	43192702	-4000	4000	2294
chr19	49285638	49293638	49293273	8000	49289638	-4000	4000	3635
chr19	51008739	51016739	51014949	8000	51012739	-4000	4000	2210
chr19	57290069	57298069	57290716	8000	57294069	-4000	4000	-3353
chr19	23218755	23226755	23223757	8000	23222755	-4000	4000	1002
chr19	57954437	57962437	57958660	8000	57958437	-4000	4000	223
chr19	744329	752329	746627	8000	748329	-4000	4000	-1702
chr19	35022471	35030471	35023441	8000	35026471	-4000	4000	-3030
chr19	43188702	43196702	43193298	8000	43192702	-4000	4000	596
chr19	43868365	43876365	43873410	8000	43872365	-4000	4000	1045
chr19	56371846	56379846	56377055	8000	56375846	-4000	4000	1209
chr19	51486952	51494952	51491675	8000	51490952	-4000	4000	723
chr19	49709731	49717731	49711736	8000	49713731	-4000	4000	-1995
chr19	7954573	7962573	7959064	8000	7958573	-4000	4000	491
chr19	53576269	53584269	53577373	8000	53580269	-4000	4000	-2896
chr19	3800024	3808024	3806018	8000	3804024	-4000	4000	1994
chr19	35795988	35803988	35802234	8000	35799988	-4000	4000	2246
chr19	11975290	11983290	11979872	8000	11979290	-4000	4000	582
chr19	37389066	37397066	37389371	8000	37393066	-4000	4000	-3695
chr19	38904980	38912980	38905097	8000	38908980	-4000	4000	-3883
chr19	40218208	40226208	40222435	8000	40222208	-4000	4000	227
chr19	56657980	56665980	56664149	8000	56661980	-4000	4000	2169
chr19	36632618	36640618	36638834	8000	36636618	-4000	4000	2216
chr19	9110828	9118828	9115209	8000	9114828	-4000	4000	381
chr19	14946033	14954033	14950333	8000	14950033	-4000	4000	300
chr19	57127926	57135926	57130776	8000	57131926	-4000	4000	-1150
chr19	54303070	54311070	54307505	8000	54307070	-4000	4000	435
chr19	36632618	36640618	36639740	8000	36636618	-4000	4000	3122
chr19	44105886	44113886	44106509	8000	44109886	-4000	4000	-3377
chr19	44325695	44333695	44327434	8000	44329695	-4000	4000	-2261
chr19	17820780	17828780	17826683	8000	17824780	-4000	4000	1903
chr19	50427314	50435314	50428053	8000	50431314	-4000	4000	-3261
chr19	53062606	53070606	53070057	8000	53066606	-4000	4000	3451
chr19	15874023	15882023	15878611	8000	15878023	-4000	4000	588
chr19	52698813	52706813	52704531	8000	52702813	-4000	4000	1718
chr19	40389766	40397766	40395792	8000	40393766	-4000	4000	2026
chr19	40389766	40397766	40397002	8000	40393766	-4000	4000	3236
chr19	40389766	40397766	40397212	8000	40393766	-4000	4000	3446
chr19	5862171	5870171	5866748	8000	5866171	-4000	4000	577
chr19	9462355	9470355	9468118	8000	9466355	-4000	4000	1763
chr19	12313477	12321477	12319022	8000	12317477	-4000	4000	1545
chr19	11831216	11839216	11831933	8000	11835216	-4000	4000	-3283
chr19	14049218	14057218	14054475	8000	14053218	-4000	4000	1257
chr19	15447624	15455624	15448226	8000	15451624	-4000	4000	-3398
chr19	8058660	8066660	8066180	8000	8062660	-4000	4000	3520
chr19	8516778	8524778	8522729	8000	8520778	-4000	4000	1951
chr19	12642511	12650511	12646570	8000	12646511	-4000	4000	59
chr19	14938448	14946448	14942292	8000	14942448	-4000	4000	-156
chr19	19250756	19258756	19256791	8000	19254756	-4000	4000	2035
chr19	35150302	35158302	35155350	8000	35154302	-4000	4000	1048
chr19	36178276	36186276	36182814	8000	36182276	-4000	4000	538
chr19	47797243	47805243	47802760	8000	47801243	-4000	4000	1517
chr19	50902351	50910351	50908532	8000	50906351	-4000	4000	2181
chr19	55147767	55155767	55154172	8000	55151767	-4000	4000	2405
chr19	4886437	4894437	4891354	8000	4890437	-4000	4000	917
chr19	34952354	34960354	34959291	8000	34956354	-4000	4000	2937
chr19	36632618	36640618	36638889	8000	36636618	-4000	4000	2271
chr19	36632618	36640618	36638977	8000	36636618	-4000	4000	2359
chr19	36632618	36640618	36639236	8000	36636618	-4000	4000	2618
chr19	36632618	36640618	36639477	8000	36636618	-4000	4000	2859
chr19	42230583	42238583	42234588	8000	42234583	-4000	4000	5
chr19	51406020	51414020	51411051	8000	51410020	-4000	4000	1031
chr19	54090668	54098668	54095251	8000	54094668	-4000	4000	583
chr19	54269812	54277812	54276452	8000	54273812	-4000	4000	2640
chr19	8728160	8736160	8731813	8000	8732160	-4000	4000	-347
chr19	35750519	35758519	35752620	8000	35754519	-4000	4000	-1899
chr19	39198825	39206825	39200350	8000	39202825	-4000	4000	-2475
chr19	48111445	48119445	48117659	8000	48115445	-4000	4000	2214
chr19	49043638	49051638	49047644	8000	49047638	-4000	4000	6
chr19	5838888	5846888	5844351	8000	5842888	-4000	4000	1463
chr19	10482125	10490125	10486521	8000	10486125	-4000	4000	396
chr19	11975290	11983290	11978478	8000	11979290	-4000	4000	-812
chr19	13876757	13884757	13877515	8000	13880757	-4000	4000	-3242
chr19	54090668	54098668	54095272	8000	54094668	-4000	4000	604
chr19	15738343	15746343	15742037	8000	15742343	-4000	4000	-306
chr19	19706472	19714472	19711961	8000	19710472	-4000	4000	1489
chr19	52698813	52706813	52705030	8000	52702813	-4000	4000	2217
chr19	56185570	56193570	56190906	8000	56189570	-4000	4000	1336
chr19	38874555	38882555	38879175	8000	38878555	-4000	4000	620
chr19	54036825	54044825	54040865	8000	54040825	-4000	4000	40
chr19	57127926	57135926	57131507	8000	57131926	-4000	4000	-419
chr19	36178276	36186276	36182909	8000	36182276	-4000	4000	633
chr19	37609749	37617749	37612577	8000	37613749	-4000	4000	-1172
chr19	51486952	51494952	51491619	8000	51490952	-4000	4000	667
chr19	1776988	1784988	1784826	8000	1780988	-4000	4000	3838
chr19	47516690	47524690	47521984	8000	47520690	-4000	4000	1294
chr19	54780322	54788322	54783508	8000	54784322	-4000	4000	-814
chr19	11805622	11813622	11807581	8000	11809622	-4000	4000	-2041
chr19	11975290	11983290	11978929	8000	11979290	-4000	4000	-361
chr19	459346	467346	463919	8000	463346	-4000	4000	573
chr19	16888606	16896606	16890403	8000	16892606	-4000	4000	-2203
chr19	17820780	17828780	17826888	8000	17824780	-4000	4000	2108
chr19	21800946	21808946	21808658	8000	21804946	-4000	4000	3712
chr19	35519367	35527367	35523474	8000	35523367	-4000	4000	107
chr19	36178276	36186276	36183165	8000	36182276	-4000	4000	889
chr19	37609749	37617749	37611665	8000	37613749	-4000	4000	-2084
chr19	44325695	44333695	44327473	8000	44329695	-4000	4000	-2222
chr19	51446847	51454847	51454748	8000	51450847	-4000	4000	3901
chr19	57973076	57981076	57979248	8000	57977076	-4000	4000	2172
chr19	45791713	45799713	45796047	8000	45795713	-4000	4000	334
chr19	18203961	18211961	18211770	8000	18207961	-4000	4000	3809
chr19	38797671	38805671	38803582	8000	38801671	-4000	4000	1911
chr19	44105886	44113886	44107065	8000	44109886	-4000	4000	-2821
chr19	1776988	1784988	1782209	8000	1780988	-4000	4000	1221
chr19	1776988	1784988	1783123	8000	1780988	-4000	4000	2135
chr19	4288232	4296232	4290547	8000	4292232	-4000	4000	-1685
chr19	9122012	9130012	9126235	8000	9126012	-4000	4000	223
chr19	12664071	12672071	12668390	8000	12668071	-4000	4000	319
chr19	52698813	52706813	52704844	8000	52702813	-4000	4000	2031
chr19	55649161	55657161	55652683	8000	55653161	-4000	4000	-478
chr19	56657980	56665980	56664364	8000	56661980	-4000	4000	2384
chr19	15658825	15666825	15659445	8000	15662825	-4000	4000	-3380
chr19	56552808	56560808	56554751	8000	56556808	-4000	4000	-2057
chr19	56770547	56778547	56774836	8000	56774547	-4000	4000	289
chr19	15447624	15455624	15454810	8000	15451624	-4000	4000	3186
chr19	51708387	51716387	51714053	8000	51712387	-4000	4000	1666
chr19	5774734	5782734	5776294	8000	5778734	-4000	4000	-2440
chr19	9110828	9118828	9115415	8000	9114828	-4000	4000	587
chr19	15725052	15733052	15728204	8000	15729052	-4000	4000	-848
chr19	7765605	7773605	7766305	8000	7769605	-4000	4000	-3300
chr19	11831216	11839216	11832646	8000	11835216	-4000	4000	-2570
chr19	15800549	15808549	15807354	8000	15804549	-4000	4000	2805
chr19	52414412	52422412	52416857	8000	52418412	-4000	4000	-1555
chr19	54863207	54871207	54866546	8000	54867207	-4000	4000	-661
chr19	50856764	50864764	50858550	8000	50860764	-4000	4000	-2214
chr19	48633946	48641946	48639388	8000	48637946	-4000	4000	1442
chr19	48372377	48380377	48376184	8000	48376377	-4000	4000	-193
chr19	17809576	17817576	17816993	8000	17813576	-4000	4000	3417
chr19	10508742	10516742	10514420	8000	10512742	-4000	4000	1678
chr19	40389766	40397766	40396210	8000	40393766	-4000	4000	2444
chr19	47318066	47326066	47320471	8000	47322066	-4000	4000	-1595
chr19	48025383	48033383	48030370	8000	48029383	-4000	4000	987
chr19	54780322	54788322	54784020	8000	54784322	-4000	4000	-302
chr19	55009705	55017705	55014349	8000	55013705	-4000	4000	644
chr19	48701951	48709951	48703553	8000	48705951	-4000	4000	-2398
chr19	9408429	9416429	9413338	8000	9412429	-4000	4000	909
chr19	9408429	9416429	9413582	8000	9412429	-4000	4000	1153
chr19	9849718	9857718	9854248	8000	9853718	-4000	4000	530
chr19	12313477	12321477	12318419	8000	12317477	-4000	4000	942
chr19	21800946	21808946	21807657	8000	21804946	-4000	4000	2711
chr19	50815146	50823146	50821892	8000	50819146	-4000	4000	2746
chr19	52109091	52117091	52116126	8000	52113091	-4000	4000	3035
chr19	7898021	7906021	7899419	8000	7902021	-4000	4000	-2602
chr19	44083318	44091318	44085854	8000	44087318	-4000	4000	-1464
chr19	52149864	52157864	52157181	8000	52153864	-4000	4000	3317
chr19	52414412	52422412	52416050	8000	52418412	-4000	4000	-2362
chr19	19641198	19649198	19645423	8000	19645198	-4000	4000	225
chr19	54269812	54277812	54276966	8000	54273812	-4000	4000	3154
chr19	17891174	17899174	17893944	8000	17895174	-4000	4000	-1230
chr19	50306542	50314542	50307092	8000	50310542	-4000	4000	-3450
chr19	57290069	57298069	57292269	8000	57294069	-4000	4000	-1800
chr19	47839330	47847330	47839516	8000	47843330	-4000	4000	-3814
chr19	53257837	53265837	53259195	8000	53261837	-4000	4000	-2642
chr19	37880823	37888823	37886963	8000	37884823	-4000	4000	2140
chr19	50954631	50962631	50959107	8000	50958631	-4000	4000	476
chr19	35750519	35758519	35753180	8000	35754519	-4000	4000	-1339
chr19	14874203	14882203	14881221	8000	14878203	-4000	4000	3018
chr19	52793408	52801408	52800548	8000	52797408	-4000	4000	3140
chr19	54245421	54253421	54252923	8000	54249421	-4000	4000	3502
chr19	51944759	51952759	51944942	8000	51948759	-4000	4000	-3817
chr19	9408429	9416429	9413548	8000	9412429	-4000	4000	1119
chr19	8728160	8736160	8731406	8000	8732160	-4000	4000	-754
chr19	20196488	20204488	20197824	8000	20200488	-4000	4000	-2664
chr19	6490319	6498319	6495809	8000	6494319	-4000	4000	1490
chr19	38797671	38805671	38802067	8000	38801671	-4000	4000	396
chr19	58363618	58371618	58368969	8000	58367618	-4000	4000	1351
chr19	56657980	56665980	56663969	8000	56661980	-4000	4000	1989
chr19	43716021	43724021	43718845	8000	43720021	-4000	4000	-1176
chr19	51384289	51392289	51387242	8000	51388289	-4000	4000	-1047
chr19	42230583	42238583	42234635	8000	42234583	-4000	4000	52
chr19	10088338	10096338	10090008	8000	10092338	-4000	4000	-2330
chr19	11975290	11983290	11978946	8000	11979290	-4000	4000	-344
chr19	50856764	50864764	50859785	8000	50860764	-4000	4000	-979
chr19	11780078	11788078	11780410	8000	11784078	-4000	4000	-3668
chr19	15447624	15455624	15452797	8000	15451624	-4000	4000	1173
chr19	34398413	34406413	34399224	8000	34402413	-4000	4000	-3189
chr19	40376439	40384439	40379508	8000	40380439	-4000	4000	-931
chr19	42424278	42432278	42427261	8000	42428278	-4000	4000	-1017
chr19	46462491	46470491	46468513	8000	46466491	-4000	4000	2022
chr19	51265330	51273330	51265587	8000	51269330	-4000	4000	-3743
chr19	52698813	52706813	52704847	8000	52702813	-4000	4000	2034
chr19	2991179	2999179	2997748	8000	2995179	-4000	4000	2569
chr19	43610498	43618498	43613108	8000	43614498	-4000	4000	-1390
chr19	55147767	55155767	55154763	8000	55151767	-4000	4000	2996
chr19	36178276	36186276	36183601	8000	36182276	-4000	4000	1325
chr19	9408429	9416429	9413744	8000	9412429	-4000	4000	1315
chr19	46462491	46470491	46470131	8000	46466491	-4000	4000	3640
chr19	35734880	35742880	35737664	8000	35738880	-4000	4000	-1216
chr19	2228578	2236578	2233278	8000	2232578	-4000	4000	700
chr19	45498513	45506513	45499226	8000	45502513	-4000	4000	-3287
chr19	37692371	37700371	37698130	8000	37696371	-4000	4000	1759
chr19	12880422	12888422	12881115	8000	12884422	-4000	4000	-3307
chr19	17398939	17406939	17405464	8000	17402939	-4000	4000	2525
chr19	46339433	46347433	46339581	8000	46343433	-4000	4000	-3852
chr19	50972468	50980468	50977617	8000	50976468	-4000	4000	1149
chr19	53062606	53070606	53069540	8000	53066606	-4000	4000	2934
chr19	39294673	39302673	39298485	8000	39298673	-4000	4000	-188
chr19	15725052	15733052	15728737	8000	15729052	-4000	4000	-315
chr19	55360382	55368382	55362968	8000	55364382	-4000	4000	-1414
chr19	56185570	56193570	56191871	8000	56189570	-4000	4000	2301
chr19	48292457	48300457	48297543	8000	48296457	-4000	4000	1086
chr19	51987332	51995332	51992828	8000	51991332	-4000	4000	1496
chr19	52321922	52329922	52322328	8000	52325922	-4000	4000	-3594
chr19	37126368	37134368	37127912	8000	37130368	-4000	4000	-2456
chr19	47839330	47847330	47839743	8000	47843330	-4000	4000	-3587
chr19	56215670	56223670	56223637	8000	56219670	-4000	4000	3967
chr19	11831216	11839216	11833123	8000	11835216	-4000	4000	-2093
chr19	50721708	50729708	50723473	8000	50725708	-4000	4000	-2235
chr19	44325695	44333695	44327856	8000	44329695	-4000	4000	-1839
chr19	52698813	52706813	52704818	8000	52702813	-4000	4000	2005
chr19	52698813	52706813	52704381	8000	52702813	-4000	4000	1568
chr19	17820780	17828780	17826796	8000	17824780	-4000	4000	2016
chr19	14938448	14946448	14942424	8000	14942448	-4000	4000	-24
chr19	42397514	42405514	42402926	8000	42401514	-4000	4000	1412
chr19	43414597	43422597	43416221	8000	43418597	-4000	4000	-2376
chr19	49709731	49717731	49711982	8000	49713731	-4000	4000	-1749
chr19	32826509	32834509	32830611	8000	32830509	-4000	4000	102
chr19	49018953	49026953	49024016	8000	49022953	-4000	4000	1063
chr19	9184818	9192818	9186662	8000	9188818	-4000	4000	-2156
chr19	9462355	9470355	9468067	8000	9466355	-4000	4000	1712
chr19	15874023	15882023	15879832	8000	15878023	-4000	4000	1809
chr19	52414412	52422412	52415125	8000	52418412	-4000	4000	-3287
chr19	15800549	15808549	15808032	8000	15804549	-4000	4000	3483
chr19	43994326	44002326	43996229	8000	43998326	-4000	4000	-2097
chr19	45869797	45877797	45873097	8000	45873797	-4000	4000	-700
chr19	52149864	52157864	52155354	8000	52153864	-4000	4000	1490
chr19	44009924	44017924	44010302	8000	44013924	-4000	4000	-3622
chr19	49425401	49433401	49432614	8000	49429401	-4000	4000	3213
chr19	40376439	40384439	40383865	8000	40380439	-4000	4000	3426
chr19	52008765	52016765	52016620	8000	52012765	-4000	4000	3855
chr19	52414412	52422412	52415768	8000	52418412	-4000	4000	-2644
chr19	57127926	57135926	57135205	8000	57131926	-4000	4000	3279
chr19	1532046	1540046	1533985	8000	1536046	-4000	4000	-2061
chr19	12970760	12978760	12973405	8000	12974760	-4000	4000	-1355
chr19	54598381	54606381	54599358	8000	54602381	-4000	4000	-3023
chr19	54780322	54788322	54783685	8000	54784322	-4000	4000	-637
chr19	57589890	57597890	57591330	8000	57593890	-4000	4000	-2560
chr19	18203961	18211961	18211066	8000	18207961	-4000	4000	3105
chr19	38405051	38413051	38412944	8000	38409051	-4000	4000	3893
chr19	8576240	8584240	8577375	8000	8580240	-4000	4000	-2865
chr19	50821289	50829289	50826748	8000	50825289	-4000	4000	1459
chr19	44174381	44182381	44175471	8000	44178381	-4000	4000	-2910
chr19	11831216	11839216	11833021	8000	11835216	-4000	4000	-2195
chr19	44105886	44113886	44106294	8000	44109886	-4000	4000	-3592
chr19	57640041	57648041	57641902	8000	57644041	-4000	4000	-2139
chr19	4538593	4546593	4546236	8000	4542593	-4000	4000	3643
chr19	6579183	6587183	6586114	8000	6583183	-4000	4000	2931
chr19	11831216	11839216	11833703	8000	11835216	-4000	4000	-1513
chr19	14071062	14079062	14074273	8000	14075062	-4000	4000	-789
chr19	17549839	17557839	17551977	8000	17553839	-4000	4000	-1862
chr19	37407155	37415155	37414043	8000	37411155	-4000	4000	2888
chr19	44174381	44182381	44176782	8000	44178381	-4000	4000	-1599
chr19	51367606	51375606	51371656	8000	51371606	-4000	4000	50
chr19	54887420	54895420	54889883	8000	54891420	-4000	4000	-1537
chr19	56435325	56443325	56441443	8000	56439325	-4000	4000	2118
chr19	39107493	39115493	39110434	8000	39111493	-4000	4000	-1059
chr19	39603474	39611474	39604659	8000	39607474	-4000	4000	-2815
chr19	9408429	9416429	9413637	8000	9412429	-4000	4000	1208
chr19	15800549	15808549	15807638	8000	15804549	-4000	4000	3089
chr19	19250756	19258756	19258545	8000	19254756	-4000	4000	3789
chr19	13137147	13145147	13137326	8000	13141147	-4000	4000	-3821
chr19	22663671	22671671	22664163	8000	22667671	-4000	4000	-3508
chr19	2929218	2937218	2933698	8000	2933218	-4000	4000	480
chr19	17549839	17557839	17553520	8000	17553839	-4000	4000	-319
chr19	39294673	39302673	39298605	8000	39298673	-4000	4000	-68
chr19	44470428	44478428	44476617	8000	44474428	-4000	4000	2189
chr19	52027378	52035378	52034601	8000	52031378	-4000	4000	3223
chr19	54997142	55005142	55000845	8000	55001142	-4000	4000	-297
chr19	1477428	1485428	1482993	8000	1481428	-4000	4000	1565
chr19	48440931	48448931	48442209	8000	48444931	-4000	4000	-2722
chr19	49622439	49630439	49625192	8000	49626439	-4000	4000	-1247
chr19	6490319	6498319	6495765	8000	6494319	-4000	4000	1446
chr19	8370370	8378370	8371417	8000	8374370	-4000	4000	-2953
chr19	35734880	35742880	35738327	8000	35738880	-4000	4000	-553
chr19	43963709	43971709	43966489	8000	43967709	-4000	4000	-1220
chr19	9248625	9256625	9251366	8000	9252625	-4000	4000	-1259
chr19	6747530	6755530	6751226	8000	6751530	-4000	4000	-304
chr19	38797671	38805671	38801900	8000	38801671	-4000	4000	229
chr19	42920132	42928132	42926551	8000	42924132	-4000	4000	2419
chr19	50821289	50829289	50825753	8000	50825289	-4000	4000	464
chr19	43359172	43367172	43362242	8000	43363172	-4000	4000	-930
chr19	14027551	14035551	14032454	8000	14031551	-4000	4000	903
chr19	43188702	43196702	43195226	8000	43192702	-4000	4000	2524
chr19	301573	309573	307133	8000	305573	-4000	4000	1560
chr19	57127926	57135926	57131399	8000	57131926	-4000	4000	-527
chr19	40389766	40397766	40395217	8000	40393766	-4000	4000	1451
chr19	39705444	39713444	39705967	8000	39709444	-4000	4000	-3477
chr19	49522428	49530428	49525408	8000	49526428	-4000	4000	-1020
chr19	50512892	50520892	50518454	8000	50516892	-4000	4000	1562
chr19	15447624	15455624	15448363	8000	15451624	-4000	4000	-3261
chr19	49709731	49717731	49710536	8000	49713731	-4000	4000	-3195
chr19	53789741	53797741	53795895	8000	53793741	-4000	4000	2154
chr19	53576269	53584269	53577814	8000	53580269	-4000	4000	-2455
chr19	39705444	39713444	39709236	8000	39709444	-4000	4000	-208
chr19	45498513	45506513	45499661	8000	45502513	-4000	4000	-2852
chr19	55009705	55017705	55014890	8000	55013705	-4000	4000	1185
chr19	11361698	11369698	11364753	8000	11365698	-4000	4000	-945
chr19	37407155	37415155	37413353	8000	37411155	-4000	4000	2198
chr19	47797243	47805243	47802965	8000	47801243	-4000	4000	1722
chr19	51326891	51334891	51328692	8000	51330891	-4000	4000	-2199
chr19	56435325	56443325	56442289	8000	56439325	-4000	4000	2964
chr19	38366943	38374943	38370616	8000	38370943	-4000	4000	-327
chr19	56185570	56193570	56191899	8000	56189570	-4000	4000	2329
chr19	21287160	21295160	21294672	8000	21291160	-4000	4000	3512
chr19	39294673	39302673	39298232	8000	39298673	-4000	4000	-441
chr19	39294673	39302673	39298576	8000	39298673	-4000	4000	-97
chr19	41877372	41885372	41879597	8000	41881372	-4000	4000	-1775
chr19	57749575	57757575	57756969	8000	57753575	-4000	4000	3394
chr19	14874203	14882203	14880559	8000	14878203	-4000	4000	2356
chr19	13876757	13884757	13880470	8000	13880757	-4000	4000	-287
chr19	8693400	8701400	8698235	8000	8697400	-4000	4000	835
chr19	39859323	39867323	39866882	8000	39863323	-4000	4000	3559
chr19	37609749	37617749	37612346	8000	37613749	-4000	4000	-1403
chr19	7765605	7773605	7767720	8000	7769605	-4000	4000	-1885
chr19	48025383	48033383	48030430	8000	48029383	-4000	4000	1047
chr19	55308562	55316562	55308647	8000	55312562	-4000	4000	-3915
chr19	8516778	8524778	8521228	8000	8520778	-4000	4000	450
chr19	9091669	9099669	9093748	8000	9095669	-4000	4000	-1921
chr19	9091669	9099669	9093894	8000	9095669	-4000	4000	-1775
chr19	36994700	37002700	36997267	8000	36998700	-4000	4000	-1433
chr19	40389766	40397766	40394943	8000	40393766	-4000	4000	1177
chr19	48754333	48762333	48756146	8000	48758333	-4000	4000	-2187
chr19	49018953	49026953	49022962	8000	49022953	-4000	4000	9
chr19	52698813	52706813	52705571	8000	52702813	-4000	4000	2758
chr19	53062606	53070606	53068836	8000	53066606	-4000	4000	2230
chr19	11717265	11725265	11722091	8000	11721265	-4000	4000	826
chr19	13926879	13934879	13929414	8000	13930879	-4000	4000	-1465
chr19	51341169	51349169	51347006	8000	51345169	-4000	4000	1837
chr19	53576269	53584269	53577688	8000	53580269	-4000	4000	-2581
chr19	53576269	53584269	53577689	8000	53580269	-4000	4000	-2580
chr19	18203961	18211961	18211190	8000	18207961	-4000	4000	3229
chr19	22175089	22183089	22180184	8000	22179089	-4000	4000	1095
chr19	34586644	34594644	34593498	8000	34590644	-4000	4000	2854
chr19	39603474	39611474	39604624	8000	39607474	-4000	4000	-2850
chr19	42374769	42382769	42376063	8000	42378769	-4000	4000	-2706
chr19	48701951	48709951	48703616	8000	48705951	-4000	4000	-2335
chr19	54780322	54788322	54788211	8000	54784322	-4000	4000	3889
chr19	56185570	56193570	56192984	8000	56189570	-4000	4000	3414
chr19	58363618	58371618	58368538	8000	58367618	-4000	4000	920
chr19	42748686	42756686	42754268	8000	42752686	-4000	4000	1582
chr19	53231381	53239381	53238075	8000	53235381	-4000	4000	2694
chr19	32583453	32591453	32586076	8000	32587453	-4000	4000	-1377
chr19	42862464	42870464	42869025	8000	42866464	-4000	4000	2561
chr19	43716021	43724021	43719213	8000	43720021	-4000	4000	-808
chr19	52363778	52371778	52366374	8000	52367778	-4000	4000	-1404
chr19	54863207	54871207	54865909	8000	54867207	-4000	4000	-1298
chr19	9248625	9256625	9251358	8000	9252625	-4000	4000	-1267
chr19	50972468	50980468	50980458	8000	50976468	-4000	4000	3990
chr19	50507600	50515600	50513771	8000	50511600	-4000	4000	2171
chr19	9462355	9470355	9466843	8000	9466355	-4000	4000	488
chr19	58453833	58461833	58455806	8000	58457833	-4000	4000	-2027
chr19	19250756	19258756	19258728	8000	19254756	-4000	4000	3972
chr19	35368962	35376962	35371403	8000	35372962	-4000	4000	-1559
chr19	38591273	38599273	38597540	8000	38595273	-4000	4000	2267
chr19	51018216	51026216	51023095	8000	51022216	-4000	4000	879
chr19	49043638	49051638	49044046	8000	49047638	-4000	4000	-3592
chr19	2832735	2840735	2834044	8000	2836735	-4000	4000	-2691
chr19	9184818	9192818	9188548	8000	9188818	-4000	4000	-270
chr19	48633946	48641946	48635348	8000	48637946	-4000	4000	-2598
chr19	49418419	49426419	49423322	8000	49422419	-4000	4000	903
chr19	53012123	53020123	53014508	8000	53016123	-4000	4000	-1615
chr19	52698813	52706813	52704413	8000	52702813	-4000	4000	1600
chr19	9096407	9104407	9102719	8000	9100407	-4000	4000	2312
chr19	4834341	4842341	4839167	8000	4838341	-4000	4000	826
chr19	6936459	6944459	6937645	8000	6940459	-4000	4000	-2814
chr19	7765605	7773605	7768858	8000	7769605	-4000	4000	-747
chr19	12341944	12349944	12349904	8000	12345944	-4000	4000	3960
chr19	17288131	17296131	17294350	8000	17292131	-4000	4000	2219
chr19	17784568	17792568	17784809	8000	17788568	-4000	4000	-3759
chr19	34741378	34749378	34741452	8000	34745378	-4000	4000	-3926
chr19	34754073	34762073	34759582	8000	34758073	-4000	4000	1509
chr19	58122248	58130248	58128782	8000	58126248	-4000	4000	2534
chr19	9378617	9386617	9381784	8000	9382617	-4000	4000	-833
chr19	48708725	48716725	48713738	8000	48712725	-4000	4000	1013
chr19	50512892	50520892	50518894	8000	50516892	-4000	4000	2002
chr19	50507600	50515600	50513012	8000	50511600	-4000	4000	1412
chr19	54586287	54594287	54594200	8000	54590287	-4000	4000	3913
chr19	49972468	49980468	49979141	8000	49976468	-4000	4000	2673
chr19	52321922	52329922	52322928	8000	52325922	-4000	4000	-2994
chr19	53062606	53070606	53068325	8000	53066606	-4000	4000	1719
chr19	53062606	53070606	53070210	8000	53066606	-4000	4000	3604
chr19	43618368	43626368	43623219	8000	43622368	-4000	4000	851
chr19	5862171	5870171	5867528	8000	5866171	-4000	4000	1357
chr19	3590507	3598507	3592207	8000	3594507	-4000	4000	-2300
chr19	4288232	4296232	4292735	8000	4292232	-4000	4000	503
chr19	7557764	7565764	7561697	8000	7561764	-4000	4000	-67
chr19	9184818	9192818	9186511	8000	9188818	-4000	4000	-2307
chr19	9378617	9386617	9380848	8000	9382617	-4000	4000	-1769
chr19	13876757	13884757	13880472	8000	13880757	-4000	4000	-285
chr19	13876757	13884757	13880595	8000	13880757	-4000	4000	-162
chr19	14071062	14079062	14074518	8000	14075062	-4000	4000	-544
chr19	15946350	15954350	15949224	8000	15950350	-4000	4000	-1126
chr19	19706472	19714472	19711456	8000	19710472	-4000	4000	984
chr19	32825580	32833580	32826137	8000	32829580	-4000	4000	-3443
chr19	34682397	34690397	34684678	8000	34686397	-4000	4000	-1719
chr19	37609749	37617749	37611836	8000	37613749	-4000	4000	-1913
chr19	39859323	39867323	39863714	8000	39863323	-4000	4000	391
chr19	44174381	44182381	44176574	8000	44178381	-4000	4000	-1807
chr19	44325695	44333695	44328028	8000	44329695	-4000	4000	-1667
chr19	47739134	47747134	47740914	8000	47743134	-4000	4000	-2220
chr19	51018216	51026216	51023184	8000	51022216	-4000	4000	968
chr19	52027378	52035378	52034767	8000	52031378	-4000	4000	3389
chr19	54732632	54740632	54735330	8000	54736632	-4000	4000	-1302
chr19	57127926	57135926	57129960	8000	57131926	-4000	4000	-1966
chr19	58050631	58058631	58052610	8000	58054631	-4000	4000	-2021
chr19	58363618	58371618	58367755	8000	58367618	-4000	4000	137
chr19	19508418	19516418	19516159	8000	19512418	-4000	4000	3741
chr19	49043638	49051638	49048827	8000	49047638	-4000	4000	1189
chr19	2929218	2937218	2933363	8000	2933218	-4000	4000	145
chr19	53062606	53070606	53068661	8000	53066606	-4000	4000	2055
chr19	11780078	11788078	11781340	8000	11784078	-4000	4000	-2738
chr19	14071062	14079062	14074436	8000	14075062	-4000	4000	-626
chr19	45302413	45310413	45307488	8000	45306413	-4000	4000	1075
chr19	50507600	50515600	50512233	8000	50511600	-4000	4000	633
chr19	54506687	54514687	54510627	8000	54510687	-4000	4000	-60
chr19	44156313	44164313	44156759	8000	44160313	-4000	4000	-3554
chr19	18438663	18446663	18446379	8000	18442663	-4000	4000	3716
chr19	47516690	47524690	47521241	8000	47520690	-4000	4000	551
chr19	16475067	16483067	16482684	8000	16479067	-4000	4000	3617
chr19	47001077	47009077	47004730	8000	47005077	-4000	4000	-347
chr19	47318066	47326066	47320141	8000	47322066	-4000	4000	-1925
chr19	57127926	57135926	57129535	8000	57131926	-4000	4000	-2391
chr19	5452856	5460856	5455844	8000	5456856	-4000	4000	-1012
chr19	17809576	17817576	17816833	8000	17813576	-4000	4000	3257
chr19	41833074	41841074	41837123	8000	41837074	-4000	4000	49
chr19	7765605	7773605	7767369	8000	7769605	-4000	4000	-2236
chr19	7765605	7773605	7768896	8000	7769605	-4000	4000	-709
chr19	11780078	11788078	11780192	8000	11784078	-4000	4000	-3886
chr19	15658825	15666825	15659289	8000	15662825	-4000	4000	-3536
chr19	17288131	17296131	17292774	8000	17292131	-4000	4000	643
chr19	21056050	21064050	21057291	8000	21060050	-4000	4000	-2759
chr19	22175089	22183089	22181488	8000	22179089	-4000	4000	2399
chr19	35368962	35376962	35372022	8000	35372962	-4000	4000	-940
chr19	36178276	36186276	36182492	8000	36182276	-4000	4000	216
chr19	42898086	42906086	42902417	8000	42902086	-4000	4000	331
chr19	48633946	48641946	48639338	8000	48637946	-4000	4000	1392
chr19	48633946	48641946	48640207	8000	48637946	-4000	4000	2261
chr19	51606960	51614960	51612370	8000	51610960	-4000	4000	1410
chr19	55009705	55017705	55014468	8000	55013705	-4000	4000	763
chr19	55147767	55155767	55151842	8000	55151767	-4000	4000	75
chr19	58209562	58217562	58212831	8000	58213562	-4000	4000	-731
chr19	58453833	58461833	58455521	8000	58457833	-4000	4000	-2312
chr19	15725052	15733052	15728526	8000	15729052	-4000	4000	-526
chr19	10482125	10490125	10489834	8000	10486125	-4000	4000	3709
chr19	51073495	51081495	51078152	8000	51077495	-4000	4000	657
chr19	54245421	54253421	54252426	8000	54249421	-4000	4000	3005
chr19	55670716	55678716	55677704	8000	55674716	-4000	4000	2988
chr19	58122248	58130248	58128502	8000	58126248	-4000	4000	2254
chr19	6422037	6430037	6426434	8000	6426037	-4000	4000	397
chr19	9110828	9118828	9115136	8000	9114828	-4000	4000	308
chr19	9110828	9118828	9115359	8000	9114828	-4000	4000	531
chr19	9378617	9386617	9381422	8000	9382617	-4000	4000	-1195
chr19	11615161	11623161	11616782	8000	11619161	-4000	4000	-2379
chr19	12074106	12082106	12076266	8000	12078106	-4000	4000	-1840
chr19	12642511	12650511	12646648	8000	12646511	-4000	4000	137
chr19	13759296	13767296	13764561	8000	13763296	-4000	4000	1265
chr19	15693174	15701174	15696929	8000	15697174	-4000	4000	-245
chr19	33204864	33212864	33210482	8000	33208864	-4000	4000	1618
chr19	34586644	34594644	34594241	8000	34590644	-4000	4000	3597
chr19	34682397	34690397	34684016	8000	34686397	-4000	4000	-2381
chr19	37880823	37888823	37887592	8000	37884823	-4000	4000	2769
chr19	39504481	39512481	39505505	8000	39508481	-4000	4000	-2976
chr19	39727255	39735255	39731398	8000	39731255	-4000	4000	143
chr19	40572464	40580464	40576060	8000	40576464	-4000	4000	-404
chr19	40572464	40580464	40577299	8000	40576464	-4000	4000	835
chr19	44130822	44138822	44131278	8000	44134822	-4000	4000	-3544
chr19	44945565	44953565	44948775	8000	44949565	-4000	4000	-790
chr19	49669916	49677916	49677280	8000	49673916	-4000	4000	3364
chr19	51132651	51140651	51136075	8000	51136651	-4000	4000	-576
chr19	53012123	53020123	53015356	8000	53016123	-4000	4000	-767
chr19	53789741	53797741	53794004	8000	53793741	-4000	4000	263
chr19	53903652	53911652	53906365	8000	53907652	-4000	4000	-1287
chr19	56435325	56443325	56442633	8000	56439325	-4000	4000	3308
chr19	57258728	57266728	57261744	8000	57262728	-4000	4000	-984
chr19	58453833	58461833	58455763	8000	58457833	-4000	4000	-2070
chr19	45403334	45411334	45409608	8000	45407334	-4000	4000	2274
chr19	14946033	14954033	14953000	8000	14950033	-4000	4000	2967
chr19	36178276	36186276	36182594	8000	36182276	-4000	4000	318
chr19	9462355	9470355	9467256	8000	9466355	-4000	4000	901
chr19	15800549	15808549	15807964	8000	15804549	-4000	4000	3415
chr19	34351566	34359566	34352814	8000	34355566	-4000	4000	-2752
chr19	34754073	34762073	34759057	8000	34758073	-4000	4000	984
chr19	38874555	38882555	38881151	8000	38878555	-4000	4000	2596
chr19	39294673	39302673	39296861	8000	39298673	-4000	4000	-1812
chr19	43060209	43068209	43066601	8000	43064209	-4000	4000	2392
chr19	48283608	48291608	48286849	8000	48287608	-4000	4000	-759
chr19	48633946	48641946	48638982	8000	48637946	-4000	4000	1036
chr19	55154661	55162661	55157102	8000	55158661	-4000	4000	-1559
chr19	4265088	4273088	4268645	8000	4269088	-4000	4000	-443
chr19	55167196	55175196	55174547	8000	55171196	-4000	4000	3351
chr19	57450790	57458790	57455547	8000	57454790	-4000	4000	757
chr19	58551712	58559712	58556117	8000	58555712	-4000	4000	405
chr19	29560551	29568551	29563851	8000	29564551	-4000	4000	-700
chr19	51367606	51375606	51372601	8000	51371606	-4000	4000	995
chr19	11462240	11470240	11466744	8000	11466240	-4000	4000	504
chr19	39603474	39611474	39605335	8000	39607474	-4000	4000	-2139
chr19	51944759	51952759	51945707	8000	51948759	-4000	4000	-3052
chr19	54245421	54253421	54252021	8000	54249421	-4000	4000	2600
chr19	39324353	39332353	39328406	8000	39328353	-4000	4000	53
chr19	11372951	11380951	11375752	8000	11376951	-4000	4000	-1199
chr19	32826509	32834509	32830523	8000	32830509	-4000	4000	14
chr19	29820312	29828312	29822550	8000	29824312	-4000	4000	-1762
chr19	32593006	32601006	32600044	8000	32597006	-4000	4000	3038
chr19	50512892	50520892	50517551	8000	50516892	-4000	4000	659
chr19	8058660	8066660	8062307	8000	8062660	-4000	4000	-353
chr19	36909029	36917029	36916070	8000	36913029	-4000	4000	3041
chr19	58363618	58371618	58368542	8000	58367618	-4000	4000	924
chr19	12074106	12082106	12077262	8000	12078106	-4000	4000	-844
chr19	29820312	29828312	29822588	8000	29824312	-4000	4000	-1724
chr19	53257837	53265837	53259135	8000	53261837	-4000	4000	-2702
chr19	55769420	55777420	55772836	8000	55773420	-4000	4000	-584
chr19	4671224	4679224	4675342	8000	4675224	-4000	4000	118
chr19	2832735	2840735	2834361	8000	2836735	-4000	4000	-2374
chr19	35343361	35351361	35345653	8000	35347361	-4000	4000	-1708
chr19	22175089	22183089	22180460	8000	22179089	-4000	4000	1371
chr19	29201320	29209320	29207587	8000	29205320	-4000	4000	2267
chr19	15800549	15808549	15807046	8000	15804549	-4000	4000	2497
chr19	42306814	42314814	42309679	8000	42310814	-4000	4000	-1135
chr19	56770547	56778547	56775402	8000	56774547	-4000	4000	855
chr19	36632618	36640618	36639774	8000	36636618	-4000	4000	3156
chr19	22663671	22671671	22664712	8000	22667671	-4000	4000	-2959
chr19	42230583	42238583	42234587	8000	42234583	-4000	4000	4
chr19	54634022	54642022	54635707	8000	54638022	-4000	4000	-2315
chr19	15874023	15882023	15878871	8000	15878023	-4000	4000	848
chr19	11372951	11380951	11375549	8000	11376951	-4000	4000	-1402
chr19	11831216	11839216	11832416	8000	11835216	-4000	4000	-2800
chr19	19890674	19898674	19891562	8000	19894674	-4000	4000	-3112
chr19	43188702	43196702	43193262	8000	43192702	-4000	4000	560
chr19	48283608	48291608	48286928	8000	48287608	-4000	4000	-680
chr19	51341169	51349169	51345252	8000	51345169	-4000	4000	83
chr19	54887420	54895420	54888135	8000	54891420	-4000	4000	-3285
chr19	47839330	47847330	47839731	8000	47843330	-4000	4000	-3599
chr19	9122012	9130012	9126806	8000	9126012	-4000	4000	794
chr19	9248625	9256625	9251985	8000	9252625	-4000	4000	-640
chr19	11780078	11788078	11780794	8000	11784078	-4000	4000	-3284
chr19	18568220	18576220	18569346	8000	18572220	-4000	4000	-2874
chr19	36178276	36186276	36183460	8000	36182276	-4000	4000	1184
chr19	54634022	54642022	54635101	8000	54638022	-4000	4000	-2921
chr19	15447624	15455624	15454260	8000	15451624	-4000	4000	2636
chr19	58050631	58058631	58052507	8000	58054631	-4000	4000	-2124
chr19	48043843	48051843	48048243	8000	48047843	-4000	4000	400
chr19	10292778	10300778	10293695	8000	10296778	-4000	4000	-3083
chr19	35356489	35364489	35358908	8000	35360489	-4000	4000	-1581
chr19	53262676	53270676	53267366	8000	53266676	-4000	4000	690
chr19	8839340	8847340	8843144	8000	8843340	-4000	4000	-196
chr19	13876757	13884757	13882831	8000	13880757	-4000	4000	2074
chr19	34754073	34762073	34760550	8000	34758073	-4000	4000	2477
chr19	15946350	15954350	15949595	8000	15950350	-4000	4000	-755
chr19	34941170	34949170	34944489	8000	34945170	-4000	4000	-681
chr19	36178276	36186276	36182797	8000	36182276	-4000	4000	521
chr19	39302566	39310566	39307787	8000	39306566	-4000	4000	1221
chr19	50856764	50864764	50859803	8000	50860764	-4000	4000	-961
chr19	11615161	11623161	11617740	8000	11619161	-4000	4000	-1421
chr19	43550692	43558692	43551580	8000	43554692	-4000	4000	-3112
chr19	51446847	51454847	51454757	8000	51450847	-4000	4000	3910
chr19	1776988	1784988	1784856	8000	1780988	-4000	4000	3868
chr19	15800549	15808549	15807421	8000	15804549	-4000	4000	2872
chr19	36632618	36640618	36638764	8000	36636618	-4000	4000	2146
chr19	44083318	44091318	44086626	8000	44087318	-4000	4000	-692
chr19	5452856	5460856	5456387	8000	5456856	-4000	4000	-469
chr19	49735753	49743753	49741934	8000	49739753	-4000	4000	2181
chr19	54347384	54355384	54355369	8000	54351384	-4000	4000	3985
chr19	14083851	14091851	14088519	8000	14087851	-4000	4000	668
chr19	15725052	15733052	15728156	8000	15729052	-4000	4000	-896
chr19	21718771	21726771	21726721	8000	21722771	-4000	4000	3950
chr19	41092195	41100195	41095812	8000	41096195	-4000	4000	-383
chr19	15946350	15954350	15949392	8000	15950350	-4000	4000	-958
chr19	46227243	46235243	46230157	8000	46231243	-4000	4000	-1086
chr19	36178276	36186276	36183000	8000	36182276	-4000	4000	724
chr19	38591273	38599273	38597441	8000	38595273	-4000	4000	2168
chr19	42862464	42870464	42867939	8000	42866464	-4000	4000	1475
chr19	53231381	53239381	53237194	8000	53235381	-4000	4000	1813
chr19	19141569	19149569	19146601	8000	19145569	-4000	4000	1032
chr19	40389766	40397766	40397287	8000	40393766	-4000	4000	3521
chr19	43456787	43464787	43461691	8000	43460787	-4000	4000	904
chr19	43848017	43856017	43848352	8000	43852017	-4000	4000	-3665
chr19	55009705	55017705	55014424	8000	55013705	-4000	4000	719
chr19	917005	925005	918593	8000	921005	-4000	4000	-2412
chr19	22663671	22671671	22664401	8000	22667671	-4000	4000	-3270
chr19	50512892	50520892	50518396	8000	50516892	-4000	4000	1504
chr19	5862171	5870171	5867303	8000	5866171	-4000	4000	1132
chr19	8516778	8524778	8521266	8000	8520778	-4000	4000	488
chr19	47378704	47386704	47380855	8000	47382704	-4000	4000	-1849
chr19	58428814	58436814	58434912	8000	58432814	-4000	4000	2098
chr19	52225518	52233518	52225807	8000	52229518	-4000	4000	-3711
chr19	8516778	8524778	8522715	8000	8520778	-4000	4000	1937
chr19	18568220	18576220	18575073	8000	18572220	-4000	4000	2853
chr19	2832735	2840735	2834254	8000	2836735	-4000	4000	-2481
chr19	18192784	18200784	18198826	8000	18196784	-4000	4000	2042
chr19	18192784	18200784	18200347	8000	18196784	-4000	4000	3563
chr19	22175089	22183089	22180733	8000	22179089	-4000	4000	1644
chr19	42306814	42314814	42314314	8000	42310814	-4000	4000	3500
chr19	43414597	43422597	43417927	8000	43418597	-4000	4000	-670
chr19	54329185	54337185	54333605	8000	54333185	-4000	4000	420
chr19	56657980	56665980	56665096	8000	56661980	-4000	4000	3116
chr19	4532402	4540402	4534054	8000	4536402	-4000	4000	-2348
chr19	21800946	21808946	21807653	8000	21804946	-4000	4000	2707
chr19	44470428	44478428	44477930	8000	44474428	-4000	4000	3502
chr19	51051626	51059626	51058624	8000	51055626	-4000	4000	2998
chr19	55649161	55657161	55651383	8000	55653161	-4000	4000	-1778
chr19	48633946	48641946	48638954	8000	48637946	-4000	4000	1008
chr19	51384289	51392289	51387201	8000	51388289	-4000	4000	-1088
chr19	47216822	47224822	47221866	8000	47220822	-4000	4000	1044
chr19	39782291	39790291	39784547	8000	39786291	-4000	4000	-1744
chr19	15231519	15239519	15238233	8000	15235519	-4000	4000	2714
chr19	22970883	22978883	22977099	8000	22974883	-4000	4000	2216
chr19	45403334	45411334	45409076	8000	45407334	-4000	4000	1742
chr19	53492255	53500255	53492264	8000	53496255	-4000	4000	-3991
chr19	54036825	54044825	54042190	8000	54040825	-4000	4000	1365
chr19	45869797	45877797	45872892	8000	45873797	-4000	4000	-905
chr19	51149526	51157526	51153153	8000	51153526	-4000	4000	-373
chr19	8728160	8736160	8731730	8000	8732160	-4000	4000	-430
chr19	51606960	51614960	51612243	8000	51610960	-4000	4000	1283
chr19	8516778	8524778	8522487	8000	8520778	-4000	4000	1709
chr19	49018953	49026953	49023993	8000	49022953	-4000	4000	1040
chr19	6422037	6430037	6426292	8000	6426037	-4000	4000	255
chr19	34586644	34594644	34594543	8000	34590644	-4000	4000	3899
chr19	55177247	55185247	55181654	8000	55181247	-4000	4000	407
chr19	57355898	57363898	57357807	8000	57359898	-4000	4000	-2091
chr19	11195295	11203295	11202599	8000	11199295	-4000	4000	3304
chr19	11615161	11623161	11616828	8000	11619161	-4000	4000	-2333
chr19	12313477	12321477	12318419	8000	12317477	-4000	4000	942
chr19	15946350	15954350	15949623	8000	15950350	-4000	4000	-727
chr19	42898086	42906086	42902187	8000	42902086	-4000	4000	101
chr19	50512892	50520892	50518289	8000	50516892	-4000	4000	1397
chr19	44083318	44091318	44086125	8000	44087318	-4000	4000	-1193
chr19	22087480	22095480	22089578	8000	22091480	-4000	4000	-1902
chr19	35120297	35128297	35125477	8000	35124297	-4000	4000	1180
chr19	44325695	44333695	44327926	8000	44329695	-4000	4000	-1769
chr19	15447624	15455624	15448268	8000	15451624	-4000	4000	-3356
chr19	49413990	49421990	49417412	8000	49417990	-4000	4000	-578
chr19	41952879	41960879	41958316	8000	41956879	-4000	4000	1437
chr19	55147767	55155767	55154173	8000	55151767	-4000	4000	2406
chr19	9184818	9192818	9186627	8000	9188818	-4000	4000	-2191
chr19	34225288	34233288	34228648	8000	34229288	-4000	4000	-640
chr19	35784822	35792822	35788401	8000	35788822	-4000	4000	-421
chr19	412589	420589	416932	8000	416589	-4000	4000	343
chr19	36994700	37002700	36997745	8000	36998700	-4000	4000	-955
chr19	42082110	42090110	42088775	8000	42086110	-4000	4000	2665
chr19	47001077	47009077	47004646	8000	47005077	-4000	4000	-431
chr19	47739134	47747134	47742867	8000	47743134	-4000	4000	-267
chr19	48292457	48300457	48297063	8000	48296457	-4000	4000	606
chr19	48633946	48641946	48639402	8000	48637946	-4000	4000	1456
chr19	35349862	35357862	35352158	8000	35353862	-4000	4000	-1704
chr19	44174381	44182381	44174785	8000	44178381	-4000	4000	-3596
chr19	58209562	58217562	58212769	8000	58213562	-4000	4000	-793
chr19	35784822	35792822	35785477	8000	35788822	-4000	4000	-3345
chr19	39239455	39247455	39244916	8000	39243455	-4000	4000	1461
chr19	39239455	39247455	39243675	8000	39243455	-4000	4000	220
chr19	57589890	57597890	57591293	8000	57593890	-4000	4000	-2597
chr19	15658825	15666825	15659365	8000	15662825	-4000	4000	-3460
chr19	50512892	50520892	50518351	8000	50516892	-4000	4000	1459
chr19	5838888	5846888	5843897	8000	5842888	-4000	4000	1009
chr19	9462355	9470355	9467089	8000	9466355	-4000	4000	734
chr19	40389766	40397766	40396375	8000	40393766	-4000	4000	2609
chr19	19248233	19256233	19250095	8000	19252233	-4000	4000	-2138
chr19	51008739	51016739	51016058	8000	51012739	-4000	4000	3319
chr19	3176332	3184332	3179504	8000	3180332	-4000	4000	-828
chr19	42424278	42432278	42427158	8000	42428278	-4000	4000	-1120
chr19	50512892	50520892	50518831	8000	50516892	-4000	4000	1939
chr19	40389766	40397766	40395722	8000	40393766	-4000	4000	1956
chr19	44325695	44333695	44327543	8000	44329695	-4000	4000	-2152
chr19	54810517	54818517	54813928	8000	54814517	-4000	4000	-589
chr19	54810517	54818517	54813929	8000	54814517	-4000	4000	-588
chr19	48025383	48033383	48030242	8000	48029383	-4000	4000	859
chr19	54634022	54642022	54635775	8000	54638022	-4000	4000	-2247
chr19	19706472	19714472	19713013	8000	19710472	-4000	4000	2541
chr19	50512892	50520892	50519160	8000	50516892	-4000	4000	2268
chr19	52381795	52389795	52385040	8000	52385795	-4000	4000	-755
chr19	6673704	6681704	6679161	8000	6677704	-4000	4000	1457
chr19	613221	621221	618747	8000	617221	-4000	4000	1526
chr19	2423638	2431638	2430866	8000	2427638	-4000	4000	3228
chr19	2929218	2937218	2934277	8000	2933218	-4000	4000	1059
chr19	2991179	2999179	2997925	8000	2995179	-4000	4000	2746
chr19	3773970	3781970	3779177	8000	3777970	-4000	4000	1207
chr19	4288232	4296232	4292797	8000	4292232	-4000	4000	565
chr19	4538593	4546593	4538698	8000	4542593	-4000	4000	-3895
chr19	4538593	4546593	4538889	8000	4542593	-4000	4000	-3704
chr19	6579183	6587183	6586058	8000	6583183	-4000	4000	2875
chr19	7557764	7565764	7560668	8000	7561764	-4000	4000	-1096
chr19	9159424	9167424	9160218	8000	9163424	-4000	4000	-3206
chr19	9408429	9416429	9413214	8000	9412429	-4000	4000	785
chr19	10282615	10290615	10287127	8000	10286615	-4000	4000	512
chr19	10284522	10292522	10291220	8000	10288522	-4000	4000	2698
chr19	11831216	11839216	11833532	8000	11835216	-4000	4000	-1684
chr19	12138090	12146090	12145480	8000	12142090	-4000	4000	3390
chr19	12313477	12321477	12321306	8000	12317477	-4000	4000	3829
chr19	13770282	13778282	13772210	8000	13774282	-4000	4000	-2072
chr19	14049218	14057218	14054838	8000	14053218	-4000	4000	1620
chr19	14836466	14844466	14841838	8000	14840466	-4000	4000	1372
chr19	14938448	14946448	14941640	8000	14942448	-4000	4000	-808
chr19	17517288	17525288	17520953	8000	17521288	-4000	4000	-335
chr19	17809576	17817576	17816719	8000	17813576	-4000	4000	3143
chr19	17820780	17828780	17826747	8000	17824780	-4000	4000	1967
chr19	19706472	19714472	19711549	8000	19710472	-4000	4000	1077
chr19	21800946	21808946	21808611	8000	21804946	-4000	4000	3665
chr19	22970883	22978883	22976800	8000	22974883	-4000	4000	1917
chr19	29201320	29209320	29207517	8000	29205320	-4000	4000	2197
chr19	34422168	34430168	34426070	8000	34426168	-4000	4000	-98
chr19	34941170	34949170	34944542	8000	34945170	-4000	4000	-628
chr19	35447767	35455767	35450719	8000	35451767	-4000	4000	-1048
chr19	37126368	37134368	37128844	8000	37130368	-4000	4000	-1524
chr19	37389066	37397066	37389607	8000	37393066	-4000	4000	-3459
chr19	37609749	37617749	37611738	8000	37613749	-4000	4000	-2011
chr19	38405051	38413051	38405532	8000	38409051	-4000	4000	-3519
chr19	39405412	39413412	39408562	8000	39409412	-4000	4000	-850
chr19	41807554	41815554	41810845	8000	41811554	-4000	4000	-709
chr19	42424278	42432278	42426267	8000	42428278	-4000	4000	-2011
chr19	42862464	42870464	42866996	8000	42866464	-4000	4000	532
chr19	42920132	42928132	42926715	8000	42924132	-4000	4000	2583
chr19	44174381	44182381	44176112	8000	44178381	-4000	4000	-2269
chr19	44325695	44333695	44328153	8000	44329695	-4000	4000	-1542
chr19	44470428	44478428	44476723	8000	44474428	-4000	4000	2295
chr19	44470428	44478428	44477296	8000	44474428	-4000	4000	2868
chr19	44470428	44478428	44477399	8000	44474428	-4000	4000	2971
chr19	46035182	46043182	46040240	8000	46039182	-4000	4000	1058
chr19	48626717	48634717	48633710	8000	48630717	-4000	4000	2993
chr19	48716585	48724585	48720774	8000	48720585	-4000	4000	189
chr19	48940969	48948969	48942445	8000	48944969	-4000	4000	-2524
chr19	50767732	50775732	50771032	8000	50771732	-4000	4000	-700
chr19	50815146	50823146	50819949	8000	50819146	-4000	4000	803
chr19	51018216	51026216	51024744	8000	51022216	-4000	4000	2528
chr19	51363098	51371098	51368536	8000	51367098	-4000	4000	1438
chr19	51944759	51952759	51945539	8000	51948759	-4000	4000	-3220
chr19	51960340	51968340	51965802	8000	51964340	-4000	4000	1462
chr19	52027378	52035378	52034328	8000	52031378	-4000	4000	2950
chr19	52363778	52371778	52366789	8000	52367778	-4000	4000	-989
chr19	52414412	52422412	52416740	8000	52418412	-4000	4000	-1672
chr19	52793408	52801408	52799913	8000	52797408	-4000	4000	2505
chr19	55147767	55155767	55151807	8000	55151767	-4000	4000	40
chr19	55515099	55523099	55517832	8000	55519099	-4000	4000	-1267
chr19	55515099	55523099	55518066	8000	55519099	-4000	4000	-1033
chr19	56770547	56778547	56774847	8000	56774547	-4000	4000	300
chr19	57127926	57135926	57134929	8000	57131926	-4000	4000	3003
chr19	57127926	57135926	57135611	8000	57131926	-4000	4000	3685
chr19	57326770	57334770	57328489	8000	57330770	-4000	4000	-2281
chr19	57450790	57458790	57455917	8000	57454790	-4000	4000	1127
chr19	57589890	57597890	57591021	8000	57593890	-4000	4000	-2869
chr19	57973076	57981076	57979071	8000	57977076	-4000	4000	1995
chr19	58428814	58436814	58433408	8000	58432814	-4000	4000	594
chr19	58428814	58436814	58435194	8000	58432814	-4000	4000	2380
chr19	4538593	4546593	4538667	8000	4542593	-4000	4000	-3926
chr19	8693400	8701400	8698149	8000	8697400	-4000	4000	749
chr19	9378617	9386617	9381460	8000	9382617	-4000	4000	-1157
chr19	53939950	53947950	53941653	8000	53943950	-4000	4000	-2297
chr19	54634022	54642022	54635612	8000	54638022	-4000	4000	-2410
chr19	41092195	41100195	41094980	8000	41096195	-4000	4000	-1215
chr19	44756044	44764044	44756284	8000	44760044	-4000	4000	-3760
chr19	8058660	8066660	8066136	8000	8062660	-4000	4000	3476
chr19	17288131	17296131	17294490	8000	17292131	-4000	4000	2359
chr19	1477428	1485428	1481715	8000	1481428	-4000	4000	287
chr19	6490319	6498319	6495526	8000	6494319	-4000	4000	1207
chr19	38863830	38871830	38869210	8000	38867830	-4000	4000	1380
chr19	23143221	23151221	23146263	8000	23147221	-4000	4000	-958
chr19	44796652	44804652	44800405	8000	44800652	-4000	4000	-247
chr19	43716021	43724021	43719784	8000	43720021	-4000	4000	-237
chr19	6432079	6440079	6432204	8000	6436079	-4000	4000	-3875
chr19	39977764	39985764	39979836	8000	39981764	-4000	4000	-1928
chr19	14874203	14882203	14880482	8000	14878203	-4000	4000	2279
chr19	42920132	42928132	42926715	8000	42924132	-4000	4000	2583
chr19	11717265	11725265	11722690	8000	11721265	-4000	4000	1425
chr19	43642095	43650095	43646348	8000	43646095	-4000	4000	253
chr19	3176332	3184332	3179902	8000	3180332	-4000	4000	-430
chr19	50992018	51000018	50996103	8000	50996018	-4000	4000	85
chr19	4288232	4296232	4292767	8000	4292232	-4000	4000	535
chr19	5452856	5460856	5456582	8000	5456856	-4000	4000	-274
chr19	6579183	6587183	6585947	8000	6583183	-4000	4000	2764
chr19	36178276	36186276	36183140	8000	36182276	-4000	4000	864
chr19	56657980	56665980	56664920	8000	56661980	-4000	4000	2940
chr19	43963709	43971709	43966823	8000	43967709	-4000	4000	-886
chr19	46462491	46470491	46470318	8000	46466491	-4000	4000	3827
chr19	57130096	57138096	57136956	8000	57134096	-4000	4000	2860
chr19	8505678	8513678	8512480	8000	8509678	-4000	4000	2802
chr19	38874555	38882555	38879289	8000	38878555	-4000	4000	734
chr19	37609749	37617749	37612355	8000	37613749	-4000	4000	-1394
chr19	2914473	2922473	2917352	8000	2918473	-4000	4000	-1121
chr19	5452856	5460856	5456136	8000	5456856	-4000	4000	-720
chr19	5862171	5870171	5867038	8000	5866171	-4000	4000	867
chr19	6463207	6471207	6468030	8000	6467207	-4000	4000	823
chr19	6673704	6681704	6680206	8000	6677704	-4000	4000	2502
chr19	7765605	7773605	7768927	8000	7769605	-4000	4000	-678
chr19	8516778	8524778	8521498	8000	8520778	-4000	4000	720
chr19	9096407	9104407	9103291	8000	9100407	-4000	4000	2884
chr19	9122012	9130012	9126660	8000	9126012	-4000	4000	648
chr19	9122012	9130012	9126828	8000	9126012	-4000	4000	816
chr19	9159424	9167424	9160928	8000	9163424	-4000	4000	-2496
chr19	9462355	9470355	9467306	8000	9466355	-4000	4000	951
chr19	9462355	9470355	9469147	8000	9466355	-4000	4000	2792
chr19	9955561	9963561	9960540	8000	9959561	-4000	4000	979
chr19	11361698	11369698	11364730	8000	11365698	-4000	4000	-968
chr19	11615161	11623161	11617050	8000	11619161	-4000	4000	-2111
chr19	11717265	11725265	11722491	8000	11721265	-4000	4000	1226
chr19	11780078	11788078	11780795	8000	11784078	-4000	4000	-3283
chr19	11780078	11788078	11781044	8000	11784078	-4000	4000	-3034
chr19	11780078	11788078	11781853	8000	11784078	-4000	4000	-2225
chr19	11805622	11813622	11806476	8000	11809622	-4000	4000	-3146
chr19	11805622	11813622	11806980	8000	11809622	-4000	4000	-2642
chr19	11831216	11839216	11831490	8000	11835216	-4000	4000	-3726
chr19	12074106	12082106	12076904	8000	12078106	-4000	4000	-1202
chr19	12138090	12146090	12145311	8000	12142090	-4000	4000	3221
chr19	12457559	12465559	12464028	8000	12461559	-4000	4000	2469
chr19	12457559	12465559	12464990	8000	12461559	-4000	4000	3431
chr19	12970760	12978760	12973426	8000	12974760	-4000	4000	-1334
chr19	14049218	14057218	14050832	8000	14053218	-4000	4000	-2386
chr19	15054293	15062293	15055211	8000	15058293	-4000	4000	-3082
chr19	15800549	15808549	15807058	8000	15804549	-4000	4000	2509
chr19	15874023	15882023	15879399	8000	15878023	-4000	4000	1376
chr19	15946350	15954350	15949038	8000	15950350	-4000	4000	-1312
chr19	19260364	19268364	19266592	8000	19264364	-4000	4000	2228
chr19	19706472	19714472	19711810	8000	19710472	-4000	4000	1338
chr19	21056050	21064050	21056803	8000	21060050	-4000	4000	-3247
chr19	21287160	21295160	21294663	8000	21291160	-4000	4000	3503
chr19	22087480	22095480	22088217	8000	22091480	-4000	4000	-3263
chr19	22175089	22183089	22180914	8000	22179089	-4000	4000	1825
chr19	22387019	22395019	22391360	8000	22391019	-4000	4000	341
chr19	23218755	23226755	23223943	8000	23222755	-4000	4000	1188
chr19	24125968	24133968	24127697	8000	24129968	-4000	4000	-2271
chr19	29201320	29209320	29207837	8000	29205320	-4000	4000	2517
chr19	32974229	32982229	32976606	8000	32978229	-4000	4000	-1623
chr19	32974229	32982229	32980158	8000	32978229	-4000	4000	1929
chr19	34682397	34690397	34685287	8000	34686397	-4000	4000	-1110
chr19	34952354	34960354	34958313	8000	34956354	-4000	4000	1959
chr19	34952354	34960354	34960332	8000	34956354	-4000	4000	3978
chr19	35343361	35351361	35346602	8000	35347361	-4000	4000	-759
chr19	35447767	35455767	35450755	8000	35451767	-4000	4000	-1012
chr19	36101108	36109108	36103364	8000	36105108	-4000	4000	-1744
chr19	37407155	37415155	37413786	8000	37411155	-4000	4000	2631
chr19	37609749	37617749	37613160	8000	37613749	-4000	4000	-589
chr19	37692371	37700371	37698389	8000	37696371	-4000	4000	2018
chr19	37880823	37888823	37887559	8000	37884823	-4000	4000	2736
chr19	37880823	37888823	37888317	8000	37884823	-4000	4000	3494
chr19	39705444	39713444	39707215	8000	39709444	-4000	4000	-2229
chr19	39727255	39735255	39734408	8000	39731255	-4000	4000	3153
chr19	40065152	40073152	40072868	8000	40069152	-4000	4000	3716
chr19	41421001	41429001	41424599	8000	41425001	-4000	4000	-402
chr19	41807554	41815554	41811328	8000	41811554	-4000	4000	-226
chr19	41877372	41885372	41879578	8000	41881372	-4000	4000	-1794
chr19	41952879	41960879	41957038	8000	41956879	-4000	4000	159
chr19	42748686	42756686	42755051	8000	42752686	-4000	4000	2365
chr19	43359172	43367172	43361185	8000	43363172	-4000	4000	-1987
chr19	43868365	43876365	43872437	8000	43872365	-4000	4000	72
chr19	43868365	43876365	43873286	8000	43872365	-4000	4000	921
chr19	43908624	43916624	43913531	8000	43912624	-4000	4000	907
chr19	44083318	44091318	44086162	8000	44087318	-4000	4000	-1156
chr19	44470428	44478428	44476523	8000	44474428	-4000	4000	2095
chr19	45869797	45877797	45872854	8000	45873797	-4000	4000	-943
chr19	47318066	47326066	47320711	8000	47322066	-4000	4000	-1355
chr19	47839330	47847330	47839665	8000	47843330	-4000	4000	-3665
chr19	48292457	48300457	48297325	8000	48296457	-4000	4000	868
chr19	48701951	48709951	48703932	8000	48705951	-4000	4000	-2019
chr19	48833097	48841097	48837541	8000	48837097	-4000	4000	444
chr19	48962879	48970879	48966708	8000	48966879	-4000	4000	-171
chr19	49709731	49717731	49710423	8000	49713731	-4000	4000	-3308
chr19	50856764	50864764	50858213	8000	50860764	-4000	4000	-2551
chr19	50902351	50910351	50908217	8000	50906351	-4000	4000	1866
chr19	51944759	51952759	51945310	8000	51948759	-4000	4000	-3449
chr19	51960340	51968340	51965692	8000	51964340	-4000	4000	1352
chr19	51987332	51995332	51994617	8000	51991332	-4000	4000	3285
chr19	52008765	52016765	52016510	8000	52012765	-4000	4000	3745
chr19	52027378	52035378	52033745	8000	52031378	-4000	4000	2367
chr19	52109091	52117091	52114665	8000	52113091	-4000	4000	1574
chr19	52109091	52117091	52116659	8000	52113091	-4000	4000	3568
chr19	52149864	52157864	52156046	8000	52153864	-4000	4000	2182
chr19	52321922	52329922	52322170	8000	52325922	-4000	4000	-3752
chr19	52321922	52329922	52322506	8000	52325922	-4000	4000	-3416
chr19	52363778	52371778	52365911	8000	52367778	-4000	4000	-1867
chr19	52414412	52422412	52415550	8000	52418412	-4000	4000	-2862
chr19	52414412	52422412	52415687	8000	52418412	-4000	4000	-2725
chr19	52414412	52422412	52416527	8000	52418412	-4000	4000	-1885
chr19	52448315	52456315	52451633	8000	52452315	-4000	4000	-682
chr19	52448315	52456315	52451829	8000	52452315	-4000	4000	-486
chr19	52856851	52864851	52864124	8000	52860851	-4000	4000	3273
chr19	53633009	53641009	53634590	8000	53637009	-4000	4000	-2419
chr19	54303070	54311070	54307667	8000	54307070	-4000	4000	597
chr19	54732632	54740632	54735323	8000	54736632	-4000	4000	-1309
chr19	54810517	54818517	54814218	8000	54814517	-4000	4000	-299
chr19	54810517	54818517	54818386	8000	54814517	-4000	4000	3869
chr19	56185570	56193570	56190120	8000	56189570	-4000	4000	550
chr19	56215670	56223670	56222689	8000	56219670	-4000	4000	3019
chr19	56552808	56560808	56553981	8000	56556808	-4000	4000	-2827
chr19	56552808	56560808	56554291	8000	56556808	-4000	4000	-2517
chr19	56657980	56665980	56665177	8000	56661980	-4000	4000	3197
chr19	57127926	57135926	57135821	8000	57131926	-4000	4000	3895
chr19	57450790	57458790	57456267	8000	57454790	-4000	4000	1477
chr19	57954437	57962437	57958702	8000	57958437	-4000	4000	265
chr19	57973076	57981076	57978665	8000	57977076	-4000	4000	1589
chr19	57973076	57981076	57979621	8000	57977076	-4000	4000	2545
chr19	58122248	58130248	58128836	8000	58126248	-4000	4000	2588
chr19	58209562	58217562	58212749	8000	58213562	-4000	4000	-813
chr19	9248625	9256625	9251683	8000	9252625	-4000	4000	-942
chr19	11717265	11725265	11721894	8000	11721265	-4000	4000	629
chr19	11975290	11983290	11979938	8000	11979290	-4000	4000	648
chr19	15155038	15163038	15160569	8000	15159038	-4000	4000	1531
chr19	16475067	16483067	16482557	8000	16479067	-4000	4000	3490
chr19	20946697	20954697	20949765	8000	20950697	-4000	4000	-932
chr19	21800946	21808946	21807724	8000	21804946	-4000	4000	2778
chr19	35795988	35803988	35802234	8000	35799988	-4000	4000	2246
chr19	39727255	39735255	39731417	8000	39731255	-4000	4000	162
chr19	49063397	49071397	49070754	8000	49067397	-4000	4000	3357
chr19	52027378	52035378	52034664	8000	52031378	-4000	4000	3286
chr19	52149864	52157864	52155376	8000	52153864	-4000	4000	1512
chr19	53262676	53270676	53267112	8000	53266676	-4000	4000	436
chr19	57150021	57158021	57154332	8000	57154021	-4000	4000	311
chr19	57231548	57239548	57232109	8000	57235548	-4000	4000	-3439
chr19	57640041	57648041	57641239	8000	57644041	-4000	4000	-2802
chr19	57620724	57628724	57621456	8000	57624724	-4000	4000	-3268
chr19	4288232	4296232	4292528	8000	4292232	-4000	4000	296
chr19	50767732	50775732	50770705	8000	50771732	-4000	4000	-1027
chr19	39859323	39867323	39863364	8000	39863323	-4000	4000	41
chr19	7765605	7773605	7766339	8000	7769605	-4000	4000	-3266
chr19	3590507	3598507	3592297	8000	3594507	-4000	4000	-2210
chr19	58079838	58087838	58086321	8000	58083838	-4000	4000	2483
chr19	29560551	29568551	29563897	8000	29564551	-4000	4000	-654
chr19	54303070	54311070	54307647	8000	54307070	-4000	4000	577
chr19	11361698	11369698	11363820	8000	11365698	-4000	4000	-1878
chr19	6490319	6498319	6495875	8000	6494319	-4000	4000	1556
chr19	40389766	40397766	40396671	8000	40393766	-4000	4000	2905
chr19	12138090	12146090	12145892	8000	12142090	-4000	4000	3802
chr19	15447624	15455624	15451897	8000	15451624	-4000	4000	273
chr19	37389066	37397066	37389824	8000	37393066	-4000	4000	-3242
chr19	39705444	39713444	39706003	8000	39709444	-4000	4000	-3441
chr19	47797243	47805243	47801741	8000	47801243	-4000	4000	498
chr19	57640041	57648041	57640947	8000	57644041	-4000	4000	-3094
chr19	38405051	38413051	38412989	8000	38409051	-4000	4000	3938
chr19	50876567	50884567	50876725	8000	50880567	-4000	4000	-3842
chr19	48791062	48799062	48795227	8000	48795062	-4000	4000	165
chr19	401445	409445	407162	8000	405445	-4000	4000	1717
chr19	9248625	9256625	9251175	8000	9252625	-4000	4000	-1450
chr19	20946697	20954697	20949595	8000	20950697	-4000	4000	-1102
chr19	49043638	49051638	49044185	8000	49047638	-4000	4000	-3453
chr19	55308801	55316801	55312980	8000	55312801	-4000	4000	179
chr19	42291797	42299797	42294898	8000	42295797	-4000	4000	-899
chr19	36178276	36186276	36182950	8000	36182276	-4000	4000	674
chr19	47739134	47747134	47741138	8000	47743134	-4000	4000	-1996
chr19	49051793	49059793	49055376	8000	49055793	-4000	4000	-417
chr19	53231381	53239381	53237795	8000	53235381	-4000	4000	2414
chr19	45869797	45877797	45872917	8000	45873797	-4000	4000	-880
chr19	11831216	11839216	11831924	8000	11835216	-4000	4000	-3292
chr19	42082110	42090110	42088767	8000	42086110	-4000	4000	2657
chr19	44130822	44138822	44132018	8000	44134822	-4000	4000	-2804
chr19	51025092	51033092	51029226	8000	51029092	-4000	4000	134
chr19	51051626	51059626	51058642	8000	51055626	-4000	4000	3016
chr19	5862171	5870171	5866879	8000	5866171	-4000	4000	708
chr19	37731833	37739833	37738469	8000	37735833	-4000	4000	2636
chr19	50721708	50729708	50723535	8000	50725708	-4000	4000	-2173
chr19	56215670	56223670	56221464	8000	56219670	-4000	4000	1794
chr19	53262676	53270676	53267183	8000	53266676	-4000	4000	507
chr19	7724958	7732958	7729877	8000	7728958	-4000	4000	919
chr19	15725052	15733052	15728641	8000	15729052	-4000	4000	-411
chr19	2929218	2937218	2934638	8000	2933218	-4000	4000	1420
chr19	48633946	48641946	48639787	8000	48637946	-4000	4000	1841
chr19	24125968	24133968	24127968	8000	24129968	-4000	4000	-2000
chr19	52008765	52016765	52015618	8000	52012765	-4000	4000	2853
chr19	55515099	55523099	55518088	8000	55519099	-4000	4000	-1011
chr19	54810517	54818517	54814275	8000	54814517	-4000	4000	-242
chr19	12664071	12672071	12668410	8000	12668071	-4000	4000	339
chr19	35750519	35758519	35754133	8000	35754519	-4000	4000	-386
chr19	46157298	46165298	46161266	8000	46161298	-4000	4000	-32
chr19	53062606	53070606	53068340	8000	53066606	-4000	4000	1734
chr19	55009705	55017705	55015086	8000	55013705	-4000	4000	1381
chr19	41833074	41841074	41838141	8000	41837074	-4000	4000	1067
chr19	35784822	35792822	35785321	8000	35788822	-4000	4000	-3501
chr19	44174381	44182381	44176654	8000	44178381	-4000	4000	-1727
chr19	54634022	54642022	54636637	8000	54638022	-4000	4000	-1385
chr19	36632618	36640618	36639449	8000	36636618	-4000	4000	2831
chr19	51008739	51016739	51014600	8000	51012739	-4000	4000	1861
chr19	55147767	55155767	55148023	8000	55151767	-4000	4000	-3744
chr19	52414412	52422412	52416401	8000	52418412	-4000	4000	-2011
chr19	57326770	57334770	57328603	8000	57330770	-4000	4000	-2167
chr19	44130822	44138822	44131038	8000	44134822	-4000	4000	-3784
chr19	44325695	44333695	44327873	8000	44329695	-4000	4000	-1822
chr19	52793408	52801408	52801143	8000	52797408	-4000	4000	3735
chr19	9091669	9099669	9093695	8000	9095669	-4000	4000	-1974
chr19	971939	979939	972706	8000	975939	-4000	4000	-3233
chr19	37126368	37134368	37128278	8000	37130368	-4000	4000	-2090
chr19	8728160	8736160	8731177	8000	8732160	-4000	4000	-983
chr19	38591273	38599273	38597337	8000	38595273	-4000	4000	2064
chr19	16475067	16483067	16482711	8000	16479067	-4000	4000	3644
chr19	52698813	52706813	52706037	8000	52702813	-4000	4000	3224
chr19	55009705	55017705	55014760	8000	55013705	-4000	4000	1055
chr19	38813471	38821471	38817182	8000	38817471	-4000	4000	-289
chr19	49018953	49026953	49022985	8000	49022953	-4000	4000	32
chr19	51513819	51521819	51520067	8000	51517819	-4000	4000	2248
chr19	11831216	11839216	11834356	8000	11835216	-4000	4000	-860
chr19	11910329	11918329	11913618	8000	11914329	-4000	4000	-711
chr19	50856764	50864764	50858591	8000	50860764	-4000	4000	-2173
chr19	20946697	20954697	20949257	8000	20950697	-4000	4000	-1440
chr19	8505678	8513678	8512415	8000	8509678	-4000	4000	2737
chr19	9184818	9192818	9186167	8000	9188818	-4000	4000	-2651
chr19	15447624	15455624	15454500	8000	15451624	-4000	4000	2876
chr19	15447624	15455624	15454717	8000	15451624	-4000	4000	3093
chr19	19706472	19714472	19711123	8000	19710472	-4000	4000	651
chr19	32974229	32982229	32980064	8000	32978229	-4000	4000	1835
chr19	35356489	35364489	35358923	8000	35360489	-4000	4000	-1566
chr19	37609749	37617749	37613459	8000	37613749	-4000	4000	-290
chr19	37731833	37739833	37739417	8000	37735833	-4000	4000	3584
chr19	42862464	42870464	42866821	8000	42866464	-4000	4000	357
chr19	43908624	43916624	43914110	8000	43912624	-4000	4000	1486
chr19	44130822	44138822	44131611	8000	44134822	-4000	4000	-3211
chr19	48440931	48448931	48442318	8000	48444931	-4000	4000	-2613
chr19	48754333	48762333	48756331	8000	48758333	-4000	4000	-2002
chr19	50876567	50884567	50876759	8000	50880567	-4000	4000	-3808
chr19	51341169	51349169	51346977	8000	51345169	-4000	4000	1808
chr19	52008765	52016765	52015919	8000	52012765	-4000	4000	3154
chr19	53231381	53239381	53237915	8000	53235381	-4000	4000	2534
chr19	53352906	53360906	53354343	8000	53356906	-4000	4000	-2563
chr19	54598381	54606381	54600725	8000	54602381	-4000	4000	-1656
chr19	54634022	54642022	54636924	8000	54638022	-4000	4000	-1098
chr19	57127926	57135926	57130458	8000	57131926	-4000	4000	-1468
chr19	57130096	57138096	57136966	8000	57134096	-4000	4000	2870
chr19	54245421	54253421	54252503	8000	54249421	-4000	4000	3082
chr19	18667721	18675721	18668970	8000	18671721	-4000	4000	-2751
chr19	11195295	11203295	11200929	8000	11199295	-4000	4000	1634
chr19	39239455	39247455	39244885	8000	39243455	-4000	4000	1430
chr19	11361698	11369698	11364640	8000	11365698	-4000	4000	-1058
chr19	1477428	1485428	1482438	8000	1481428	-4000	4000	1010
chr19	3924082	3932082	3924605	8000	3928082	-4000	4000	-3477
chr19	46406329	46414329	46412571	8000	46410329	-4000	4000	2242
chr19	3924082	3932082	3924733	8000	3928082	-4000	4000	-3349
chr19	14049218	14057218	14054871	8000	14053218	-4000	4000	1653
chr19	37126368	37134368	37128298	8000	37130368	-4000	4000	-2070
chr19	54732632	54740632	54736486	8000	54736632	-4000	4000	-146
chr19	37389066	37397066	37389927	8000	37393066	-4000	4000	-3139
chr19	2991179	2999179	2994073	8000	2995179	-4000	4000	-1106
chr19	15725052	15733052	15728089	8000	15729052	-4000	4000	-963
chr19	20946697	20954697	20948928	8000	20950697	-4000	4000	-1769
chr19	46406329	46414329	46411032	8000	46410329	-4000	4000	703
chr19	12138090	12146090	12145542	8000	12142090	-4000	4000	3452
chr19	19260364	19268364	19266568	8000	19264364	-4000	4000	2204
chr19	12759003	12767003	12763425	8000	12763003	-4000	4000	422
chr19	12759003	12767003	12763426	8000	12763003	-4000	4000	423
chr19	34741378	34749378	34741707	8000	34745378	-4000	4000	-3671
chr19	5862171	5870171	5867197	8000	5866171	-4000	4000	1026
chr19	14027551	14035551	14031931	8000	14031551	-4000	4000	380
chr19	43359172	43367172	43362097	8000	43363172	-4000	4000	-1075
chr19	58338332	58346332	58339621	8000	58342332	-4000	4000	-2711
chr19	54887420	54895420	54888182	8000	54891420	-4000	4000	-3238
chr19	15447624	15455624	15454182	8000	15451624	-4000	4000	2558
chr19	12138090	12146090	12145947	8000	12142090	-4000	4000	3857
chr19	18192784	18200784	18198850	8000	18196784	-4000	4000	2066
chr19	41752737	41760737	41755633	8000	41756737	-4000	4000	-1104
chr19	41807554	41815554	41811346	8000	41811554	-4000	4000	-208
chr19	48633946	48641946	48639797	8000	48637946	-4000	4000	1851
chr19	51025092	51033092	51031918	8000	51029092	-4000	4000	2826
chr19	52414412	52422412	52415870	8000	52418412	-4000	4000	-2542
chr19	54598381	54606381	54600885	8000	54602381	-4000	4000	-1496
chr19	55154661	55162661	55159217	8000	55158661	-4000	4000	556
chr19	11975290	11983290	11978743	8000	11979290	-4000	4000	-547
chr19	21800946	21808946	21808350	8000	21804946	-4000	4000	3404
chr19	48372377	48380377	48375636	8000	48376377	-4000	4000	-741
chr19	43716021	43724021	43719696	8000	43720021	-4000	4000	-325
chr19	8844844	8852844	8851284	8000	8848844	-4000	4000	2440
chr19	41124381	41132381	41124878	8000	41128381	-4000	4000	-3503
chr19	43618368	43626368	43625078	8000	43622368	-4000	4000	2710
chr19	4532402	4540402	4538455	8000	4536402	-4000	4000	2053
chr19	48440931	48448931	48442251	8000	48444931	-4000	4000	-2680
chr19	12074106	12082106	12076686	8000	12078106	-4000	4000	-1420
chr19	57290069	57298069	57290834	8000	57294069	-4000	4000	-3235
chr19	44325695	44333695	44329932	8000	44329695	-4000	4000	237
chr19	51008739	51016739	51009276	8000	51012739	-4000	4000	-3463
chr19	57326770	57334770	57329183	8000	57330770	-4000	4000	-1587
chr19	52008765	52016765	52016188	8000	52012765	-4000	4000	3423
chr19	12313477	12321477	12318369	8000	12317477	-4000	4000	892
chr19	45403334	45411334	45409517	8000	45407334	-4000	4000	2183
chr19	2832735	2840735	2834601	8000	2836735	-4000	4000	-2134
chr19	8728160	8736160	8731490	8000	8732160	-4000	4000	-670
chr19	18203961	18211961	18211868	8000	18207961	-4000	4000	3907
chr19	37407155	37415155	37413873	8000	37411155	-4000	4000	2718
chr19	44470428	44478428	44476639	8000	44474428	-4000	4000	2211
chr19	46406329	46414329	46411348	8000	46410329	-4000	4000	1019
chr19	6490319	6498319	6495758	8000	6494319	-4000	4000	1439
chr19	34398413	34406413	34400147	8000	34402413	-4000	4000	-2266
chr19	56371846	56379846	56377096	8000	56375846	-4000	4000	1250
chr19	11975290	11983290	11980126	8000	11979290	-4000	4000	836
chr19	44105886	44113886	44107986	8000	44109886	-4000	4000	-1900
chr19	46406329	46414329	46411242	8000	46410329	-4000	4000	913
chr19	34754073	34762073	34759677	8000	34758073	-4000	4000	1604
chr19	40572464	40580464	40575631	8000	40576464	-4000	4000	-833
chr19	46629953	46637953	46637555	8000	46633953	-4000	4000	3602
chr19	54826778	54834778	54829981	8000	54830778	-4000	4000	-797
chr19	34682397	34690397	34684984	8000	34686397	-4000	4000	-1413
chr19	1872810	1880810	1877566	8000	1876810	-4000	4000	756
chr19	12138090	12146090	12145355	8000	12142090	-4000	4000	3265
chr19	852247	860247	853386	8000	856247	-4000	4000	-2861
chr19	7765605	7773605	7767571	8000	7769605	-4000	4000	-2034
chr19	22663671	22671671	22665107	8000	22667671	-4000	4000	-2564
chr19	38874555	38882555	38879629	8000	38878555	-4000	4000	1074
chr19	46116067	46124067	46120096	8000	46120067	-4000	4000	29
chr19	50427314	50435314	50428240	8000	50431314	-4000	4000	-3074
chr19	56181775	56189775	56185299	8000	56185775	-4000	4000	-476
chr19	9378617	9386617	9381883	8000	9382617	-4000	4000	-734
chr19	51960340	51968340	51965299	8000	51964340	-4000	4000	959
chr19	14836466	14844466	14841245	8000	14840466	-4000	4000	779
chr19	52793408	52801408	52800654	8000	52797408	-4000	4000	3246
chr19	57326770	57334770	57328514	8000	57330770	-4000	4000	-2256
chr19	32974229	32982229	32980029	8000	32978229	-4000	4000	1800
chr19	45403334	45411334	45409519	8000	45407334	-4000	4000	2185
chr19	52698813	52706813	52706184	8000	52702813	-4000	4000	3371
chr19	37407155	37415155	37413127	8000	37411155	-4000	4000	1972
chr19	12138090	12146090	12140266	8000	12142090	-4000	4000	-1824
chr19	46406329	46414329	46411577	8000	46410329	-4000	4000	1248
chr19	5452856	5460856	5456792	8000	5456856	-4000	4000	-64
chr19	42862464	42870464	42868807	8000	42866464	-4000	4000	2343
chr19	5826408	5834408	5832180	8000	5830408	-4000	4000	1772
chr19	42920132	42928132	42926586	8000	42924132	-4000	4000	2454
chr19	44470428	44478428	44477294	8000	44474428	-4000	4000	2866
chr19	16686023	16694023	16688291	8000	16690023	-4000	4000	-1732
chr19	35150302	35158302	35153967	8000	35154302	-4000	4000	-335
chr19	37126368	37134368	37129170	8000	37130368	-4000	4000	-1198
chr19	37389066	37397066	37389628	8000	37393066	-4000	4000	-3438
chr19	37731833	37739833	37739630	8000	37735833	-4000	4000	3797
chr19	44009924	44017924	44010850	8000	44013924	-4000	4000	-3074
chr19	51025092	51033092	51029442	8000	51029092	-4000	4000	350
chr19	54586287	54594287	54587244	8000	54590287	-4000	4000	-3043
chr19	57675152	57683152	57679132	8000	57679152	-4000	4000	-20
chr19	15447624	15455624	15452741	8000	15451624	-4000	4000	1117
chr19	45909214	45917214	45914358	8000	45913214	-4000	4000	1144
chr19	4320043	4328043	4325398	8000	4324043	-4000	4000	1355
chr19	19250756	19258756	19257744	8000	19254756	-4000	4000	2988
chr19	9206276	9214276	9214252	8000	9210276	-4000	4000	3976
chr19	32593006	32601006	32600028	8000	32597006	-4000	4000	3022
chr19	39405412	39413412	39408710	8000	39409412	-4000	4000	-702
chr19	57127926	57135926	57131064	8000	57131926	-4000	4000	-862
chr19	51708387	51716387	51713986	8000	51712387	-4000	4000	1599
chr19	8693400	8701400	8697530	8000	8697400	-4000	4000	130
chr19	50512892	50520892	50518697	8000	50516892	-4000	4000	1805
chr19	38797671	38805671	38803431	8000	38801671	-4000	4000	1760
chr19	43762533	43770533	43769439	8000	43766533	-4000	4000	2906
chr19	44130822	44138822	44131202	8000	44134822	-4000	4000	-3620
chr19	35368962	35376962	35371944	8000	35372962	-4000	4000	-1018
chr19	35519367	35527367	35526854	8000	35523367	-4000	4000	3487
chr19	9408429	9416429	9414543	8000	9412429	-4000	4000	2114
chr19	51708387	51716387	51714088	8000	51712387	-4000	4000	1701
chr19	8693400	8701400	8697746	8000	8697400	-4000	4000	346
chr19	44105886	44113886	44107750	8000	44109886	-4000	4000	-2136
chr19	1778075	1786075	1785558	8000	1782075	-4000	4000	3483
chr19	6432079	6440079	6432149	8000	6436079	-4000	4000	-3930
chr19	58428814	58436814	58434919	8000	58432814	-4000	4000	2105
chr19	41615015	41623015	41620613	8000	41619015	-4000	4000	1598
chr19	57127926	57135926	57129873	8000	57131926	-4000	4000	-2053
chr19	54887420	54895420	54889670	8000	54891420	-4000	4000	-1750
chr19	54887420	54895420	54888188	8000	54891420	-4000	4000	-3232
chr19	4320043	4328043	4325449	8000	4324043	-4000	4000	1406
chr19	11780078	11788078	11780829	8000	11784078	-4000	4000	-3249
chr19	35220800	35228800	35224889	8000	35224800	-4000	4000	89
chr19	51018216	51026216	51023827	8000	51022216	-4000	4000	1611
chr19	51960340	51968340	51966081	8000	51964340	-4000	4000	1741
chr19	35356489	35364489	35359043	8000	35360489	-4000	4000	-1446
chr19	43359172	43367172	43360293	8000	43363172	-4000	4000	-2879
chr19	14027551	14035551	14032392	8000	14031551	-4000	4000	841
chr19	22175089	22183089	22179738	8000	22179089	-4000	4000	649
chr19	57675152	57683152	57679047	8000	57679152	-4000	4000	-105
chr19	1776988	1784988	1783050	8000	1780988	-4000	4000	2062
chr19	4538593	4546593	4538646	8000	4542593	-4000	4000	-3947
chr19	18568220	18576220	18575293	8000	18572220	-4000	4000	3073
chr19	22663671	22671671	22664466	8000	22667671	-4000	4000	-3205
chr19	34586644	34594644	34594238	8000	34590644	-4000	4000	3594
chr19	41615015	41623015	41619247	8000	41619015	-4000	4000	232
chr19	6657253	6665253	6665211	8000	6661253	-4000	4000	3958
chr19	11160270	11168270	11166596	8000	11164270	-4000	4000	2326
chr19	37609749	37617749	37613150	8000	37613749	-4000	4000	-599
chr19	19260364	19268364	19260922	8000	19264364	-4000	4000	-3442
chr19	14049218	14057218	14050874	8000	14053218	-4000	4000	-2344
chr19	43908624	43916624	43913392	8000	43912624	-4000	4000	768
chr19	51960340	51968340	51965468	8000	51964340	-4000	4000	1128
chr19	56657980	56665980	56664880	8000	56661980	-4000	4000	2900
chr19	57130096	57138096	57135969	8000	57134096	-4000	4000	1873
chr19	8058660	8066660	8062265	8000	8062660	-4000	4000	-395
chr19	11717265	11725265	11722524	8000	11721265	-4000	4000	1259
chr19	35750519	35758519	35752315	8000	35754519	-4000	4000	-2204
chr19	41848333	41856333	41851665	8000	41852333	-4000	4000	-668
chr19	52698813	52706813	52706230	8000	52702813	-4000	4000	3417
chr19	9091669	9099669	9093811	8000	9095669	-4000	4000	-1858
chr19	57231548	57239548	57232225	8000	57235548	-4000	4000	-3323
chr19	48791062	48799062	48796430	8000	48795062	-4000	4000	1368
chr19	52027378	52035378	52034886	8000	52031378	-4000	4000	3508
chr19	53231381	53239381	53237951	8000	53235381	-4000	4000	2570
chr19	54810517	54818517	54813280	8000	54814517	-4000	4000	-1237
chr19	12074106	12082106	12075913	8000	12078106	-4000	4000	-2193
chr19	39782291	39790291	39785716	8000	39786291	-4000	4000	-575
chr19	41203539	41211539	41206017	8000	41207539	-4000	4000	-1522
chr19	50902351	50910351	50907023	8000	50906351	-4000	4000	672
chr19	57973076	57981076	57978587	8000	57977076	-4000	4000	1511
chr19	50876567	50884567	50878492	8000	50880567	-4000	4000	-2075
chr19	39859323	39867323	39866827	8000	39863323	-4000	4000	3504
chr19	14608035	14616035	14610075	8000	14612035	-4000	4000	-1960
chr19	16888606	16896606	16893183	8000	16892606	-4000	4000	577
chr19	42374769	42382769	42376356	8000	42378769	-4000	4000	-2413
chr19	52027378	52035378	52035215	8000	52031378	-4000	4000	3837
chr19	52027378	52035378	52035333	8000	52031378	-4000	4000	3955
chr19	52149864	52157864	52155029	8000	52153864	-4000	4000	1165
chr19	53257837	53265837	53258617	8000	53261837	-4000	4000	-3220
chr19	57675152	57683152	57678826	8000	57679152	-4000	4000	-326
chr19	11975290	11983290	11979943	8000	11979290	-4000	4000	653
chr19	50821289	50829289	50825431	8000	50825289	-4000	4000	142
chr19	7557764	7565764	7561764	8000	7561764	-4000	4000	0
chr19	3764575	3772575	3771700	8000	3768575	-4000	4000	3125
chr19	17891174	17899174	17893822	8000	17895174	-4000	4000	-1352
chr19	9955561	9963561	9960877	8000	9959561	-4000	4000	1316
chr19	12313477	12321477	12317991	8000	12317477	-4000	4000	514
chr19	12341944	12349944	12349763	8000	12345944	-4000	4000	3819
chr19	13876757	13884757	13877421	8000	13880757	-4000	4000	-3336
chr19	24125968	24133968	24126867	8000	24129968	-4000	4000	-3101
chr19	33126542	33134542	33130362	8000	33130542	-4000	4000	-180
chr19	35674483	35682483	35675978	8000	35678483	-4000	4000	-2505
chr19	37389066	37397066	37389078	8000	37393066	-4000	4000	-3988
chr19	41092195	41100195	41095960	8000	41096195	-4000	4000	-235
chr19	42748686	42756686	42754398	8000	42752686	-4000	4000	1712
chr19	43642095	43650095	43649069	8000	43646095	-4000	4000	2974
chr19	43963709	43971709	43967155	8000	43967709	-4000	4000	-554
chr19	44130822	44138822	44131962	8000	44134822	-4000	4000	-2860
chr19	46406329	46414329	46412107	8000	46410329	-4000	4000	1778
chr19	51960340	51968340	51965015	8000	51964340	-4000	4000	675
chr19	51987332	51995332	51993089	8000	51991332	-4000	4000	1757
chr19	52414412	52422412	52415356	8000	52418412	-4000	4000	-3056
chr19	52698813	52706813	52705471	8000	52702813	-4000	4000	2658
chr19	55781397	55789397	55785763	8000	55785397	-4000	4000	366
chr19	18667721	18675721	18668841	8000	18671721	-4000	4000	-2880
chr19	47471150	47479150	47477774	8000	47475150	-4000	4000	2624
chr19	42306814	42314814	42310368	8000	42310814	-4000	4000	-446
chr19	50767732	50775732	50771389	8000	50771732	-4000	4000	-343
chr19	57973076	57981076	57978573	8000	57977076	-4000	4000	1497
chr19	22175089	22183089	22180297	8000	22179089	-4000	4000	1208
chr19	39239455	39247455	39243695	8000	39243455	-4000	4000	240
chr19	39424415	39432415	39425462	8000	39428415	-4000	4000	-2953
chr19	8400434	8408434	8403619	8000	8404434	-4000	4000	-815
chr19	9248625	9256625	9251136	8000	9252625	-4000	4000	-1489
chr19	14049218	14057218	14055213	8000	14053218	-4000	4000	1995
chr19	33204864	33212864	33208880	8000	33208864	-4000	4000	16
chr19	33204864	33212864	33209305	8000	33208864	-4000	4000	441
chr19	34952354	34960354	34958226	8000	34956354	-4000	4000	1872
chr19	40417589	40425589	40422975	8000	40421589	-4000	4000	1386
chr19	41014398	41022398	41016674	8000	41018398	-4000	4000	-1724
chr19	42306814	42314814	42314323	8000	42310814	-4000	4000	3509
chr19	42424278	42432278	42428963	8000	42428278	-4000	4000	685
chr19	49522428	49530428	49525326	8000	49526428	-4000	4000	-1102
chr19	49709731	49717731	49711795	8000	49713731	-4000	4000	-1936
chr19	51588510	51596510	51592916	8000	51592510	-4000	4000	406
chr19	55515099	55523099	55518228	8000	55519099	-4000	4000	-871
chr19	57326770	57334770	57328825	8000	57330770	-4000	4000	-1945
chr19	12970760	12978760	12973539	8000	12974760	-4000	4000	-1221
chr19	30012612	30020612	30015007	8000	30016612	-4000	4000	-1605
chr19	46157298	46165298	46160686	8000	46161298	-4000	4000	-612
chr19	46462491	46470491	46469802	8000	46466491	-4000	4000	3311
chr19	57326770	57334770	57327940	8000	57330770	-4000	4000	-2830
chr19	4288232	4296232	4294616	8000	4292232	-4000	4000	2384
chr19	21056050	21064050	21056848	8000	21060050	-4000	4000	-3202
chr19	35165881	35173881	35166380	8000	35169881	-4000	4000	-3501
chr19	52698813	52706813	52704413	8000	52702813	-4000	4000	1600
chr20	36647766	36655766	36653622	8000	36651766	-4000	4000	1856
chr20	50999656	51007656	51004544	8000	51003656	-4000	4000	888
chr20	45881266	45889266	45884746	8000	45885266	-4000	4000	-520
chr20	57644392	57652392	57651609	8000	57648392	-4000	4000	3217
chr20	13296651	13304651	13299483	8000	13300651	-4000	4000	-1168
chr20	35697347	35705347	35705232	8000	35701347	-4000	4000	3885
chr20	1974757	1982757	1980564	8000	1978757	-4000	4000	1807
chr20	17480578	17488578	17481637	8000	17484578	-4000	4000	-2941
chr20	18184387	18192387	18184703	8000	18188387	-4000	4000	-3684
chr20	23369062	23377062	23369596	8000	23373062	-4000	4000	-3466
chr20	31602515	31610515	31606051	8000	31606515	-4000	4000	-464
chr20	41356582	41364582	41362332	8000	41360582	-4000	4000	1750
chr20	45205768	45213768	45207553	8000	45209768	-4000	4000	-2215
chr20	56402362	56410362	56403640	8000	56406362	-4000	4000	-2722
chr20	57491966	57499966	57498671	8000	57495966	-4000	4000	2705
chr20	61949469	61957469	61953607	8000	61953469	-4000	4000	138
chr20	33019703	33027703	33020391	8000	33023703	-4000	4000	-3312
chr20	9533370	9541370	9539528	8000	9537370	-4000	4000	2158
chr20	37097226	37105226	37102788	8000	37101226	-4000	4000	1562
chr20	2477817	2485817	2483050	8000	2481817	-4000	4000	1233
chr20	6776246	6784246	6778934	8000	6780246	-4000	4000	-1312
chr20	23743562	23751562	23747872	8000	23747562	-4000	4000	310
chr20	56364663	56372663	56366199	8000	56368663	-4000	4000	-2464
chr20	33671477	33679477	33676943	8000	33675477	-4000	4000	1466
chr20	2477817	2485817	2482918	8000	2481817	-4000	4000	1101
chr20	33403957	33411957	33408403	8000	33407957	-4000	4000	446
chr20	47652877	47660877	47653504	8000	47656877	-4000	4000	-3373
chr20	63552695	63560695	63556112	8000	63556695	-4000	4000	-583
chr20	33040047	33048047	33043319	8000	33044047	-4000	4000	-728
chr20	4848356	4856356	4854998	8000	4852356	-4000	4000	2642
chr20	53563071	53571071	53567985	8000	53567071	-4000	4000	914
chr20	56245815	56253815	56249510	8000	56249815	-4000	4000	-305
chr20	57599846	57607846	57604702	8000	57603846	-4000	4000	856
chr20	45172544	45180544	45176030	8000	45176544	-4000	4000	-514
chr20	25002230	25010230	25007903	8000	25006230	-4000	4000	1673
chr20	45477532	45485532	45479971	8000	45481532	-4000	4000	-1561
chr20	23492010	23500010	23495893	8000	23496010	-4000	4000	-117
chr20	25224075	25232075	25225225	8000	25228075	-4000	4000	-2850
chr20	50884916	50892916	50892193	8000	50888916	-4000	4000	3277
chr20	23035237	23043237	23035861	8000	23039237	-4000	4000	-3376
chr20	38725372	38733372	38728381	8000	38729372	-4000	4000	-991
chr20	35946370	35954370	35949823	8000	35950370	-4000	4000	-547
chr20	23035237	23043237	23035855	8000	23039237	-4000	4000	-3382
chr20	56245815	56253815	56248792	8000	56249815	-4000	4000	-1023
chr20	49984886	49992886	49987919	8000	49988886	-4000	4000	-967
chr20	34709439	34717439	34710341	8000	34713439	-4000	4000	-3098
chr20	45087214	45095214	45094840	8000	45091214	-4000	4000	3626
chr20	50581241	50589241	50581368	8000	50585241	-4000	4000	-3873
chr20	51778331	51786331	51784271	8000	51782331	-4000	4000	1940
chr20	45105452	45113452	45109754	8000	45109452	-4000	4000	302
chr20	23871934	23879934	23879493	8000	23875934	-4000	4000	3559
chr20	33019703	33027703	33023421	8000	33023703	-4000	4000	-282
chr20	19718926	19726926	19721232	8000	19722926	-4000	4000	-1694
chr20	38768520	38776520	38771843	8000	38772520	-4000	4000	-677
chr20	50188668	50196668	50192415	8000	50192668	-4000	4000	-253
chr20	1974757	1982757	1980906	8000	1978757	-4000	4000	2149
chr20	23369062	23377062	23370224	8000	23373062	-4000	4000	-2838
chr20	23035237	23043237	23036296	8000	23039237	-4000	4000	-2941
chr20	36547447	36555447	36548075	8000	36551447	-4000	4000	-3372
chr20	2790074	2798074	2796005	8000	2794074	-4000	4000	1931
chr20	23871934	23879934	23877595	8000	23875934	-4000	4000	1661
chr20	45603939	45611939	45608001	8000	45607939	-4000	4000	62
chr20	63552695	63560695	63556336	8000	63556695	-4000	4000	-359
chr20	23598410	23606410	23603556	8000	23602410	-4000	4000	1146
chr20	35697347	35705347	35705252	8000	35701347	-4000	4000	3905
chr20	56245815	56253815	56249513	8000	56249815	-4000	4000	-302
chr20	5921353	5929353	5923439	8000	5925353	-4000	4000	-1914
chr20	21714481	21722481	21714863	8000	21718481	-4000	4000	-3618
chr20	35281731	35289731	35288496	8000	35285731	-4000	4000	2765
chr20	45530196	45538196	45534322	8000	45534196	-4000	4000	126
chr20	45530196	45538196	45534432	8000	45534196	-4000	4000	236
chr20	49628945	49636945	49636434	8000	49632945	-4000	4000	3489
chr20	59859564	59867564	59866371	8000	59863564	-4000	4000	2807
chr20	50884916	50892916	50892194	8000	50888916	-4000	4000	3278
chr20	1974757	1982757	1980878	8000	1978757	-4000	4000	2121
chr20	2337059	2345059	2339899	8000	2341059	-4000	4000	-1160
chr20	31400845	31408845	31406103	8000	31404845	-4000	4000	1258
chr20	31797805	31805805	31801158	8000	31801805	-4000	4000	-647
chr20	32979773	32987773	32985813	8000	32983773	-4000	4000	2040
chr20	35274907	35282907	35280717	8000	35278907	-4000	4000	1810
chr20	36886229	36894229	36892981	8000	36890229	-4000	4000	2752
chr20	38574859	38582859	38581270	8000	38578859	-4000	4000	2411
chr20	41356582	41364582	41362711	8000	41360582	-4000	4000	2129
chr20	49899391	49907391	49905768	8000	49903391	-4000	4000	2377
chr20	9526524	9534524	9529688	8000	9530524	-4000	4000	-836
chr20	9533370	9541370	9539472	8000	9537370	-4000	4000	2102
chr20	11922609	11930609	11923307	8000	11926609	-4000	4000	-3302
chr20	23035237	23043237	23035882	8000	23039237	-4000	4000	-3355
chr20	23035237	23043237	23036559	8000	23039237	-4000	4000	-2678
chr20	35281731	35289731	35287815	8000	35285731	-4000	4000	2084
chr20	45220458	45228458	45222256	8000	45224458	-4000	4000	-2202
chr20	45881266	45889266	45883463	8000	45885266	-4000	4000	-1803
chr20	64096643	64104643	64098011	8000	64100643	-4000	4000	-2632
chr20	756080	764080	761565	8000	760080	-4000	4000	1485
chr20	44347238	44355238	44350981	8000	44351238	-4000	4000	-257
chr20	63552695	63560695	63556383	8000	63556695	-4000	4000	-312
chr20	45603939	45611939	45610202	8000	45607939	-4000	4000	2263
chr20	45644563	45652563	45650556	8000	45648563	-4000	4000	1993
chr20	46536946	46544946	46541251	8000	46540946	-4000	4000	305
chr20	5295218	5303218	5302681	8000	5299218	-4000	4000	3463
chr20	17489905	17497905	17494306	8000	17493905	-4000	4000	401
chr20	2428753	2436753	2432511	8000	2432753	-4000	4000	-242
chr20	44065616	44073616	44068984	8000	44069616	-4000	4000	-632
chr20	1936592	1944592	1937417	8000	1940592	-4000	4000	-3175
chr20	23743562	23751562	23750753	8000	23747562	-4000	4000	3191
chr20	56515449	56523449	56518198	8000	56519449	-4000	4000	-1251
chr20	31830689	31838689	31834263	8000	31834689	-4000	4000	-426
chr20	10633684	10641684	10641499	8000	10637684	-4000	4000	3815
chr20	33671477	33679477	33677256	8000	33675477	-4000	4000	1779
chr20	62292213	62300213	62293824	8000	62296213	-4000	4000	-2389
chr20	642626	650626	648790	8000	646626	-4000	4000	2164
chr20	23492010	23500010	23493000	8000	23496010	-4000	4000	-3010
chr20	2790074	2798074	2796610	8000	2794074	-4000	4000	2536
chr20	45172544	45180544	45176031	8000	45176544	-4000	4000	-513
chr20	183853	191853	189585	8000	187853	-4000	4000	1732
chr20	4724460	4732460	4725336	8000	4728460	-4000	4000	-3124
chr20	38123780	38131780	38131109	8000	38127780	-4000	4000	3329
chr20	53563071	53571071	53567266	8000	53567071	-4000	4000	195
chr20	35628340	35636340	35630911	8000	35632340	-4000	4000	-1429
chr20	46056150	46064150	46057270	8000	46060150	-4000	4000	-2880
chr20	50999656	51007656	51004280	8000	51003656	-4000	4000	624
chr20	23981050	23989050	23985775	8000	23985050	-4000	4000	725
chr20	35111364	35119364	35118702	8000	35115364	-4000	4000	3338
chr20	45807427	45815427	45811251	8000	45811427	-4000	4000	-176
chr20	45881266	45889266	45887139	8000	45885266	-4000	4000	1873
chr20	19998457	20006457	20001098	8000	20002457	-4000	4000	-1359
chr20	2790074	2798074	2794235	8000	2794074	-4000	4000	161
chr20	32435319	32443319	32436720	8000	32439319	-4000	4000	-2599
chr20	41398083	41406083	41404715	8000	41402083	-4000	4000	2632
chr20	43537881	43545881	43540799	8000	43541881	-4000	4000	-1082
chr20	155163	163163	158816	8000	159163	-4000	4000	-347
chr20	41356582	41364582	41362062	8000	41360582	-4000	4000	1480
chr20	55993357	56001357	55998690	8000	55997357	-4000	4000	1333
chr20	46495630	46503630	46501901	8000	46499630	-4000	4000	2271
chr20	22576998	22584998	22582278	8000	22580998	-4000	4000	1280
chr20	35628340	35636340	35631170	8000	35632340	-4000	4000	-1170
chr20	31299212	31307212	31303210	8000	31303212	-4000	4000	-2
chr20	46495630	46503630	46502469	8000	46499630	-4000	4000	2839
chr20	36886229	36894229	36889395	8000	36890229	-4000	4000	-834
chr20	62384634	62392634	62390236	8000	62388634	-4000	4000	1602
chr20	93094	101094	96376	8000	97094	-4000	4000	-718
chr20	23035237	23043237	23036565	8000	23039237	-4000	4000	-2672
chr20	9533370	9541370	9538950	8000	9537370	-4000	4000	1580
chr20	44620247	44628247	44621058	8000	44624247	-4000	4000	-3189
chr20	49984886	49992886	49987942	8000	49988886	-4000	4000	-944
chr20	59944680	59952680	59946175	8000	59948680	-4000	4000	-2505
chr20	45220458	45228458	45222429	8000	45224458	-4000	4000	-2029
chr20	257096	265096	259145	8000	261096	-4000	4000	-1951
chr20	50077124	50085124	50082923	8000	50081124	-4000	4000	1799
chr20	45205768	45213768	45208250	8000	45209768	-4000	4000	-1518
chr20	45680651	45688651	45684889	8000	45684651	-4000	4000	238
chr20	93094	101094	96286	8000	97094	-4000	4000	-808
chr20	57483959	57491959	57488847	8000	57487959	-4000	4000	888
chr20	59022654	59030654	59024027	8000	59026654	-4000	4000	-2627
chr20	45894621	45902621	45894712	8000	45898621	-4000	4000	-3909
chr20	31299212	31307212	31303229	8000	31303212	-4000	4000	17
chr20	41356582	41364582	41362684	8000	41360582	-4000	4000	2102
chr20	57375211	57383211	57378059	8000	57379211	-4000	4000	-1152
chr20	11922609	11930609	11922643	8000	11926609	-4000	4000	-3966
chr20	49628945	49636945	49636079	8000	49632945	-4000	4000	3134
chr20	1936592	1944592	1937705	8000	1940592	-4000	4000	-2887
chr20	44620247	44628247	44626554	8000	44624247	-4000	4000	2307
chr20	49628945	49636945	49636260	8000	49632945	-4000	4000	3315
chr20	225886	233886	229545	8000	229886	-4000	4000	-341
chr20	45220458	45228458	45222605	8000	45224458	-4000	4000	-1853
chr20	4216630	4224630	4221582	8000	4220630	-4000	4000	952
chr20	20356703	20364703	20360608	8000	20360703	-4000	4000	-95
chr20	24955928	24963928	24963900	8000	24959928	-4000	4000	3972
chr20	43722164	43730164	43726271	8000	43726164	-4000	4000	107
chr20	43722164	43730164	43726272	8000	43726164	-4000	4000	108
chr20	45875122	45883122	45882787	8000	45879122	-4000	4000	3665
chr20	63552695	63560695	63555702	8000	63556695	-4000	4000	-993
chr20	46125863	46133863	46128124	8000	46129863	-4000	4000	-1739
chr20	49499874	49507874	49507859	8000	49503874	-4000	4000	3985
chr20	62837159	62845159	62842063	8000	62841159	-4000	4000	904
chr20	6035856	6043856	6037204	8000	6039856	-4000	4000	-2652
chr20	50999656	51007656	51004021	8000	51003656	-4000	4000	365
chr20	36547447	36555447	36549228	8000	36551447	-4000	4000	-2219
chr20	5921353	5929353	5923027	8000	5925353	-4000	4000	-2326
chr20	20029655	20037655	20033173	8000	20033655	-4000	4000	-482
chr20	6070845	6078845	6077337	8000	6074845	-4000	4000	2492
chr20	45508461	45516461	45512752	8000	45512461	-4000	4000	291
chr20	2477817	2485817	2483427	8000	2481817	-4000	4000	1610
chr20	33305871	33313871	33309714	8000	33309871	-4000	4000	-157
chr20	17731871	17739871	17735837	8000	17735871	-4000	4000	-34
chr20	21242622	21250622	21246517	8000	21246622	-4000	4000	-105
chr20	23350771	23358771	23354037	8000	23354771	-4000	4000	-734
chr20	31941000	31949000	31943112	8000	31945000	-4000	4000	-1888
chr20	2790074	2798074	2797194	8000	2794074	-4000	4000	3120
chr20	63970116	63978116	63977022	8000	63974116	-4000	4000	2906
chr20	20029655	20037655	20032646	8000	20033655	-4000	4000	-1009
chr20	17489905	17497905	17494108	8000	17493905	-4000	4000	203
chr20	21507017	21515017	21512331	8000	21511017	-4000	4000	1314
chr20	45875122	45883122	45877544	8000	45879122	-4000	4000	-1578
chr20	43537881	43545881	43540986	8000	43541881	-4000	4000	-895
chr20	5933228	5941228	5941107	8000	5937228	-4000	4000	3879
chr20	46553823	46561823	46560090	8000	46557823	-4000	4000	2267
chr20	50884916	50892916	50891470	8000	50888916	-4000	4000	2554
chr20	50884916	50892916	50891627	8000	50888916	-4000	4000	2711
chr20	50884916	50892916	50892150	8000	50888916	-4000	4000	3234
chr20	4724460	4732460	4724548	8000	4728460	-4000	4000	-3912
chr20	45220458	45228458	45222255	8000	45224458	-4000	4000	-2203
chr20	56515449	56523449	56517171	8000	56519449	-4000	4000	-2278
chr20	2790074	2798074	2796137	8000	2794074	-4000	4000	2063
chr20	5921353	5929353	5923110	8000	5925353	-4000	4000	-2243
chr20	18312996	18320996	18315471	8000	18316996	-4000	4000	-1525
chr20	25448628	25456628	25453639	8000	25452628	-4000	4000	1011
chr20	32846405	32854405	32846653	8000	32850405	-4000	4000	-3752
chr20	38206503	38214503	38213147	8000	38210503	-4000	4000	2644
chr20	57164753	57172753	57171083	8000	57168753	-4000	4000	2330
chr20	33671477	33679477	33677213	8000	33675477	-4000	4000	1736
chr20	17605919	17613919	17607387	8000	17609919	-4000	4000	-2532
chr20	57644392	57652392	57648512	8000	57648392	-4000	4000	120
chr20	22576998	22584998	22584221	8000	22580998	-4000	4000	3223
chr20	45508461	45516461	45512674	8000	45512461	-4000	4000	213
chr20	50077124	50085124	50082800	8000	50081124	-4000	4000	1676
chr20	4724460	4732460	4724742	8000	4728460	-4000	4000	-3718
chr20	17489905	17497905	17494608	8000	17493905	-4000	4000	703
chr20	17489905	17497905	17494610	8000	17493905	-4000	4000	705
chr20	9533370	9541370	9539233	8000	9537370	-4000	4000	1863
chr20	1974757	1982757	1980572	8000	1978757	-4000	4000	1815
chr20	31369923	31377923	31372909	8000	31373923	-4000	4000	-1014
chr20	33305871	33313871	33307441	8000	33309871	-4000	4000	-2430
chr20	58907192	58915192	58909748	8000	58911192	-4000	4000	-1444
chr20	23035237	23043237	23036504	8000	23039237	-4000	4000	-2733
chr20	4216630	4224630	4221322	8000	4220630	-4000	4000	692
chr20	41398083	41406083	41404730	8000	41402083	-4000	4000	2647
chr20	56515449	56523449	56518219	8000	56519449	-4000	4000	-1230
chr20	57644392	57652392	57652148	8000	57648392	-4000	4000	3756
chr20	59321992	59329992	59324427	8000	59325992	-4000	4000	-1565
chr20	2337059	2345059	2339982	8000	2341059	-4000	4000	-1077
chr20	46125863	46133863	46129014	8000	46129863	-4000	4000	-849
chr20	64096643	64104643	64098951	8000	64100643	-4000	4000	-1692
chr20	64238253	64246253	64240550	8000	64242253	-4000	4000	-1703
chr20	45105452	45113452	45110659	8000	45109452	-4000	4000	1207
chr20	31660452	31668452	31664770	8000	31664452	-4000	4000	318
chr20	41120487	41128487	41123609	8000	41124487	-4000	4000	-878
chr20	33354839	33362839	33359229	8000	33358839	-4000	4000	390
chr20	45220458	45228458	45222507	8000	45224458	-4000	4000	-1951
chr20	31830689	31838689	31832071	8000	31834689	-4000	4000	-2618
chr20	46056150	46064150	46056231	8000	46060150	-4000	4000	-3919
chr20	50873177	50881177	50876597	8000	50877177	-4000	4000	-580
chr20	56364663	56372663	56366384	8000	56368663	-4000	4000	-2279
chr20	3663965	3671965	3669315	8000	3667965	-4000	4000	1350
chr20	36747791	36755791	36752874	8000	36751791	-4000	4000	1083
chr20	45530196	45538196	45538084	8000	45534196	-4000	4000	3888
chr20	45875122	45883122	45877938	8000	45879122	-4000	4000	-1184
chr20	37097226	37105226	37102776	8000	37101226	-4000	4000	1550
chr20	58455101	58463101	58460965	8000	58459101	-4000	4000	1864
chr20	38768520	38776520	38771723	8000	38772520	-4000	4000	-797
chr20	49628945	49636945	49634390	8000	49632945	-4000	4000	1445
chr20	56245815	56253815	56249092	8000	56249815	-4000	4000	-723
chr20	62965585	62973585	62966833	8000	62969585	-4000	4000	-2752
chr20	50930867	50938867	50935120	8000	50934867	-4000	4000	253
chr20	3682970	3690970	3689510	8000	3686970	-4000	4000	2540
chr20	183853	191853	188002	8000	187853	-4000	4000	149
chr20	32435319	32443319	32436704	8000	32439319	-4000	4000	-2615
chr20	64096643	64104643	64098104	8000	64100643	-4000	4000	-2539
chr20	4216630	4224630	4221895	8000	4220630	-4000	4000	1265
chr20	63635705	63643705	63640572	8000	63639705	-4000	4000	867
chr20	4724460	4732460	4724801	8000	4728460	-4000	4000	-3659
chr20	33403957	33411957	33408512	8000	33407957	-4000	4000	555
chr20	32979773	32987773	32985165	8000	32983773	-4000	4000	1392
chr20	33223806	33231806	33226430	8000	33227806	-4000	4000	-1376
chr20	33354839	33362839	33358898	8000	33358839	-4000	4000	59
chr20	2756108	2764108	2758920	8000	2760108	-4000	4000	-1188
chr20	4848356	4856356	4852655	8000	4852356	-4000	4000	299
chr20	23350771	23358771	23354134	8000	23354771	-4000	4000	-637
chr20	40681848	40689848	40688823	8000	40685848	-4000	4000	2975
chr20	41120487	41128487	41122083	8000	41124487	-4000	4000	-2404
chr20	45875122	45883122	45877969	8000	45879122	-4000	4000	-1153
chr20	18312996	18320996	18316269	8000	18316996	-4000	4000	-727
chr20	1313571	1321571	1319607	8000	1317571	-4000	4000	2036
chr20	36026700	36034700	36030552	8000	36030700	-4000	4000	-148
chr20	45248239	45256239	45252404	8000	45252239	-4000	4000	165
chr20	45894621	45902621	45899062	8000	45898621	-4000	4000	441
chr20	3663965	3671965	3669306	8000	3667965	-4000	4000	1341
chr20	18379367	18387367	18384544	8000	18383367	-4000	4000	1177
chr20	33069628	33077628	33072782	8000	33073628	-4000	4000	-846
chr20	33177412	33185412	33178162	8000	33181412	-4000	4000	-3250
chr20	5921353	5929353	5923445	8000	5925353	-4000	4000	-1908
chr20	6776246	6784246	6778789	8000	6780246	-4000	4000	-1457
chr20	59321992	59329992	59324375	8000	59325992	-4000	4000	-1617
chr20	64238253	64246253	64240343	8000	64242253	-4000	4000	-1910
chr20	7878985	7886985	7883480	8000	7882985	-4000	4000	495
chr20	49499874	49507874	49507769	8000	49503874	-4000	4000	3895
chr20	33788269	33796269	33789520	8000	33792269	-4000	4000	-2749
chr20	40681848	40689848	40687876	8000	40685848	-4000	4000	2028
chr20	63970116	63978116	63975725	8000	63974116	-4000	4000	1609
chr20	2477817	2485817	2484253	8000	2481817	-4000	4000	2436
chr20	13296651	13304651	13299190	8000	13300651	-4000	4000	-1461
chr20	20356703	20364703	20360301	8000	20360703	-4000	4000	-402
chr20	35281731	35289731	35287365	8000	35285731	-4000	4000	1634
chr20	35281731	35289731	35288800	8000	35285731	-4000	4000	3069
chr20	36886229	36894229	36893057	8000	36890229	-4000	4000	2828
chr20	44724509	44732509	44727104	8000	44728509	-4000	4000	-1405
chr20	49233946	49241946	49235081	8000	49237946	-4000	4000	-2865
chr20	326224	334224	329193	8000	330224	-4000	4000	-1031
chr20	326224	334224	329968	8000	330224	-4000	4000	-256
chr20	3647118	3655118	3648446	8000	3651118	-4000	4000	-2672
chr20	18312996	18320996	18316702	8000	18316996	-4000	4000	-294
chr20	20385530	20393530	20393089	8000	20389530	-4000	4000	3559
chr20	35111364	35119364	35115775	8000	35115364	-4000	4000	411
chr20	35281731	35289731	35287423	8000	35285731	-4000	4000	1692
chr20	56515449	56523449	56517166	8000	56519449	-4000	4000	-2283
chr20	61949469	61957469	61953625	8000	61953469	-4000	4000	156
chr20	642626	650626	648797	8000	646626	-4000	4000	2171
chr20	11922609	11930609	11922757	8000	11926609	-4000	4000	-3852
chr20	56364663	56372663	56366203	8000	56368663	-4000	4000	-2460
chr20	31830689	31838689	31834458	8000	31834689	-4000	4000	-231
chr20	32628183	32636183	32633924	8000	32632183	-4000	4000	1741
chr20	44724509	44732509	44724829	8000	44728509	-4000	4000	-3680
chr20	25669195	25677195	25676690	8000	25673195	-4000	4000	3495
chr20	93094	101094	96033	8000	97094	-4000	4000	-1061
chr20	93094	101094	96151	8000	97094	-4000	4000	-943
chr20	45894621	45902621	45902571	8000	45898621	-4000	4000	3950
chr20	32331011	32339011	32331667	8000	32335011	-4000	4000	-3344
chr20	51778331	51786331	51784253	8000	51782331	-4000	4000	1922
chr20	5933228	5941228	5938590	8000	5937228	-4000	4000	1362
chr20	7878985	7886985	7885727	8000	7882985	-4000	4000	2742
chr20	36747791	36755791	36752793	8000	36751791	-4000	4000	1002
chr20	10632829	10640829	10639432	8000	10636829	-4000	4000	2603
chr20	11922609	11930609	11923178	8000	11926609	-4000	4000	-3431
chr20	23369062	23377062	23370693	8000	23373062	-4000	4000	-2369
chr20	33107751	33115751	33111444	8000	33111751	-4000	4000	-307
chr20	36647766	36655766	36653225	8000	36651766	-4000	4000	1459
chr20	45172544	45180544	45174961	8000	45176544	-4000	4000	-1583
chr20	49499874	49507874	49505907	8000	49503874	-4000	4000	2033
chr20	50999656	51007656	51004052	8000	51003656	-4000	4000	396
chr20	53563071	53571071	53567548	8000	53567071	-4000	4000	477
chr20	57599846	57607846	57604447	8000	57603846	-4000	4000	601
chr20	59022654	59030654	59024569	8000	59026654	-4000	4000	-2085
chr20	59944680	59952680	59946499	8000	59948680	-4000	4000	-2181
chr20	62292213	62300213	62294601	8000	62296213	-4000	4000	-1612
chr20	3923309	3931309	3923418	8000	3927309	-4000	4000	-3891
chr20	17489905	17497905	17495012	8000	17493905	-4000	4000	1107
chr20	32805356	32813356	32807976	8000	32809356	-4000	4000	-1380
chr20	33850366	33858366	33852152	8000	33854366	-4000	4000	-2214
chr20	35111364	35119364	35115464	8000	35115364	-4000	4000	100
chr20	45875122	45883122	45877733	8000	45879122	-4000	4000	-1389
chr20	46495630	46503630	46501698	8000	46499630	-4000	4000	2068
chr20	5860395	5868395	5863387	8000	5864395	-4000	4000	-1008
chr20	58907192	58915192	58909964	8000	58911192	-4000	4000	-1228
chr20	37941350	37949350	37944058	8000	37945350	-4000	4000	-1292
chr20	31255632	31263632	31259577	8000	31259632	-4000	4000	-55
chr20	43643299	43651299	43646977	8000	43647299	-4000	4000	-322
chr20	54149446	54157446	54157184	8000	54153446	-4000	4000	3738
chr20	46056150	46064150	46057769	8000	46060150	-4000	4000	-2381
chr20	35111364	35119364	35118547	8000	35115364	-4000	4000	3183
chr20	45172544	45180544	45176105	8000	45176544	-4000	4000	-439
chr20	41398083	41406083	41402818	8000	41402083	-4000	4000	735
chr20	64096643	64104643	64098780	8000	64100643	-4000	4000	-1863
chr20	23035237	23043237	23036455	8000	23039237	-4000	4000	-2782
chr20	23440930	23448930	23444038	8000	23444930	-4000	4000	-892
chr20	59022654	59030654	59023919	8000	59026654	-4000	4000	-2735
chr20	63339223	63347223	63346719	8000	63343223	-4000	4000	3496
chr20	25669195	25677195	25676761	8000	25673195	-4000	4000	3566
chr20	45205768	45213768	45207509	8000	45209768	-4000	4000	-2259
chr20	63534489	63542489	63542192	8000	63538489	-4000	4000	3703
chr20	49628945	49636945	49636149	8000	49632945	-4000	4000	3204
chr20	64238253	64246253	64239871	8000	64242253	-4000	4000	-2382
chr20	5295218	5303218	5302254	8000	5299218	-4000	4000	3036
chr20	35281731	35289731	35287069	8000	35285731	-4000	4000	1338
chr20	22576998	22584998	22582687	8000	22580998	-4000	4000	1689
chr20	5921353	5929353	5922973	8000	5925353	-4000	4000	-2380
chr20	44065616	44073616	44068671	8000	44069616	-4000	4000	-945
chr20	43643299	43651299	43647099	8000	43647299	-4000	4000	-200
chr20	2790074	2798074	2794411	8000	2794074	-4000	4000	337
chr20	23819769	23827769	23826447	8000	23823769	-4000	4000	2678
chr20	46012561	46020561	46016423	8000	46016561	-4000	4000	-138
chr20	51778331	51786331	51784187	8000	51782331	-4000	4000	1856
chr20	23598410	23606410	23603473	8000	23602410	-4000	4000	1063
chr20	62178514	62186514	62181557	8000	62182514	-4000	4000	-957
chr20	50930867	50938867	50935034	8000	50934867	-4000	4000	167
chr20	33354839	33362839	33359225	8000	33358839	-4000	4000	386
chr20	41356582	41364582	41362892	8000	41360582	-4000	4000	2310
chr20	45105452	45113452	45110694	8000	45109452	-4000	4000	1242
chr20	23440930	23448930	23444862	8000	23444930	-4000	4000	-68
chr20	34998404	35006404	35005746	8000	35002404	-4000	4000	3342
chr20	62384634	62392634	62388332	8000	62388634	-4000	4000	-302
chr20	62837159	62845159	62838740	8000	62841159	-4000	4000	-2419
chr20	10304258	10312258	10306335	8000	10308258	-4000	4000	-1923
chr20	44276947	44284947	44279036	8000	44280947	-4000	4000	-1911
chr20	46553823	46561823	46559968	8000	46557823	-4000	4000	2145
chr20	58907192	58915192	58910827	8000	58911192	-4000	4000	-365
chr20	23819769	23827769	23826447	8000	23823769	-4000	4000	2678
chr20	2639580	2647580	2641498	8000	2643580	-4000	4000	-2082
chr20	23035237	23043237	23035606	8000	23039237	-4000	4000	-3631
chr20	9526524	9534524	9529770	8000	9530524	-4000	4000	-754
chr20	5921353	5929353	5923455	8000	5925353	-4000	4000	-1898
chr20	45205768	45213768	45208485	8000	45209768	-4000	4000	-1283
chr20	57483959	57491959	57488409	8000	57487959	-4000	4000	450
chr20	45881266	45889266	45883686	8000	45885266	-4000	4000	-1580
chr20	58455101	58463101	58461103	8000	58459101	-4000	4000	2002
chr20	32097856	32105856	32101413	8000	32101856	-4000	4000	-443
chr20	36886229	36894229	36889380	8000	36890229	-4000	4000	-849
chr20	32957845	32965845	32958461	8000	32961845	-4000	4000	-3384
chr20	47205214	47213214	47210497	8000	47209214	-4000	4000	1283
chr20	1974757	1982757	1980666	8000	1978757	-4000	4000	1909
chr20	44298840	44306840	44306769	8000	44302840	-4000	4000	3929
chr20	23035237	23043237	23036203	8000	23039237	-4000	4000	-3034
chr20	5110953	5118953	5115114	8000	5114953	-4000	4000	161
chr20	2477817	2485817	2484138	8000	2481817	-4000	4000	2321
chr20	7878985	7886985	7883656	8000	7882985	-4000	4000	671
chr20	18312996	18320996	18316280	8000	18316996	-4000	4000	-716
chr20	225886	233886	229846	8000	229886	-4000	4000	-40
chr20	393559	401559	396414	8000	397559	-4000	4000	-1145
chr20	2428753	2436753	2432652	8000	2432753	-4000	4000	-101
chr20	2639580	2647580	2641233	8000	2643580	-4000	4000	-2347
chr20	3773504	3781504	3778450	8000	3777504	-4000	4000	946
chr20	5921353	5929353	5923150	8000	5925353	-4000	4000	-2203
chr20	16049197	16057197	16049844	8000	16053197	-4000	4000	-3353
chr20	16738564	16746564	16740987	8000	16742564	-4000	4000	-1577
chr20	18184387	18192387	18184709	8000	18188387	-4000	4000	-3678
chr20	18184387	18192387	18187363	8000	18188387	-4000	4000	-1024
chr20	18312996	18320996	18315463	8000	18316996	-4000	4000	-1533
chr20	18312996	18320996	18316702	8000	18316996	-4000	4000	-294
chr20	18480646	18488646	18483627	8000	18484646	-4000	4000	-1019
chr20	21507017	21515017	21512315	8000	21511017	-4000	4000	1298
chr20	23369062	23377062	23370187	8000	23373062	-4000	4000	-2875
chr20	23981050	23989050	23986097	8000	23985050	-4000	4000	1047
chr20	25608935	25616935	25616403	8000	25612935	-4000	4000	3468
chr20	32979773	32987773	32985870	8000	32983773	-4000	4000	2097
chr20	35946370	35954370	35954169	8000	35950370	-4000	4000	3799
chr20	36886229	36894229	36893100	8000	36890229	-4000	4000	2871
chr20	43722164	43730164	43726434	8000	43726164	-4000	4000	270
chr20	44065616	44073616	44066746	8000	44069616	-4000	4000	-2870
chr20	45119425	45127425	45124168	8000	45123425	-4000	4000	743
chr20	45819214	45827214	45824386	8000	45823214	-4000	4000	1172
chr20	50884916	50892916	50892514	8000	50888916	-4000	4000	3598
chr20	56245815	56253815	56248970	8000	56249815	-4000	4000	-845
chr20	57491966	57499966	57498606	8000	57495966	-4000	4000	2640
chr20	57644392	57652392	57652001	8000	57648392	-4000	4000	3609
chr20	59859564	59867564	59866339	8000	59863564	-4000	4000	2775
chr20	45547153	45555153	45552040	8000	45551153	-4000	4000	887
chr20	41398083	41406083	41405181	8000	41402083	-4000	4000	3098
chr20	45875122	45883122	45877479	8000	45879122	-4000	4000	-1643
chr20	46536946	46544946	46541760	8000	46540946	-4000	4000	814
chr20	50930867	50938867	50936240	8000	50934867	-4000	4000	1373
chr20	43537881	43545881	43539888	8000	43541881	-4000	4000	-1993
chr20	50999656	51007656	51004620	8000	51003656	-4000	4000	964
chr20	40681848	40689848	40687815	8000	40685848	-4000	4000	1967
chr20	6035856	6043856	6037141	8000	6039856	-4000	4000	-2715
chr20	59022654	59030654	59022919	8000	59026654	-4000	4000	-3735
chr20	56245815	56253815	56249272	8000	56249815	-4000	4000	-543
chr20	10633684	10641684	10641203	8000	10637684	-4000	4000	3519
chr20	41174448	41182448	41180239	8000	41178448	-4000	4000	1791
chr20	38333505	38341505	38334492	8000	38337505	-4000	4000	-3013
chr20	49092960	49100960	49096761	8000	49096960	-4000	4000	-199
chr20	225886	233886	229804	8000	229886	-4000	4000	-82
chr20	419596	427596	422207	8000	423596	-4000	4000	-1389
chr20	642626	650626	648890	8000	646626	-4000	4000	2264
chr20	2790074	2798074	2796259	8000	2794074	-4000	4000	2185
chr20	2790074	2798074	2797055	8000	2794074	-4000	4000	2981
chr20	5295218	5303218	5302414	8000	5299218	-4000	4000	3196
chr20	7878985	7886985	7883656	8000	7882985	-4000	4000	671
chr20	18312996	18320996	18315958	8000	18316996	-4000	4000	-1038
chr20	23446403	23454403	23450561	8000	23450403	-4000	4000	158
chr20	25669195	25677195	25674919	8000	25673195	-4000	4000	1724
chr20	31373164	31381164	31377181	8000	31377164	-4000	4000	17
chr20	31602515	31610515	31605670	8000	31606515	-4000	4000	-845
chr20	31830689	31838689	31833769	8000	31834689	-4000	4000	-920
chr20	33040047	33048047	33042851	8000	33044047	-4000	4000	-1196
chr20	33223806	33231806	33223818	8000	33227806	-4000	4000	-3988
chr20	33223806	33231806	33227555	8000	33227806	-4000	4000	-251
chr20	37313260	37321260	37316644	8000	37317260	-4000	4000	-616
chr20	38123780	38131780	38130331	8000	38127780	-4000	4000	2551
chr20	38574859	38582859	38574986	8000	38578859	-4000	4000	-3873
chr20	38725372	38733372	38728081	8000	38729372	-4000	4000	-1291
chr20	44904532	44912532	44905048	8000	44908532	-4000	4000	-3484
chr20	45119425	45127425	45124432	8000	45123425	-4000	4000	1007
chr20	45220458	45228458	45222031	8000	45224458	-4000	4000	-2427
chr20	45220458	45228458	45222307	8000	45224458	-4000	4000	-2151
chr20	45875122	45883122	45878407	8000	45879122	-4000	4000	-715
chr20	46495630	46503630	46501211	8000	46499630	-4000	4000	1581
chr20	46495630	46503630	46501795	8000	46499630	-4000	4000	2165
chr20	46495630	46503630	46502669	8000	46499630	-4000	4000	3039
chr20	46536946	46544946	46541623	8000	46540946	-4000	4000	677
chr20	57483959	57491959	57488482	8000	57487959	-4000	4000	523
chr20	57564121	57572121	57565714	8000	57568121	-4000	4000	-2407
chr20	57599846	57607846	57604742	8000	57603846	-4000	4000	896
chr20	59022654	59030654	59023508	8000	59026654	-4000	4000	-3146
chr20	10633684	10641684	10640932	8000	10637684	-4000	4000	3248
chr20	37097226	37105226	37102694	8000	37101226	-4000	4000	1468
chr20	37097226	37105226	37102792	8000	37101226	-4000	4000	1566
chr20	41356582	41364582	41357879	8000	41360582	-4000	4000	-2703
chr20	43537881	43545881	43541006	8000	43541881	-4000	4000	-875
chr20	44065616	44073616	44066798	8000	44069616	-4000	4000	-2818
chr20	46495630	46503630	46502835	8000	46499630	-4000	4000	3205
chr20	46553823	46561823	46560074	8000	46557823	-4000	4000	2251
chr20	50884916	50892916	50890578	8000	50888916	-4000	4000	1662
chr20	64096643	64104643	64098280	8000	64100643	-4000	4000	-2363
chr20	59859564	59867564	59866510	8000	59863564	-4000	4000	2946
chr20	23681640	23689640	23685771	8000	23685640	-4000	4000	131
chr20	44065616	44073616	44069609	8000	44069616	-4000	4000	-7
chr20	31602515	31610515	31606358	8000	31606515	-4000	4000	-157
chr20	32846405	32854405	32849937	8000	32850405	-4000	4000	-468
chr20	35946370	35954370	35947533	8000	35950370	-4000	4000	-2837
chr20	56245815	56253815	56249160	8000	56249815	-4000	4000	-655
chr20	1313571	1321571	1318413	8000	1317571	-4000	4000	842
chr20	38123780	38131780	38131124	8000	38127780	-4000	4000	3344
chr20	36992349	37000349	36998830	8000	36996349	-4000	4000	2481
chr20	296321	304321	298727	8000	300321	-4000	4000	-1594
chr20	64096643	64104643	64097894	8000	64100643	-4000	4000	-2749
chr20	45087214	45095214	45095057	8000	45091214	-4000	4000	3843
chr20	36647766	36655766	36653639	8000	36651766	-4000	4000	1873
chr20	13385392	13393392	13390226	8000	13389392	-4000	4000	834
chr20	57491966	57499966	57498431	8000	57495966	-4000	4000	2465
chr20	63236784	63244784	63239573	8000	63240784	-4000	4000	-1211
chr20	49984886	49992886	49987989	8000	49988886	-4000	4000	-897
chr20	31373164	31381164	31373181	8000	31377164	-4000	4000	-3983
chr20	36524637	36532637	36527164	8000	36528637	-4000	4000	-1473
chr20	23819769	23827769	23826503	8000	23823769	-4000	4000	2734
chr20	32979773	32987773	32985744	8000	32983773	-4000	4000	1971
chr20	23035237	23043237	23035829	8000	23039237	-4000	4000	-3408
chr20	23035237	23043237	23035830	8000	23039237	-4000	4000	-3407
chr20	38574859	38582859	38575075	8000	38578859	-4000	4000	-3784
chr20	56515449	56523449	56518389	8000	56519449	-4000	4000	-1060
chr20	62965585	62973585	62966833	8000	62969585	-4000	4000	-2752
chr20	1438162	1446162	1446022	8000	1442162	-4000	4000	3860
chr20	2337059	2345059	2340517	8000	2341059	-4000	4000	-542
chr20	19998457	20006457	20000943	8000	20002457	-4000	4000	-1514
chr20	20029655	20037655	20032544	8000	20033655	-4000	4000	-1111
chr20	23743562	23751562	23749063	8000	23747562	-4000	4000	1501
chr20	24955928	24963928	24963690	8000	24959928	-4000	4000	3762
chr20	31446257	31454257	31450078	8000	31450257	-4000	4000	-179
chr20	50884916	50892916	50892096	8000	50888916	-4000	4000	3180
chr20	4724460	4732460	4724892	8000	4728460	-4000	4000	-3568
chr20	25669195	25677195	25676476	8000	25673195	-4000	4000	3281
chr20	17489905	17497905	17494379	8000	17493905	-4000	4000	474
chr20	45406610	45414610	45410216	8000	45410610	-4000	4000	-394
chr20	18810378	18818378	18813920	8000	18814378	-4000	4000	-458
chr20	49092960	49100960	49096485	8000	49096960	-4000	4000	-475
chr20	43537881	43545881	43540785	8000	43541881	-4000	4000	-1096
chr20	4724460	4732460	4724620	8000	4728460	-4000	4000	-3840
chr20	18312996	18320996	18315890	8000	18316996	-4000	4000	-1106
chr20	13710322	13718322	13715059	8000	13714322	-4000	4000	737
chr20	58157150	58165150	58160983	8000	58161150	-4000	4000	-167
chr20	56245815	56253815	56249535	8000	56249815	-4000	4000	-280
chr20	59944680	59952680	59945024	8000	59948680	-4000	4000	-3656
chr20	38725372	38733372	38727676	8000	38729372	-4000	4000	-1696
chr20	17605919	17613919	17607557	8000	17609919	-4000	4000	-2362
chr20	23981050	23989050	23985743	8000	23985050	-4000	4000	693
chr20	50884916	50892916	50891813	8000	50888916	-4000	4000	2897
chr20	63236784	63244784	63237962	8000	63240784	-4000	4000	-2822
chr20	56245815	56253815	56248731	8000	56249815	-4000	4000	-1084
chr20	17952979	17960979	17954118	8000	17956979	-4000	4000	-2861
chr20	57564121	57572121	57564387	8000	57568121	-4000	4000	-3734
chr20	11922609	11930609	11923456	8000	11926609	-4000	4000	-3153
chr20	11922609	11930609	11923657	8000	11926609	-4000	4000	-2952
chr20	58907192	58915192	58909365	8000	58911192	-4000	4000	-1827
chr20	32028180	32036180	32029820	8000	32032180	-4000	4000	-2360
chr20	23681640	23689640	23688955	8000	23685640	-4000	4000	3315
chr20	19998457	20006457	20001414	8000	20002457	-4000	4000	-1043
chr20	38574859	38582859	38578829	8000	38578859	-4000	4000	-30
chr20	45205768	45213768	45208366	8000	45209768	-4000	4000	-1402
chr20	2790074	2798074	2796137	8000	2794074	-4000	4000	2063
chr20	17489905	17497905	17494497	8000	17493905	-4000	4000	592
chr20	53563071	53571071	53569141	8000	53567071	-4000	4000	2070
chr20	3035076	3043076	3038469	8000	3039076	-4000	4000	-607
chr20	50752795	50760795	50753027	8000	50756795	-4000	4000	-3768
chr20	33671477	33679477	33677512	8000	33675477	-4000	4000	2035
chr20	18810378	18818378	18814237	8000	18814378	-4000	4000	-141
chr20	5921353	5929353	5923831	8000	5925353	-4000	4000	-1522
chr20	45220458	45228458	45222503	8000	45224458	-4000	4000	-1955
chr20	46495630	46503630	46501856	8000	46499630	-4000	4000	2226
chr20	865900	873900	872997	8000	869900	-4000	4000	3097
chr20	45875122	45883122	45877397	8000	45879122	-4000	4000	-1725
chr20	59859564	59867564	59866337	8000	59863564	-4000	4000	2773
chr20	2790074	2798074	2795830	8000	2794074	-4000	4000	1756
chr20	45477532	45485532	45479983	8000	45481532	-4000	4000	-1549
chr20	35281731	35289731	35287340	8000	35285731	-4000	4000	1609
chr20	25669195	25677195	25676208	8000	25673195	-4000	4000	3013
chr20	45819214	45827214	45824333	8000	45823214	-4000	4000	1119
chr20	4848356	4856356	4853377	8000	4852356	-4000	4000	1021
chr20	62384634	62392634	62390139	8000	62388634	-4000	4000	1505
chr20	6776246	6784246	6778769	8000	6780246	-4000	4000	-1477
chr20	5921353	5929353	5923118	8000	5925353	-4000	4000	-2235
chr20	45220458	45228458	45222257	8000	45224458	-4000	4000	-2201
chr20	22576998	22584998	22581719	8000	22580998	-4000	4000	721
chr20	23743562	23751562	23747787	8000	23747562	-4000	4000	225
chr20	16268104	16276104	16273049	8000	16272104	-4000	4000	945
chr20	45477532	45485532	45479988	8000	45481532	-4000	4000	-1544
chr20	45220458	45228458	45223250	8000	45224458	-4000	4000	-1208
chr20	2477817	2485817	2483298	8000	2481817	-4000	4000	1481
chr20	46012561	46020561	46013789	8000	46016561	-4000	4000	-2772
chr20	58907192	58915192	58910772	8000	58911192	-4000	4000	-420
chr20	2790074	2798074	2797967	8000	2794074	-4000	4000	3893
chr20	41398083	41406083	41405154	8000	41402083	-4000	4000	3071
chr20	45105452	45113452	45110769	8000	45109452	-4000	4000	1317
chr20	22576998	22584998	22584375	8000	22580998	-4000	4000	3377
chr20	47652877	47660877	47656685	8000	47656877	-4000	4000	-192
chr20	1974757	1982757	1980526	8000	1978757	-4000	4000	1769
chr20	5933228	5941228	5938520	8000	5937228	-4000	4000	1292
chr20	31373164	31381164	31373290	8000	31377164	-4000	4000	-3874
chr20	1313571	1321571	1318071	8000	1317571	-4000	4000	500
chr20	6070845	6078845	6077179	8000	6074845	-4000	4000	2334
chr20	33671477	33679477	33678330	8000	33675477	-4000	4000	2853
chr20	37313260	37321260	37316496	8000	37317260	-4000	4000	-764
chr20	45248239	45256239	45252332	8000	45252239	-4000	4000	93
chr20	56364663	56372663	56370110	8000	56368663	-4000	4000	1447
chr20	44065616	44073616	44069580	8000	44069616	-4000	4000	-36
chr20	44904532	44912532	44904978	8000	44908532	-4000	4000	-3554
chr20	5540439	5548439	5546840	8000	5544439	-4000	4000	2401
chr20	9533370	9541370	9538482	8000	9537370	-4000	4000	1112
chr20	9533370	9541370	9539362	8000	9537370	-4000	4000	1992
chr20	40681848	40689848	40688770	8000	40685848	-4000	4000	2922
chr20	49899391	49907391	49904227	8000	49903391	-4000	4000	836
chr20	49899391	49907391	49905234	8000	49903391	-4000	4000	1843
chr20	49628945	49636945	49636095	8000	49632945	-4000	4000	3150
chr21	18265116	18273116	18270006	8000	18269116	-4000	4000	890
chr21	26831755	26839755	26838509	8000	26835755	-4000	4000	2754
chr21	33068413	33076413	33071821	8000	33072413	-4000	4000	-592
chr21	33580687	33588687	33583556	8000	33584687	-4000	4000	-1131
chr21	32264228	32272228	32270427	8000	32268228	-4000	4000	2199
chr21	26462209	26470209	26468472	8000	26466209	-4000	4000	2263
chr21	30427026	30435026	30430388	8000	30431026	-4000	4000	-638
chr21	34367381	34375381	34371084	8000	34371381	-4000	4000	-297
chr21	30210006	30218006	30215491	8000	30214006	-4000	4000	1485
chr21	46661124	46669124	46664318	8000	46665124	-4000	4000	-806
chr21	44845585	44853585	44851532	8000	44849585	-4000	4000	1947
chr21	29000384	29008384	29006422	8000	29004384	-4000	4000	2038
chr21	32624759	32632759	32631351	8000	32628759	-4000	4000	2592
chr21	44764580	44772580	44771328	8000	44768580	-4000	4000	2748
chr21	46001050	46009050	46004029	8000	46005050	-4000	4000	-1021
chr21	42293244	42301244	42294637	8000	42297244	-4000	4000	-2607
chr21	18265116	18273116	18266662	8000	18269116	-4000	4000	-2454
chr21	32307018	32315018	32314610	8000	32311018	-4000	4000	3592
chr21	36142562	36150562	36146556	8000	36146562	-4000	4000	-6
chr21	44881953	44889953	44888784	8000	44885953	-4000	4000	2831
chr21	42342357	42350357	42349915	8000	42346357	-4000	4000	3558
chr21	32307018	32315018	32314905	8000	32311018	-4000	4000	3887
chr21	26831755	26839755	26837389	8000	26835755	-4000	4000	1634
chr21	26831755	26839755	26838567	8000	26835755	-4000	4000	2812
chr21	32624759	32632759	32631208	8000	32628759	-4000	4000	2449
chr21	41794225	41802225	41801454	8000	41798225	-4000	4000	3229
chr21	43029931	43037931	43030141	8000	43033931	-4000	4000	-3790
chr21	44294648	44302648	44297702	8000	44298648	-4000	4000	-946
chr21	30609431	30617431	30613824	8000	30613431	-4000	4000	393
chr21	29000384	29008384	29007905	8000	29004384	-4000	4000	3521
chr21	33580687	33588687	33584744	8000	33584687	-4000	4000	57
chr21	44881953	44889953	44886368	8000	44885953	-4000	4000	415
chr21	45938454	45946454	45941768	8000	45942454	-4000	4000	-686
chr21	42307667	42315667	42312217	8000	42311667	-4000	4000	550
chr21	46128848	46136848	46129236	8000	46132848	-4000	4000	-3612
chr21	33481530	33489530	33488330	8000	33485530	-4000	4000	2800
chr21	30876644	30884644	30881105	8000	30880644	-4000	4000	461
chr21	33481530	33489530	33488577	8000	33485530	-4000	4000	3047
chr21	33481530	33489530	33489376	8000	33485530	-4000	4000	3846
chr21	39925397	39933397	39929021	8000	39929397	-4000	4000	-376
chr21	44323376	44331376	44325150	8000	44327376	-4000	4000	-2226
chr21	30421265	30429265	30425490	8000	30425265	-4000	4000	225
chr21	34714227	34722227	34716403	8000	34718227	-4000	4000	-1824
chr21	32624759	32632759	32630965	8000	32628759	-4000	4000	2206
chr21	30285145	30293145	30289344	8000	30289145	-4000	4000	199
chr21	10602140	10610140	10605436	8000	10606140	-4000	4000	-704
chr21	46001050	46009050	46001200	8000	46005050	-4000	4000	-3850
chr21	43758307	43766307	43759304	8000	43762307	-4000	4000	-3003
chr21	36290274	36298274	36293472	8000	36294274	-4000	4000	-802
chr21	46128848	46136848	46129199	8000	46132848	-4000	4000	-3649
chr21	26831755	26839755	26839721	8000	26835755	-4000	4000	3966
chr21	25768460	25776460	25769682	8000	25772460	-4000	4000	-2778
chr21	36456621	36464621	36461248	8000	36460621	-4000	4000	627
chr21	33499931	33507931	33504268	8000	33503931	-4000	4000	337
chr21	29171889	29179889	29174925	8000	29175889	-4000	4000	-964
chr21	36290274	36298274	36293674	8000	36294274	-4000	4000	-600
chr21	46001050	46009050	46002535	8000	46005050	-4000	4000	-2515
chr21	31667000	31675000	31667266	8000	31671000	-4000	4000	-3734
chr21	30639136	30647136	30642896	8000	30643136	-4000	4000	-240
chr21	30161565	30169565	30165980	8000	30165565	-4000	4000	415
chr21	33068413	33076413	33072127	8000	33072413	-4000	4000	-286
chr21	10602140	10610140	10605422	8000	10606140	-4000	4000	-718
chr21	31664931	31672931	31666503	8000	31668931	-4000	4000	-2428
chr21	25581656	25589656	25587774	8000	25585656	-4000	4000	2118
chr21	31034159	31042159	31038185	8000	31038159	-4000	4000	26
chr21	34783801	34791801	34788403	8000	34787801	-4000	4000	602
chr21	30475706	30483706	30480208	8000	30479706	-4000	4000	502
chr21	30367390	30375390	30371515	8000	30371390	-4000	4000	125
chr21	37058846	37066846	37065624	8000	37062846	-4000	4000	2778
chr21	30586105	30594105	30592692	8000	30590105	-4000	4000	2587
chr21	33293160	33301160	33296236	8000	33297160	-4000	4000	-924
chr21	46128848	46136848	46132526	8000	46132848	-4000	4000	-322
chr21	14367115	14375115	14373666	8000	14371115	-4000	4000	2551
chr21	30427026	30435026	30430418	8000	30431026	-4000	4000	-608
chr21	29000384	29008384	29006281	8000	29004384	-4000	4000	1897
chr21	38820955	38828955	38822715	8000	38824955	-4000	4000	-2240
chr21	36290274	36298274	36293338	8000	36294274	-4000	4000	-936
chr21	41735369	41743369	41740956	8000	41739369	-4000	4000	1587
chr21	42342357	42350357	42347619	8000	42346357	-4000	4000	1262
chr21	36142562	36150562	36146484	8000	36146562	-4000	4000	-78
chr21	37219420	37227420	37221404	8000	37223420	-4000	4000	-2016
chr21	30609431	30617431	30616609	8000	30613431	-4000	4000	3178
chr21	37015662	37023662	37017912	8000	37019662	-4000	4000	-1750
chr21	30483043	30491043	30487315	8000	30487043	-4000	4000	272
chr21	38376027	38384027	38383597	8000	38380027	-4000	4000	3570
chr21	30492824	30500824	30497014	8000	30496824	-4000	4000	190
chr21	41881112	41889112	41888990	8000	41885112	-4000	4000	3878
chr21	30639136	30647136	30642924	8000	30643136	-4000	4000	-212
chr21	40006999	40014999	40012778	8000	40010999	-4000	4000	1779
chr21	26831755	26839755	26837991	8000	26835755	-4000	4000	2236
chr21	44493893	44501893	44499788	8000	44497893	-4000	4000	1895
chr21	30210006	30218006	30214889	8000	30214006	-4000	4000	883
chr21	30421265	30429265	30425423	8000	30425265	-4000	4000	158
chr21	30631619	30639619	30635278	8000	30635619	-4000	4000	-341
chr21	26831755	26839755	26838268	8000	26835755	-4000	4000	2513
chr21	32264228	32272228	32269014	8000	32268228	-4000	4000	786
chr21	30436869	30444869	30440581	8000	30440869	-4000	4000	-288
chr21	30161565	30169565	30166042	8000	30165565	-4000	4000	477
chr21	44881953	44889953	44889394	8000	44885953	-4000	4000	3441
chr21	14957235	14965235	14964937	8000	14961235	-4000	4000	3702
chr21	31667000	31675000	31667333	8000	31671000	-4000	4000	-3667
chr21	30333013	30341013	30337154	8000	30337013	-4000	4000	141
chr21	44881953	44889953	44888893	8000	44885953	-4000	4000	2940
chr21	46566015	46574015	46567747	8000	46570015	-4000	4000	-2268
chr21	30161565	30169565	30166519	8000	30165565	-4000	4000	954
chr21	41794225	41802225	41801321	8000	41798225	-4000	4000	3096
chr21	30210006	30218006	30215347	8000	30214006	-4000	4000	1341
chr21	30537535	30545535	30541664	8000	30541535	-4000	4000	129
chr21	26831755	26839755	26837927	8000	26835755	-4000	4000	2172
chr21	29171889	29179889	29174816	8000	29175889	-4000	4000	-1073
chr21	30161565	30169565	30166025	8000	30165565	-4000	4000	460
chr21	30367390	30375390	30371906	8000	30371390	-4000	4000	516
chr21	37199112	37207112	37200288	8000	37203112	-4000	4000	-2824
chr21	46566015	46574015	46566668	8000	46570015	-4000	4000	-3347
chr21	15876064	15884064	15878678	8000	15880064	-4000	4000	-1386
chr21	25768460	25776460	25769664	8000	25772460	-4000	4000	-2796
chr21	28924144	28932144	28930428	8000	28928144	-4000	4000	2284
chr21	31114416	31122416	31119682	8000	31118416	-4000	4000	1266
chr21	33580687	33588687	33582030	8000	33584687	-4000	4000	-2657
chr21	42293244	42301244	42294553	8000	42297244	-4000	4000	-2691
chr21	45938454	45946454	45940151	8000	45942454	-4000	4000	-2303
chr21	30616850	30624850	30620842	8000	30620850	-4000	4000	-8
chr21	14224372	14232372	14224507	8000	14228372	-4000	4000	-3865
chr21	14481228	14489228	14486100	8000	14485228	-4000	4000	872
chr21	30751015	30759015	30755158	8000	30755015	-4000	4000	143
chr21	30808697	30816697	30813037	8000	30812697	-4000	4000	340
chr21	43029931	43037931	43030027	8000	43033931	-4000	4000	-3904
chr21	46128848	46136848	46132489	8000	46132848	-4000	4000	-359
chr21	26831755	26839755	26839736	8000	26835755	-4000	4000	3981
chr21	30333013	30341013	30337362	8000	30337013	-4000	4000	349
chr21	30285145	30293145	30289397	8000	30289145	-4000	4000	252
chr21	46594604	46602604	46602314	8000	46598604	-4000	4000	3710
chr21	30161565	30169565	30166436	8000	30165565	-4000	4000	871
chr21	31114416	31122416	31120541	8000	31118416	-4000	4000	2125
chr21	36290274	36298274	36293699	8000	36294274	-4000	4000	-575
chr21	25768460	25776460	25769081	8000	25772460	-4000	4000	-3379
chr21	45259928	45267928	45267252	8000	45263928	-4000	4000	3324
chr21	46128848	46136848	46128994	8000	46132848	-4000	4000	-3854
chr21	34783801	34791801	34790893	8000	34787801	-4000	4000	3092
chr21	30492824	30500824	30496902	8000	30496824	-4000	4000	78
chr21	32729899	32737899	32734923	8000	32733899	-4000	4000	1024
chr21	34367381	34375381	34370769	8000	34371381	-4000	4000	-612
chr21	26462209	26470209	26468618	8000	26466209	-4000	4000	2409
chr21	30277309	30285309	30281996	8000	30281309	-4000	4000	687
chr21	30210006	30218006	30215554	8000	30214006	-4000	4000	1548
chr21	30210006	30218006	30215821	8000	30214006	-4000	4000	1815
chr21	30808697	30816697	30812925	8000	30812697	-4000	4000	228
chr21	41405393	41413393	41408135	8000	41409393	-4000	4000	-1258
chr21	44845585	44853585	44851396	8000	44849585	-4000	4000	1811
chr21	45259928	45267928	45266222	8000	45263928	-4000	4000	2294
chr21	30436869	30444869	30440535	8000	30440869	-4000	4000	-334
chr21	34367381	34375381	34370618	8000	34371381	-4000	4000	-763
chr21	33293160	33301160	33296286	8000	33297160	-4000	4000	-874
chr21	46001050	46009050	46001363	8000	46005050	-4000	4000	-3687
chr21	14957235	14965235	14964828	8000	14961235	-4000	4000	3593
chr21	15876064	15884064	15877826	8000	15880064	-4000	4000	-2238
chr21	17589579	17597579	17593930	8000	17593579	-4000	4000	351
chr21	25876550	25884550	25881645	8000	25880550	-4000	4000	1095
chr21	30277309	30285309	30282244	8000	30281309	-4000	4000	935
chr21	30277309	30285309	30282841	8000	30281309	-4000	4000	1532
chr21	32786673	32794673	32794338	8000	32790673	-4000	4000	3665
chr21	33499931	33507931	33505591	8000	33503931	-4000	4000	1660
chr21	33580687	33588687	33581413	8000	33584687	-4000	4000	-3274
chr21	33580687	33588687	33582217	8000	33584687	-4000	4000	-2470
chr21	38820955	38828955	38822805	8000	38824955	-4000	4000	-2150
chr21	39511506	39519506	39511764	8000	39515506	-4000	4000	-3742
chr21	30210006	30218006	30215542	8000	30214006	-4000	4000	1536
chr21	30427026	30435026	30430620	8000	30431026	-4000	4000	-406
chr21	34714227	34722227	34716413	8000	34718227	-4000	4000	-1814
chr21	42293244	42301244	42296341	8000	42297244	-4000	4000	-903
chr21	30751015	30759015	30755185	8000	30755015	-4000	4000	170
chr21	30609431	30617431	30613874	8000	30613431	-4000	4000	443
chr21	30344399	30352399	30348539	8000	30348399	-4000	4000	140
chr21	42912803	42920803	42919018	8000	42916803	-4000	4000	2215
chr21	44881953	44889953	44886241	8000	44885953	-4000	4000	288
chr21	33293160	33301160	33296363	8000	33297160	-4000	4000	-797
chr21	38376027	38384027	38383888	8000	38380027	-4000	4000	3861
chr21	43758307	43766307	43762081	8000	43762307	-4000	4000	-226
chr21	46594604	46602604	46602394	8000	46598604	-4000	4000	3790
chr21	30586105	30594105	30592559	8000	30590105	-4000	4000	2454
chr21	30315124	30323124	30319964	8000	30319124	-4000	4000	840
chr21	33481530	33489530	33488824	8000	33485530	-4000	4000	3294
chr21	32624759	32632759	32630775	8000	32628759	-4000	4000	2016
chr21	39338315	39346315	39342328	8000	39342315	-4000	4000	13
chr21	30537535	30545535	30541779	8000	30541535	-4000	4000	244
chr21	14957235	14965235	14964865	8000	14961235	-4000	4000	3630
chr21	25768460	25776460	25769382	8000	25772460	-4000	4000	-3078
chr21	43758307	43766307	43761813	8000	43762307	-4000	4000	-494
chr21	25876550	25884550	25881726	8000	25880550	-4000	4000	1176
chr21	25876550	25884550	25881727	8000	25880550	-4000	4000	1177
chr21	32729899	32737899	32734106	8000	32733899	-4000	4000	207
chr21	46128848	46136848	46132343	8000	46132848	-4000	4000	-505
chr21	30537535	30545535	30541773	8000	30541535	-4000	4000	238
chr21	30631619	30639619	30635310	8000	30635619	-4000	4000	-309
chr21	39798081	39806081	39801333	8000	39802081	-4000	4000	-748
chr21	30586105	30594105	30592908	8000	30590105	-4000	4000	2803
chr21	30421265	30429265	30425751	8000	30425265	-4000	4000	486
chr21	43758307	43766307	43760079	8000	43762307	-4000	4000	-2228
chr21	30609431	30617431	30613720	8000	30613431	-4000	4000	289
chr21	33481530	33489530	33488547	8000	33485530	-4000	4000	3017
chr21	30475706	30483706	30480066	8000	30479706	-4000	4000	360
chr21	30631619	30639619	30635326	8000	30635619	-4000	4000	-293
chr21	30277309	30285309	30282883	8000	30281309	-4000	4000	1574
chr21	33580687	33588687	33583491	8000	33584687	-4000	4000	-1196
chr21	30483043	30491043	30487349	8000	30487043	-4000	4000	306
chr21	46132160	46140160	46137061	8000	46136160	-4000	4000	901
chr21	46128848	46136848	46128974	8000	46132848	-4000	4000	-3874
chr21	30742794	30750794	30747039	8000	30746794	-4000	4000	245
chr21	42307667	42315667	42312223	8000	42311667	-4000	4000	556
chr22	38422327	38430327	38426830	8000	38426327	-4000	4000	503
chr22	20583632	20591632	20584989	8000	20587632	-4000	4000	-2643
chr22	22241515	22249515	22244957	8000	22245515	-4000	4000	-558
chr22	24624987	24632987	24627558	8000	24628987	-4000	4000	-1429
chr22	37675802	37683802	37678652	8000	37679802	-4000	4000	-1150
chr22	19126279	19134279	19132023	8000	19130279	-4000	4000	1744
chr22	20949747	20957747	20949773	8000	20953747	-4000	4000	-3974
chr22	39083743	39091743	39086341	8000	39087743	-4000	4000	-1402
chr22	32494829	32502829	32498726	8000	32498829	-4000	4000	-103
chr22	15717631	15725631	15721318	8000	15721631	-4000	4000	-313
chr22	16586751	16594751	16591644	8000	16590751	-4000	4000	893
chr22	46251663	46259663	46256975	8000	46255663	-4000	4000	1312
chr22	38479438	38487438	38482711	8000	38483438	-4000	4000	-727
chr22	41176077	41184077	41179638	8000	41180077	-4000	4000	-439
chr22	29438455	29446455	29438904	8000	29442455	-4000	4000	-3551
chr22	24624987	24632987	24627875	8000	24628987	-4000	4000	-1112
chr22	21024013	21032013	21030916	8000	21028013	-4000	4000	2903
chr22	37200237	37208237	37207591	8000	37204237	-4000	4000	3354
chr22	17111694	17119694	17117254	8000	17115694	-4000	4000	1560
chr22	36136330	36144330	36141523	8000	36140330	-4000	4000	1193
chr22	42081526	42089526	42083251	8000	42085526	-4000	4000	-2275
chr22	50176295	50184295	50177651	8000	50180295	-4000	4000	-2644
chr22	20404461	20412461	20406084	8000	20408461	-4000	4000	-2377
chr22	39739044	39747044	39744256	8000	39743044	-4000	4000	1212
chr22	24438356	24446356	24441128	8000	24442356	-4000	4000	-1228
chr22	20237415	20245415	20242747	8000	20241415	-4000	4000	1332
chr22	26487225	26495225	26488258	8000	26491225	-4000	4000	-2967
chr22	28790555	28798555	28795035	8000	28794555	-4000	4000	480
chr22	37200237	37208237	37206789	8000	37204237	-4000	4000	2552
chr22	50157690	50165690	50158238	8000	50161690	-4000	4000	-3452
chr22	23780316	23788316	23787148	8000	23784316	-4000	4000	2832
chr22	29726956	29734956	29729166	8000	29730956	-4000	4000	-1790
chr22	31130807	31138807	31133485	8000	31134807	-4000	4000	-1322
chr22	37813176	37821176	37815796	8000	37817176	-4000	4000	-1380
chr22	37200237	37208237	37207566	8000	37204237	-4000	4000	3329
chr22	15525139	15533139	15529076	8000	15529139	-4000	4000	-63
chr22	29053488	29061488	29059045	8000	29057488	-4000	4000	1557
chr22	32145006	32153006	32149547	8000	32149006	-4000	4000	541
chr22	37885407	37893407	37886780	8000	37889407	-4000	4000	-2627
chr22	38988778	38996778	38992513	8000	38992778	-4000	4000	-265
chr22	39488194	39496194	39488970	8000	39492194	-4000	4000	-3224
chr22	46251663	46259663	46258282	8000	46255663	-4000	4000	2619
chr22	50520780	50528780	50522876	8000	50524780	-4000	4000	-1904
chr22	38988778	38996778	38991500	8000	38992778	-4000	4000	-1278
chr22	36936439	36944439	36937992	8000	36940439	-4000	4000	-2447
chr22	16779412	16787412	16783806	8000	16783412	-4000	4000	394
chr22	16957936	16965936	16962709	8000	16961936	-4000	4000	773
chr22	36874017	36882017	36877783	8000	36878017	-4000	4000	-234
chr22	32214464	32222464	32218529	8000	32218464	-4000	4000	65
chr22	21447463	21455463	21450764	8000	21451463	-4000	4000	-699
chr22	24536423	24544423	24542971	8000	24540423	-4000	4000	2548
chr22	50482440	50490440	50483310	8000	50486440	-4000	4000	-3130
chr22	50157690	50165690	50158248	8000	50161690	-4000	4000	-3442
chr22	19445911	19453911	19450854	8000	19449911	-4000	4000	943
chr22	36222209	36230209	36228038	8000	36226209	-4000	4000	1829
chr22	46251663	46259663	46256488	8000	46255663	-4000	4000	825
chr22	35725483	35733483	35726845	8000	35729483	-4000	4000	-2638
chr22	45291874	45299874	45293224	8000	45295874	-4000	4000	-2650
chr22	15717631	15725631	15721600	8000	15721631	-4000	4000	-31
chr22	36874017	36882017	36877837	8000	36878017	-4000	4000	-180
chr22	41395326	41403326	41399071	8000	41399326	-4000	4000	-255
chr22	39488194	39496194	39488456	8000	39492194	-4000	4000	-3738
chr22	41994221	42002221	41997898	8000	41998221	-4000	4000	-323
chr22	44877162	44885162	44882962	8000	44881162	-4000	4000	1800
chr22	22241515	22249515	22245046	8000	22245515	-4000	4000	-469
chr22	39488194	39496194	39488224	8000	39492194	-4000	4000	-3970
chr22	50055391	50063391	50061604	8000	50059391	-4000	4000	2213
chr22	31952243	31960243	31956136	8000	31956243	-4000	4000	-107
chr22	20404461	20412461	20405677	8000	20408461	-4000	4000	-2784
chr22	22509736	22517736	22515607	8000	22513736	-4000	4000	1871
chr22	19032282	19040282	19039043	8000	19036282	-4000	4000	2761
chr22	37675802	37683802	37677038	8000	37679802	-4000	4000	-2764
chr22	37363960	37371960	37371509	8000	37367960	-4000	4000	3549
chr22	16779412	16787412	16784269	8000	16783412	-4000	4000	857
chr22	30173075	30181075	30176733	8000	30177075	-4000	4000	-342
chr22	32186435	32194435	32190649	8000	32190435	-4000	4000	214
chr22	45291874	45299874	45293242	8000	45295874	-4000	4000	-2632
chr22	36483190	36491190	36490236	8000	36487190	-4000	4000	3046
chr22	45184017	45192017	45186761	8000	45188017	-4000	4000	-1256
chr22	46326810	46334810	46330697	8000	46330810	-4000	4000	-113
chr22	20237415	20245415	20242567	8000	20241415	-4000	4000	1152
chr22	15717631	15725631	15721600	8000	15721631	-4000	4000	-31
chr22	16957936	16965936	16965219	8000	16961936	-4000	4000	3283
chr22	29438455	29446455	29441635	8000	29442455	-4000	4000	-820
chr22	31526634	31534634	31531055	8000	31530634	-4000	4000	421
chr22	22643898	22651898	22647638	8000	22647898	-4000	4000	-260
chr22	29766413	29774413	29767510	8000	29770413	-4000	4000	-2903
chr22	36185124	36193124	36191879	8000	36189124	-4000	4000	2755
chr22	50574959	50582959	50576992	8000	50578959	-4000	4000	-1967
chr22	22543701	22551701	22548177	8000	22547701	-4000	4000	476
chr22	19720224	19728224	19720651	8000	19724224	-4000	4000	-3573
chr22	36936439	36944439	36938422	8000	36940439	-4000	4000	-2017
chr22	50741339	50749339	50744785	8000	50745339	-4000	4000	-554
chr22	35725483	35733483	35726754	8000	35729483	-4000	4000	-2729
chr22	26027045	26035045	26027230	8000	26031045	-4000	4000	-3815
chr22	40678812	40686812	40679432	8000	40682812	-4000	4000	-3380
chr22	15717631	15725631	15721486	8000	15721631	-4000	4000	-145
chr22	50259713	50267713	50266794	8000	50263713	-4000	4000	3081
chr22	22543701	22551701	22548481	8000	22547701	-4000	4000	780
chr22	24438356	24446356	24441043	8000	24442356	-4000	4000	-1313
chr22	24438356	24446356	24441044	8000	24442356	-4000	4000	-1312
chr22	39739044	39747044	39743924	8000	39743044	-4000	4000	880
chr22	18601815	18609815	18608921	8000	18605815	-4000	4000	3106
chr22	36556857	36564857	36564640	8000	36560857	-4000	4000	3783
chr22	45841307	45849307	45843712	8000	45845307	-4000	4000	-1595
chr22	46353340	46361340	46355571	8000	46357340	-4000	4000	-1769
chr22	49886080	49894080	49887395	8000	49890080	-4000	4000	-2685
chr22	36987120	36995120	36991532	8000	36991120	-4000	4000	412
chr22	43035516	43043516	43039844	8000	43039516	-4000	4000	328
chr22	26487225	26495225	26488162	8000	26491225	-4000	4000	-3063
chr22	50441090	50449090	50448551	8000	50445090	-4000	4000	3461
chr22	21024013	21032013	21031419	8000	21028013	-4000	4000	3406
chr22	29694598	29702598	29694912	8000	29698598	-4000	4000	-3686
chr22	35083387	35091387	35084382	8000	35087387	-4000	4000	-3005
chr22	16586751	16594751	16590990	8000	16590751	-4000	4000	239
chr22	15525139	15533139	15529031	8000	15529139	-4000	4000	-108
chr22	38669850	38677850	38671110	8000	38673850	-4000	4000	-2740
chr22	38107495	38115495	38113502	8000	38111495	-4000	4000	2007
chr22	38107495	38115495	38110568	8000	38111495	-4000	4000	-927
chr22	32145006	32153006	32152597	8000	32149006	-4000	4000	3591
chr22	32214464	32222464	32221000	8000	32218464	-4000	4000	2536
chr22	40331808	40339808	40334433	8000	40335808	-4000	4000	-1375
chr22	16957936	16965936	16962574	8000	16961936	-4000	4000	638
chr22	23055415	23063415	23059519	8000	23059415	-4000	4000	104
chr22	46251663	46259663	46257442	8000	46255663	-4000	4000	1779
chr22	45340063	45348063	45344624	8000	45344063	-4000	4000	561
chr22	50618754	50626754	50625401	8000	50622754	-4000	4000	2647
chr22	32409845	32417845	32414315	8000	32413845	-4000	4000	470
chr22	36263530	36271530	36265452	8000	36267530	-4000	4000	-2078
chr22	38514948	38522948	38519809	8000	38518948	-4000	4000	861
chr22	41994221	42002221	41997210	8000	41998221	-4000	4000	-1011
chr22	45597135	45605135	45600580	8000	45601135	-4000	4000	-555
chr22	49886080	49894080	49886857	8000	49890080	-4000	4000	-3223
chr22	44877162	44885162	44883270	8000	44881162	-4000	4000	2108
chr22	29438455	29446455	29439429	8000	29442455	-4000	4000	-3026
chr22	17726855	17734855	17727144	8000	17730855	-4000	4000	-3711
chr22	21024013	21032013	21026485	8000	21028013	-4000	4000	-1528
chr22	21447463	21455463	21447955	8000	21451463	-4000	4000	-3508
chr22	28790555	28798555	28795061	8000	28794555	-4000	4000	506
chr22	29487390	29495390	29489297	8000	29491390	-4000	4000	-2093
chr22	29766413	29774413	29767507	8000	29770413	-4000	4000	-2906
chr22	30903824	30911824	30906782	8000	30907824	-4000	4000	-1042
chr22	28790555	28798555	28795006	8000	28794555	-4000	4000	451
chr22	17111694	17119694	17119282	8000	17115694	-4000	4000	3588
chr22	38422327	38430327	38427624	8000	38426327	-4000	4000	1297
chr22	18601815	18609815	18607415	8000	18605815	-4000	4000	1600
chr22	29438455	29446455	29441228	8000	29442455	-4000	4000	-1227
chr22	43125712	43133712	43133370	8000	43129712	-4000	4000	3658
chr22	30484902	30492902	30489867	8000	30488902	-4000	4000	965
chr22	30550635	30558635	30555642	8000	30554635	-4000	4000	1007
chr22	44877162	44885162	44883081	8000	44881162	-4000	4000	1919
chr22	23055415	23063415	23059639	8000	23059415	-4000	4000	224
chr22	20583632	20591632	20584410	8000	20587632	-4000	4000	-3222
chr22	21467269	21475269	21469718	8000	21471269	-4000	4000	-1551
chr22	23780316	23788316	23787036	8000	23784316	-4000	4000	2720
chr22	28785301	28793301	28786789	8000	28789301	-4000	4000	-2512
chr22	29766413	29774413	29767510	8000	29770413	-4000	4000	-2903
chr22	30903824	30911824	30907333	8000	30907824	-4000	4000	-491
chr22	36796684	36804684	36800729	8000	36800684	-4000	4000	45
chr22	38681543	38689543	38686466	8000	38685543	-4000	4000	923
chr22	50574959	50582959	50577840	8000	50578959	-4000	4000	-1119
chr22	19445911	19453911	19450798	8000	19449911	-4000	4000	887
chr22	22892111	22900111	22893806	8000	22896111	-4000	4000	-2305
chr22	36263530	36271530	36265411	8000	36267530	-4000	4000	-2119
chr22	50176295	50184295	50176950	8000	50180295	-4000	4000	-3345
chr22	50618754	50626754	50625391	8000	50622754	-4000	4000	2637
chr22	15717631	15725631	15721436	8000	15721631	-4000	4000	-195
chr22	31952243	31960243	31956699	8000	31956243	-4000	4000	456
chr22	38107495	38115495	38110571	8000	38111495	-4000	4000	-924
chr22	23695176	23703176	23698219	8000	23699176	-4000	4000	-957
chr22	17586995	17594995	17587220	8000	17590995	-4000	4000	-3775
chr22	23055415	23063415	23059506	8000	23059415	-4000	4000	91
chr22	18601815	18609815	18608217	8000	18605815	-4000	4000	2402
chr22	37025821	37033821	37029502	8000	37029821	-4000	4000	-319
chr22	46239755	46247755	46244971	8000	46243755	-4000	4000	1216
chr22	17133511	17141511	17138579	8000	17137511	-4000	4000	1068
chr22	22543701	22551701	22550245	8000	22547701	-4000	4000	2544
chr22	19720224	19728224	19720664	8000	19724224	-4000	4000	-3560
chr22	43524744	43532744	43530879	8000	43528744	-4000	4000	2135
chr22	22543701	22551701	22548328	8000	22547701	-4000	4000	627
chr22	29438455	29446455	29441851	8000	29442455	-4000	4000	-604
chr22	28790555	28798555	28795162	8000	28794555	-4000	4000	607
chr22	35390214	35398214	35393972	8000	35394214	-4000	4000	-242
chr22	24715034	24723034	24719568	8000	24719034	-4000	4000	534
chr22	45340063	45348063	45345482	8000	45344063	-4000	4000	1419
chr22	20144007	20152007	20145292	8000	20148007	-4000	4000	-2715
chr22	19516612	19524612	19524096	8000	19520612	-4000	4000	3484
chr22	22643898	22651898	22646375	8000	22647898	-4000	4000	-1523
chr22	50618754	50626754	50625664	8000	50622754	-4000	4000	2910
chr22	35390214	35398214	35393496	8000	35394214	-4000	4000	-718
chr22	29054672	29062672	29061861	8000	29058672	-4000	4000	3189
chr22	37938822	37946822	37945128	8000	37942822	-4000	4000	2306
chr22	46239755	46247755	46245096	8000	46243755	-4000	4000	1341
chr22	50055391	50063391	50061572	8000	50059391	-4000	4000	2181
chr22	36936439	36944439	36938634	8000	36940439	-4000	4000	-1805
chr22	40039534	40047534	40044952	8000	40043534	-4000	4000	1418
chr22	35734736	35742736	35738906	8000	35738736	-4000	4000	170
chr22	38669850	38677850	38670636	8000	38673850	-4000	4000	-3214
chr22	41994221	42002221	41994838	8000	41998221	-4000	4000	-3383
chr22	32186435	32194435	32191211	8000	32190435	-4000	4000	776
chr22	31130807	31138807	31136983	8000	31134807	-4000	4000	2176
chr22	19871517	19879517	19878391	8000	19875517	-4000	4000	2874
chr22	32357161	32365161	32358250	8000	32361161	-4000	4000	-2911
chr22	49886080	49894080	49886859	8000	49890080	-4000	4000	-3221
chr22	22509736	22517736	22513792	8000	22513736	-4000	4000	56
chr22	21633329	21641329	21636597	8000	21637329	-4000	4000	-732
chr22	29766413	29774413	29767543	8000	29770413	-4000	4000	-2870
chr22	26487225	26495225	26488142	8000	26491225	-4000	4000	-3083
chr22	26439423	26447423	26443165	8000	26443423	-4000	4000	-258
chr22	17174790	17182790	17181897	8000	17178790	-4000	4000	3107
chr22	38422327	38430327	38427437	8000	38426327	-4000	4000	1110
chr22	17174790	17182790	17181440	8000	17178790	-4000	4000	2650
chr22	22643898	22651898	22647228	8000	22647898	-4000	4000	-670
chr22	42570382	42578382	42571301	8000	42574382	-4000	4000	-3081
chr22	16957936	16965936	16962616	8000	16961936	-4000	4000	680
chr22	17726855	17734855	17727157	8000	17730855	-4000	4000	-3698
chr22	19720224	19728224	19721881	8000	19724224	-4000	4000	-2343
chr22	20237415	20245415	20242056	8000	20241415	-4000	4000	641
chr22	21633329	21641329	21635084	8000	21637329	-4000	4000	-2245
chr22	22509736	22517736	22514839	8000	22513736	-4000	4000	1103
chr22	22892111	22900111	22893724	8000	22896111	-4000	4000	-2387
chr22	29438455	29446455	29438694	8000	29442455	-4000	4000	-3761
chr22	29487390	29495390	29490723	8000	29491390	-4000	4000	-667
chr22	36222209	36230209	36227761	8000	36226209	-4000	4000	1552
chr22	36222209	36230209	36228121	8000	36226209	-4000	4000	1912
chr22	36874017	36882017	36875967	8000	36878017	-4000	4000	-2050
chr22	37200237	37208237	37207471	8000	37204237	-4000	4000	3234
chr22	38107495	38115495	38109145	8000	38111495	-4000	4000	-2350
chr22	39029276	39037276	39032247	8000	39033276	-4000	4000	-1029
chr22	39488194	39496194	39488606	8000	39492194	-4000	4000	-3588
chr22	39739044	39747044	39743763	8000	39743044	-4000	4000	719
chr22	41429494	41437494	41437040	8000	41433494	-4000	4000	3546
chr22	41795456	41803456	41799420	8000	41799456	-4000	4000	-36
chr22	41994221	42002221	41996929	8000	41998221	-4000	4000	-1292
chr22	41994221	42002221	41997083	8000	41998221	-4000	4000	-1138
chr22	46251663	46259663	46256470	8000	46255663	-4000	4000	807
chr22	46251663	46259663	46258469	8000	46255663	-4000	4000	2806
chr22	46251663	46259663	46259293	8000	46255663	-4000	4000	3630
chr22	50176295	50184295	50177606	8000	50180295	-4000	4000	-2689
chr22	50305030	50313030	50312184	8000	50309030	-4000	4000	3154
chr22	50441090	50449090	50447423	8000	50445090	-4000	4000	2333
chr22	50547112	50555112	50548338	8000	50551112	-4000	4000	-2774
chr22	22543701	22551701	22548257	8000	22547701	-4000	4000	556
chr22	18127720	18135720	18130883	8000	18131720	-4000	4000	-837
chr22	15717631	15725631	15721449	8000	15721631	-4000	4000	-182
chr22	50547112	50555112	50549498	8000	50551112	-4000	4000	-1614
chr22	37675802	37683802	37679648	8000	37679802	-4000	4000	-154
chr22	32186435	32194435	32193102	8000	32190435	-4000	4000	2667
chr22	42054456	42062456	42060263	8000	42058456	-4000	4000	1807
chr22	45340063	45348063	45340747	8000	45344063	-4000	4000	-3316
chr22	42831412	42839412	42831638	8000	42835412	-4000	4000	-3774
chr22	16586751	16594751	16590928	8000	16590751	-4000	4000	177
chr22	20977360	20985360	20979575	8000	20981360	-4000	4000	-1785
chr22	21024013	21032013	21031059	8000	21028013	-4000	4000	3046
chr22	21024013	21032013	21031498	8000	21028013	-4000	4000	3485
chr22	22509736	22517736	22514368	8000	22513736	-4000	4000	632
chr22	22509736	22517736	22515172	8000	22513736	-4000	4000	1436
chr22	22643898	22651898	22647778	8000	22647898	-4000	4000	-120
chr22	23569125	23577125	23573140	8000	23573125	-4000	4000	15
chr22	29487390	29495390	29489322	8000	29491390	-4000	4000	-2068
chr22	29766413	29774413	29767506	8000	29770413	-4000	4000	-2907
chr22	32109029	32117029	32110386	8000	32113029	-4000	4000	-2643
chr22	32409845	32417845	32417127	8000	32413845	-4000	4000	3282
chr22	37311341	37319341	37313482	8000	37315341	-4000	4000	-1859
chr22	38988778	38996778	38991540	8000	38992778	-4000	4000	-1238
chr22	39739044	39747044	39743628	8000	39743044	-4000	4000	584
chr22	39739044	39747044	39743868	8000	39743044	-4000	4000	824
chr22	43820509	43828509	43826036	8000	43824509	-4000	4000	1527
chr22	46251663	46259663	46258165	8000	46255663	-4000	4000	2502
chr22	46251663	46259663	46259249	8000	46255663	-4000	4000	3586
chr22	46251663	46259663	46259347	8000	46255663	-4000	4000	3684
chr22	46251663	46259663	46259613	8000	46255663	-4000	4000	3950
chr22	50574959	50582959	50576269	8000	50578959	-4000	4000	-2690
chr22	20949747	20957747	20949919	8000	20953747	-4000	4000	-3828
chr22	26626669	26634669	26630359	8000	26630669	-4000	4000	-310
chr22	50729298	50737298	50731773	8000	50733298	-4000	4000	-1525
chr22	36263530	36271530	36265698	8000	36267530	-4000	4000	-1832
chr22	23780316	23788316	23782473	8000	23784316	-4000	4000	-1843
chr22	46251663	46259663	46256658	8000	46255663	-4000	4000	995
chr22	46251663	46259663	46256659	8000	46255663	-4000	4000	996
chr22	50157690	50165690	50161365	8000	50161690	-4000	4000	-325
chr22	40406054	40414054	40411867	8000	40410054	-4000	4000	1813
chr22	50618754	50626754	50626231	8000	50622754	-4000	4000	3477
chr22	18601815	18609815	18608013	8000	18605815	-4000	4000	2198
chr22	29438455	29446455	29441470	8000	29442455	-4000	4000	-985
chr22	21447463	21455463	21450628	8000	21451463	-4000	4000	-835
chr22	32186435	32194435	32191170	8000	32190435	-4000	4000	735
chr22	22480421	22488421	22488138	8000	22484421	-4000	4000	3717
chr22	36136330	36144330	36141383	8000	36140330	-4000	4000	1053
chr22	46251663	46259663	46258823	8000	46255663	-4000	4000	3160
chr22	22480421	22488421	22487949	8000	22484421	-4000	4000	3528
chr22	22543701	22551701	22550203	8000	22547701	-4000	4000	2502
chr22	29487390	29495390	29489323	8000	29491390	-4000	4000	-2067
chr22	39969721	39977721	39970918	8000	39973721	-4000	4000	-2803
chr22	37803432	37811432	37810084	8000	37807432	-4000	4000	2652
chr22	18601815	18609815	18608209	8000	18605815	-4000	4000	2394
chr22	15525139	15533139	15528924	8000	15529139	-4000	4000	-215
chr22	22643898	22651898	22647713	8000	22647898	-4000	4000	-185
chr22	23780316	23788316	23780467	8000	23784316	-4000	4000	-3849
chr22	26027045	26035045	26027583	8000	26031045	-4000	4000	-3462
chr22	35083387	35091387	35085827	8000	35087387	-4000	4000	-1560
chr22	46251663	46259663	46257123	8000	46255663	-4000	4000	1460
chr22	36222209	36230209	36227891	8000	36226209	-4000	4000	1682
chr22	46251663	46259663	46258304	8000	46255663	-4000	4000	2641
chr22	39051972	39059972	39052749	8000	39055972	-4000	4000	-3223
chr22	30903824	30911824	30906283	8000	30907824	-4000	4000	-1541
chr22	40406054	40414054	40410505	8000	40410054	-4000	4000	451
chr22	32186435	32194435	32192962	8000	32190435	-4000	4000	2527
chr22	32494829	32502829	32495519	8000	32498829	-4000	4000	-3310
chr22	50482440	50490440	50483272	8000	50486440	-4000	4000	-3168
chr22	30903824	30911824	30905885	8000	30907824	-4000	4000	-1939
chr22	38215291	38223291	38219476	8000	38219291	-4000	4000	185
chr22	39518683	39526683	39522687	8000	39522683	-4000	4000	4
chr22	37025821	37033821	37029412	8000	37029821	-4000	4000	-409
chr22	38681543	38689543	38683777	8000	38685543	-4000	4000	-1766
chr22	46251663	46259663	46259095	8000	46255663	-4000	4000	3432
chr22	46251663	46259663	46257544	8000	46255663	-4000	4000	1881
chr22	46251663	46259663	46259119	8000	46255663	-4000	4000	3456
chr22	26027045	26035045	26027504	8000	26031045	-4000	4000	-3541
chr22	19142993	19150993	19148992	8000	19146993	-4000	4000	1999
chr22	37662932	37670932	37666773	8000	37666932	-4000	4000	-159
chr22	29438455	29446455	29438528	8000	29442455	-4000	4000	-3927
chr22	50763501	50771501	50768833	8000	50767501	-4000	4000	1332
chr22	17586995	17594995	17594585	8000	17590995	-4000	4000	3590
chr22	50498949	50506949	50506796	8000	50502949	-4000	4000	3847
chr22	19779223	19787223	19782915	8000	19783223	-4000	4000	-308
chr22	32357161	32365161	32358325	8000	32361161	-4000	4000	-2836
chr22	37803432	37811432	37810077	8000	37807432	-4000	4000	2645
chr22	15525139	15533139	15528966	8000	15529139	-4000	4000	-173
chr22	37938822	37946822	37944193	8000	37942822	-4000	4000	1371
chr22	45428509	45436509	45431008	8000	45432509	-4000	4000	-1501
chr22	30550635	30558635	30555023	8000	30554635	-4000	4000	388
chr22	24438356	24446356	24441758	8000	24442356	-4000	4000	-598
chr22	32357161	32365161	32360359	8000	32361161	-4000	4000	-802
chr22	23780316	23788316	23782336	8000	23784316	-4000	4000	-1980
chr22	40678812	40686812	40681008	8000	40682812	-4000	4000	-1804
chr22	37311341	37319341	37313642	8000	37315341	-4000	4000	-1699
chr22	29487390	29495390	29490074	8000	29491390	-4000	4000	-1316
chr22	24624987	24632987	24627535	8000	24628987	-4000	4000	-1452
chr22	32186435	32194435	32193041	8000	32190435	-4000	4000	2606
chr22	37363960	37371960	37371193	8000	37367960	-4000	4000	3233
chr22	23780316	23788316	23782155	8000	23784316	-4000	4000	-2161
chr22	29438455	29446455	29439025	8000	29442455	-4000	4000	-3430
chr22	30550635	30558635	30555972	8000	30554635	-4000	4000	1337
chr22	30903824	30911824	30906549	8000	30907824	-4000	4000	-1275
chr22	36936439	36944439	36938074	8000	36940439	-4000	4000	-2365
chr22	19326698	19334698	19331183	8000	19330698	-4000	4000	485
chr22	16586751	16594751	16591070	8000	16590751	-4000	4000	319
chr22	44877162	44885162	44881698	8000	44881162	-4000	4000	536
chr22	44877162	44885162	44882264	8000	44881162	-4000	4000	1102
chr22	41240779	41248779	41246543	8000	41244779	-4000	4000	1764
chrX	65737931	65745931	65738972	8000	65741931	-4000	4000	-2959
chrX	153578939	153586939	153580335	8000	153582939	-4000	4000	-2604
chrX	71140103	71148103	71148044	8000	71144103	-4000	4000	3941
chrX	103495130	103503130	103499798	8000	103499130	-4000	4000	668
chrX	54441454	54449454	54444635	8000	54445454	-4000	4000	-819
chrX	70236659	70244659	70239839	8000	70240659	-4000	4000	-820
chrX	103495130	103503130	103500438	8000	103499130	-4000	4000	1308
chrX	112453112	112461112	112455506	8000	112457112	-4000	4000	-1606
chrX	26136736	26144736	26139556	8000	26140736	-4000	4000	-1180
chrX	70501490	70509490	70503778	8000	70505490	-4000	4000	-1712
chrX	78959727	78967727	78961111	8000	78963727	-4000	4000	-2616
chrX	135755846	135763846	135760403	8000	135759846	-4000	4000	557
chrX	148022665	148030665	148024992	8000	148026665	-4000	4000	-1673
chrX	152723484	152731484	152727662	8000	152727484	-4000	4000	178
chrX	143504735	143512735	143509110	8000	143508735	-4000	4000	375
chrX	78959727	78967727	78960530	8000	78963727	-4000	4000	-3197
chrX	112453112	112461112	112455631	8000	112457112	-4000	4000	-1481
chrX	120621674	120629674	120626515	8000	120625674	-4000	4000	841
chrX	17796049	17804049	17801068	8000	17800049	-4000	4000	1019
chrX	55074909	55082909	55076100	8000	55078909	-4000	4000	-2809
chrX	70035472	70043472	70041951	8000	70039472	-4000	4000	2479
chrX	78959727	78967727	78961191	8000	78963727	-4000	4000	-2536
chrX	154831788	154839788	154837639	8000	154835788	-4000	4000	1851
chrX	34940915	34948915	34943145	8000	34944915	-4000	4000	-1770
chrX	54812015	54820015	54814456	8000	54816015	-4000	4000	-1559
chrX	126159499	126167499	126164666	8000	126163499	-4000	4000	1167
chrX	136043269	136051269	136044536	8000	136047269	-4000	4000	-2733
chrX	34125752	34133752	34130016	8000	34129752	-4000	4000	264
chrX	17796049	17804049	17800612	8000	17800049	-4000	4000	563
chrX	1306381	1314381	1309445	8000	1310381	-4000	4000	-936
chrX	2930045	2938045	2934921	8000	2934045	-4000	4000	876
chrX	11771772	11779772	11772194	8000	11775772	-4000	4000	-3578
chrX	12919169	12927169	12919464	8000	12923169	-4000	4000	-3705
chrX	14002726	14010726	14009168	8000	14006726	-4000	4000	2442
chrX	34940915	34948915	34944264	8000	34944915	-4000	4000	-651
chrX	47089314	47097314	47092995	8000	47093314	-4000	4000	-319
chrX	53076615	53084615	53077396	8000	53080615	-4000	4000	-3219
chrX	55480616	55488616	55488017	8000	55484616	-4000	4000	3401
chrX	57114551	57122551	57119774	8000	57118551	-4000	4000	1223
chrX	70429390	70437390	70431117	8000	70433390	-4000	4000	-2273
chrX	72297691	72305691	72302111	8000	72301691	-4000	4000	420
chrX	83508127	83516127	83509454	8000	83512127	-4000	4000	-2673
chrX	87666050	87674050	87669298	8000	87670050	-4000	4000	-752
chrX	103305346	103313346	103309949	8000	103309346	-4000	4000	603
chrX	103374164	103382164	103377640	8000	103378164	-4000	4000	-524
chrX	116170974	116178974	116172993	8000	116174974	-4000	4000	-1981
chrX	135909062	135917062	135909767	8000	135913062	-4000	4000	-3295
chrX	149881835	149889835	149884454	8000	149885835	-4000	4000	-1381
chrX	23782210	23790210	23783848	8000	23786210	-4000	4000	-2362
chrX	143504735	143512735	143508898	8000	143508735	-4000	4000	163
chrX	102600159	102608159	102603512	8000	102604159	-4000	4000	-647
chrX	17796049	17804049	17800447	8000	17800049	-4000	4000	398
chrX	51486011	51494011	51491553	8000	51490011	-4000	4000	1542
chrX	70429390	70437390	70431086	8000	70433390	-4000	4000	-2304
chrX	135578510	135586510	135581615	8000	135582510	-4000	4000	-895
chrX	40644305	40652305	40647031	8000	40648305	-4000	4000	-1274
chrX	121046094	121054094	121047916	8000	121050094	-4000	4000	-2178
chrX	155060034	155068034	155064006	8000	155064034	-4000	4000	-28
chrX	34125752	34133752	34131996	8000	34129752	-4000	4000	2244
chrX	101341661	101349661	101348585	8000	101345661	-4000	4000	2924
chrX	23935509	23943509	23938618	8000	23939509	-4000	4000	-891
chrX	18649629	18657629	18656669	8000	18653629	-4000	4000	3040
chrX	54928961	54936961	54933871	8000	54932961	-4000	4000	910
chrX	70035472	70043472	70042204	8000	70039472	-4000	4000	2732
chrX	78267468	78275468	78272946	8000	78271468	-4000	4000	1478
chrX	85088284	85096284	85094166	8000	85092284	-4000	4000	1882
chrX	139951728	139959728	139956669	8000	139955728	-4000	4000	941
chrX	27819014	27827014	27822012	8000	27823014	-4000	4000	-1002
chrX	40644305	40652305	40647039	8000	40648305	-4000	4000	-1266
chrX	48969720	48977720	48969767	8000	48973720	-4000	4000	-3953
chrX	135029546	135037546	135032977	8000	135033546	-4000	4000	-569
chrX	151921171	151929171	151924469	8000	151925171	-4000	4000	-702
chrX	17731994	17739994	17732445	8000	17735994	-4000	4000	-3549
chrX	149713268	149721268	149716113	8000	149717268	-4000	4000	-1155
chrX	116457686	116465686	116459237	8000	116461686	-4000	4000	-2449
chrX	126545383	126553383	126551549	8000	126549383	-4000	4000	2166
chrX	131269506	131277506	131275555	8000	131273506	-4000	4000	2049
chrX	1399139	1407139	1403383	8000	1403139	-4000	4000	244
chrX	101651281	101659281	101655664	8000	101655281	-4000	4000	383
chrX	51898354	51906354	51901820	8000	51902354	-4000	4000	-534
chrX	3108727	3116727	3112391	8000	3112727	-4000	4000	-336
chrX	55449566	55457566	55453106	8000	55453566	-4000	4000	-460
chrX	151741564	151749564	151744397	8000	151745564	-4000	4000	-1167
chrX	24999694	25007694	25004639	8000	25003694	-4000	4000	945
chrX	40644305	40652305	40651835	8000	40648305	-4000	4000	3530
chrX	1306381	1314381	1309527	8000	1310381	-4000	4000	-854
chrX	27456207	27464207	27462114	8000	27460207	-4000	4000	1907
chrX	57593477	57601477	57594630	8000	57597477	-4000	4000	-2847
chrX	153868221	153876221	153868399	8000	153872221	-4000	4000	-3822
chrX	69156851	69164851	69163218	8000	69160851	-4000	4000	2367
chrX	26191646	26199646	26195026	8000	26195646	-4000	4000	-620
chrX	79171318	79179318	79171499	8000	79175318	-4000	4000	-3819
chrX	114999975	115007975	115004007	8000	115003975	-4000	4000	32
chrX	46878358	46886358	46881545	8000	46882358	-4000	4000	-813
chrX	101550700	101558700	101554245	8000	101554700	-4000	4000	-455
chrX	20145911	20153911	20151088	8000	20149911	-4000	4000	1177
chrX	72297691	72305691	72305311	8000	72301691	-4000	4000	3620
chrX	111289779	111297779	111295127	8000	111293779	-4000	4000	1348
chrX	145825856	145833856	145828669	8000	145829856	-4000	4000	-1187
chrX	101651281	101659281	101655967	8000	101655281	-4000	4000	686
chrX	106028435	106036435	106034242	8000	106032435	-4000	4000	1807
chrX	120868607	120876607	120875352	8000	120872607	-4000	4000	2745
chrX	24363839	24371839	24365294	8000	24367839	-4000	4000	-2545
chrX	110519021	110527021	110521151	8000	110523021	-4000	4000	-1870
chrX	151741564	151749564	151744132	8000	151745564	-4000	4000	-1432
chrX	71528374	71536374	71529923	8000	71532374	-4000	4000	-2451
chrX	23782210	23790210	23783865	8000	23786210	-4000	4000	-2345
chrX	47441178	47449178	47447614	8000	47445178	-4000	4000	2436
chrX	153868221	153876221	153868690	8000	153872221	-4000	4000	-3531
chrX	88750785	88758785	88754382	8000	88754785	-4000	4000	-403
chrX	6529618	6537618	6534150	8000	6533618	-4000	4000	532
chrX	149544210	149552210	149546788	8000	149548210	-4000	4000	-1422
chrX	151921171	151929171	151924279	8000	151925171	-4000	4000	-892
chrX	132071943	132079943	132077650	8000	132075943	-4000	4000	1707
chrX	149881835	149889835	149884673	8000	149885835	-4000	4000	-1162
chrX	17796049	17804049	17801704	8000	17800049	-4000	4000	1655
chrX	119611724	119619724	119618632	8000	119615724	-4000	4000	2908
chrX	153056467	153064467	153058535	8000	153060467	-4000	4000	-1932
chrX	83508127	83516127	83508868	8000	83512127	-4000	4000	-3259
chrX	104007147	104015147	104013429	8000	104011147	-4000	4000	2282
chrX	120621674	120629674	120626396	8000	120625674	-4000	4000	722
chrX	46878358	46886358	46881489	8000	46882358	-4000	4000	-869
chrX	27456207	27464207	27462939	8000	27460207	-4000	4000	2732
chrX	55622192	55630192	55624159	8000	55626192	-4000	4000	-2033
chrX	76427342	76435342	76430128	8000	76431342	-4000	4000	-1214
chrX	93708274	93716274	93710695	8000	93712274	-4000	4000	-1579
chrX	133531745	133539745	133535784	8000	133535745	-4000	4000	39
chrX	85269362	85277362	85270668	8000	85273362	-4000	4000	-2694
chrX	151177465	151185465	151180164	8000	151181465	-4000	4000	-1301
chrX	13766939	13774939	13772815	8000	13770939	-4000	4000	1876
chrX	47441178	47449178	47448751	8000	47445178	-4000	4000	3573
chrX	27745942	27753942	27747898	8000	27749942	-4000	4000	-2044
chrX	51742232	51750232	51744801	8000	51746232	-4000	4000	-1431
chrX	102600159	102608159	102603344	8000	102604159	-4000	4000	-815
chrX	13314647	13322647	13319576	8000	13318647	-4000	4000	929
chrX	126545383	126553383	126552237	8000	126549383	-4000	4000	2854
chrX	135359413	135367413	135359912	8000	135363413	-4000	4000	-3501
chrX	1399139	1407139	1403447	8000	1403139	-4000	4000	308
chrX	142198342	142206342	142203954	8000	142202342	-4000	4000	1612
chrX	81109699	81117699	81114954	8000	81113699	-4000	4000	1255
chrX	55220108	55228108	55224027	8000	55224108	-4000	4000	-81
chrX	101345447	101353447	101353237	8000	101349447	-4000	4000	3790
chrX	101408297	101416297	101413483	8000	101412297	-4000	4000	1186
chrX	154483306	154491306	154487669	8000	154487306	-4000	4000	363
chrX	300529	308529	307460	8000	304529	-4000	4000	2931
chrX	132071943	132079943	132078561	8000	132075943	-4000	4000	2618
chrX	151741564	151749564	151743128	8000	151745564	-4000	4000	-2436
chrX	31067233	31075233	31071644	8000	31071233	-4000	4000	411
chrX	152723484	152731484	152727647	8000	152727484	-4000	4000	163
chrX	136489780	136497780	136492084	8000	136493780	-4000	4000	-1696
chrX	102749530	102757530	102749859	8000	102753530	-4000	4000	-3671
chrX	106204956	106212956	106206858	8000	106208956	-4000	4000	-2098
chrX	134883632	134891632	134889129	8000	134887632	-4000	4000	1497
chrX	51742232	51750232	51745257	8000	51746232	-4000	4000	-975
chrX	101408297	101416297	101413321	8000	101412297	-4000	4000	1024
chrX	47211128	47219128	47211225	8000	47215128	-4000	4000	-3903
chrX	102600159	102608159	102603440	8000	102604159	-4000	4000	-719
chrX	102934300	102942300	102937717	8000	102938300	-4000	4000	-583
chrX	126545383	126553383	126551487	8000	126549383	-4000	4000	2104
chrX	140498985	140506985	140504644	8000	140502985	-4000	4000	1659
chrX	27819014	27827014	27822421	8000	27823014	-4000	4000	-593
chrX	44143872	44151872	44148819	8000	44147872	-4000	4000	947
chrX	89918883	89926883	89922123	8000	89922883	-4000	4000	-760
chrX	104038454	104046454	104040127	8000	104042454	-4000	4000	-2327
chrX	30248040	30256040	30250977	8000	30252040	-4000	4000	-1063
chrX	2899972	2907972	2907340	8000	2903972	-4000	4000	3368
chrX	17731994	17739994	17732326	8000	17735994	-4000	4000	-3668
chrX	17796049	17804049	17801625	8000	17800049	-4000	4000	1576
chrX	29952718	29960718	29955622	8000	29956718	-4000	4000	-1096
chrX	47441178	47449178	47447432	8000	47445178	-4000	4000	2254
chrX	47619172	47627172	47619776	8000	47623172	-4000	4000	-3396
chrX	54927431	54935431	54927734	8000	54931431	-4000	4000	-3697
chrX	64911802	64919802	64918920	8000	64915802	-4000	4000	3118
chrX	76427342	76435342	76429147	8000	76431342	-4000	4000	-2195
chrX	104007147	104015147	104013618	8000	104011147	-4000	4000	2471
chrX	121046094	121054094	121049458	8000	121050094	-4000	4000	-636
chrX	126817786	126825786	126821076	8000	126821786	-4000	4000	-710
chrX	131085885	131093885	131088765	8000	131089885	-4000	4000	-1120
chrX	136489780	136497780	136492286	8000	136493780	-4000	4000	-1494
chrX	139951728	139959728	139958078	8000	139955728	-4000	4000	2350
chrX	141893832	141901832	141897001	8000	141897832	-4000	4000	-831
chrX	153798166	153806166	153803598	8000	153802166	-4000	4000	1432
chrX	12886361	12894361	12887309	8000	12890361	-4000	4000	-3052
chrX	76174314	76182314	76177730	8000	76178314	-4000	4000	-584
chrX	118822968	118830968	118825479	8000	118826968	-4000	4000	-1489
chrX	136412890	136420890	136414241	8000	136416890	-4000	4000	-2649
chrX	152698347	152706347	152701363	8000	152702347	-4000	4000	-984
chrX	91434584	91442584	91435650	8000	91438584	-4000	4000	-2934
chrX	120868607	120876607	120875304	8000	120872607	-4000	4000	2697
chrX	139722346	139730346	139728825	8000	139726346	-4000	4000	2479
chrX	126159499	126167499	126164585	8000	126163499	-4000	4000	1086
chrX	34125752	34133752	34131267	8000	34129752	-4000	4000	1515
chrX	136209220	136217220	136210075	8000	136213220	-4000	4000	-3145
chrX	152129310	152137310	152135459	8000	152133310	-4000	4000	2149
chrX	102655083	102663083	102657343	8000	102659083	-4000	4000	-1740
chrX	3304565	3312565	3310522	8000	3308565	-4000	4000	1957
chrX	21881423	21889423	21882615	8000	21885423	-4000	4000	-2808
chrX	34125752	34133752	34130819	8000	34129752	-4000	4000	1067
chrX	46493422	46501422	46500341	8000	46497422	-4000	4000	2919
chrX	49164483	49172483	49165298	8000	49168483	-4000	4000	-3185
chrX	50912641	50920641	50916354	8000	50916641	-4000	4000	-287
chrX	51742232	51750232	51744906	8000	51746232	-4000	4000	-1326
chrX	64220194	64228194	64224202	8000	64224194	-4000	4000	8
chrX	70277840	70285840	70283574	8000	70281840	-4000	4000	1734
chrX	78267468	78275468	78273239	8000	78271468	-4000	4000	1771
chrX	78267468	78275468	78273671	8000	78271468	-4000	4000	2203
chrX	83508127	83516127	83508656	8000	83512127	-4000	4000	-3471
chrX	83508127	83516127	83509170	8000	83512127	-4000	4000	-2957
chrX	131085885	131093885	131088645	8000	131089885	-4000	4000	-1240
chrX	132072990	132080990	132080227	8000	132076990	-4000	4000	3237
chrX	135578510	135586510	135579952	8000	135582510	-4000	4000	-2558
chrX	152984824	152992824	152990659	8000	152988824	-4000	4000	1835
chrX	154446654	154454654	154448494	8000	154450654	-4000	4000	-2160
chrX	153056467	153064467	153058535	8000	153060467	-4000	4000	-1932
chrX	134561838	134569838	134566625	8000	134565838	-4000	4000	787
chrX	72868025	72876025	72872378	8000	72872025	-4000	4000	353
chrX	1382152	1390152	1389512	8000	1386152	-4000	4000	3360
chrX	21881423	21889423	21882516	8000	21885423	-4000	4000	-2907
chrX	47410498	47418498	47413605	8000	47414498	-4000	4000	-893
chrX	14727812	14735812	14730739	8000	14731812	-4000	4000	-1073
chrX	78125295	78133295	78130708	8000	78129295	-4000	4000	1413
chrX	114906061	114914061	114906668	8000	114910061	-4000	4000	-3393
chrX	128046962	128054962	128051540	8000	128050962	-4000	4000	578
chrX	26191646	26199646	26194448	8000	26195646	-4000	4000	-1198
chrX	55254415	55262415	55260597	8000	55258415	-4000	4000	2182
chrX	49201063	49209063	49205670	8000	49205063	-4000	4000	607
chrX	70501490	70509490	70504517	8000	70505490	-4000	4000	-973
chrX	102136426	102144426	102140500	8000	102140426	-4000	4000	74
chrX	123596561	123604561	123600777	8000	123600561	-4000	4000	216
chrX	150510178	150518178	150512504	8000	150514178	-4000	4000	-1674
chrX	136508346	136516346	136509112	8000	136512346	-4000	4000	-3234
chrX	119074635	119082635	119081447	8000	119078635	-4000	4000	2812
chrX	153647326	153655326	153650147	8000	153651326	-4000	4000	-1179
chrX	77500880	77508880	77507247	8000	77504880	-4000	4000	2367
chrX	35799735	35807735	35803123	8000	35803735	-4000	4000	-612
chrX	151719194	151727194	151721914	8000	151723194	-4000	4000	-1280
chrX	57593477	57601477	57594447	8000	57597477	-4000	4000	-3030
chrX	66591637	66599637	66599628	8000	66595637	-4000	4000	3991
chrX	70236659	70244659	70237073	8000	70240659	-4000	4000	-3586
chrX	139951728	139959728	139955816	8000	139955728	-4000	4000	88
chrX	54927431	54935431	54928643	8000	54931431	-4000	4000	-2788
chrX	154647972	154655972	154653324	8000	154651972	-4000	4000	1352
chrX	102509682	102517682	102513987	8000	102513682	-4000	4000	305
chrX	34940915	34948915	34944461	8000	34944915	-4000	4000	-454
chrX	132071943	132079943	132077650	8000	132075943	-4000	4000	1707
chrX	132622015	132630015	132628489	8000	132626015	-4000	4000	2474
chrX	78267468	78275468	78273042	8000	78271468	-4000	4000	1574
chrX	79171318	79179318	79171375	8000	79175318	-4000	4000	-3943
chrX	102655083	102663083	102656062	8000	102659083	-4000	4000	-3021
chrX	103788619	103796619	103789379	8000	103792619	-4000	4000	-3240
chrX	47441178	47449178	47448344	8000	47445178	-4000	4000	3166
chrX	78267468	78275468	78273336	8000	78271468	-4000	4000	1868
chrX	50912641	50920641	50916301	8000	50916641	-4000	4000	-340
chrX	120868607	120876607	120873871	8000	120872607	-4000	4000	1264
chrX	27819014	27827014	27821419	8000	27823014	-4000	4000	-1595
chrX	30248040	30256040	30251198	8000	30252040	-4000	4000	-842
chrX	135909062	135917062	135912867	8000	135913062	-4000	4000	-195
chrX	26191646	26199646	26194798	8000	26195646	-4000	4000	-848
chrX	46493422	46501422	46499599	8000	46497422	-4000	4000	2177
chrX	73208299	73216299	73213941	8000	73212299	-4000	4000	1642
chrX	103495130	103503130	103500304	8000	103499130	-4000	4000	1174
chrX	102509682	102517682	102514122	8000	102513682	-4000	4000	440
chrX	29952718	29960718	29955828	8000	29956718	-4000	4000	-890
chrX	64911802	64919802	64917186	8000	64915802	-4000	4000	1384
chrX	12919169	12927169	12920856	8000	12923169	-4000	4000	-2313
chrX	51742232	51750232	51744596	8000	51746232	-4000	4000	-1636
chrX	153665733	153673733	153672143	8000	153669733	-4000	4000	2410
chrX	34125752	34133752	34131780	8000	34129752	-4000	4000	2028
chrX	53076615	53084615	53076996	8000	53080615	-4000	4000	-3619
chrX	100595885	100603885	100599790	8000	100599885	-4000	4000	-95
chrX	101341661	101349661	101348786	8000	101345661	-4000	4000	3125
chrX	101611118	101619118	101616491	8000	101615118	-4000	4000	1373
chrX	115303563	115311563	115306304	8000	115307563	-4000	4000	-1259
chrX	131085885	131093885	131088656	8000	131089885	-4000	4000	-1229
chrX	152162234	152170234	152168492	8000	152166234	-4000	4000	2258
chrX	152733669	152741669	152737164	8000	152737669	-4000	4000	-505
chrX	153056467	153064467	153057885	8000	153060467	-4000	4000	-2582
chrX	44840888	44848888	44844467	8000	44844888	-4000	4000	-421
chrX	79171318	79179318	79171501	8000	79175318	-4000	4000	-3817
chrX	34125752	34133752	34131740	8000	34129752	-4000	4000	1988
chrX	100986831	100994831	100987545	8000	100990831	-4000	4000	-3286
chrX	103495130	103503130	103500573	8000	103499130	-4000	4000	1443
chrX	152822994	152830994	152827705	8000	152826994	-4000	4000	711
chrX	103071810	103079810	103078598	8000	103075810	-4000	4000	2788
chrX	26136736	26144736	26139463	8000	26140736	-4000	4000	-1273
chrX	153071019	153079019	153073694	8000	153075019	-4000	4000	-1325
chrX	34940915	34948915	34943398	8000	34944915	-4000	4000	-1517
chrX	71099532	71107532	71101416	8000	71103532	-4000	4000	-2116
chrX	86828604	86836604	86832227	8000	86832604	-4000	4000	-377
chrX	119584337	119592337	119590271	8000	119588337	-4000	4000	1934
chrX	152698347	152706347	152701953	8000	152702347	-4000	4000	-394
chrX	152762136	152770136	152766530	8000	152766136	-4000	4000	394
chrX	71609583	71617583	71612882	8000	71613583	-4000	4000	-701
chrX	54744918	54752918	54751276	8000	54748918	-4000	4000	2358
chrX	49109407	49117407	49115925	8000	49113407	-4000	4000	2518
chrX	149544210	149552210	149545845	8000	149548210	-4000	4000	-2365
chrX	23782210	23790210	23785782	8000	23786210	-4000	4000	-428
chrX	26191646	26199646	26193818	8000	26195646	-4000	4000	-1828
chrX	76427342	76435342	76429120	8000	76431342	-4000	4000	-2222
chrX	111756649	111764649	111759913	8000	111760649	-4000	4000	-736
chrX	119074635	119082635	119081336	8000	119078635	-4000	4000	2701
chrX	141905374	141913374	141905714	8000	141909374	-4000	4000	-3660
chrX	154405168	154413168	154405587	8000	154409168	-4000	4000	-3581
chrX	27973992	27981992	27980399	8000	27977992	-4000	4000	2407
chrX	73451171	73459171	73454587	8000	73455171	-4000	4000	-584
chrX	102934300	102942300	102938058	8000	102938300	-4000	4000	-242
chrX	135046932	135054932	135052047	8000	135050932	-4000	4000	1115
chrX	14002726	14010726	14009014	8000	14006726	-4000	4000	2288
chrX	110519021	110527021	110521641	8000	110523021	-4000	4000	-1380
chrX	23935509	23943509	23938631	8000	23939509	-4000	4000	-878
chrX	135029546	135037546	135033462	8000	135033546	-4000	4000	-84
chrX	65737931	65745931	65739837	8000	65741931	-4000	4000	-2094
chrX	3304565	3312565	3309559	8000	3308565	-4000	4000	994
chrX	150986771	150994771	150987846	8000	150990771	-4000	4000	-2925
chrX	153665733	153673733	153671822	8000	153669733	-4000	4000	2089
chrX	27973992	27981992	27980907	8000	27977992	-4000	4000	2915
chrX	119072373	119080373	119073993	8000	119076373	-4000	4000	-2380
chrX	112770503	112778503	112778418	8000	112774503	-4000	4000	3915
chrX	121046094	121054094	121048552	8000	121050094	-4000	4000	-1542
chrX	145252208	145260208	145255715	8000	145256208	-4000	4000	-493
chrX	149592556	149600556	149597961	8000	149596556	-4000	4000	1405
chrX	150986771	150994771	150988085	8000	150990771	-4000	4000	-2686
chrX	30233495	30241495	30236776	8000	30237495	-4000	4000	-719
chrX	140779578	140787578	140783887	8000	140783578	-4000	4000	309
chrX	147947125	147955125	147949344	8000	147951125	-4000	4000	-1781
chrX	27745942	27753942	27747055	8000	27749942	-4000	4000	-2887
chrX	142198342	142206342	142202945	8000	142202342	-4000	4000	603
chrX	78754714	78762714	78755923	8000	78758714	-4000	4000	-2791
chrX	110519021	110527021	110521570	8000	110523021	-4000	4000	-1451
chrX	126159499	126167499	126164788	8000	126163499	-4000	4000	1289
chrX	30248040	30256040	30250568	8000	30252040	-4000	4000	-1472
chrX	141693411	141701411	141697643	8000	141697411	-4000	4000	232
chrX	21650695	21658695	21657474	8000	21654695	-4000	4000	2779
chrX	142198342	142206342	142203770	8000	142202342	-4000	4000	1428
chrX	57593477	57601477	57593657	8000	57597477	-4000	4000	-3820
chrX	3304565	3312565	3310986	8000	3308565	-4000	4000	2421
chrX	55622192	55630192	55624502	8000	55626192	-4000	4000	-1690
chrX	108075184	108083184	108077081	8000	108079184	-4000	4000	-2103
chrX	70060179	70068179	70063244	8000	70064179	-4000	4000	-935
chrX	132071943	132079943	132077650	8000	132075943	-4000	4000	1707
chrX	128046962	128054962	128051913	8000	128050962	-4000	4000	951
chrX	50186777	50194777	50192939	8000	50190777	-4000	4000	2162
chrX	52640061	52648061	52644530	8000	52644061	-4000	4000	469
chrX	133212662	133220662	133217050	8000	133216662	-4000	4000	388
chrX	133212662	133220662	133217051	8000	133216662	-4000	4000	389
chrX	57485193	57493193	57488821	8000	57489193	-4000	4000	-372
chrX	103305346	103313346	103309509	8000	103309346	-4000	4000	163
chrX	85088284	85096284	85093191	8000	85092284	-4000	4000	907
chrX	103818327	103826327	103825703	8000	103822327	-4000	4000	3376
chrX	1458581	1466581	1466217	8000	1462581	-4000	4000	3636
chrX	118822968	118830968	118825274	8000	118826968	-4000	4000	-1694
chrX	139722346	139730346	139728911	8000	139726346	-4000	4000	2565
chrX	106204956	106212956	106205667	8000	106208956	-4000	4000	-3289
chrX	49201063	49209063	49205664	8000	49205063	-4000	4000	601
chrX	70277840	70285840	70284630	8000	70281840	-4000	4000	2790
chrX	139559459	139567459	139560814	8000	139563459	-4000	4000	-2645
chrX	152733669	152741669	152736849	8000	152737669	-4000	4000	-820
chrX	108151607	108159607	108159493	8000	108155607	-4000	4000	3886
chrX	102600159	102608159	102603530	8000	102604159	-4000	4000	-629
chrX	103213246	103221246	103216470	8000	103217246	-4000	4000	-776
chrX	34940915	34948915	34943685	8000	34944915	-4000	4000	-1230
chrX	50186777	50194777	50192795	8000	50190777	-4000	4000	2018
chrX	72297691	72305691	72301898	8000	72301691	-4000	4000	207
chrX	85269362	85277362	85270066	8000	85273362	-4000	4000	-3296
chrX	121046094	121054094	121048882	8000	121050094	-4000	4000	-1212
chrX	154155032	154163032	154156489	8000	154159032	-4000	4000	-2543
chrX	142198342	142206342	142203120	8000	142202342	-4000	4000	778
chrX	26136736	26144736	26139736	8000	26140736	-4000	4000	-1000
chrX	51404843	51412843	51406955	8000	51408843	-4000	4000	-1888
chrX	51404843	51412843	51408199	8000	51408843	-4000	4000	-644
chrX	78267468	78275468	78273399	8000	78271468	-4000	4000	1931
chrX	151177465	151185465	151180580	8000	151181465	-4000	4000	-885
chrX	18649629	18657629	18650583	8000	18653629	-4000	4000	-3046
chrX	145825856	145833856	145829353	8000	145829856	-4000	4000	-503
chrX	103818327	103826327	103825742	8000	103822327	-4000	4000	3415
chrX	112770503	112778503	112776772	8000	112774503	-4000	4000	2269
chrX	149713268	149721268	149716421	8000	149717268	-4000	4000	-847
chrX	73208299	73216299	73213455	8000	73212299	-4000	4000	1156
chrX	70254166	70262166	70259416	8000	70258166	-4000	4000	1250
chrX	10233660	10241660	10235343	8000	10237660	-4000	4000	-2317
chrX	31067233	31075233	31071781	8000	31071233	-4000	4000	548
chrX	40644305	40652305	40651821	8000	40648305	-4000	4000	3516
chrX	50186777	50194777	50193343	8000	50190777	-4000	4000	2566
chrX	45108779	45116779	45110251	8000	45112779	-4000	4000	-2528
chrX	53076615	53084615	53077768	8000	53080615	-4000	4000	-2847
chrX	151177465	151185465	151180160	8000	151181465	-4000	4000	-1305
chrX	49201063	49209063	49208656	8000	49205063	-4000	4000	3593
chrX	35799735	35807735	35802640	8000	35803735	-4000	4000	-1095
chrX	54441454	54449454	54444092	8000	54445454	-4000	4000	-1362
chrX	75778987	75786987	75784267	8000	75782987	-4000	4000	1280
chrX	130054071	130062071	130056008	8000	130058071	-4000	4000	-2063
chrX	51404843	51412843	51408340	8000	51408843	-4000	4000	-503
chrX	119611724	119619724	119618767	8000	119615724	-4000	4000	3043
chrX	46493422	46501422	46500050	8000	46497422	-4000	4000	2628
chrX	46493422	46501422	46500517	8000	46497422	-4000	4000	3095
chrX	107709221	107717221	107714729	8000	107713221	-4000	4000	1508
chrX	140999706	141007706	141002675	8000	141003706	-4000	4000	-1031
chrX	13314647	13322647	13319871	8000	13318647	-4000	4000	1224
chrX	109368906	109376906	109376126	8000	109372906	-4000	4000	3220
chrX	134988473	134996473	134992080	8000	134992473	-4000	4000	-393
chrX	154417726	154425726	154420902	8000	154421726	-4000	4000	-824
chrX	120254398	120262398	120256803	8000	120258398	-4000	4000	-1595
chrX	12886361	12894361	12887523	8000	12890361	-4000	4000	-2838
chrX	48182220	48190220	48186821	8000	48186220	-4000	4000	601
chrX	57901430	57909430	57908881	8000	57905430	-4000	4000	3451
chrX	79356384	79364384	79361068	8000	79360384	-4000	4000	684
chrX	85857180	85865180	85862421	8000	85861180	-4000	4000	1241
chrX	12720523	12728523	12721782	8000	12724523	-4000	4000	-2741
chrX	136661547	136669547	136665835	8000	136665547	-4000	4000	288
chrX	64264081	64272081	64269038	8000	64268081	-4000	4000	957
chrX	121046094	121054094	121049559	8000	121050094	-4000	4000	-535
chrX	70201704	70209704	70201972	8000	70205704	-4000	4000	-3732
chrX	103354462	103362462	103357944	8000	103358462	-4000	4000	-518
chrX	136508346	136516346	136510164	8000	136512346	-4000	4000	-2182
chrX	34940915	34948915	34943558	8000	34944915	-4000	4000	-1357
chrX	26157824	26165824	26161275	8000	26161824	-4000	4000	-549
chrX	34940915	34948915	34943297	8000	34944915	-4000	4000	-1618
chrX	54744918	54752918	54750107	8000	54748918	-4000	4000	1189
chrX	106204956	106212956	106205865	8000	106208956	-4000	4000	-3091
chrX	131269506	131277506	131275126	8000	131273506	-4000	4000	1620
chrX	48687427	48695427	48688311	8000	48691427	-4000	4000	-3116
chrX	48687427	48695427	48688917	8000	48691427	-4000	4000	-2510
chrX	107709221	107717221	107716730	8000	107713221	-4000	4000	3509
chrX	69156851	69164851	69162704	8000	69160851	-4000	4000	1853
chrX	48687427	48695427	48689433	8000	48691427	-4000	4000	-1994
chrX	126545383	126553383	126550970	8000	126549383	-4000	4000	1587
chrX	153071019	153079019	153074809	8000	153075019	-4000	4000	-210
chrX	108693545	108701545	108696451	8000	108697545	-4000	4000	-1094
chrX	130180870	130188870	130184435	8000	130184870	-4000	4000	-435
chrX	155254235	155262235	155261071	8000	155258235	-4000	4000	2836
chrX	129925761	129933761	129929550	8000	129929761	-4000	4000	-211
chrX	153583925	153591925	153588408	8000	153587925	-4000	4000	483
chrX	13708244	13716244	13716096	8000	13712244	-4000	4000	3852
chrX	55622192	55630192	55624286	8000	55626192	-4000	4000	-1906
chrX	64911802	64919802	64917904	8000	64915802	-4000	4000	2102
chrX	71099532	71107532	71101529	8000	71103532	-4000	4000	-2003
chrX	105763829	105771829	105767496	8000	105767829	-4000	4000	-333
chrX	152733669	152741669	152736753	8000	152737669	-4000	4000	-916
chrX	126817786	126825786	126821286	8000	126821786	-4000	4000	-500
chrX	152733669	152741669	152737250	8000	152737669	-4000	4000	-419
chrX	49604538	49612538	49606068	8000	49608538	-4000	4000	-2470
chrX	152762136	152770136	152766608	8000	152766136	-4000	4000	472
chrX	30248040	30256040	30251417	8000	30252040	-4000	4000	-623
chrX	50186777	50194777	50193714	8000	50190777	-4000	4000	2937
chrX	102749530	102757530	102750130	8000	102753530	-4000	4000	-3400
chrX	132071943	132079943	132077650	8000	132075943	-4000	4000	1707
chrX	50361409	50369409	50368996	8000	50365409	-4000	4000	3587
chrX	85088284	85096284	85094934	8000	85092284	-4000	4000	2650
chrX	136209220	136217220	136209323	8000	136213220	-4000	4000	-3897
chrX	10233660	10241660	10233760	8000	10237660	-4000	4000	-3900
chrX	17796049	17804049	17801940	8000	17800049	-4000	4000	1891
chrX	27745942	27753942	27748239	8000	27749942	-4000	4000	-1703
chrX	93666930	93674930	93671718	8000	93670930	-4000	4000	788
chrX	102934300	102942300	102938080	8000	102938300	-4000	4000	-220
chrX	149881835	149889835	149884761	8000	149885835	-4000	4000	-1074
chrX	151921171	151929171	151923818	8000	151925171	-4000	4000	-1353
chrX	153647326	153655326	153650207	8000	153651326	-4000	4000	-1119
chrX	47211128	47219128	47214584	8000	47215128	-4000	4000	-544
chrX	50186777	50194777	50193099	8000	50190777	-4000	4000	2322
chrX	71099532	71107532	71104787	8000	71103532	-4000	4000	1255
chrX	72157750	72165750	72159959	8000	72161750	-4000	4000	-1791
chrX	128046962	128054962	128051887	8000	128050962	-4000	4000	925
chrX	141893832	141901832	141897252	8000	141897832	-4000	4000	-580
chrX	12886361	12894361	12887910	8000	12890361	-4000	4000	-2451
chrX	37007664	37015664	37008734	8000	37011664	-4000	4000	-2930
chrX	102136426	102144426	102141162	8000	102140426	-4000	4000	736
chrX	153868221	153876221	153868336	8000	153872221	-4000	4000	-3885
chrX	103213246	103221246	103216855	8000	103217246	-4000	4000	-391
chrX	150986771	150994771	150987302	8000	150990771	-4000	4000	-3469
chrX	88750785	88758785	88753506	8000	88754785	-4000	4000	-1279
chrX	131269506	131277506	131275592	8000	131273506	-4000	4000	2086
chrX	149925527	149933527	149932756	8000	149929527	-4000	4000	3229
chrX	83508127	83516127	83509238	8000	83512127	-4000	4000	-2889
chrX	141905374	141913374	141907694	8000	141909374	-4000	4000	-1680
chrX	151177465	151185465	151180720	8000	151181465	-4000	4000	-745
chrX	35799735	35807735	35802161	8000	35803735	-4000	4000	-1574
chrX	47441178	47449178	47448368	8000	47445178	-4000	4000	3190
chrX	51742232	51750232	51745665	8000	51746232	-4000	4000	-567
chrX	101651281	101659281	101655896	8000	101655281	-4000	4000	615
chrX	101651281	101659281	101656544	8000	101655281	-4000	4000	1263
chrX	108150671	108158671	108153806	8000	108154671	-4000	4000	-865
chrX	136661547	136669547	136667892	8000	136665547	-4000	4000	2345
chrX	47211128	47219128	47214809	8000	47215128	-4000	4000	-319
chrX	47441178	47449178	47447620	8000	47445178	-4000	4000	2442
chrX	135046932	135054932	135052061	8000	135050932	-4000	4000	1129
chrX	140999706	141007706	141003705	8000	141003706	-4000	4000	-1
chrX	18235313	18243313	18241093	8000	18239313	-4000	4000	1780
chrX	52792144	52800144	52796503	8000	52796144	-4000	4000	359
chrX	153979194	153987194	153982631	8000	153983194	-4000	4000	-563
chrX	132622015	132630015	132628914	8000	132626015	-4000	4000	2899
chrX	6529618	6537618	6533946	8000	6533618	-4000	4000	328
chrX	103213246	103221246	103216559	8000	103217246	-4000	4000	-687
chrX	118822968	118830968	118826073	8000	118826968	-4000	4000	-895
chrX	51742232	51750232	51744680	8000	51746232	-4000	4000	-1552
chrX	140779578	140787578	140784142	8000	140783578	-4000	4000	564
chrX	152822994	152830994	152827914	8000	152826994	-4000	4000	920
chrX	26157824	26165824	26161516	8000	26161824	-4000	4000	-308
chrX	26191646	26199646	26194486	8000	26195646	-4000	4000	-1160
chrX	68721842	68729842	68724478	8000	68725842	-4000	4000	-1364
chrX	70921579	70929579	70927804	8000	70925579	-4000	4000	2225
chrX	91434584	91442584	91436256	8000	91438584	-4000	4000	-2328
chrX	102934300	102942300	102937507	8000	102938300	-4000	4000	-793
chrX	111241099	111249099	111247986	8000	111245099	-4000	4000	2887
chrX	120868607	120876607	120875391	8000	120872607	-4000	4000	2784
chrX	135909062	135917062	135911251	8000	135913062	-4000	4000	-1811
chrX	149713268	149721268	149716675	8000	149717268	-4000	4000	-593
chrX	149881835	149889835	149884681	8000	149885835	-4000	4000	-1154
chrX	37007664	37015664	37009869	8000	37011664	-4000	4000	-1795
chrX	26157824	26165824	26161732	8000	26161824	-4000	4000	-92
chrX	21650695	21658695	21657454	8000	21654695	-4000	4000	2759
chrX	126545383	126553383	126551990	8000	126549383	-4000	4000	2607
chrX	64181117	64189117	64187445	8000	64185117	-4000	4000	2328
chrX	2930045	2938045	2935107	8000	2934045	-4000	4000	1062
chrX	50186777	50194777	50192694	8000	50190777	-4000	4000	1917
chrX	78754714	78762714	78754852	8000	78758714	-4000	4000	-3862
chrX	152733669	152741669	152736987	8000	152737669	-4000	4000	-682
chrX	7894247	7902247	7900768	8000	7898247	-4000	4000	2521
chrX	7894247	7902247	7900769	8000	7898247	-4000	4000	2522
chrX	2215506	2223506	2220932	8000	2219506	-4000	4000	1426
chrX	78754714	78762714	78756893	8000	78758714	-4000	4000	-1821
chrX	135909062	135917062	135911315	8000	135913062	-4000	4000	-1747
chrX	103818327	103826327	103825703	8000	103822327	-4000	4000	3376
chrX	27973992	27981992	27981152	8000	27977992	-4000	4000	3160
chrX	152984824	152992824	152990814	8000	152988824	-4000	4000	1990
chrX	79356384	79364384	79362601	8000	79360384	-4000	4000	2217
chrX	70254166	70262166	70258701	8000	70258166	-4000	4000	535
chrX	81109699	81117699	81116239	8000	81113699	-4000	4000	2540
chrX	93666930	93674930	93672935	8000	93670930	-4000	4000	2005
chrX	48182220	48190220	48190177	8000	48186220	-4000	4000	3957
chrX	141893832	141901832	141896649	8000	141897832	-4000	4000	-1183
chrX	49201063	49209063	49208645	8000	49205063	-4000	4000	3582
chrX	119074635	119082635	119081379	8000	119078635	-4000	4000	2744
chrX	149772867	149780867	149774785	8000	149776867	-4000	4000	-2082
chrX	130409656	130417656	130412739	8000	130413656	-4000	4000	-917
chrX	153056467	153064467	153059798	8000	153060467	-4000	4000	-669
chrX	30554809	30562809	30559899	8000	30558809	-4000	4000	1090
chrX	47441178	47449178	47448858	8000	47445178	-4000	4000	3680
chrX	13766939	13774939	13768194	8000	13770939	-4000	4000	-2745
chrX	30216089	30224089	30218974	8000	30220089	-4000	4000	-1115
chrX	151921171	151929171	151923722	8000	151925171	-4000	4000	-1449
chrX	47441178	47449178	47447483	8000	47445178	-4000	4000	2305
chrX	49164483	49172483	49165049	8000	49168483	-4000	4000	-3434
chrX	74301034	74309034	74304261	8000	74305034	-4000	4000	-773
chrX	78754714	78762714	78755544	8000	78758714	-4000	4000	-3170
chrX	152723484	152731484	152727491	8000	152727484	-4000	4000	7
chrX	136207359	136215359	136208503	8000	136211359	-4000	4000	-2856
chrX	101550700	101558700	101552938	8000	101554700	-4000	4000	-1762
chrX	140779578	140787578	140784008	8000	140783578	-4000	4000	430
chrX	37007664	37015664	37009534	8000	37011664	-4000	4000	-2130
chrX	47244328	47252328	47244689	8000	47248328	-4000	4000	-3639
chrX	56563868	56571868	56565577	8000	56567868	-4000	4000	-2291
chrX	70201704	70209704	70204317	8000	70205704	-4000	4000	-1387
chrX	101651281	101659281	101656002	8000	101655281	-4000	4000	721
chrX	118822968	118830968	118826566	8000	118826968	-4000	4000	-402
chrX	69156851	69164851	69163068	8000	69160851	-4000	4000	2217
chrX	78959727	78967727	78960830	8000	78963727	-4000	4000	-2897
chrX	116457686	116465686	116461983	8000	116461686	-4000	4000	297
chrX	152733669	152741669	152736242	8000	152737669	-4000	4000	-1427
chrX	49315841	49323841	49317184	8000	49319841	-4000	4000	-2657
chrX	153868221	153876221	153869545	8000	153872221	-4000	4000	-2676
chrX	34125752	34133752	34131378	8000	34129752	-4000	4000	1626
chrX	149772867	149780867	149775040	8000	149776867	-4000	4000	-1827
chrX	102749530	102757530	102751934	8000	102753530	-4000	4000	-1596
chrX	153056467	153064467	153057208	8000	153060467	-4000	4000	-3259
chrX	134561838	134569838	134566418	8000	134565838	-4000	4000	580
chrX	141893832	141901832	141897536	8000	141897832	-4000	4000	-296
chrX	71099532	71107532	71104073	8000	71103532	-4000	4000	541
chrX	8462510	8470510	8466351	8000	8466510	-4000	4000	-159
chrX	55088842	55096842	55091393	8000	55092842	-4000	4000	-1449
chrX	71099532	71107532	71104392	8000	71103532	-4000	4000	860
chrX	139951728	139959728	139955740	8000	139955728	-4000	4000	12
chrX	141905374	141913374	141907075	8000	141909374	-4000	4000	-2299
chrX	118790535	118798535	118792049	8000	118794535	-4000	4000	-2486
chrX	18235313	18243313	18240733	8000	18239313	-4000	4000	1420
chrX	48918024	48926024	48918610	8000	48922024	-4000	4000	-3414
chrX	71099532	71107532	71103321	8000	71103532	-4000	4000	-211
chrX	45108779	45116779	45111607	8000	45112779	-4000	4000	-1172
chrX	70921579	70929579	70926097	8000	70925579	-4000	4000	518
chrX	27973992	27981992	27979573	8000	27977992	-4000	4000	1581
chrX	149713268	149721268	149716520	8000	149717268	-4000	4000	-748
chrX	149713268	149721268	149716754	8000	149717268	-4000	4000	-514
chrX	57901430	57909430	57908039	8000	57905430	-4000	4000	2609
chrX	141905374	141913374	141905516	8000	141909374	-4000	4000	-3858
chrX	114999975	115007975	115004010	8000	115003975	-4000	4000	35
chrX	126159499	126167499	126164887	8000	126163499	-4000	4000	1388
chrX	27973992	27981992	27979587	8000	27977992	-4000	4000	1595
chrX	15277697	15285697	15283618	8000	15281697	-4000	4000	1921
chrX	152733669	152741669	152736875	8000	152737669	-4000	4000	-794
chrX	103305346	103313346	103310406	8000	103309346	-4000	4000	1060
chrX	55220108	55228108	55221802	8000	55224108	-4000	4000	-2306
chrX	70236659	70244659	70238313	8000	70240659	-4000	4000	-2346
chrX	78652068	78660068	78658073	8000	78656068	-4000	4000	2005
chrX	120422148	120430148	120428559	8000	120426148	-4000	4000	2411
chrX	152969481	152977481	152971298	8000	152973481	-4000	4000	-2183
chrX	114906061	114914061	114907165	8000	114910061	-4000	4000	-2896
chrX	30727462	30735462	30728769	8000	30731462	-4000	4000	-2693
chrX	55480616	55488616	55487548	8000	55484616	-4000	4000	2932
chrX	85088284	85096284	85094945	8000	85092284	-4000	4000	2661
chrX	91434584	91442584	91435559	8000	91438584	-4000	4000	-3025
chrX	154831788	154839788	154837543	8000	154835788	-4000	4000	1755
chrX	54928961	54936961	54930160	8000	54932961	-4000	4000	-2801
chrX	50186777	50194777	50193594	8000	50190777	-4000	4000	2817
chrX	153583925	153591925	153588187	8000	153587925	-4000	4000	262
chrX	135909062	135917062	135910429	8000	135913062	-4000	4000	-2633
chrX	152733669	152741669	152740735	8000	152737669	-4000	4000	3066
chrX	17731994	17739994	17732112	8000	17735994	-4000	4000	-3882
chrX	51404843	51412843	51408546	8000	51408843	-4000	4000	-297
chrX	37007664	37015664	37010197	8000	37011664	-4000	4000	-1467
chrX	50186777	50194777	50193428	8000	50190777	-4000	4000	2651
chrX	13314647	13322647	13319780	8000	13318647	-4000	4000	1133
chrX	73073276	73081276	73077850	8000	73077276	-4000	4000	574
chrX	112453112	112461112	112457124	8000	112457112	-4000	4000	12
chrX	70201704	70209704	70204469	8000	70205704	-4000	4000	-1235
chrX	152762136	152770136	152767066	8000	152766136	-4000	4000	930
chrX	78652068	78660068	78657141	8000	78656068	-4000	4000	1073
chrX	91434584	91442584	91435699	8000	91438584	-4000	4000	-2885
chrX	48342427	48350427	48348294	8000	48346427	-4000	4000	1867
chrX	53427258	53435258	53433813	8000	53431258	-4000	4000	2555
chrX	154439467	154447467	154446511	8000	154443467	-4000	4000	3044
chrX	101651281	101659281	101657120	8000	101655281	-4000	4000	1839
chrX	130059955	130067955	130067196	8000	130063955	-4000	4000	3241
chrX	136209220	136217220	136210068	8000	136213220	-4000	4000	-3152
chrX	77903376	77911376	77905227	8000	77907376	-4000	4000	-2149
chrX	153979194	153987194	153981977	8000	153983194	-4000	4000	-1217
chrX	152756222	152764222	152760041	8000	152760222	-4000	4000	-181
chrX	34125752	34133752	34130648	8000	34129752	-4000	4000	896
chrX	133019168	133027168	133026918	8000	133023168	-4000	4000	3750
chrX	18823921	18831921	18825755	8000	18827921	-4000	4000	-2166
chrX	129588561	129596561	129589000	8000	129592561	-4000	4000	-3561
chrX	114906061	114914061	114907103	8000	114910061	-4000	4000	-2958
chrX	126817786	126825786	126821328	8000	126821786	-4000	4000	-458
chrX	78125295	78133295	78126050	8000	78129295	-4000	4000	-3245
chrX	30554809	30562809	30560279	8000	30558809	-4000	4000	1470
chrX	155060034	155068034	155065330	8000	155064034	-4000	4000	1296
chrX	8462510	8470510	8465353	8000	8466510	-4000	4000	-1157
chrX	13314647	13322647	13318893	8000	13318647	-4000	4000	246
chrX	37007664	37015664	37009509	8000	37011664	-4000	4000	-2155
chrX	48687427	48695427	48688096	8000	48691427	-4000	4000	-3331
chrX	112453112	112461112	112455364	8000	112457112	-4000	4000	-1748
chrX	148022665	148030665	148024946	8000	148026665	-4000	4000	-1719
chrX	17796049	17804049	17801514	8000	17800049	-4000	4000	1465
chrX	27745942	27753942	27747675	8000	27749942	-4000	4000	-2267
chrX	34125752	34133752	34132111	8000	34129752	-4000	4000	2359
chrX	47410498	47418498	47413458	8000	47414498	-4000	4000	-1040
chrX	152733669	152741669	152740971	8000	152737669	-4000	4000	3302
chrX	153798166	153806166	153803572	8000	153802166	-4000	4000	1406
chrX	77453278	77461278	77454212	8000	77457278	-4000	4000	-3066
chrX	48516814	48524814	48520412	8000	48520814	-4000	4000	-402
chrX	55449566	55457566	55453020	8000	55453566	-4000	4000	-546
chrX	135029546	135037546	135032656	8000	135033546	-4000	4000	-890
chrX	81109699	81117699	81115090	8000	81113699	-4000	4000	1391
chrX	102600159	102608159	102602578	8000	102604159	-4000	4000	-1581
chrX	102655083	102663083	102657353	8000	102659083	-4000	4000	-1730
chrX	152733669	152741669	152736811	8000	152737669	-4000	4000	-858
chrX	116457686	116465686	116458980	8000	116461686	-4000	4000	-2706
chrX	24554087	24562087	24560794	8000	24558087	-4000	4000	2707
chrX	70201704	70209704	70205065	8000	70205704	-4000	4000	-639
chrX	71099532	71107532	71101659	8000	71103532	-4000	4000	-1873
chrX	78125295	78133295	78129904	8000	78129295	-4000	4000	609
chrX	81294547	81302547	81297280	8000	81298547	-4000	4000	-1267
chrX	13314647	13322647	13319991	8000	13318647	-4000	4000	1344
chrX	130054071	130062071	130056182	8000	130058071	-4000	4000	-1889
chrX	130369361	130377361	130373007	8000	130373361	-4000	4000	-354
chrX	37007664	37015664	37009149	8000	37011664	-4000	4000	-2515
chrX	48909182	48917182	48915095	8000	48913182	-4000	4000	1913
chrX	70035472	70043472	70043199	8000	70039472	-4000	4000	3727
chrX	78652068	78660068	78658386	8000	78656068	-4000	4000	2318
chrX	151719194	151727194	151721501	8000	151723194	-4000	4000	-1693
chrX	80441311	80449311	80442948	8000	80445311	-4000	4000	-2363
chrX	37007664	37015664	37010562	8000	37011664	-4000	4000	-1102
chrX	101408297	101416297	101413231	8000	101412297	-4000	4000	934
chrX	30823442	30831442	30831194	8000	30827442	-4000	4000	3752
chrX	44840888	44848888	44844223	8000	44844888	-4000	4000	-665
chrX	48957378	48965378	48962121	8000	48961378	-4000	4000	743
chrX	50186777	50194777	50193686	8000	50190777	-4000	4000	2909
chrX	89918883	89926883	89922797	8000	89922883	-4000	4000	-86
chrX	101092367	101100367	101096305	8000	101096367	-4000	4000	-62
chrX	101878288	101886288	101883428	8000	101882288	-4000	4000	1140
chrX	128046962	128054962	128051447	8000	128050962	-4000	4000	485
chrX	151719194	151727194	151722953	8000	151723194	-4000	4000	-241
chrX	50186777	50194777	50193260	8000	50190777	-4000	4000	2483
chrX	13031617	13039617	13036867	8000	13035617	-4000	4000	1250
chrX	79356384	79364384	79361146	8000	79360384	-4000	4000	762
chrX	57593477	57601477	57594951	8000	57597477	-4000	4000	-2526
chrX	103305346	103313346	103309523	8000	103309346	-4000	4000	177
chrX	140498985	140506985	140504607	8000	140502985	-4000	4000	1622
chrX	71609583	71617583	71612515	8000	71613583	-4000	4000	-1068
chrX	132622015	132630015	132628506	8000	132626015	-4000	4000	2491
chrX	143707955	143715955	143712493	8000	143711955	-4000	4000	538
chrX	102655083	102663083	102656785	8000	102659083	-4000	4000	-2298
chrX	45108779	45116779	45110250	8000	45112779	-4000	4000	-2529
chrX	149544210	149552210	149545677	8000	149548210	-4000	4000	-2533
chrX	103495130	103503130	103500738	8000	103499130	-4000	4000	1608
chrX	136412890	136420890	136414164	8000	136416890	-4000	4000	-2726
chrX	12886361	12894361	12888620	8000	12890361	-4000	4000	-1741
chrX	145825856	145833856	145827906	8000	145829856	-4000	4000	-1950
chrX	151921171	151929171	151924618	8000	151925171	-4000	4000	-553
chrX	30823442	30831442	30830518	8000	30827442	-4000	4000	3076
chrX	51742232	51750232	51745402	8000	51746232	-4000	4000	-830
chrX	69156851	69164851	69162294	8000	69160851	-4000	4000	1443
chrX	47441178	47449178	47448986	8000	47445178	-4000	4000	3808
chrX	44519639	44527639	44527278	8000	44523639	-4000	4000	3639
chrX	51898354	51906354	51901833	8000	51902354	-4000	4000	-521
chrX	131269506	131277506	131275503	8000	131273506	-4000	4000	1997
chrX	152733669	152741669	152737223	8000	152737669	-4000	4000	-446
chrX	131085885	131093885	131086626	8000	131089885	-4000	4000	-3259
chrX	103818327	103826327	103825759	8000	103822327	-4000	4000	3432
chrX	71099532	71107532	71106011	8000	71103532	-4000	4000	2479
chrX	27456207	27464207	27460819	8000	27460207	-4000	4000	612
chrX	50095235	50103235	50097438	8000	50099235	-4000	4000	-1797
chrX	74529917	74537917	74531548	8000	74533917	-4000	4000	-2369
chrX	118682163	118690163	118685785	8000	118686163	-4000	4000	-378
chrX	124371903	124379903	124371903	8000	124375903	-4000	4000	-4000
chrX	14002726	14010726	14008987	8000	14006726	-4000	4000	2261
chrX	70236659	70244659	70238273	8000	70240659	-4000	4000	-2386
chrX	107601255	107609255	107602555	8000	107605255	-4000	4000	-2700
chrX	110519021	110527021	110521974	8000	110523021	-4000	4000	-1047
chrX	114906061	114914061	114907031	8000	114910061	-4000	4000	-3030
chrX	133019168	133027168	133025113	8000	133023168	-4000	4000	1945
chrX	16149518	16157518	16152309	8000	16153518	-4000	4000	-1209
chrX	105763829	105771829	105767483	8000	105767829	-4000	4000	-346
chrX	132072990	132080990	132080262	8000	132076990	-4000	4000	3272
chrX	22999589	23007589	23000541	8000	23003589	-4000	4000	-3048
chrX	35799735	35807735	35802377	8000	35803735	-4000	4000	-1358
chrX	12886361	12894361	12888894	8000	12890361	-4000	4000	-1467
chrX	15826694	15834694	15827229	8000	15830694	-4000	4000	-3465
chrX	30233495	30241495	30235935	8000	30237495	-4000	4000	-1560
chrX	49315841	49323841	49323226	8000	49319841	-4000	4000	3385
chrX	55088842	55096842	55090512	8000	55092842	-4000	4000	-2330
chrX	64220194	64228194	64224252	8000	64224194	-4000	4000	58
chrX	78267468	78275468	78273035	8000	78271468	-4000	4000	1567
chrX	102655083	102663083	102655269	8000	102659083	-4000	4000	-3814
chrX	106028435	106036435	106033455	8000	106032435	-4000	4000	1020
chrX	119584337	119592337	119590850	8000	119588337	-4000	4000	2513
chrX	135359413	135367413	135361319	8000	135363413	-4000	4000	-2094
chrX	150669143	150677143	150671633	8000	150673143	-4000	4000	-1510
chrX	152733669	152741669	152736662	8000	152737669	-4000	4000	-1007
chrX	152756222	152764222	152759864	8000	152760222	-4000	4000	-358
chrX	22999589	23007589	23001656	8000	23003589	-4000	4000	-1933
chrX	21650695	21658695	21656297	8000	21654695	-4000	4000	1602
chrX	119584337	119592337	119590356	8000	119588337	-4000	4000	2019
chrX	119584337	119592337	119590357	8000	119588337	-4000	4000	2020
chrX	6529618	6537618	6534104	8000	6533618	-4000	4000	486
chrX	7840143	7848143	7843597	8000	7844143	-4000	4000	-546
chrX	8165944	8173944	8170250	8000	8169944	-4000	4000	306
chrX	12820222	12828222	12822802	8000	12824222	-4000	4000	-1420
chrX	21650695	21658695	21656238	8000	21654695	-4000	4000	1543
chrX	30233495	30241495	30236688	8000	30237495	-4000	4000	-807
chrX	47410498	47418498	47412698	8000	47414498	-4000	4000	-1800
chrX	49070433	49078433	49076692	8000	49074433	-4000	4000	2259
chrX	49341922	49349922	49342913	8000	49345922	-4000	4000	-3009
chrX	51404843	51412843	51407094	8000	51408843	-4000	4000	-1749
chrX	51742232	51750232	51743468	8000	51746232	-4000	4000	-2764
chrX	57593477	57601477	57593543	8000	57597477	-4000	4000	-3934
chrX	69156851	69164851	69161885	8000	69160851	-4000	4000	1034
chrX	70060179	70068179	70063145	8000	70064179	-4000	4000	-1034
chrX	71528374	71536374	71529901	8000	71532374	-4000	4000	-2473
chrX	72868025	72876025	72872458	8000	72872025	-4000	4000	433
chrX	79356384	79364384	79361350	8000	79360384	-4000	4000	966
chrX	101341661	101349661	101346409	8000	101345661	-4000	4000	748
chrX	101341661	101349661	101348703	8000	101345661	-4000	4000	3042
chrX	126545383	126553383	126551974	8000	126549383	-4000	4000	2591
chrX	150986771	150994771	150987909	8000	150990771	-4000	4000	-2862
chrX	152762136	152770136	152766471	8000	152766136	-4000	4000	335
chrX	153665733	153673733	153671086	8000	153669733	-4000	4000	1353
chrX	37007664	37015664	37011456	8000	37011664	-4000	4000	-208
chrX	35799735	35807735	35803440	8000	35803735	-4000	4000	-295
chrX	65737931	65745931	65739162	8000	65741931	-4000	4000	-2769
chrX	152733669	152741669	152736824	8000	152737669	-4000	4000	-845
chrX	9945443	9953443	9946817	8000	9949443	-4000	4000	-2626
chrX	69156851	69164851	69163214	8000	69160851	-4000	4000	2363
chrX	70524940	70532940	70529848	8000	70528940	-4000	4000	908
chrX	102655083	102663083	102656369	8000	102659083	-4000	4000	-2714
chrX	51486011	51494011	51491579	8000	51490011	-4000	4000	1568
chrX	29952718	29960718	29955817	8000	29956718	-4000	4000	-901
chrX	50186777	50194777	50192647	8000	50190777	-4000	4000	1870
chrX	106028435	106036435	106034262	8000	106032435	-4000	4000	1827
chrX	133019168	133027168	133025895	8000	133023168	-4000	4000	2727
chrX	153179880	153187880	153183225	8000	153183880	-4000	4000	-655
chrX	27973992	27981992	27980964	8000	27977992	-4000	4000	2972
chrX	34125752	34133752	34131062	8000	34129752	-4000	4000	1310
chrX	151921171	151929171	151924758	8000	151925171	-4000	4000	-413
chrX	16149518	16157518	16152906	8000	16153518	-4000	4000	-612
chrX	54812015	54820015	54814737	8000	54816015	-4000	4000	-1278
chrX	103818327	103826327	103825118	8000	103822327	-4000	4000	2791
chrX	3304565	3312565	3310323	8000	3308565	-4000	4000	1758
chrX	53076615	53084615	53077188	8000	53080615	-4000	4000	-3427
chrX	101651281	101659281	101657609	8000	101655281	-4000	4000	2328
chrX	149881835	149889835	149884994	8000	149885835	-4000	4000	-841
chrX	151719194	151727194	151721943	8000	151723194	-4000	4000	-1251
chrX	154155032	154163032	154156420	8000	154159032	-4000	4000	-2612
chrX	2878820	2886820	2881314	8000	2882820	-4000	4000	-1506
chrX	15380799	15388799	15384040	8000	15384799	-4000	4000	-759
chrX	48454537	48462537	48459002	8000	48458537	-4000	4000	465
chrX	50347914	50355914	50351875	8000	50351914	-4000	4000	-39
chrX	73208299	73216299	73213883	8000	73212299	-4000	4000	1584
chrX	77821747	77829747	77829229	8000	77825747	-4000	4000	3482
chrX	102655083	102663083	102658156	8000	102659083	-4000	4000	-927
chrX	133019168	133027168	133025419	8000	133023168	-4000	4000	2251
chrX	143707955	143715955	143712404	8000	143711955	-4000	4000	449
chrX	153056467	153064467	153057434	8000	153060467	-4000	4000	-3033
chrX	154774684	154782684	154779214	8000	154778684	-4000	4000	530
chrX	131269506	131277506	131276227	8000	131273506	-4000	4000	2721
chrX	13031617	13039617	13037844	8000	13035617	-4000	4000	2227
chrX	30248040	30256040	30251328	8000	30252040	-4000	4000	-712
chrX	71297522	71305522	71297888	8000	71301522	-4000	4000	-3634
chrX	136656390	136664390	136659417	8000	136660390	-4000	4000	-973
chrX	153578939	153586939	153580133	8000	153582939	-4000	4000	-2806
chrX	1382152	1390152	1389626	8000	1386152	-4000	4000	3474
chrX	18649629	18657629	18656650	8000	18653629	-4000	4000	3021
chrX	24212255	24220255	24213317	8000	24216255	-4000	4000	-2938
chrX	24363839	24371839	24364712	8000	24367839	-4000	4000	-3127
chrX	30554809	30562809	30559562	8000	30558809	-4000	4000	753
chrX	34125752	34133752	34131459	8000	34129752	-4000	4000	1707
chrX	34940915	34948915	34943803	8000	34944915	-4000	4000	-1112
chrX	47057242	47065242	47058924	8000	47061242	-4000	4000	-2318
chrX	47057242	47065242	47060057	8000	47061242	-4000	4000	-1185
chrX	48342427	48350427	48350010	8000	48346427	-4000	4000	3583
chrX	63343228	63351228	63350450	8000	63347228	-4000	4000	3222
chrX	64181117	64189117	64187514	8000	64185117	-4000	4000	2397
chrX	71099532	71107532	71101278	8000	71103532	-4000	4000	-2254
chrX	74301034	74309034	74304375	8000	74305034	-4000	4000	-659
chrX	74301034	74309034	74304630	8000	74305034	-4000	4000	-404
chrX	80441311	80449311	80443445	8000	80445311	-4000	4000	-1866
chrX	93666930	93674930	93671718	8000	93670930	-4000	4000	788
chrX	102749530	102757530	102750732	8000	102753530	-4000	4000	-2798
chrX	103058651	103066651	103062987	8000	103062651	-4000	4000	336
chrX	112453112	112461112	112455352	8000	112457112	-4000	4000	-1760
chrX	119584337	119592337	119590890	8000	119588337	-4000	4000	2553
chrX	119756202	119764202	119759796	8000	119760202	-4000	4000	-406
chrX	129765536	129773536	129768654	8000	129769536	-4000	4000	-882
chrX	135029546	135037546	135033202	8000	135033546	-4000	4000	-344
chrX	149577653	149585653	149582129	8000	149581653	-4000	4000	476
chrX	151741564	151749564	151742632	8000	151745564	-4000	4000	-2932
chrX	152129310	152137310	152135560	8000	152133310	-4000	4000	2250
chrX	152733669	152741669	152737250	8000	152737669	-4000	4000	-419
chrX	154017573	154025573	154023995	8000	154021573	-4000	4000	2422
chrX	47211128	47219128	47214548	8000	47215128	-4000	4000	-580
chrX	51898354	51906354	51901612	8000	51902354	-4000	4000	-742
chrX	152704261	152712261	152708568	8000	152708261	-4000	4000	307
chrX	49164483	49172483	49164880	8000	49168483	-4000	4000	-3603
chrX	9020232	9028232	9027952	8000	9024232	-4000	4000	3720
chrX	17796049	17804049	17801258	8000	17800049	-4000	4000	1209
chrX	19529977	19537977	19536223	8000	19533977	-4000	4000	2246
chrX	24363839	24371839	24363868	8000	24367839	-4000	4000	-3971
chrX	24554087	24562087	24561908	8000	24558087	-4000	4000	3821
chrX	26191646	26199646	26195160	8000	26195646	-4000	4000	-486
chrX	37007664	37015664	37008449	8000	37011664	-4000	4000	-3215
chrX	50186777	50194777	50192561	8000	50190777	-4000	4000	1784
chrX	69156851	69164851	69163277	8000	69160851	-4000	4000	2426
chrX	78959727	78967727	78961415	8000	78963727	-4000	4000	-2312
chrX	102934300	102942300	102937997	8000	102938300	-4000	4000	-303
chrX	107057885	107065885	107065633	8000	107061885	-4000	4000	3748
chrX	133019168	133027168	133025658	8000	133023168	-4000	4000	2490
chrX	136508346	136516346	136510176	8000	136512346	-4000	4000	-2170
chrX	153056467	153064467	153057311	8000	153060467	-4000	4000	-3156
chrX	154483306	154491306	154488864	8000	154487306	-4000	4000	1558
chrX	3304565	3312565	3310232	8000	3308565	-4000	4000	1667
chrX	12919169	12927169	12921902	8000	12923169	-4000	4000	-1267
chrX	24363839	24371839	24364689	8000	24367839	-4000	4000	-3150
chrX	70501490	70509490	70503910	8000	70505490	-4000	4000	-1580
chrX	119611724	119619724	119618763	8000	119615724	-4000	4000	3039
chrX	132072990	132080990	132080052	8000	132076990	-4000	4000	3062
chrX	152984824	152992824	152991687	8000	152988824	-4000	4000	2863
chrX	104246038	104254038	104250183	8000	104250038	-4000	4000	145
chrX	79171318	79179318	79171893	8000	79175318	-4000	4000	-3425
chrX	80441311	80449311	80443558	8000	80445311	-4000	4000	-1753
chrX	80441311	80449311	80443559	8000	80445311	-4000	4000	-1752
chrX	101611118	101619118	101616721	8000	101615118	-4000	4000	1603
chrX	134424791	134432791	134425214	8000	134428791	-4000	4000	-3577
chrX	149713268	149721268	149716656	8000	149717268	-4000	4000	-612
chrX	7894247	7902247	7900760	8000	7898247	-4000	4000	2513
chrX	55622192	55630192	55623553	8000	55626192	-4000	4000	-2639
chrX	156006817	156014817	156009838	8000	156010817	-4000	4000	-979
chrX	54812015	54820015	54815382	8000	54816015	-4000	4000	-633
chrX	103269691	103277691	103274048	8000	103273691	-4000	4000	357
chrX	126545383	126553383	126551721	8000	126549383	-4000	4000	2338
chrX	149592556	149600556	149598126	8000	149596556	-4000	4000	1570
chrX	13766939	13774939	13774306	8000	13770939	-4000	4000	3367
chrX	47619172	47627172	47624361	8000	47623172	-4000	4000	1189
chrX	83508127	83516127	83508498	8000	83512127	-4000	4000	-3629
chrX	108150671	108158671	108153695	8000	108154671	-4000	4000	-976
chrX	142198342	142206342	142203247	8000	142202342	-4000	4000	905
chrX	48454537	48462537	48458700	8000	48458537	-4000	4000	163
chrX	55220108	55228108	55221792	8000	55224108	-4000	4000	-2316
chrX	145825856	145833856	145829562	8000	145829856	-4000	4000	-294
chrX	55622192	55630192	55624652	8000	55626192	-4000	4000	-1540
chrX	1378689	1386689	1378698	8000	1382689	-4000	4000	-3991
chrX	70060179	70068179	70063165	8000	70064179	-4000	4000	-1014
chrX	34125752	34133752	34130758	8000	34129752	-4000	4000	1006
chrX	53076615	53084615	53077477	8000	53080615	-4000	4000	-3138
chrX	27745942	27753942	27748357	8000	27749942	-4000	4000	-1585
chrX	17796049	17804049	17800619	8000	17800049	-4000	4000	570
chrX	74301034	74309034	74304596	8000	74305034	-4000	4000	-438
chrX	106028435	106036435	106034303	8000	106032435	-4000	4000	1868
chrX	48790311	48798311	48791917	8000	48794311	-4000	4000	-2394
chrX	78652068	78660068	78657472	8000	78656068	-4000	4000	1404
chrX	17731994	17739994	17732149	8000	17735994	-4000	4000	-3845
chrX	27973992	27981992	27978762	8000	27977992	-4000	4000	770
chrX	71099532	71107532	71101196	8000	71103532	-4000	4000	-2336
chrX	119584337	119592337	119589328	8000	119588337	-4000	4000	991
chrX	106204956	106212956	106206352	8000	106208956	-4000	4000	-2604
chrX	71297522	71305522	71303473	8000	71301522	-4000	4000	1951
chrX	78125295	78133295	78131722	8000	78129295	-4000	4000	2427
chrX	100909445	100917445	100914973	8000	100913445	-4000	4000	1528
chrX	51404843	51412843	51408334	8000	51408843	-4000	4000	-509
chrX	17731994	17739994	17732680	8000	17735994	-4000	4000	-3314
chrX	107976864	107984864	107981500	8000	107980864	-4000	4000	636
chrX	149772867	149780867	149774603	8000	149776867	-4000	4000	-2264
chrX	79171318	79179318	79171715	8000	79175318	-4000	4000	-3603
chrX	153798166	153806166	153804231	8000	153802166	-4000	4000	2065
chrX	300529	308529	304963	8000	304529	-4000	4000	434
chrX	51404843	51412843	51407242	8000	51408843	-4000	4000	-1601
chrX	106204956	106212956	106206910	8000	106208956	-4000	4000	-2046
chrX	126159499	126167499	126164673	8000	126163499	-4000	4000	1174
chrX	153868221	153876221	153871119	8000	153872221	-4000	4000	-1102
chrX	78125295	78133295	78126031	8000	78129295	-4000	4000	-3264
chrX	70429390	70437390	70433126	8000	70433390	-4000	4000	-264
chrX	76427342	76435342	76430665	8000	76431342	-4000	4000	-677
chrX	71528374	71536374	71530122	8000	71532374	-4000	4000	-2252
chrX	102655083	102663083	102656777	8000	102659083	-4000	4000	-2306
chrX	118822968	118830968	118826331	8000	118826968	-4000	4000	-637
chrX	75778987	75786987	75784285	8000	75782987	-4000	4000	1298
chrX	12886361	12894361	12887972	8000	12890361	-4000	4000	-2389
chrX	133212662	133220662	133217229	8000	133216662	-4000	4000	567
chrX	13031617	13039617	13038390	8000	13035617	-4000	4000	2773
chrX	48969720	48977720	48970024	8000	48973720	-4000	4000	-3696
chrX	70277840	70285840	70281707	8000	70281840	-4000	4000	-133
chrX	132622015	132630015	132628743	8000	132626015	-4000	4000	2728
chrX	131269506	131277506	131274846	8000	131273506	-4000	4000	1340
chrX	154006506	154014506	154012647	8000	154010506	-4000	4000	2141
chrX	130059955	130067955	130067266	8000	130063955	-4000	4000	3311
chrX	149881835	149889835	149885064	8000	149885835	-4000	4000	-771
chrX	24304210	24312210	24311343	8000	24308210	-4000	4000	3133
chrX	37007664	37015664	37011276	8000	37011664	-4000	4000	-388
chrX	101611118	101619118	101616504	8000	101615118	-4000	4000	1386
chrX	70162324	70170324	70165973	8000	70166324	-4000	4000	-351
chrX	101651281	101659281	101657466	8000	101655281	-4000	4000	2185
chrX	101651281	101659281	101657468	8000	101655281	-4000	4000	2187
chrX	143504735	143512735	143508939	8000	143508735	-4000	4000	204
chrX	117893813	117901813	117898873	8000	117897813	-4000	4000	1060
chrX	88750785	88758785	88753721	8000	88754785	-4000	4000	-1064
chrX	107976864	107984864	107981008	8000	107980864	-4000	4000	144
chrX	108150671	108158671	108153878	8000	108154671	-4000	4000	-793
chrX	80441311	80449311	80442728	8000	80445311	-4000	4000	-2583
chrX	151921171	151929171	151924469	8000	151925171	-4000	4000	-702
chrX	34125752	34133752	34130724	8000	34129752	-4000	4000	972
chrX	65737931	65745931	65739798	8000	65741931	-4000	4000	-2133
chrX	30248040	30256040	30250763	8000	30252040	-4000	4000	-1277
chrX	47410498	47418498	47412649	8000	47414498	-4000	4000	-1849
chrX	149713268	149721268	149716803	8000	149717268	-4000	4000	-465
chrX	152162234	152170234	152168146	8000	152166234	-4000	4000	1912
chrX	154774684	154782684	154779340	8000	154778684	-4000	4000	656
chrX	101878288	101886288	101884511	8000	101882288	-4000	4000	2223
chrX	26191646	26199646	26193816	8000	26195646	-4000	4000	-1830
chrX	66017738	66025738	66022661	8000	66021738	-4000	4000	923
chrX	70162324	70170324	70166115	8000	70166324	-4000	4000	-209
chrX	78754714	78762714	78754930	8000	78758714	-4000	4000	-3784
chrX	79356384	79364384	79363526	8000	79360384	-4000	4000	3142
chrX	118682163	118690163	118685769	8000	118686163	-4000	4000	-394
chrX	152723484	152731484	152728170	8000	152727484	-4000	4000	686
chrX	2215506	2223506	2220993	8000	2219506	-4000	4000	1487
chrX	30248040	30256040	30250522	8000	30252040	-4000	4000	-1518
chrX	77453278	77461278	77454186	8000	77457278	-4000	4000	-3092
chrX	81109699	81117699	81116291	8000	81113699	-4000	4000	2592
chrX	103710032	103718032	103713636	8000	103714032	-4000	4000	-396
chrX	154483306	154491306	154487604	8000	154487306	-4000	4000	298
chrX	57593477	57601477	57594267	8000	57597477	-4000	4000	-3210
chrX	49201063	49209063	49207094	8000	49205063	-4000	4000	2031
chrX	101341661	101349661	101346603	8000	101345661	-4000	4000	942
chrX	152733669	152741669	152736432	8000	152737669	-4000	4000	-1237
chrX	151741564	151749564	151744423	8000	151745564	-4000	4000	-1141
chrX	30233495	30241495	30237206	8000	30237495	-4000	4000	-289
chrX	78959727	78967727	78960792	8000	78963727	-4000	4000	-2935
chrX	54812015	54820015	54815454	8000	54816015	-4000	4000	-561
chrX	57593477	57601477	57594422	8000	57597477	-4000	4000	-3055
chrX	76174314	76182314	76177686	8000	76178314	-4000	4000	-628
chrX	78652068	78660068	78657677	8000	78656068	-4000	4000	1609
chrX	106204956	106212956	106206764	8000	106208956	-4000	4000	-2192
chrX	103495130	103503130	103500270	8000	103499130	-4000	4000	1140
chrX	152723484	152731484	152728169	8000	152727484	-4000	4000	685
chrX	131269506	131277506	131274090	8000	131273506	-4000	4000	584
chrX	35799735	35807735	35802257	8000	35803735	-4000	4000	-1478
chrX	103710032	103718032	103713705	8000	103714032	-4000	4000	-327
chrX	129588561	129596561	129589926	8000	129592561	-4000	4000	-2635
chrX	70429390	70437390	70431080	8000	70433390	-4000	4000	-2310
chrX	130180870	130188870	130184315	8000	130184870	-4000	4000	-555
chrX	134988473	134996473	134991248	8000	134992473	-4000	4000	-1225
chrX	103071810	103079810	103077743	8000	103075810	-4000	4000	1933
chrX	71099532	71107532	71103337	8000	71103532	-4000	4000	-195
chrX	126159499	126167499	126164915	8000	126163499	-4000	4000	1416
chrX	9945443	9953443	9946855	8000	9949443	-4000	4000	-2588
chrX	70201704	70209704	70201972	8000	70205704	-4000	4000	-3732
chrX	15341596	15349596	15346236	8000	15345596	-4000	4000	640
chrX	154483306	154491306	154487575	8000	154487306	-4000	4000	269
chrX	135909062	135917062	135912389	8000	135913062	-4000	4000	-673
chrX	55088842	55096842	55091337	8000	55092842	-4000	4000	-1505
chrX	81294547	81302547	81297226	8000	81298547	-4000	4000	-1321
chrX	103213246	103221246	103216310	8000	103217246	-4000	4000	-936
chrX	27973992	27981992	27980248	8000	27977992	-4000	4000	2256
chrX	128046962	128054962	128052111	8000	128050962	-4000	4000	1149
chrX	126159499	126167499	126165427	8000	126163499	-4000	4000	1928
chrX	47244328	47252328	47245443	8000	47248328	-4000	4000	-2885
chrX	128046962	128054962	128051348	8000	128050962	-4000	4000	386
chrX	129765536	129773536	129768494	8000	129769536	-4000	4000	-1042
chrX	153868221	153876221	153868896	8000	153872221	-4000	4000	-3325
chrX	16840519	16848519	16845827	8000	16844519	-4000	4000	1308
chrX	22999589	23007589	23001249	8000	23003589	-4000	4000	-2340
chrX	34125752	34133752	34130979	8000	34129752	-4000	4000	1227
chrX	49201063	49209063	49205728	8000	49205063	-4000	4000	665
chrX	55480616	55488616	55487483	8000	55484616	-4000	4000	2867
chrX	139559459	139567459	139560831	8000	139563459	-4000	4000	-2628
chrX	53076615	53084615	53083075	8000	53080615	-4000	4000	2460
chrX	57114551	57122551	57119939	8000	57118551	-4000	4000	1388
chrX	140779578	140787578	140783702	8000	140783578	-4000	4000	124
chrX	142198342	142206342	142203494	8000	142202342	-4000	4000	1152
chrX	11113651	11121651	11118591	8000	11117651	-4000	4000	940
chrX	51742232	51750232	51745761	8000	51746232	-4000	4000	-471
chrX	78125295	78133295	78125897	8000	78129295	-4000	4000	-3398
chrX	132071943	132079943	132073044	8000	132075943	-4000	4000	-2899
chrX	34940915	34948915	34943297	8000	34944915	-4000	4000	-1618
chrX	119584337	119592337	119589863	8000	119588337	-4000	4000	1526
chrX	149925527	149933527	149932351	8000	149929527	-4000	4000	2824
chrX	154446654	154454654	154450232	8000	154450654	-4000	4000	-422
chrX	139951728	139959728	139956508	8000	139955728	-4000	4000	780
chrX	11113651	11121651	11118554	8000	11117651	-4000	4000	903
chrX	30216089	30224089	30218598	8000	30220089	-4000	4000	-1491
chrX	83508127	83516127	83508341	8000	83512127	-4000	4000	-3786
chrX	103788619	103796619	103790631	8000	103792619	-4000	4000	-1988
chrX	49183815	49191815	49191335	8000	49187815	-4000	4000	3520
chrX	49164483	49172483	49167231	8000	49168483	-4000	4000	-1252
chrX	49683447	49691447	49689496	8000	49687447	-4000	4000	2049
chrX	81109699	81117699	81115169	8000	81113699	-4000	4000	1470
chrX	149592556	149600556	149598096	8000	149596556	-4000	4000	1540
chrX	135046932	135054932	135051926	8000	135050932	-4000	4000	994
chrX	64264081	64272081	64270967	8000	64268081	-4000	4000	2886
chrX	70416886	70424886	70419760	8000	70420886	-4000	4000	-1126
chrX	152984824	152992824	152990513	8000	152988824	-4000	4000	1689
chrX	1598520	1606520	1599233	8000	1602520	-4000	4000	-3287
chrX	2930045	2938045	2935139	8000	2934045	-4000	4000	1094
chrX	3304565	3312565	3311420	8000	3308565	-4000	4000	2855
chrX	9945443	9953443	9946743	8000	9949443	-4000	4000	-2700
chrX	11771772	11779772	11772622	8000	11775772	-4000	4000	-3150
chrX	13766939	13774939	13769320	8000	13770939	-4000	4000	-1619
chrX	18649629	18657629	18653476	8000	18653629	-4000	4000	-153
chrX	21650695	21658695	21652465	8000	21654695	-4000	4000	-2230
chrX	21990837	21998837	21992612	8000	21994837	-4000	4000	-2225
chrX	23935509	23943509	23939297	8000	23939509	-4000	4000	-212
chrX	27819014	27827014	27822111	8000	27823014	-4000	4000	-903
chrX	29952718	29960718	29954635	8000	29956718	-4000	4000	-2083
chrX	37007664	37015664	37010794	8000	37011664	-4000	4000	-870
chrX	46493422	46501422	46499722	8000	46497422	-4000	4000	2300
chrX	47057242	47065242	47058320	8000	47061242	-4000	4000	-2922
chrX	48263444	48271444	48266330	8000	48267444	-4000	4000	-1114
chrX	50912641	50920641	50916264	8000	50916641	-4000	4000	-377
chrX	51898354	51906354	51901563	8000	51902354	-4000	4000	-791
chrX	52692896	52700896	52698055	8000	52696896	-4000	4000	1159
chrX	52792144	52800144	52797332	8000	52796144	-4000	4000	1188
chrX	52814301	52822301	52815145	8000	52818301	-4000	4000	-3156
chrX	53076615	53084615	53083218	8000	53080615	-4000	4000	2603
chrX	53084540	53092540	53087790	8000	53088540	-4000	4000	-750
chrX	55480616	55488616	55487640	8000	55484616	-4000	4000	3024
chrX	57593477	57601477	57594257	8000	57597477	-4000	4000	-3220
chrX	65737931	65745931	65739132	8000	65741931	-4000	4000	-2799
chrX	70201704	70209704	70205022	8000	70205704	-4000	4000	-682
chrX	71099532	71107532	71106103	8000	71103532	-4000	4000	2571
chrX	71221516	71229516	71223961	8000	71225516	-4000	4000	-1555
chrX	75778987	75786987	75783624	8000	75782987	-4000	4000	637
chrX	88750785	88758785	88753975	8000	88754785	-4000	4000	-810
chrX	93666930	93674930	93672782	8000	93670930	-4000	4000	1852
chrX	101092367	101100367	101094783	8000	101096367	-4000	4000	-1584
chrX	101550700	101558700	101553054	8000	101554700	-4000	4000	-1646
chrX	108693545	108701545	108695292	8000	108697545	-4000	4000	-2253
chrX	120868607	120876607	120875034	8000	120872607	-4000	4000	2427
chrX	129925761	129933761	129926244	8000	129929761	-4000	4000	-3517
chrX	130059955	130067955	130066933	8000	130063955	-4000	4000	2978
chrX	130059955	130067955	130067266	8000	130063955	-4000	4000	3311
chrX	130369361	130377361	130371561	8000	130373361	-4000	4000	-1800
chrX	133212662	133220662	133217866	8000	133216662	-4000	4000	1204
chrX	141905374	141913374	141906855	8000	141909374	-4000	4000	-2519
chrX	141905374	141913374	141907064	8000	141909374	-4000	4000	-2310
chrX	142198342	142206342	142202934	8000	142202342	-4000	4000	592
chrX	142198342	142206342	142203229	8000	142202342	-4000	4000	887
chrX	151921171	151929171	151923674	8000	151925171	-4000	4000	-1497
chrX	152733669	152741669	152736743	8000	152737669	-4000	4000	-926
chrX	152762136	152770136	152766532	8000	152766136	-4000	4000	396
chrX	153443668	153451668	153447693	8000	153447668	-4000	4000	25
chrX	153443668	153451668	153447821	8000	153447668	-4000	4000	153
chrX	153578939	153586939	153580450	8000	153582939	-4000	4000	-2489
chrX	153647326	153655326	153650189	8000	153651326	-4000	4000	-1137
chrX	153798166	153806166	153804616	8000	153802166	-4000	4000	2450
chrX	153979194	153987194	153982230	8000	153983194	-4000	4000	-964
chrX	154326350	154334350	154327596	8000	154330350	-4000	4000	-2754
chrX	155060034	155068034	155065959	8000	155064034	-4000	4000	1925
chrX	156006817	156014817	156007531	8000	156010817	-4000	4000	-3286
chrX	106675439	106683439	106678174	8000	106679439	-4000	4000	-1265
chrX	140999706	141007706	141002726	8000	141003706	-4000	4000	-980
chrX	34940915	34948915	34943844	8000	34944915	-4000	4000	-1071
chrX	3304565	3312565	3310200	8000	3308565	-4000	4000	1635
chrX	21881423	21889423	21882659	8000	21885423	-4000	4000	-2764
chrX	81109699	81117699	81116291	8000	81113699	-4000	4000	2592
chrX	114999975	115007975	115007962	8000	115003975	-4000	4000	3987
chrX	119584337	119592337	119590304	8000	119588337	-4000	4000	1967
chrX	132622015	132630015	132628749	8000	132626015	-4000	4000	2734
chrX	1306381	1314381	1309614	8000	1310381	-4000	4000	-767
chrX	86828604	86836604	86832337	8000	86832604	-4000	4000	-267
chrX	49604538	49612538	49606307	8000	49608538	-4000	4000	-2231
chrX	87666050	87674050	87666850	8000	87670050	-4000	4000	-3200
chrX	106204956	106212956	106207551	8000	106208956	-4000	4000	-1405
chrX	152129310	152137310	152134594	8000	152133310	-4000	4000	1284
chrX	152984824	152992824	152991331	8000	152988824	-4000	4000	2507
chrX	18888298	18896298	18893607	8000	18892298	-4000	4000	1309
chrX	18985307	18993307	18989911	8000	18989307	-4000	4000	604
chrX	30216089	30224089	30219739	8000	30220089	-4000	4000	-350
chrX	30727462	30735462	30729638	8000	30731462	-4000	4000	-1824
chrX	41232579	41240579	41235450	8000	41236579	-4000	4000	-1129
chrX	51486011	51494011	51491243	8000	51490011	-4000	4000	1232
chrX	74728856	74736856	74736725	8000	74732856	-4000	4000	3869
chrX	101878288	101886288	101884040	8000	101882288	-4000	4000	1752
chrX	103818327	103826327	103825353	8000	103822327	-4000	4000	3026
chrX	129588561	129596561	129590238	8000	129592561	-4000	4000	-2323
chrX	149713268	149721268	149715923	8000	149717268	-4000	4000	-1345
chrX	47410498	47418498	47413388	8000	47414498	-4000	4000	-1110
chrX	22999589	23007589	23000611	8000	23003589	-4000	4000	-2978
chrX	48182220	48190220	48187673	8000	48186220	-4000	4000	1453
chrX	103328326	103336326	103332046	8000	103332326	-4000	4000	-280
chrX	130054071	130062071	130055981	8000	130058071	-4000	4000	-2090
chrX	152756222	152764222	152759591	8000	152760222	-4000	4000	-631
chrX	141893832	141901832	141895295	8000	141897832	-4000	4000	-2537
chrX	151741564	151749564	151743524	8000	151745564	-4000	4000	-2040
chrX	55480616	55488616	55488057	8000	55484616	-4000	4000	3441
chrX	48687427	48695427	48689371	8000	48691427	-4000	4000	-2056
chrX	102655083	102663083	102657888	8000	102659083	-4000	4000	-1195
chrX	120254398	120262398	120255495	8000	120258398	-4000	4000	-2903
chrX	135909062	135917062	135910044	8000	135913062	-4000	4000	-3018
chrX	15380799	15388799	15384873	8000	15384799	-4000	4000	74
chrX	70501490	70509490	70502181	8000	70505490	-4000	4000	-3309
chrX	52814301	52822301	52818230	8000	52818301	-4000	4000	-71
chrX	79356384	79364384	79362785	8000	79360384	-4000	4000	2401
chrX	107240247	107248247	107243262	8000	107244247	-4000	4000	-985
chrX	126545383	126553383	126551759	8000	126549383	-4000	4000	2376
chrX	23782210	23790210	23783216	8000	23786210	-4000	4000	-2994
chrX	47089314	47097314	47092940	8000	47093314	-4000	4000	-374
chrX	48826138	48834138	48829986	8000	48830138	-4000	4000	-152
chrX	93666930	93674930	93673471	8000	93670930	-4000	4000	2541
chrX	147947125	147955125	147948767	8000	147951125	-4000	4000	-2358
chrX	152762136	152770136	152767347	8000	152766136	-4000	4000	1211
chrX	155060034	155068034	155064027	8000	155064034	-4000	4000	-7
chrX	141905374	141913374	141907681	8000	141909374	-4000	4000	-1693
chrX	152698347	152706347	152701546	8000	152702347	-4000	4000	-801
chrX	3304565	3312565	3310143	8000	3308565	-4000	4000	1578
chrX	3304565	3312565	3311331	8000	3308565	-4000	4000	2766
chrX	12886361	12894361	12886718	8000	12890361	-4000	4000	-3643
chrX	12919169	12927169	12919689	8000	12923169	-4000	4000	-3480
chrX	13706504	13714504	13714466	8000	13710504	-4000	4000	3962
chrX	15557047	15565047	15561812	8000	15561047	-4000	4000	765
chrX	16840519	16848519	16845058	8000	16844519	-4000	4000	539
chrX	18649629	18657629	18653445	8000	18653629	-4000	4000	-184
chrX	19529977	19537977	19536342	8000	19533977	-4000	4000	2365
chrX	22999589	23007589	23000208	8000	23003589	-4000	4000	-3381
chrX	22999589	23007589	23001701	8000	23003589	-4000	4000	-1888
chrX	24992986	25000986	24995881	8000	24996986	-4000	4000	-1105
chrX	26136736	26144736	26138993	8000	26140736	-4000	4000	-1743
chrX	26191646	26199646	26194523	8000	26195646	-4000	4000	-1123
chrX	26191646	26199646	26194606	8000	26195646	-4000	4000	-1040
chrX	27819014	27827014	27821966	8000	27823014	-4000	4000	-1048
chrX	27973992	27981992	27981022	8000	27977992	-4000	4000	3030
chrX	30233495	30241495	30236616	8000	30237495	-4000	4000	-879
chrX	30554809	30562809	30559659	8000	30558809	-4000	4000	850
chrX	31067233	31075233	31071278	8000	31071233	-4000	4000	45
chrX	34940915	34948915	34943351	8000	34944915	-4000	4000	-1564
chrX	35799735	35807735	35802929	8000	35803735	-4000	4000	-806
chrX	36381317	36389317	36384954	8000	36385317	-4000	4000	-363
chrX	40045815	40053815	40052199	8000	40049815	-4000	4000	2384
chrX	44519639	44527639	44527281	8000	44523639	-4000	4000	3642
chrX	45144373	45152373	45151561	8000	45148373	-4000	4000	3188
chrX	46493422	46501422	46500542	8000	46497422	-4000	4000	3120
chrX	47211128	47219128	47213031	8000	47215128	-4000	4000	-2097
chrX	47211128	47219128	47214339	8000	47215128	-4000	4000	-789
chrX	47441178	47449178	47447607	8000	47445178	-4000	4000	2429
chrX	48342427	48350427	48348376	8000	48346427	-4000	4000	1949
chrX	49109407	49117407	49115796	8000	49113407	-4000	4000	2389
chrX	50186777	50194777	50193559	8000	50190777	-4000	4000	2782
chrX	51404843	51412843	51408162	8000	51408843	-4000	4000	-681
chrX	51486011	51494011	51491509	8000	51490011	-4000	4000	1498
chrX	56563868	56571868	56564937	8000	56567868	-4000	4000	-2931
chrX	64220194	64228194	64225406	8000	64224194	-4000	4000	1212
chrX	66264867	66272867	66266813	8000	66268867	-4000	4000	-2054
chrX	69156851	69164851	69161906	8000	69160851	-4000	4000	1055
chrX	69156851	69164851	69162110	8000	69160851	-4000	4000	1259
chrX	69156851	69164851	69162213	8000	69160851	-4000	4000	1362
chrX	69156851	69164851	69162833	8000	69160851	-4000	4000	1982
chrX	70036542	70044542	70043496	8000	70040542	-4000	4000	2954
chrX	70254166	70262166	70259201	8000	70258166	-4000	4000	1035
chrX	70277840	70285840	70282822	8000	70281840	-4000	4000	982
chrX	70921579	70929579	70926902	8000	70925579	-4000	4000	1323
chrX	72868025	72876025	72872399	8000	72872025	-4000	4000	374
chrX	78125295	78133295	78131466	8000	78129295	-4000	4000	2171
chrX	80441311	80449311	80442663	8000	80445311	-4000	4000	-2648
chrX	81109699	81117699	81114596	8000	81113699	-4000	4000	897
chrX	83508127	83516127	83509278	8000	83512127	-4000	4000	-2849
chrX	93708274	93716274	93709430	8000	93712274	-4000	4000	-2844
chrX	101550700	101558700	101553708	8000	101554700	-4000	4000	-992
chrX	101550700	101558700	101553850	8000	101554700	-4000	4000	-850
chrX	101611118	101619118	101616334	8000	101615118	-4000	4000	1216
chrX	101878288	101886288	101884710	8000	101882288	-4000	4000	2422
chrX	102509682	102517682	102513937	8000	102513682	-4000	4000	255
chrX	102600159	102608159	102603511	8000	102604159	-4000	4000	-648
chrX	102749530	102757530	102750150	8000	102753530	-4000	4000	-3380
chrX	103269691	103277691	103274580	8000	103273691	-4000	4000	889
chrX	103328326	103336326	103331777	8000	103332326	-4000	4000	-549
chrX	103710032	103718032	103713798	8000	103714032	-4000	4000	-234
chrX	103818327	103826327	103825420	8000	103822327	-4000	4000	3093
chrX	103818327	103826327	103825720	8000	103822327	-4000	4000	3393
chrX	105763829	105771829	105767101	8000	105767829	-4000	4000	-728
chrX	108075184	108083184	108076191	8000	108079184	-4000	4000	-2993
chrX	108080207	108088207	108087539	8000	108084207	-4000	4000	3332
chrX	111756649	111764649	111759856	8000	111760649	-4000	4000	-793
chrX	115106616	115114616	115113298	8000	115110616	-4000	4000	2682
chrX	116170974	116178974	116172372	8000	116174974	-4000	4000	-2602
chrX	116457686	116465686	116459110	8000	116461686	-4000	4000	-2576
chrX	119240466	119248466	119243170	8000	119244466	-4000	4000	-1296
chrX	120254398	120262398	120255088	8000	120258398	-4000	4000	-3310
chrX	120621674	120629674	120627005	8000	120625674	-4000	4000	1331
chrX	121046094	121054094	121048267	8000	121050094	-4000	4000	-1827
chrX	130059955	130067955	130067008	8000	130063955	-4000	4000	3053
chrX	131269506	131277506	131273827	8000	131273506	-4000	4000	321
chrX	131269506	131277506	131275476	8000	131273506	-4000	4000	1970
chrX	131269506	131277506	131276105	8000	131273506	-4000	4000	2599
chrX	132622015	132630015	132628176	8000	132626015	-4000	4000	2161
chrX	134242207	134250207	134244981	8000	134246207	-4000	4000	-1226
chrX	134424791	134432791	134425452	8000	134428791	-4000	4000	-3339
chrX	135578510	135586510	135580008	8000	135582510	-4000	4000	-2502
chrX	135909062	135917062	135911589	8000	135913062	-4000	4000	-1473
chrX	135909062	135917062	135911938	8000	135913062	-4000	4000	-1124
chrX	136207359	136215359	136207901	8000	136211359	-4000	4000	-3458
chrX	152698347	152706347	152701945	8000	152702347	-4000	4000	-402
chrX	152723484	152731484	152728119	8000	152727484	-4000	4000	635
chrX	152822994	152830994	152828606	8000	152826994	-4000	4000	1612
chrX	154326350	154334350	154329824	8000	154330350	-4000	4000	-526
chrX	15380799	15388799	15384980	8000	15384799	-4000	4000	181
chrX	23682397	23690397	23686304	8000	23686397	-4000	4000	-93
chrX	63343228	63351228	63350066	8000	63347228	-4000	4000	2838
chrX	64181117	64189117	64186041	8000	64185117	-4000	4000	924
chrX	69156851	69164851	69162658	8000	69160851	-4000	4000	1807
chrX	70416886	70424886	70420264	8000	70420886	-4000	4000	-622
chrX	75778987	75786987	75783794	8000	75782987	-4000	4000	807
chrX	89918883	89926883	89922817	8000	89922883	-4000	4000	-66
chrX	114906061	114914061	114907414	8000	114910061	-4000	4000	-2647
chrX	133212662	133220662	133217593	8000	133216662	-4000	4000	931
chrX	135152540	135160540	135158251	8000	135156540	-4000	4000	1711
chrX	152733669	152741669	152736488	8000	152737669	-4000	4000	-1181
chrX	152162234	152170234	152168428	8000	152166234	-4000	4000	2194
chrX	66591637	66599637	66599607	8000	66595637	-4000	4000	3970
chrX	103495130	103503130	103500621	8000	103499130	-4000	4000	1491
chrX	153056467	153064467	153058673	8000	153060467	-4000	4000	-1794
chrX	109540698	109548698	109542509	8000	109544698	-4000	4000	-2189
chrX	143504735	143512735	143508977	8000	143508735	-4000	4000	242
chrX	156006817	156014817	156010199	8000	156010817	-4000	4000	-618
chrX	1598520	1606520	1600659	8000	1602520	-4000	4000	-1861
chrX	48516814	48524814	48523979	8000	48520814	-4000	4000	3165
chrX	69156851	69164851	69161626	8000	69160851	-4000	4000	775
chrX	154774684	154782684	154781688	8000	154778684	-4000	4000	3004
chrX	37007664	37015664	37009335	8000	37011664	-4000	4000	-2329
chrX	52640061	52648061	52645460	8000	52644061	-4000	4000	1399
chrX	73208299	73216299	73213398	8000	73212299	-4000	4000	1099
chrX	53427258	53435258	53430617	8000	53431258	-4000	4000	-641
chrX	64911802	64919802	64919223	8000	64915802	-4000	4000	3421
chrX	27973992	27981992	27980827	8000	27977992	-4000	4000	2835
chrX	49164483	49172483	49164810	8000	49168483	-4000	4000	-3673
chrX	141893832	141901832	141896503	8000	141897832	-4000	4000	-1329
chrX	120379249	120387249	120380964	8000	120383249	-4000	4000	-2285
chrX	107601255	107609255	107601294	8000	107605255	-4000	4000	-3961
chrX	108080207	108088207	108087595	8000	108084207	-4000	4000	3388
chrX	9945443	9953443	9946760	8000	9949443	-4000	4000	-2683
chrX	107709221	107717221	107714723	8000	107713221	-4000	4000	1502
chrX	30233495	30241495	30236655	8000	30237495	-4000	4000	-840
chrX	102655083	102663083	102657490	8000	102659083	-4000	4000	-1593
chrX	118822968	118830968	118825588	8000	118826968	-4000	4000	-1380
chrX	153798166	153806166	153804422	8000	153802166	-4000	4000	2256
chrX	37007664	37015664	37009928	8000	37011664	-4000	4000	-1736
chrX	64264081	64272081	64268732	8000	64268081	-4000	4000	651
chrX	34940915	34948915	34942859	8000	34944915	-4000	4000	-2056
chrX	73451171	73459171	73453534	8000	73455171	-4000	4000	-1637
chrX	73451171	73459171	73453535	8000	73455171	-4000	4000	-1636
chrX	22999589	23007589	23001637	8000	23003589	-4000	4000	-1952
chrX	37007664	37015664	37010302	8000	37011664	-4000	4000	-1362
chrX	49683447	49691447	49689437	8000	49687447	-4000	4000	1990
chrX	78652068	78660068	78657771	8000	78656068	-4000	4000	1703
chrX	126545383	126553383	126551673	8000	126549383	-4000	4000	2290
chrX	52508077	52516077	52512147	8000	52512077	-4000	4000	70
chrX	114999975	115007975	115005217	8000	115003975	-4000	4000	1242
chrX	70416886	70424886	70419697	8000	70420886	-4000	4000	-1189
chrX	156021710	156029710	156025453	8000	156025710	-4000	4000	-257
chrX	41471710	41479710	41474566	8000	41475710	-4000	4000	-1144
chrX	81109699	81117699	81116291	8000	81113699	-4000	4000	2592
chrX	48957378	48965378	48962574	8000	48961378	-4000	4000	1196
chrX	50186777	50194777	50194299	8000	50190777	-4000	4000	3522
chrX	136043269	136051269	136045655	8000	136047269	-4000	4000	-1614
chrX	76427342	76435342	76428924	8000	76431342	-4000	4000	-2418
chrX	12919169	12927169	12921158	8000	12923169	-4000	4000	-2011
chrX	121046094	121054094	121048112	8000	121050094	-4000	4000	-1982
chrX	50347914	50355914	50351619	8000	50351914	-4000	4000	-295
chrX	51742232	51750232	51743621	8000	51746232	-4000	4000	-2611
chrX	51742232	51750232	51745418	8000	51746232	-4000	4000	-814
chrX	153056467	153064467	153057109	8000	153060467	-4000	4000	-3358
chrX	27973992	27981992	27980821	8000	27977992	-4000	4000	2829
chrX	136661547	136669547	136668136	8000	136665547	-4000	4000	2589
chrX	152733669	152741669	152736537	8000	152737669	-4000	4000	-1132
chrX	47410498	47418498	47410717	8000	47414498	-4000	4000	-3781
chrX	47441178	47449178	47447657	8000	47445178	-4000	4000	2479
chrX	24074810	24082810	24076940	8000	24078810	-4000	4000	-1870
chrX	101878288	101886288	101884193	8000	101882288	-4000	4000	1905
chrX	136489780	136497780	136492276	8000	136493780	-4000	4000	-1504
chrX	48263444	48271444	48266326	8000	48267444	-4000	4000	-1118
chrX	155060034	155068034	155061898	8000	155064034	-4000	4000	-2136
chrX	72868025	72876025	72872429	8000	72872025	-4000	4000	404
chrX	14727812	14735812	14730296	8000	14731812	-4000	4000	-1516
chrX	149544210	149552210	149546788	8000	149548210	-4000	4000	-1422
chrX	154647972	154655972	154653318	8000	154651972	-4000	4000	1346
chrX	73208299	73216299	73213352	8000	73212299	-4000	4000	1053
chrX	50347914	50355914	50351806	8000	50351914	-4000	4000	-108
chrX	50347914	50355914	50351807	8000	50351914	-4000	4000	-107
chrX	70236659	70244659	70239903	8000	70240659	-4000	4000	-756
chrX	85269362	85277362	85271399	8000	85273362	-4000	4000	-1963
chrX	149713268	149721268	149716814	8000	149717268	-4000	4000	-454
chrX	151672739	151680739	151676115	8000	151676739	-4000	4000	-624
chrX	52792144	52800144	52796356	8000	52796144	-4000	4000	212
chrX	120379249	120387249	120379632	8000	120383249	-4000	4000	-3617
chrX	74529917	74537917	74531458	8000	74533917	-4000	4000	-2459
chrX	101651281	101659281	101656438	8000	101655281	-4000	4000	1157
chrX	1306381	1314381	1309522	8000	1310381	-4000	4000	-859
chrX	8462510	8470510	8466386	8000	8466510	-4000	4000	-124
chrX	18888298	18896298	18895135	8000	18892298	-4000	4000	2837
chrX	26136736	26144736	26139498	8000	26140736	-4000	4000	-1238
chrX	44840888	44848888	44844364	8000	44844888	-4000	4000	-524
chrX	48790311	48798311	48794024	8000	48794311	-4000	4000	-287
chrX	49164483	49172483	49164655	8000	49168483	-4000	4000	-3828
chrX	51742232	51750232	51745331	8000	51746232	-4000	4000	-901
chrX	53076615	53084615	53076778	8000	53080615	-4000	4000	-3837
chrX	71140103	71148103	71147966	8000	71144103	-4000	4000	3863
chrX	71297522	71305522	71300162	8000	71301522	-4000	4000	-1360
chrX	71297522	71305522	71305277	8000	71301522	-4000	4000	3755
chrX	75778987	75786987	75783315	8000	75782987	-4000	4000	328
chrX	80027774	80035774	80031018	8000	80031774	-4000	4000	-756
chrX	91434584	91442584	91436599	8000	91438584	-4000	4000	-1985
chrX	102600159	102608159	102603395	8000	102604159	-4000	4000	-764
chrX	102655083	102663083	102656265	8000	102659083	-4000	4000	-2818
chrX	104038454	104046454	104040248	8000	104042454	-4000	4000	-2206
chrX	116170974	116178974	116172958	8000	116174974	-4000	4000	-2016
chrX	140498985	140506985	140504467	8000	140502985	-4000	4000	1482
chrX	143707955	143715955	143711990	8000	143711955	-4000	4000	35
chrX	152756222	152764222	152759507	8000	152760222	-4000	4000	-715
chrX	152865729	152873729	152869156	8000	152869729	-4000	4000	-573
chrX	153056467	153064467	153057537	8000	153060467	-4000	4000	-2930
chrX	153665733	153673733	153672189	8000	153669733	-4000	4000	2456
chrX	30233495	30241495	30235930	8000	30237495	-4000	4000	-1565
chrX	102600159	102608159	102603475	8000	102604159	-4000	4000	-684
chrX	18888298	18896298	18893584	8000	18892298	-4000	4000	1286
chrX	37007664	37015664	37008565	8000	37011664	-4000	4000	-3099
chrX	23782210	23790210	23783952	8000	23786210	-4000	4000	-2258
chrX	24363839	24371839	24364432	8000	24367839	-4000	4000	-3407
chrX	34125752	34133752	34131780	8000	34129752	-4000	4000	2028
chrX	64220194	64228194	64225161	8000	64224194	-4000	4000	967
chrX	134988473	134996473	134991248	8000	134992473	-4000	4000	-1225
chrX	152733669	152741669	152737090	8000	152737669	-4000	4000	-579
chrX	102600159	102608159	102603078	8000	102604159	-4000	4000	-1081
chrX	135046932	135054932	135051322	8000	135050932	-4000	4000	390
chrX	136043269	136051269	136044541	8000	136047269	-4000	4000	-2728
chrX	50186777	50194777	50190786	8000	50190777	-4000	4000	9
chrX	70429390	70437390	70431089	8000	70433390	-4000	4000	-2301
chrX	72868025	72876025	72872520	8000	72872025	-4000	4000	495
chrX	152129310	152137310	152134779	8000	152133310	-4000	4000	1469
chrX	156021710	156029710	156025584	8000	156025710	-4000	4000	-126
chrX	10233660	10241660	10233871	8000	10237660	-4000	4000	-3789
chrX	51742232	51750232	51743924	8000	51746232	-4000	4000	-2308
chrX	135029546	135037546	135033058	8000	135033546	-4000	4000	-488
chrX	155939769	155947769	155943159	8000	155943769	-4000	4000	-610
chrX	47211128	47219128	47212768	8000	47215128	-4000	4000	-2360
chrX	48790311	48798311	48793842	8000	48794311	-4000	4000	-469
chrX	74529917	74537917	74531590	8000	74533917	-4000	4000	-2327
chrX	55074909	55082909	55077413	8000	55078909	-4000	4000	-1496
chrX	104038454	104046454	104040041	8000	104042454	-4000	4000	-2413
chrX	27456207	27464207	27461484	8000	27460207	-4000	4000	1277
chrX	27745942	27753942	27747687	8000	27749942	-4000	4000	-2255
chrX	55088842	55096842	55091412	8000	55092842	-4000	4000	-1430
chrX	102655083	102663083	102655456	8000	102659083	-4000	4000	-3627
chrX	116170974	116178974	116173216	8000	116174974	-4000	4000	-1758
chrX	121046094	121054094	121048759	8000	121050094	-4000	4000	-1335
chrX	154006506	154014506	154012625	8000	154010506	-4000	4000	2119
chrX	24212255	24220255	24213574	8000	24216255	-4000	4000	-2681
chrX	116170974	116178974	116173731	8000	116174974	-4000	4000	-1243
chrX	54928961	54936961	54929349	8000	54932961	-4000	4000	-3612
chrX	81109699	81117699	81113750	8000	81113699	-4000	4000	51
chrX	153665733	153673733	153671879	8000	153669733	-4000	4000	2146
chrX	50186777	50194777	50194278	8000	50190777	-4000	4000	3501
chrX	18985307	18993307	18990849	8000	18989307	-4000	4000	1542
chrX	149881835	149889835	149885173	8000	149885835	-4000	4000	-662
chrX	14918327	14926327	14920118	8000	14922327	-4000	4000	-2209
chrX	119450478	119458478	119454027	8000	119454478	-4000	4000	-451
chrX	83508127	83516127	83508887	8000	83512127	-4000	4000	-3240
chrX	149577653	149585653	149581718	8000	149581653	-4000	4000	65
chrX	149881835	149889835	149885373	8000	149885835	-4000	4000	-462
chrX	64181117	64189117	64186087	8000	64185117	-4000	4000	970
chrX	74529917	74537917	74531712	8000	74533917	-4000	4000	-2205
chrX	66017738	66025738	66025104	8000	66021738	-4000	4000	3366
chrX	128046962	128054962	128052095	8000	128050962	-4000	4000	1133
chrX	26191646	26199646	26195268	8000	26195646	-4000	4000	-378
chrX	92619230	92627230	92623091	8000	92623230	-4000	4000	-139
chrX	22999589	23007589	23000078	8000	23003589	-4000	4000	-3511
chrX	47619172	47627172	47626423	8000	47623172	-4000	4000	3251
chrX	65503887	65511887	65505932	8000	65507887	-4000	4000	-1955
chrX	47619172	47627172	47626364	8000	47623172	-4000	4000	3192
chrX	70236659	70244659	70239784	8000	70240659	-4000	4000	-875
chrX	70921579	70929579	70928499	8000	70925579	-4000	4000	2920
chrX	71609583	71617583	71612411	8000	71613583	-4000	4000	-1172
chrX	141893832	141901832	141895518	8000	141897832	-4000	4000	-2314
chrX	34125752	34133752	34130578	8000	34129752	-4000	4000	826
chrX	34125752	34133752	34132083	8000	34129752	-4000	4000	2331
chrX	54928961	54936961	54929774	8000	54932961	-4000	4000	-3187
chrX	64911802	64919802	64917792	8000	64915802	-4000	4000	1990
chrX	69156851	69164851	69162985	8000	69160851	-4000	4000	2134
chrX	48769648	48777648	48773447	8000	48773648	-4000	4000	-201
chrX	53084540	53092540	53087850	8000	53088540	-4000	4000	-690
chrX	145825856	145833856	145829548	8000	145829856	-4000	4000	-308
chrX	27745942	27753942	27746908	8000	27749942	-4000	4000	-3034
chrX	152733669	152741669	152740691	8000	152737669	-4000	4000	3022
chrX	47567901	47575901	47575274	8000	47571901	-4000	4000	3373
chrX	118822968	118830968	118826449	8000	118826968	-4000	4000	-519
chrX	43944776	43952776	43949894	8000	43948776	-4000	4000	1118
chrX	13766939	13774939	13767207	8000	13770939	-4000	4000	-3732
chrX	18823921	18831921	18827280	8000	18827921	-4000	4000	-641
chrX	37007664	37015664	37008571	8000	37011664	-4000	4000	-3093
chrX	57130530	57138530	57136303	8000	57134530	-4000	4000	1773
chrX	71099532	71107532	71104035	8000	71103532	-4000	4000	503
chrX	71297522	71305522	71304587	8000	71301522	-4000	4000	3065
chrX	77821747	77829747	77829146	8000	77825747	-4000	4000	3399
chrX	135909062	135917062	135912817	8000	135913062	-4000	4000	-245
chrX	45144373	45152373	45151788	8000	45148373	-4000	4000	3415
chrX	14727812	14735812	14730232	8000	14731812	-4000	4000	-1580
chrX	14727812	14735812	14731407	8000	14731812	-4000	4000	-405
chrX	85273396	85281396	85279426	8000	85277396	-4000	4000	2030
chrX	53528096	53536096	53535491	8000	53532096	-4000	4000	3395
chrX	27973992	27981992	27979488	8000	27977992	-4000	4000	1496
chrX	18888298	18896298	18893198	8000	18892298	-4000	4000	900
chrX	18985307	18993307	18990669	8000	18989307	-4000	4000	1362
chrX	26157824	26165824	26161271	8000	26161824	-4000	4000	-553
chrX	48182220	48190220	48186799	8000	48186220	-4000	4000	579
chrX	87666050	87674050	87669323	8000	87670050	-4000	4000	-727
chrX	86828604	86836604	86832313	8000	86832604	-4000	4000	-291
chrX	19356056	19364056	19360804	8000	19360056	-4000	4000	748
chrX	64220194	64228194	64225052	8000	64224194	-4000	4000	858
chrX	110519021	110527021	110521682	8000	110523021	-4000	4000	-1339
chrX	141905374	141913374	141906479	8000	141909374	-4000	4000	-2895
chrX	76427342	76435342	76428249	8000	76431342	-4000	4000	-3093
chrX	34940915	34948915	34943722	8000	34944915	-4000	4000	-1193
chrX	34940915	34948915	34943560	8000	34944915	-4000	4000	-1355
chrX	51404843	51412843	51407555	8000	51408843	-4000	4000	-1288
chrX	65503887	65511887	65504092	8000	65507887	-4000	4000	-3795
chrX	71528374	71536374	71529914	8000	71532374	-4000	4000	-2460
chrX	78652068	78660068	78656818	8000	78656068	-4000	4000	750
chrX	15380799	15388799	15384061	8000	15384799	-4000	4000	-738
chrX	27819014	27827014	27821313	8000	27823014	-4000	4000	-1701
chrX	51742232	51750232	51745601	8000	51746232	-4000	4000	-631
chrX	64220194	64228194	64225462	8000	64224194	-4000	4000	1268
chrX	93666930	93674930	93672870	8000	93670930	-4000	4000	1940
chrX	111241099	111249099	111246708	8000	111245099	-4000	4000	1609
chrX	27456207	27464207	27461287	8000	27460207	-4000	4000	1080
chrX	52814301	52822301	52815149	8000	52818301	-4000	4000	-3152
chrX	57901430	57909430	57908214	8000	57905430	-4000	4000	2784
chrX	78959727	78967727	78960607	8000	78963727	-4000	4000	-3120
chrX	129442501	129450501	129446931	8000	129446501	-4000	4000	430
chrX	102749530	102757530	102750043	8000	102753530	-4000	4000	-3487
chrX	103305346	103313346	103309717	8000	103309346	-4000	4000	371
chrX	119584337	119592337	119589140	8000	119588337	-4000	4000	803
chrX	15315452	15323452	15321521	8000	15319452	-4000	4000	2069
chrX	152698347	152706347	152701543	8000	152702347	-4000	4000	-804
chrX	126545383	126553383	126552131	8000	126549383	-4000	4000	2748
chrX	1598520	1606520	1601265	8000	1602520	-4000	4000	-1255
chrX	2215506	2223506	2220961	8000	2219506	-4000	4000	1455
chrX	22999589	23007589	23000537	8000	23003589	-4000	4000	-3052
chrX	53427258	53435258	53433881	8000	53431258	-4000	4000	2623
chrX	21650695	21658695	21652573	8000	21654695	-4000	4000	-2122
chrX	17750988	17758988	17753341	8000	17754988	-4000	4000	-1647
chrX	141893832	141901832	141896604	8000	141897832	-4000	4000	-1228
chrX	117893813	117901813	117899347	8000	117897813	-4000	4000	1534
chrX	152733669	152741669	152736244	8000	152737669	-4000	4000	-1425
chrX	26136736	26144736	26139970	8000	26140736	-4000	4000	-766
chrX	135578510	135586510	135579877	8000	135582510	-4000	4000	-2633
chrX	119240466	119248466	119243228	8000	119244466	-4000	4000	-1238
chrX	151741564	151749564	151743197	8000	151745564	-4000	4000	-2367
chrX	101651281	101659281	101657425	8000	101655281	-4000	4000	2144
chrX	100287644	100295644	100294461	8000	100291644	-4000	4000	2817
chrX	135029546	135037546	135033402	8000	135033546	-4000	4000	-144
chrX	65503887	65511887	65507106	8000	65507887	-4000	4000	-781
chrX	47619172	47627172	47626357	8000	47623172	-4000	4000	3185
chrX	76427342	76435342	76428217	8000	76431342	-4000	4000	-3125
chrX	66017738	66025738	66022153	8000	66021738	-4000	4000	415
chrX	43762610	43770610	43767556	8000	43766610	-4000	4000	946
chrX	103495130	103503130	103500819	8000	103499130	-4000	4000	1689
chrX	3304565	3312565	3309532	8000	3308565	-4000	4000	967
chrX	70060179	70068179	70063744	8000	70064179	-4000	4000	-435
chrX	149713268	149721268	149716295	8000	149717268	-4000	4000	-973
chrX	152733669	152741669	152737242	8000	152737669	-4000	4000	-427
chrX	154483306	154491306	154485359	8000	154487306	-4000	4000	-1947
chrX	149592556	149600556	149594516	8000	149596556	-4000	4000	-2040
chrX	70036542	70044542	70043563	8000	70040542	-4000	4000	3021
chrX	155235841	155243841	155238771	8000	155239841	-4000	4000	-1070
chrX	19356056	19364056	19359938	8000	19360056	-4000	4000	-118
chrX	143030702	143038702	143034043	8000	143034702	-4000	4000	-659
chrX	30216089	30224089	30219055	8000	30220089	-4000	4000	-1034
chrX	70254166	70262166	70259201	8000	70258166	-4000	4000	1035
chrX	34940915	34948915	34942924	8000	34944915	-4000	4000	-1991
chrX	55480616	55488616	55488307	8000	55484616	-4000	4000	3691
chrX	69156851	69164851	69162959	8000	69160851	-4000	4000	2108
chrX	75778987	75786987	75783253	8000	75782987	-4000	4000	266
chrX	75778987	75786987	75784566	8000	75782987	-4000	4000	1579
chrX	141905374	141913374	141907607	8000	141909374	-4000	4000	-1767
chrX	24554087	24562087	24562040	8000	24558087	-4000	4000	3953
chrX	75778987	75786987	75784313	8000	75782987	-4000	4000	1326
chrX	74301034	74309034	74304252	8000	74305034	-4000	4000	-782
chrX	1306381	1314381	1309514	8000	1310381	-4000	4000	-867
chrX	153647326	153655326	153650048	8000	153651326	-4000	4000	-1278
chrX	18888298	18896298	18895142	8000	18892298	-4000	4000	2844
chrX	24304210	24312210	24311469	8000	24308210	-4000	4000	3259
chrX	70416886	70424886	70419747	8000	70420886	-4000	4000	-1139
chrX	35799735	35807735	35802386	8000	35803735	-4000	4000	-1349
chrX	71297522	71305522	71304584	8000	71301522	-4000	4000	3062
chrX	88750785	88758785	88753776	8000	88754785	-4000	4000	-1009
chrX	54928961	54936961	54929266	8000	54932961	-4000	4000	-3695
chrX	70236659	70244659	70240408	8000	70240659	-4000	4000	-251
chrX	74301034	74309034	74304224	8000	74305034	-4000	4000	-810
chrX	120868607	120876607	120875399	8000	120872607	-4000	4000	2792
chrX	152865729	152873729	152867650	8000	152869729	-4000	4000	-2079
chrX	119611724	119619724	119616613	8000	119615724	-4000	4000	889
chrX	126817786	126825786	126821407	8000	126821786	-4000	4000	-379
chrX	117893813	117901813	117898719	8000	117897813	-4000	4000	906
chrX	9737037	9745037	9739593	8000	9741037	-4000	4000	-1444
chrX	55449566	55457566	55452475	8000	55453566	-4000	4000	-1091
chrX	101408297	101416297	101413317	8000	101412297	-4000	4000	1020
chrX	133212662	133220662	133217070	8000	133216662	-4000	4000	408
chrX	152733669	152741669	152736428	8000	152737669	-4000	4000	-1241
chrX	17796049	17804049	17801562	8000	17800049	-4000	4000	1513
chrX	110519021	110527021	110521105	8000	110523021	-4000	4000	-1916
chrX	34940915	34948915	34944527	8000	34944915	-4000	4000	-388
chrX	114999975	115007975	115007944	8000	115003975	-4000	4000	3969
chrX	26136736	26144736	26139426	8000	26140736	-4000	4000	-1310
chrX	41471710	41479710	41474505	8000	41475710	-4000	4000	-1205
chrX	117893813	117901813	117898273	8000	117897813	-4000	4000	460
chrX	151741564	151749564	151743399	8000	151745564	-4000	4000	-2165
chrX	18823921	18831921	18824033	8000	18827921	-4000	4000	-3888
chrX	47057242	47065242	47058218	8000	47061242	-4000	4000	-3024
chrX	47244328	47252328	47245385	8000	47248328	-4000	4000	-2943
chrX	64220194	64228194	64224901	8000	64224194	-4000	4000	707
chrX	70921579	70929579	70925809	8000	70925579	-4000	4000	230
chrX	108150671	108158671	108157217	8000	108154671	-4000	4000	2546
chrX	132622015	132630015	132628535	8000	132626015	-4000	4000	2520
chrX	135046932	135054932	135051778	8000	135050932	-4000	4000	846
chrX	149772867	149780867	149774783	8000	149776867	-4000	4000	-2084
chrX	10233660	10241660	10233872	8000	10237660	-4000	4000	-3788
chrX	12919169	12927169	12922024	8000	12923169	-4000	4000	-1145
chrX	76427342	76435342	76430742	8000	76431342	-4000	4000	-600
chrX	131269506	131277506	131276084	8000	131273506	-4000	4000	2578
chrX	141905374	141913374	141908074	8000	141909374	-4000	4000	-1300
chrX	12919169	12927169	12921451	8000	12923169	-4000	4000	-1718
chrX	19356056	19364056	19361448	8000	19360056	-4000	4000	1392
chrX	24363839	24371839	24364719	8000	24367839	-4000	4000	-3120
chrX	34940915	34948915	34943138	8000	34944915	-4000	4000	-1777
chrX	47567901	47575901	47575176	8000	47571901	-4000	4000	3275
chrX	57114551	57122551	57120513	8000	57118551	-4000	4000	1962
chrX	102655083	102663083	102655796	8000	102659083	-4000	4000	-3287
chrX	107601255	107609255	107601772	8000	107605255	-4000	4000	-3483
chrX	136661547	136669547	136667795	8000	136665547	-4000	4000	2248
chrX	153578939	153586939	153580328	8000	153582939	-4000	4000	-2611
chrX	143707955	143715955	143712441	8000	143711955	-4000	4000	486
chrX	147947125	147955125	147951043	8000	147951125	-4000	4000	-82
chrX	48263444	48271444	48266975	8000	48267444	-4000	4000	-469
chrX	117893813	117901813	117899320	8000	117897813	-4000	4000	1507
chrX	72297691	72305691	72305410	8000	72301691	-4000	4000	3719
chrX	104007147	104015147	104013198	8000	104011147	-4000	4000	2051
chrX	153665733	153673733	153671439	8000	153669733	-4000	4000	1706
chrX	54928961	54936961	54930621	8000	54932961	-4000	4000	-2340
chrX	133019168	133027168	133026169	8000	133023168	-4000	4000	3001
chrX	71099987	71107987	71107607	8000	71103987	-4000	4000	3620
chrX	132071943	132079943	132077614	8000	132075943	-4000	4000	1671
chrX	3304565	3312565	3311017	8000	3308565	-4000	4000	2452
chrX	37007664	37015664	37010244	8000	37011664	-4000	4000	-1420
chrX	37007664	37015664	37010622	8000	37011664	-4000	4000	-1042
chrX	49164483	49172483	49166290	8000	49168483	-4000	4000	-2193
chrX	70201704	70209704	70202044	8000	70205704	-4000	4000	-3660
chrX	71221516	71229516	71224412	8000	71225516	-4000	4000	-1104
chrX	93708274	93716274	93710538	8000	93712274	-4000	4000	-1736
chrX	149881835	149889835	149885228	8000	149885835	-4000	4000	-607
chrX	151672739	151680739	151674038	8000	151676739	-4000	4000	-2701
chrX	152698347	152706347	152701250	8000	152702347	-4000	4000	-1097
chrX	57901430	57909430	57909110	8000	57905430	-4000	4000	3680
chrX	11113651	11121651	11117398	8000	11117651	-4000	4000	-253
chrX	106204956	106212956	106207260	8000	106208956	-4000	4000	-1696
chrY	18023746	18031746	18026214	8000	18027746	-4000	4000	-1532
