Chr	Start	End	Mutation	Size	Middle	Start_C	End_C	Mutations_C
chr1	74564117	74572117	74571494	8000	74568117	-4000	4000	3377
chr1	38834198	38842198	38839519	8000	38838198	-4000	4000	1321
chr1	110019742	110027742	110021976	8000	110023742	-4000	4000	-1766
chr1	190093658	190101658	190098597	8000	190097658	-4000	4000	939
chr1	161710352	161718352	161711946	8000	161714352	-4000	4000	-2406
chr1	19278573	19286573	19286262	8000	19282573	-4000	4000	3689
chr1	171631417	171639417	171636268	8000	171635417	-4000	4000	851
chr1	205653851	205661851	205659182	8000	205657851	-4000	4000	1331
chr1	28765775	28773775	28769299	8000	28769775	-4000	4000	-476
chr1	151360304	151368304	151364923	8000	151364304	-4000	4000	619
chr1	151695091	151703091	151698830	8000	151699091	-4000	4000	-261
chr1	153977617	153985617	153981976	8000	153981617	-4000	4000	359
chr1	193086866	193094866	193091685	8000	193090866	-4000	4000	819
chr1	47212290	47220290	47216498	8000	47216290	-4000	4000	208
chr1	17280233	17288233	17282990	8000	17284233	-4000	4000	-1243
chr1	18481974	18489974	18483028	8000	18485974	-4000	4000	-2946
chr1	30865466	30873466	30873183	8000	30869466	-4000	4000	3717
chr1	84921583	84929583	84926590	8000	84925583	-4000	4000	1007
chr1	100146496	100154496	100148040	8000	100150496	-4000	4000	-2456
chr1	111771602	111779602	111776169	8000	111775602	-4000	4000	567
chr1	200547497	200555497	200554579	8000	200551497	-4000	4000	3082
chr1	204613170	204621170	204618558	8000	204617170	-4000	4000	1388
chr1	205653851	205661851	205659544	8000	205657851	-4000	4000	1693
chr1	243120428	243128428	243126495	8000	243124428	-4000	4000	2067
chr1	247095962	247103962	247101772	8000	247099962	-4000	4000	1810
chr1	100516277	100524277	100519684	8000	100520277	-4000	4000	-593
chr1	154940076	154948076	154947515	8000	154944076	-4000	4000	3439
chr1	37856697	37864697	37857466	8000	37860697	-4000	4000	-3231
chr1	160354952	160362952	160358302	8000	160358952	-4000	4000	-650
chr1	19278573	19286573	19285103	8000	19282573	-4000	4000	2530
chr1	23960347	23968347	23961797	8000	23964347	-4000	4000	-2550
chr1	27375176	27383176	27380117	8000	27379176	-4000	4000	941
chr1	36084275	36092275	36085835	8000	36088275	-4000	4000	-2440
chr1	37530449	37538449	37537571	8000	37534449	-4000	4000	3122
chr1	37562857	37570857	37569079	8000	37566857	-4000	4000	2222
chr1	37992770	38000770	37997456	8000	37996770	-4000	4000	686
chr1	47374839	47382839	47376884	8000	47378839	-4000	4000	-1955
chr1	85261776	85269776	85267647	8000	85265776	-4000	4000	1871
chr1	109234182	109242182	109236488	8000	109238182	-4000	4000	-1694
chr1	148478548	148486548	148483103	8000	148482548	-4000	4000	555
chr1	150261399	150269399	150262162	8000	150265399	-4000	4000	-3237
chr1	151978915	151986915	151986213	8000	151982915	-4000	4000	3298
chr1	153977617	153985617	153983538	8000	153981617	-4000	4000	1921
chr1	154940076	154948076	154945116	8000	154944076	-4000	4000	1040
chr1	154940076	154948076	154946562	8000	154944076	-4000	4000	2486
chr1	155655443	155663443	155661321	8000	155659443	-4000	4000	1878
chr1	155909045	155917045	155914223	8000	155913045	-4000	4000	1178
chr1	156304968	156312968	156309125	8000	156308968	-4000	4000	157
chr1	156664763	156672763	156670029	8000	156668763	-4000	4000	1266
chr1	159199313	159207313	159200912	8000	159203313	-4000	4000	-2401
chr1	160197886	160205886	160198713	8000	160201886	-4000	4000	-3173
chr1	161167310	161175310	161168025	8000	161171310	-4000	4000	-3285
chr1	202315781	202323781	202318238	8000	202319781	-4000	4000	-1543
chr1	205528793	205536793	205530687	8000	205532793	-4000	4000	-2106
chr1	206730281	206738281	206732725	8000	206734281	-4000	4000	-1556
chr1	232805929	232813929	232807134	8000	232809929	-4000	4000	-2795
chr1	236545005	236553005	236550966	8000	236549005	-4000	4000	1961
chr1	67697475	67705475	67705172	8000	67701475	-4000	4000	3697
chr1	70848353	70856353	70852748	8000	70852353	-4000	4000	395
chr1	109705551	109713551	109712259	8000	109709551	-4000	4000	2708
chr1	157509377	157517377	157515850	8000	157513377	-4000	4000	2473
chr1	171208686	171216686	171208861	8000	171212686	-4000	4000	-3825
chr1	10416511	10424511	10417396	8000	10420511	-4000	4000	-3115
chr1	34782369	34790369	34785459	8000	34786369	-4000	4000	-910
chr1	215233090	215241090	215235722	8000	215237090	-4000	4000	-1368
chr1	25496209	25504209	25498302	8000	25500209	-4000	4000	-1907
chr1	155610951	155618951	155611578	8000	155614951	-4000	4000	-3373
chr1	159199313	159207313	159200880	8000	159203313	-4000	4000	-2433
chr1	25828942	25836942	25835648	8000	25832942	-4000	4000	2706
chr1	202887116	202895116	202893286	8000	202891116	-4000	4000	2170
chr1	2561382	2569382	2561714	8000	2565382	-4000	4000	-3668
chr1	23187895	23195895	23193503	8000	23191895	-4000	4000	1608
chr1	31625866	31633866	31633288	8000	31629866	-4000	4000	3422
chr1	43969369	43977369	43972155	8000	43973369	-4000	4000	-1214
chr1	89002679	89010679	89007644	8000	89006679	-4000	4000	965
chr1	149880459	149888459	149886521	8000	149884459	-4000	4000	2062
chr1	159051155	159059155	159051854	8000	159055155	-4000	4000	-3301
chr1	163072802	163080802	163074549	8000	163076802	-4000	4000	-2253
chr1	186307652	186315652	186314678	8000	186311652	-4000	4000	3026
chr1	201892456	201900456	201900178	8000	201896456	-4000	4000	3722
chr1	209775208	209783208	209780540	8000	209779208	-4000	4000	1332
chr1	227914656	227922656	227921469	8000	227918656	-4000	4000	2813
chr1	70249052	70257052	70250363	8000	70253052	-4000	4000	-2689
chr1	156664763	156672763	156672085	8000	156668763	-4000	4000	3322
chr1	206182179	206190179	206187363	8000	206186179	-4000	4000	1184
chr1	26317698	26325698	26317976	8000	26321698	-4000	4000	-3722
chr1	203163405	203171405	203170314	8000	203167405	-4000	4000	2909
chr1	212895363	212903363	212895387	8000	212899363	-4000	4000	-3976
chr1	248915946	248923946	248917607	8000	248919946	-4000	4000	-2339
chr1	20660014	20668014	20664589	8000	20664014	-4000	4000	575
chr1	24150168	24158168	24157668	8000	24154168	-4000	4000	3500
chr1	91521764	91529764	91524064	8000	91525764	-4000	4000	-1700
chr1	151766107	151774107	151767237	8000	151770107	-4000	4000	-2870
chr1	159199313	159207313	159205953	8000	159203313	-4000	4000	2640
chr1	52404282	52412282	52405803	8000	52408282	-4000	4000	-2479
chr1	15486832	15494832	15492806	8000	15490832	-4000	4000	1974
chr1	24669281	24677281	24672566	8000	24673281	-4000	4000	-715
chr1	151031713	151039713	151038939	8000	151035713	-4000	4000	3226
chr1	31625866	31633866	31633220	8000	31629866	-4000	4000	3354
chr1	145973811	145981811	145977093	8000	145977811	-4000	4000	-718
chr1	160354952	160362952	160358291	8000	160358952	-4000	4000	-661
chr1	3626767	3634767	3634767	8000	3630767	-4000	4000	4000
chr1	163072802	163080802	163074576	8000	163076802	-4000	4000	-2226
chr1	170549834	170557834	170552261	8000	170553834	-4000	4000	-1573
chr1	222747004	222755004	222747043	8000	222751004	-4000	4000	-3961
chr1	74762678	74770678	74763957	8000	74766678	-4000	4000	-2721
chr1	159304224	159312224	159305985	8000	159308224	-4000	4000	-2239
chr1	244053476	244061476	244054959	8000	244057476	-4000	4000	-2517
chr1	26317698	26325698	26318024	8000	26321698	-4000	4000	-3674
chr1	12843377	12851377	12847829	8000	12847377	-4000	4000	452
chr1	25358361	25366361	25362451	8000	25362361	-4000	4000	90
chr1	203336628	203344628	203342435	8000	203340628	-4000	4000	1807
chr1	110943190	110951190	110948223	8000	110947190	-4000	4000	1033
chr1	42653190	42661190	42659319	8000	42657190	-4000	4000	2129
chr1	159778543	159786543	159782260	8000	159782543	-4000	4000	-283
chr1	19070510	19078510	19074698	8000	19074510	-4000	4000	188
chr1	24840321	24848321	24841015	8000	24844321	-4000	4000	-3306
chr1	27759116	27767116	27761435	8000	27763116	-4000	4000	-1681
chr1	31430680	31438680	31432968	8000	31434680	-4000	4000	-1712
chr1	92469043	92477043	92474838	8000	92473043	-4000	4000	1795
chr1	155082807	155090807	155086473	8000	155086807	-4000	4000	-334
chr1	155610951	155618951	155614464	8000	155614951	-4000	4000	-487
chr1	169507951	169515951	169514344	8000	169511951	-4000	4000	2393
chr1	205138505	205146505	205144297	8000	205142505	-4000	4000	1792
chr1	221697424	221705424	221702645	8000	221701424	-4000	4000	1221
chr1	68094473	68102473	68098743	8000	68098473	-4000	4000	270
chr1	145988435	145996435	145996228	8000	145992435	-4000	4000	3793
chr1	146060711	146068711	146068143	8000	146064711	-4000	4000	3432
chr1	162366475	162374475	162373910	8000	162370475	-4000	4000	3435
chr1	204418628	204426628	204424871	8000	204422628	-4000	4000	2243
chr1	209775208	209783208	209781442	8000	209779208	-4000	4000	2234
chr1	212616777	212624777	212619388	8000	212620777	-4000	4000	-1389
chr1	62447804	62455804	62448560	8000	62451804	-4000	4000	-3244
chr1	74564117	74572117	74571220	8000	74568117	-4000	4000	3103
chr1	31648263	31656263	31654846	8000	31652263	-4000	4000	2583
chr1	34754512	34762512	34762130	8000	34758512	-4000	4000	3618
chr1	202887116	202895116	202892351	8000	202891116	-4000	4000	1235
chr1	200400940	200408940	200407700	8000	200404940	-4000	4000	2760
chr1	246764137	246772137	246767240	8000	246768137	-4000	4000	-897
chr1	38020820	38028820	38023736	8000	38024820	-4000	4000	-1084
chr1	154940076	154948076	154946363	8000	154944076	-4000	4000	2287
chr1	158353553	158361553	158355431	8000	158357553	-4000	4000	-2122
chr1	158353553	158361553	158355432	8000	158357553	-4000	4000	-2121
chr1	201892456	201900456	201899628	8000	201896456	-4000	4000	3172
chr1	231014958	231022958	231019839	8000	231018958	-4000	4000	881
chr1	154975251	154983251	154975757	8000	154979251	-4000	4000	-3494
chr1	169788529	169796529	169793302	8000	169792529	-4000	4000	773
chr1	32675906	32683906	32681838	8000	32679906	-4000	4000	1932
chr1	175006789	175014789	175008650	8000	175010789	-4000	4000	-2139
chr1	24605328	24613328	24605801	8000	24609328	-4000	4000	-3527
chr1	225395292	225403292	225402963	8000	225399292	-4000	4000	3671
chr1	247445108	247453108	247448817	8000	247449108	-4000	4000	-291
chr1	24669281	24677281	24672566	8000	24673281	-4000	4000	-715
chr1	66370579	66378579	66373238	8000	66374579	-4000	4000	-1341
chr1	212616777	212624777	212618219	8000	212620777	-4000	4000	-2558
chr1	36411827	36419827	36418210	8000	36415827	-4000	4000	2383
chr1	160087340	160095340	160092989	8000	160091340	-4000	4000	1649
chr1	180968712	180976712	180976499	8000	180972712	-4000	4000	3787
chr1	198753476	198761476	198756417	8000	198757476	-4000	4000	-1059
chr1	209672390	209680390	209676006	8000	209676390	-4000	4000	-384
chr1	243120428	243128428	243126512	8000	243124428	-4000	4000	2084
chr1	45489866	45497866	45494984	8000	45493866	-4000	4000	1118
chr1	92059538	92067538	92063127	8000	92063538	-4000	4000	-411
chr1	232979435	232987435	232986142	8000	232983435	-4000	4000	2707
chr1	152999856	153007856	153003097	8000	153003856	-4000	4000	-759
chr1	168071843	168079843	168075520	8000	168075843	-4000	4000	-323
chr1	27608064	27616064	27613252	8000	27612064	-4000	4000	1188
chr1	109705551	109713551	109713368	8000	109709551	-4000	4000	3817
chr1	156304968	156312968	156310644	8000	156308968	-4000	4000	1676
chr1	26357634	26365634	26361851	8000	26361634	-4000	4000	217
chr1	161979192	161987192	161984921	8000	161983192	-4000	4000	1729
chr1	161520013	161528013	161525612	8000	161524013	-4000	4000	1599
chr1	223216819	223224819	223222116	8000	223220819	-4000	4000	1297
chr1	204613170	204621170	204619103	8000	204617170	-4000	4000	1933
chr1	47212290	47220290	47216583	8000	47216290	-4000	4000	293
chr1	52368829	52376829	52375516	8000	52372829	-4000	4000	2687
chr1	158182427	158190427	158183143	8000	158186427	-4000	4000	-3284
chr1	78885764	78893764	78891037	8000	78889764	-4000	4000	1273
chr1	94514666	94522666	94518364	8000	94518666	-4000	4000	-302
chr1	156655532	156663532	156657036	8000	156659532	-4000	4000	-2496
chr1	47374839	47382839	47377039	8000	47378839	-4000	4000	-1800
chr1	149933812	149941812	149936201	8000	149937812	-4000	4000	-1611
chr1	147291765	147299765	147294458	8000	147295765	-4000	4000	-1307
chr1	169507951	169515951	169515575	8000	169511951	-4000	4000	3624
chr1	203174931	203182931	203182841	8000	203178931	-4000	4000	3910
chr1	1397909	1405909	1405761	8000	1401909	-4000	4000	3852
chr1	13111488	13119488	13115751	8000	13115488	-4000	4000	263
chr1	182883982	182891982	182884712	8000	182887982	-4000	4000	-3270
chr1	206460436	206468436	206461093	8000	206464436	-4000	4000	-3343
chr1	152999856	153007856	153003583	8000	153003856	-4000	4000	-273
chr1	1369730	1377730	1373903	8000	1373730	-4000	4000	173
chr1	150503602	150511602	150504338	8000	150507602	-4000	4000	-3264
chr1	244705033	244713033	244705725	8000	244709033	-4000	4000	-3308
chr1	89929250	89937250	89935080	8000	89933250	-4000	4000	1830
chr1	151978915	151986915	151986127	8000	151982915	-4000	4000	3212
chr1	211567568	211575568	211575385	8000	211571568	-4000	4000	3817
chr1	145955441	145963441	145960402	8000	145959441	-4000	4000	961
chr1	12140207	12148207	12142464	8000	12144207	-4000	4000	-1743
chr1	43974295	43982295	43975847	8000	43978295	-4000	4000	-2448
chr1	171113819	171121819	171117487	8000	171117819	-4000	4000	-332
chr1	179072567	179080567	179075461	8000	179076567	-4000	4000	-1106
chr1	206460436	206468436	206462493	8000	206464436	-4000	4000	-1943
chr1	179094023	179102023	179095231	8000	179098023	-4000	4000	-2792
chr1	240485573	240493573	240493115	8000	240489573	-4000	4000	3542
chr1	54605181	54613181	54609451	8000	54609181	-4000	4000	270
chr1	207014522	207022522	207022100	8000	207018522	-4000	4000	3578
chr1	53210197	53218197	53210208	8000	53214197	-4000	4000	-3989
chr1	153977617	153985617	153982261	8000	153981617	-4000	4000	644
chr1	94514666	94522666	94517417	8000	94518666	-4000	4000	-1249
chr1	26121555	26129555	26122398	8000	26125555	-4000	4000	-3157
chr1	26796659	26804659	26797659	8000	26800659	-4000	4000	-3000
chr1	206730281	206738281	206732574	8000	206734281	-4000	4000	-1707
chr1	53907086	53915086	53910020	8000	53911086	-4000	4000	-1066
chr1	169128531	169136531	169132280	8000	169132531	-4000	4000	-251
chr1	47114318	47122318	47115591	8000	47118318	-4000	4000	-2727
chr1	155745659	155753659	155752033	8000	155749659	-4000	4000	2374
chr1	203163405	203171405	203165798	8000	203167405	-4000	4000	-1607
chr1	205298063	205306063	205304207	8000	205302063	-4000	4000	2144
chr1	223775893	223783893	223780813	8000	223779893	-4000	4000	920
chr1	26317698	26325698	26318082	8000	26321698	-4000	4000	-3616
chr1	156664763	156672763	156670656	8000	156668763	-4000	4000	1893
chr1	13821079	13829079	13823320	8000	13825079	-4000	4000	-1759
chr1	25828942	25836942	25835319	8000	25832942	-4000	4000	2377
chr1	27608064	27616064	27615746	8000	27612064	-4000	4000	3682
chr1	29322813	29330813	29323374	8000	29326813	-4000	4000	-3439
chr1	46181962	46189962	46184872	8000	46185962	-4000	4000	-1090
chr1	46409848	46417848	46413575	8000	46413848	-4000	4000	-273
chr1	114563557	114571557	114570051	8000	114567557	-4000	4000	2494
chr1	119027216	119035216	119033220	8000	119031216	-4000	4000	2004
chr1	119615377	119623377	119623187	8000	119619377	-4000	4000	3810
chr1	149787675	149795675	149788383	8000	149791675	-4000	4000	-3292
chr1	153386032	153394032	153390035	8000	153390032	-4000	4000	3
chr1	154151304	154159304	154152851	8000	154155304	-4000	4000	-2453
chr1	160087340	160095340	160094983	8000	160091340	-4000	4000	3643
chr1	186667791	186675791	186675277	8000	186671791	-4000	4000	3486
chr1	196828189	196836189	196830520	8000	196832189	-4000	4000	-1669
chr1	204613170	204621170	204618428	8000	204617170	-4000	4000	1258
chr1	206730281	206738281	206731139	8000	206734281	-4000	4000	-3142
chr1	223105404	223113404	223110642	8000	223109404	-4000	4000	1238
chr1	223105404	223113404	223112948	8000	223109404	-4000	4000	3544
chr1	227777826	227785826	227780716	8000	227781826	-4000	4000	-1110
chr1	228102679	228110679	228108075	8000	228106679	-4000	4000	1396
chr1	11915591	11923591	11922784	8000	11919591	-4000	4000	3193
chr1	113973869	113981869	113981135	8000	113977869	-4000	4000	3266
chr1	113973869	113981869	113981136	8000	113977869	-4000	4000	3267
chr1	156304968	156312968	156309302	8000	156308968	-4000	4000	334
chr1	118879046	118887046	118884095	8000	118883046	-4000	4000	1049
chr1	65411871	65419871	65412950	8000	65415871	-4000	4000	-2921
chr1	17823063	17831063	17826488	8000	17827063	-4000	4000	-575
chr1	156005048	156013048	156011786	8000	156009048	-4000	4000	2738
chr1	161225666	161233666	161230656	8000	161229666	-4000	4000	990
chr1	204418628	204426628	204424945	8000	204422628	-4000	4000	2317
chr1	248845517	248853517	248848161	8000	248849517	-4000	4000	-1356
chr1	961719	969719	962441	8000	965719	-4000	4000	-3278
chr1	6243353	6251353	6250503	8000	6247353	-4000	4000	3150
chr1	20660014	20668014	20666279	8000	20664014	-4000	4000	2265
chr1	24895511	24903511	24902491	8000	24899511	-4000	4000	2980
chr1	94892949	94900949	94897896	8000	94896949	-4000	4000	947
chr1	99305590	99313590	99306273	8000	99309590	-4000	4000	-3317
chr1	110943190	110951190	110949848	8000	110947190	-4000	4000	2658
chr1	145988435	145996435	145993675	8000	145992435	-4000	4000	1240
chr1	147752199	147760199	147759133	8000	147756199	-4000	4000	2934
chr1	149787675	149795675	149791275	8000	149791675	-4000	4000	-400
chr1	153610255	153618255	153615902	8000	153614255	-4000	4000	1647
chr1	154271875	154279875	154275644	8000	154275875	-4000	4000	-231
chr1	154347304	154355304	154348467	8000	154351304	-4000	4000	-2837
chr1	156655532	156663532	156656946	8000	156659532	-4000	4000	-2586
chr1	161225666	161233666	161228752	8000	161229666	-4000	4000	-914
chr1	161225666	161233666	161229946	8000	161229666	-4000	4000	280
chr1	161520013	161528013	161526496	8000	161524013	-4000	4000	2483
chr1	170735421	170743421	170736231	8000	170739421	-4000	4000	-3190
chr1	173179731	173187731	173186596	8000	173183731	-4000	4000	2865
chr1	200173420	200181420	200174050	8000	200177420	-4000	4000	-3370
chr1	209610870	209618870	209612048	8000	209614870	-4000	4000	-2822
chr1	223001995	223009995	223003839	8000	223005995	-4000	4000	-2156
chr1	224189441	224197441	224192348	8000	224193441	-4000	4000	-1093
chr1	225395292	225403292	225403273	8000	225399292	-4000	4000	3981
chr1	228102679	228110679	228107841	8000	228106679	-4000	4000	1162
chr1	228403935	228411935	228411015	8000	228407935	-4000	4000	3080
chr1	247095962	247103962	247100837	8000	247099962	-4000	4000	875
chr1	149880459	149888459	149886301	8000	149884459	-4000	4000	1842
chr1	225882696	225890696	225887048	8000	225886696	-4000	4000	352
chr1	117032552	117040552	117034077	8000	117036552	-4000	4000	-2475
chr1	43964022	43972022	43970623	8000	43968022	-4000	4000	2601
chr1	160993957	161001957	160998739	8000	160997957	-4000	4000	782
chr1	236545005	236553005	236552000	8000	236549005	-4000	4000	2995
chr1	93135079	93143079	93136880	8000	93139079	-4000	4000	-2199
chr1	150503602	150511602	150511484	8000	150507602	-4000	4000	3882
chr1	153977617	153985617	153982627	8000	153981617	-4000	4000	1010
chr1	156664763	156672763	156670507	8000	156668763	-4000	4000	1744
chr1	158182427	158190427	158183075	8000	158186427	-4000	4000	-3352
chr1	169128531	169136531	169132800	8000	169132531	-4000	4000	269
chr1	204613170	204621170	204618299	8000	204617170	-4000	4000	1129
chr1	209610870	209618870	209617472	8000	209614870	-4000	4000	2602
chr1	205528793	205536793	205529580	8000	205532793	-4000	4000	-3213
chr1	145988435	145996435	145995223	8000	145992435	-4000	4000	2788
chr1	15567699	15575699	15570074	8000	15571699	-4000	4000	-1625
chr1	18481974	18489974	18483716	8000	18485974	-4000	4000	-2258
chr1	211370946	211378946	211372643	8000	211374946	-4000	4000	-2303
chr1	156208796	156216796	156213022	8000	156212796	-4000	4000	226
chr1	229426365	229434365	229431456	8000	229430365	-4000	4000	1091
chr1	150642230	150650230	150648285	8000	150646230	-4000	4000	2055
chr1	161066998	161074998	161073272	8000	161070998	-4000	4000	2274
chr1	186307652	186315652	186311062	8000	186311652	-4000	4000	-590
chr1	206865223	206873223	206866009	8000	206869223	-4000	4000	-3214
chr1	150509789	150517789	150511754	8000	150513789	-4000	4000	-2035
chr1	244053476	244061476	244055214	8000	244057476	-4000	4000	-2262
chr1	109488804	109496804	109490117	8000	109492804	-4000	4000	-2687
chr1	111771602	111779602	111777089	8000	111775602	-4000	4000	1487
chr1	155316666	155324666	155320486	8000	155320666	-4000	4000	-180
chr1	204418628	204426628	204425733	8000	204422628	-4000	4000	3105
chr1	223105404	223113404	223110454	8000	223109404	-4000	4000	1050
chr1	1698379	1706379	1703915	8000	1702379	-4000	4000	1536
chr1	40236921	40244921	40237324	8000	40240921	-4000	4000	-3597
chr1	52404282	52412282	52405774	8000	52408282	-4000	4000	-2508
chr1	202315781	202323781	202318065	8000	202319781	-4000	4000	-1716
chr1	109488804	109496804	109490003	8000	109492804	-4000	4000	-2801
chr1	39965968	39973968	39969636	8000	39969968	-4000	4000	-332
chr1	46553407	46561407	46557508	8000	46557407	-4000	4000	101
chr1	155881199	155889199	155881446	8000	155885199	-4000	4000	-3753
chr1	161520013	161528013	161526482	8000	161524013	-4000	4000	2469
chr1	5858811	5866811	5863328	8000	5862811	-4000	4000	517
chr1	40492343	40500343	40495118	8000	40496343	-4000	4000	-1225
chr1	74564117	74572117	74571927	8000	74568117	-4000	4000	3810
chr1	115044011	115052011	115050434	8000	115048011	-4000	4000	2423
chr1	43359203	43367203	43359271	8000	43363203	-4000	4000	-3932
chr1	147752199	147760199	147758436	8000	147756199	-4000	4000	2237
chr1	151031713	151039713	151033913	8000	151035713	-4000	4000	-1800
chr1	156664763	156672763	156670237	8000	156668763	-4000	4000	1474
chr1	226227149	226235149	226232722	8000	226231149	-4000	4000	1573
chr1	16193854	16201854	16199173	8000	16197854	-4000	4000	1319
chr1	150509789	150517789	150511702	8000	150513789	-4000	4000	-2087
chr1	158353553	158361553	158355863	8000	158357553	-4000	4000	-1690
chr1	24052035	24060035	24057606	8000	24056035	-4000	4000	1571
chr1	39834110	39842110	39841876	8000	39838110	-4000	4000	3766
chr1	146992202	147000202	146994722	8000	146996202	-4000	4000	-1480
chr1	155316666	155324666	155320489	8000	155320666	-4000	4000	-177
chr1	209775208	209783208	209778127	8000	209779208	-4000	4000	-1081
chr1	235127634	235135634	235127886	8000	235131634	-4000	4000	-3748
chr1	84545611	84553611	84553109	8000	84549611	-4000	4000	3498
chr1	205593556	205601556	205600617	8000	205597556	-4000	4000	3061
chr1	26185884	26193884	26188249	8000	26189884	-4000	4000	-1635
chr1	26185884	26193884	26191385	8000	26189884	-4000	4000	1501
chr1	150805713	150813713	150812110	8000	150809713	-4000	4000	2397
chr1	151843101	151851101	151847802	8000	151847101	-4000	4000	701
chr1	201892456	201900456	201899243	8000	201896456	-4000	4000	2787
chr1	206098449	206106449	206102012	8000	206102449	-4000	4000	-437
chr1	206585448	206593448	206591710	8000	206589448	-4000	4000	2262
chr1	207140972	207148972	207143880	8000	207144972	-4000	4000	-1092
chr1	215617807	215625807	215625606	8000	215621807	-4000	4000	3799
chr1	244841057	244849057	244843207	8000	244845057	-4000	4000	-1850
chr1	88832255	88840255	88833098	8000	88836255	-4000	4000	-3157
chr1	109092934	109100934	109094442	8000	109096934	-4000	4000	-2492
chr1	113973869	113981869	113981269	8000	113977869	-4000	4000	3400
chr1	161537759	161545759	161542867	8000	161541759	-4000	4000	1108
chr1	186307652	186315652	186314626	8000	186311652	-4000	4000	2974
chr1	15730769	15738769	15738725	8000	15734769	-4000	4000	3956
chr1	109705551	109713551	109713374	8000	109709551	-4000	4000	3823
chr1	119740218	119748218	119744167	8000	119744218	-4000	4000	-51
chr1	156664763	156672763	156669906	8000	156668763	-4000	4000	1143
chr1	156664763	156672763	156670947	8000	156668763	-4000	4000	2184
chr1	160354952	160362952	160355928	8000	160358952	-4000	4000	-3024
chr1	186667791	186675791	186674764	8000	186671791	-4000	4000	2973
chr1	190093658	190101658	190098961	8000	190097658	-4000	4000	1303
chr1	202327657	202335657	202331954	8000	202331657	-4000	4000	297
chr1	222747004	222755004	222747049	8000	222751004	-4000	4000	-3955
chr1	248915946	248923946	248916608	8000	248919946	-4000	4000	-3338
chr1	150509789	150517789	150512795	8000	150513789	-4000	4000	-994
chr1	155610951	155618951	155614671	8000	155614951	-4000	4000	-280
chr1	159923039	159931039	159930181	8000	159927039	-4000	4000	3142
chr1	33119492	33127492	33120098	8000	33123492	-4000	4000	-3394
chr1	91676343	91684343	91683718	8000	91680343	-4000	4000	3375
chr1	150509789	150517789	150513298	8000	150513789	-4000	4000	-491
chr1	39891426	39899426	39897559	8000	39895426	-4000	4000	2133
chr1	45614904	45622904	45615028	8000	45618904	-4000	4000	-3876
chr1	155610951	155618951	155614177	8000	155614951	-4000	4000	-774
chr1	155610951	155618951	155614178	8000	155614951	-4000	4000	-773
chr1	211312385	211320385	211313446	8000	211316385	-4000	4000	-2939
chr1	158254269	158262269	158254462	8000	158258269	-4000	4000	-3807
chr1	173179731	173187731	173186566	8000	173183731	-4000	4000	2835
chr1	158353553	158361553	158356829	8000	158357553	-4000	4000	-724
chr1	233381148	233389148	233382655	8000	233385148	-4000	4000	-2493
chr1	205138505	205146505	205143975	8000	205142505	-4000	4000	1470
chr1	206730281	206738281	206732713	8000	206734281	-4000	4000	-1568
chr1	110668465	110676465	110673068	8000	110672465	-4000	4000	603
chr1	23692835	23700835	23696341	8000	23696835	-4000	4000	-494
chr1	44811585	44819585	44813422	8000	44815585	-4000	4000	-2163
chr1	155316666	155324666	155320499	8000	155320666	-4000	4000	-167
chr1	34782369	34790369	34785078	8000	34786369	-4000	4000	-1291
chr1	6181020	6189020	6186771	8000	6185020	-4000	4000	1751
chr1	153977617	153985617	153982066	8000	153981617	-4000	4000	449
chr1	171631417	171639417	171636279	8000	171635417	-4000	4000	862
chr1	223001995	223009995	223004048	8000	223005995	-4000	4000	-1947
chr1	230798003	230806003	230801607	8000	230802003	-4000	4000	-396
chr1	46257196	46265196	46261307	8000	46261196	-4000	4000	111
chr1	66370579	66378579	66372474	8000	66374579	-4000	4000	-2105
chr1	75783575	75791575	75789268	8000	75787575	-4000	4000	1693
chr1	202315781	202323781	202318697	8000	202319781	-4000	4000	-1084
chr1	231351023	231359023	231352985	8000	231355023	-4000	4000	-2038
chr1	246536561	246544561	246540915	8000	246540561	-4000	4000	354
chr1	88832255	88840255	88833374	8000	88836255	-4000	4000	-2881
chr1	111349013	111357013	111351395	8000	111353013	-4000	4000	-1618
chr1	156381219	156389219	156384862	8000	156385219	-4000	4000	-357
chr1	52605051	52613051	52606792	8000	52609051	-4000	4000	-2259
chr1	151796264	151804264	151801865	8000	151800264	-4000	4000	1601
chr1	246664595	246672595	246666303	8000	246668595	-4000	4000	-2292
chr1	62447804	62455804	62451135	8000	62451804	-4000	4000	-669
chr1	92828737	92836737	92832999	8000	92832737	-4000	4000	262
chr1	107567161	107575161	107572670	8000	107571161	-4000	4000	1509
chr1	107567161	107575161	107572797	8000	107571161	-4000	4000	1636
chr1	211312385	211320385	211313865	8000	211316385	-4000	4000	-2520
chr1	17280233	17288233	17280722	8000	17284233	-4000	4000	-3511
chr1	35418058	35426058	35419922	8000	35422058	-4000	4000	-2136
chr1	40616680	40624680	40622870	8000	40620680	-4000	4000	2190
chr1	46039661	46047661	46046016	8000	46043661	-4000	4000	2355
chr1	70848353	70856353	70852738	8000	70852353	-4000	4000	385
chr1	94525173	94533173	94530126	8000	94529173	-4000	4000	953
chr1	244705033	244713033	244708402	8000	244709033	-4000	4000	-631
chr1	158254269	158262269	158256988	8000	158258269	-4000	4000	-1281
chr1	46181962	46189962	46184823	8000	46185962	-4000	4000	-1139
chr1	150503602	150511602	150507053	8000	150507602	-4000	4000	-549
chr1	150503602	150511602	150508167	8000	150507602	-4000	4000	565
chr1	47246139	47254139	47250960	8000	47250139	-4000	4000	821
chr1	111474512	111482512	111478293	8000	111478512	-4000	4000	-219
chr1	209775208	209783208	209779442	8000	209779208	-4000	4000	234
chr1	184786724	184794724	184792636	8000	184790724	-4000	4000	1912
chr1	64689058	64697058	64691802	8000	64693058	-4000	4000	-1256
chr1	59872322	59880322	59875536	8000	59876322	-4000	4000	-786
chr1	64177498	64185498	64178465	8000	64181498	-4000	4000	-3033
chr1	67394724	67402724	67395919	8000	67398724	-4000	4000	-2805
chr1	22635678	22643678	22638971	8000	22639678	-4000	4000	-707
chr1	159199313	159207313	159205863	8000	159203313	-4000	4000	2550
chr1	113973869	113981869	113981346	8000	113977869	-4000	4000	3477
chr1	1626605	1634605	1629667	8000	1630605	-4000	4000	-938
chr1	11670354	11678354	11676104	8000	11674354	-4000	4000	1750
chr1	16981958	16989958	16986484	8000	16985958	-4000	4000	526
chr1	152298165	152306165	152304016	8000	152302165	-4000	4000	1851
chr1	248806446	248814446	248812289	8000	248810446	-4000	4000	1843
chr1	39891426	39899426	39897896	8000	39895426	-4000	4000	2470
chr1	149933812	149941812	149936787	8000	149937812	-4000	4000	-1025
chr1	150304979	150312979	150308145	8000	150308979	-4000	4000	-834
chr1	173484815	173492815	173485456	8000	173488815	-4000	4000	-3359
chr1	74762678	74770678	74763922	8000	74766678	-4000	4000	-2756
chr1	236548981	236556981	236555643	8000	236552981	-4000	4000	2662
chr1	24669281	24677281	24670242	8000	24673281	-4000	4000	-3039
chr1	113910086	113918086	113913547	8000	113914086	-4000	4000	-539
chr1	151245536	151253536	151246952	8000	151249536	-4000	4000	-2584
chr1	16193854	16201854	16198679	8000	16197854	-4000	4000	825
chr1	19971431	19979431	19978782	8000	19975431	-4000	4000	3351
chr1	22644110	22652110	22647765	8000	22648110	-4000	4000	-345
chr1	53907086	53915086	53910125	8000	53911086	-4000	4000	-961
chr1	85014082	85022082	85021151	8000	85018082	-4000	4000	3069
chr1	111410319	111418319	111414752	8000	111414319	-4000	4000	433
chr1	154958298	154966298	154963887	8000	154962298	-4000	4000	1589
chr1	155745659	155753659	155751809	8000	155749659	-4000	4000	2150
chr1	159058484	159066484	159062708	8000	159062484	-4000	4000	224
chr1	203020848	203028848	203023181	8000	203024848	-4000	4000	-1667
chr1	211567568	211575568	211575526	8000	211571568	-4000	4000	3958
chr1	23960347	23968347	23967569	8000	23964347	-4000	4000	3222
chr1	158182427	158190427	158183060	8000	158186427	-4000	4000	-3367
chr1	39891426	39899426	39897811	8000	39895426	-4000	4000	2385
chr1	27882685	27890685	27882942	8000	27886685	-4000	4000	-3743
chr1	89002679	89010679	89007507	8000	89006679	-4000	4000	828
chr1	62447804	62455804	62450504	8000	62451804	-4000	4000	-1300
chr1	154940076	154948076	154945566	8000	154944076	-4000	4000	1490
chr1	163072802	163080802	163074554	8000	163076802	-4000	4000	-2248
chr1	117032552	117040552	117033951	8000	117036552	-4000	4000	-2601
chr1	167018214	167026214	167021712	8000	167022214	-4000	4000	-502
chr1	84562194	84570194	84563415	8000	84566194	-4000	4000	-2779
chr1	110943190	110951190	110947757	8000	110947190	-4000	4000	567
chr1	32201453	32209453	32207922	8000	32205453	-4000	4000	2469
chr1	155209824	155217824	155217576	8000	155213824	-4000	4000	3752
chr1	240485573	240493573	240493085	8000	240489573	-4000	4000	3512
chr1	26121555	26129555	26121976	8000	26125555	-4000	4000	-3579
chr1	37562857	37570857	37566504	8000	37566857	-4000	4000	-353
chr1	231351023	231359023	231352632	8000	231355023	-4000	4000	-2391
chr1	109305568	109313568	109313452	8000	109309568	-4000	4000	3884
chr1	155046930	155054930	155053443	8000	155050930	-4000	4000	2513
chr1	23960347	23968347	23961791	8000	23964347	-4000	4000	-2556
chr1	40419326	40427326	40422316	8000	40423326	-4000	4000	-1010
chr1	92837924	92845924	92843906	8000	92841924	-4000	4000	1982
chr1	108966214	108974214	108970228	8000	108970214	-4000	4000	14
chr1	186186949	186194949	186189753	8000	186190949	-4000	4000	-1196
chr1	43619666	43627666	43622088	8000	43623666	-4000	4000	-1578
chr1	176853302	176861302	176857612	8000	176857302	-4000	4000	310
chr1	110397249	110405249	110401388	8000	110401249	-4000	4000	139
chr1	209672390	209680390	209675837	8000	209676390	-4000	4000	-553
chr1	68041886	68049886	68046959	8000	68045886	-4000	4000	1073
chr1	151534692	151542692	151537853	8000	151538692	-4000	4000	-839
chr1	1438882	1446882	1439221	8000	1442882	-4000	4000	-3661
chr1	39834110	39842110	39841767	8000	39838110	-4000	4000	3657
chr1	173854808	173862808	173857667	8000	173858808	-4000	4000	-1141
chr1	54752898	54760898	54758790	8000	54756898	-4000	4000	1892
chr1	113890194	113898194	113895412	8000	113894194	-4000	4000	1218
chr1	146992202	147000202	146994416	8000	146996202	-4000	4000	-1786
chr1	19678240	19686240	19683058	8000	19682240	-4000	4000	818
chr1	70140805	70148805	70148605	8000	70144805	-4000	4000	3800
chr1	40236921	40244921	40237718	8000	40240921	-4000	4000	-3203
chr1	147171351	147179351	147179097	8000	147175351	-4000	4000	3746
chr1	234381080	234389080	234383742	8000	234385080	-4000	4000	-1338
chr1	43992528	44000528	43992566	8000	43996528	-4000	4000	-3962
chr1	212616777	212624777	212619507	8000	212620777	-4000	4000	-1270
chr1	961719	969719	963353	8000	965719	-4000	4000	-2366
chr1	26472642	26480642	26475946	8000	26476642	-4000	4000	-696
chr1	43619666	43627666	43622098	8000	43623666	-4000	4000	-1568
chr1	46184683	46192683	46192408	8000	46188683	-4000	4000	3725
chr1	53964168	53972168	53966293	8000	53968168	-4000	4000	-1875
chr1	149899318	149907318	149905811	8000	149903318	-4000	4000	2493
chr1	149899318	149907318	149905813	8000	149903318	-4000	4000	2495
chr1	161161723	161169723	161165604	8000	161165723	-4000	4000	-119
chr1	186307652	186315652	186312363	8000	186311652	-4000	4000	711
chr1	209775208	209783208	209781381	8000	209779208	-4000	4000	2173
chr1	246835098	246843098	246840858	8000	246839098	-4000	4000	1760
chr1	19678240	19686240	19683171	8000	19682240	-4000	4000	931
chr1	206730281	206738281	206732807	8000	206734281	-4000	4000	-1474
chr1	32241397	32249397	32247263	8000	32245397	-4000	4000	1866
chr1	3732201	3740201	3733527	8000	3736201	-4000	4000	-2674
chr1	74022015	74030015	74026810	8000	74026015	-4000	4000	795
chr1	200547497	200555497	200554579	8000	200551497	-4000	4000	3082
chr1	204123743	204131743	204126754	8000	204127743	-4000	4000	-989
chr1	35709877	35717877	35716118	8000	35713877	-4000	4000	2241
chr1	205298063	205306063	205305312	8000	205302063	-4000	4000	3249
chr1	171113819	171121819	171117098	8000	171117819	-4000	4000	-721
chr1	77691987	77699987	77697716	8000	77695987	-4000	4000	1729
chr1	222553902	222561902	222561404	8000	222557902	-4000	4000	3502
chr1	203174931	203182931	203181253	8000	203178931	-4000	4000	2322
chr1	11915591	11923591	11922937	8000	11919591	-4000	4000	3346
chr1	64689058	64697058	64691361	8000	64693058	-4000	4000	-1697
chr1	113681923	113689923	113683283	8000	113685923	-4000	4000	-2640
chr1	89047882	89055882	89053391	8000	89051882	-4000	4000	1509
chr1	3808086	3816086	3815450	8000	3812086	-4000	4000	3364
chr1	152999856	153007856	153003423	8000	153003856	-4000	4000	-433
chr1	154544577	154552577	154547931	8000	154548577	-4000	4000	-646
chr1	20647767	20655767	20650560	8000	20651767	-4000	4000	-1207
chr1	70848353	70856353	70852859	8000	70852353	-4000	4000	506
chr1	182826384	182834384	182829082	8000	182830384	-4000	4000	-1302
chr1	47046751	47054751	47050179	8000	47050751	-4000	4000	-572
chr1	81989932	81997932	81990833	8000	81993932	-4000	4000	-3099
chr1	110943190	110951190	110950021	8000	110947190	-4000	4000	2831
chr1	207077024	207085024	207079260	8000	207081024	-4000	4000	-1764
chr1	32241397	32249397	32247588	8000	32245397	-4000	4000	2191
chr1	204613170	204621170	204618076	8000	204617170	-4000	4000	906
chr1	231351023	231359023	231351355	8000	231355023	-4000	4000	-3668
chr1	20614903	20622903	20618627	8000	20618903	-4000	4000	-276
chr1	92180725	92188725	92181072	8000	92184725	-4000	4000	-3653
chr1	148527385	148535385	148534693	8000	148531385	-4000	4000	3308
chr1	159923039	159931039	159930332	8000	159927039	-4000	4000	3293
chr1	223001995	223009995	223003288	8000	223005995	-4000	4000	-2707
chr1	34782369	34790369	34785238	8000	34786369	-4000	4000	-1131
chr1	41474775	41482775	41479316	8000	41478775	-4000	4000	541
chr1	54605181	54613181	54609644	8000	54609181	-4000	4000	463
chr1	209610870	209618870	209618561	8000	209614870	-4000	4000	3691
chr1	215233090	215241090	215234938	8000	215237090	-4000	4000	-2152
chr1	201888587	201896587	201890476	8000	201892587	-4000	4000	-2111
chr1	81989932	81997932	81990858	8000	81993932	-4000	4000	-3074
chr1	116765229	116773229	116768469	8000	116769229	-4000	4000	-760
chr1	225397502	225405502	225404680	8000	225401502	-4000	4000	3178
chr1	92180725	92188725	92181738	8000	92184725	-4000	4000	-2987
chr1	214333131	214341131	214336799	8000	214337131	-4000	4000	-332
chr1	159051155	159059155	159052053	8000	159055155	-4000	4000	-3102
chr1	175144075	175152075	175147148	8000	175148075	-4000	4000	-927
chr1	216499246	216507246	216507122	8000	216503246	-4000	4000	3876
chr1	177278422	177286422	177281742	8000	177282422	-4000	4000	-680
chr1	186307652	186315652	186314061	8000	186311652	-4000	4000	2409
chr1	198753476	198761476	198756302	8000	198757476	-4000	4000	-1174
chr1	206492889	206500889	206496172	8000	206496889	-4000	4000	-717
chr1	231351023	231359023	231353162	8000	231355023	-4000	4000	-1861
chr1	117949590	117957590	117952586	8000	117953590	-4000	4000	-1004
chr1	148478548	148486548	148483241	8000	148482548	-4000	4000	693
chr1	152999856	153007856	153003016	8000	153003856	-4000	4000	-840
chr1	75783575	75791575	75791545	8000	75787575	-4000	4000	3970
chr1	212988182	212996182	212995058	8000	212992182	-4000	4000	2876
chr1	15730769	15738769	15736717	8000	15734769	-4000	4000	1948
chr1	149880459	149888459	149886455	8000	149884459	-4000	4000	1996
chr1	154940076	154948076	154947996	8000	154944076	-4000	4000	3920
chr1	156521405	156529405	156526524	8000	156525405	-4000	4000	1119
chr1	161225666	161233666	161233246	8000	161229666	-4000	4000	3580
chr1	169788529	169796529	169793536	8000	169792529	-4000	4000	1007
chr1	231219763	231227763	231226605	8000	231223763	-4000	4000	2842
chr1	26121555	26129555	26122071	8000	26125555	-4000	4000	-3484
chr1	28331965	28339965	28334671	8000	28335965	-4000	4000	-1294
chr1	81989932	81997932	81990801	8000	81993932	-4000	4000	-3131
chr1	149924651	149932651	149926722	8000	149928651	-4000	4000	-1929
chr1	150261078	150269078	150261330	8000	150265078	-4000	4000	-3748
chr1	175144075	175152075	175146987	8000	175148075	-4000	4000	-1088
chr1	29322813	29330813	29325210	8000	29326813	-4000	4000	-1603
chr1	41474775	41482775	41479335	8000	41478775	-4000	4000	560
chr1	74564117	74572117	74571232	8000	74568117	-4000	4000	3115
chr1	156459727	156467727	156467645	8000	156463727	-4000	4000	3918
chr1	223105404	223113404	223112093	8000	223109404	-4000	4000	2689
chr1	52416836	52424836	52417984	8000	52420836	-4000	4000	-2852
chr1	168310426	168318426	168314218	8000	168314426	-4000	4000	-208
chr1	22599595	22607595	22602631	8000	22603595	-4000	4000	-964
chr1	154975251	154983251	154978037	8000	154979251	-4000	4000	-1214
chr1	225786468	225794468	225789472	8000	225790468	-4000	4000	-996
chr1	119907553	119915553	119915317	8000	119911553	-4000	4000	3764
chr1	159833492	159841492	159840745	8000	159837492	-4000	4000	3253
chr1	145734868	145742868	145738355	8000	145738868	-4000	4000	-513
chr1	167912675	167920675	167920607	8000	167916675	-4000	4000	3932
chr1	16010028	16018028	16015581	8000	16014028	-4000	4000	1553
chr1	40236921	40244921	40240314	8000	40240921	-4000	4000	-607
chr1	43619666	43627666	43621989	8000	43623666	-4000	4000	-1677
chr1	46815413	46823413	46818141	8000	46819413	-4000	4000	-1272
chr1	65411871	65419871	65412925	8000	65415871	-4000	4000	-2946
chr1	161042946	161050946	161048438	8000	161046946	-4000	4000	1492
chr1	163072802	163080802	163073500	8000	163076802	-4000	4000	-3302
chr1	171281978	171289978	171281987	8000	171285978	-4000	4000	-3991
chr1	152298165	152306165	152304640	8000	152302165	-4000	4000	2475
chr1	15114043	15122043	15114649	8000	15118043	-4000	4000	-3394
chr1	111474512	111482512	111477704	8000	111478512	-4000	4000	-808
chr1	223105404	223113404	223110896	8000	223109404	-4000	4000	1492
chr1	226140679	226148679	226146629	8000	226144679	-4000	4000	1950
chr1	160354952	160362952	160358178	8000	160358952	-4000	4000	-774
chr1	163072802	163080802	163073610	8000	163076802	-4000	4000	-3192
chr1	190093658	190101658	190099023	8000	190097658	-4000	4000	1365
chr1	23784232	23792232	23787468	8000	23788232	-4000	4000	-764
chr1	27882685	27890685	27885446	8000	27886685	-4000	4000	-1239
chr1	34977533	34985533	34983931	8000	34981533	-4000	4000	2398
chr1	120886530	120894530	120889872	8000	120890530	-4000	4000	-658
chr1	149924651	149932651	149930684	8000	149928651	-4000	4000	2033
chr1	11915591	11923591	11922782	8000	11919591	-4000	4000	3191
chr1	15114043	15122043	15114413	8000	15118043	-4000	4000	-3630
chr1	25238249	25246249	25242466	8000	25242249	-4000	4000	217
chr1	40459718	40467718	40463512	8000	40463718	-4000	4000	-206
chr1	43974295	43982295	43978033	8000	43978295	-4000	4000	-262
chr1	99690541	99698541	99694029	8000	99694541	-4000	4000	-512
chr1	100079563	100087563	100085427	8000	100083563	-4000	4000	1864
chr1	111766662	111774662	111766822	8000	111770662	-4000	4000	-3840
chr1	155881199	155889199	155881449	8000	155885199	-4000	4000	-3750
chr1	158973059	158981059	158973708	8000	158977059	-4000	4000	-3351
chr1	161359206	161367206	161365556	8000	161363206	-4000	4000	2350
chr1	206182179	206190179	206187323	8000	206186179	-4000	4000	1144
chr1	29322813	29330813	29325804	8000	29326813	-4000	4000	-1009
chr1	29115429	29123429	29119552	8000	29119429	-4000	4000	123
chr1	61677046	61685046	61681100	8000	61681046	-4000	4000	54
chr1	61677046	61685046	61681101	8000	61681046	-4000	4000	55
chr1	155881199	155889199	155881286	8000	155885199	-4000	4000	-3913
chr1	163351764	163359764	163355739	8000	163355764	-4000	4000	-25
chr1	149880459	149888459	149886630	8000	149884459	-4000	4000	2171
chr1	175144075	175152075	175144532	8000	175148075	-4000	4000	-3543
chr1	158254269	158262269	158255328	8000	158258269	-4000	4000	-2941
chr1	71059291	71067291	71063950	8000	71063291	-4000	4000	659
chr1	179916077	179924077	179918418	8000	179920077	-4000	4000	-1659
chr1	203740081	203748081	203743199	8000	203744081	-4000	4000	-882
chr1	207014522	207022522	207022512	8000	207018522	-4000	4000	3990
chr1	54221464	54229464	54226754	8000	54225464	-4000	4000	1290
chr1	151796264	151804264	151801558	8000	151800264	-4000	4000	1294
chr1	186984981	186992981	186988739	8000	186988981	-4000	4000	-242
chr1	1698379	1706379	1703884	8000	1702379	-4000	4000	1505
chr1	92828737	92836737	92833489	8000	92832737	-4000	4000	752
chr1	32932445	32940445	32937265	8000	32936445	-4000	4000	820
chr1	224189441	224197441	224189580	8000	224193441	-4000	4000	-3861
chr1	32241397	32249397	32247274	8000	32245397	-4000	4000	1877
chr1	85152889	85160889	85158804	8000	85156889	-4000	4000	1915
chr1	161167310	161175310	161167414	8000	161171310	-4000	4000	-3896
chr1	44647724	44655724	44655080	8000	44651724	-4000	4000	3356
chr1	229426365	229434365	229432040	8000	229430365	-4000	4000	1675
chr1	159199313	159207313	159204935	8000	159203313	-4000	4000	1622
chr1	166852359	166860359	166856766	8000	166856359	-4000	4000	407
chr1	215617807	215625807	215625806	8000	215621807	-4000	4000	3999
chr1	223001995	223009995	223002895	8000	223005995	-4000	4000	-3100
chr1	17062761	17070761	17069164	8000	17066761	-4000	4000	2403
chr1	168071843	168079843	168075433	8000	168075843	-4000	4000	-410
chr1	46039661	46047661	46046002	8000	46043661	-4000	4000	2341
chr1	152907886	152915886	152910375	8000	152911886	-4000	4000	-1511
chr1	156655532	156663532	156658236	8000	156659532	-4000	4000	-1296
chr1	158845506	158853506	158849266	8000	158849506	-4000	4000	-240
chr1	220695153	220703153	220696833	8000	220699153	-4000	4000	-2320
chr1	17062761	17070761	17070159	8000	17066761	-4000	4000	3398
chr1	53210197	53218197	53214429	8000	53214197	-4000	4000	232
chr1	145734868	145742868	145738155	8000	145738868	-4000	4000	-713
chr1	92828737	92836737	92834879	8000	92832737	-4000	4000	2142
chr1	37607350	37615350	37612893	8000	37611350	-4000	4000	1543
chr1	55062359	55070359	55069019	8000	55066359	-4000	4000	2660
chr1	151767334	151775334	151775077	8000	151771334	-4000	4000	3743
chr1	201892456	201900456	201900138	8000	201896456	-4000	4000	3682
chr1	228178257	228186257	228181631	8000	228182257	-4000	4000	-626
chr1	11102535	11110535	11109320	8000	11106535	-4000	4000	2785
chr1	113890194	113898194	113895485	8000	113894194	-4000	4000	1291
chr1	38881807	38889807	38886440	8000	38885807	-4000	4000	633
chr1	205528793	205536793	205531354	8000	205532793	-4000	4000	-1439
chr1	229426365	229434365	229433047	8000	229430365	-4000	4000	2682
chr1	196743504	196751504	196745883	8000	196747504	-4000	4000	-1621
chr1	53964168	53972168	53967807	8000	53968168	-4000	4000	-361
chr1	115696021	115704021	115702992	8000	115700021	-4000	4000	2971
chr1	151843101	151851101	151848185	8000	151847101	-4000	4000	1084
chr1	160604106	160612106	160610730	8000	160608106	-4000	4000	2624
chr1	109395042	109403042	109401902	8000	109399042	-4000	4000	2860
chr1	159833492	159841492	159835278	8000	159837492	-4000	4000	-2214
chr1	203740081	203748081	203743292	8000	203744081	-4000	4000	-789
chr1	236548981	236556981	236553599	8000	236552981	-4000	4000	618
chr1	70254999	70262999	70262636	8000	70258999	-4000	4000	3637
chr1	220053482	220061482	220058679	8000	220057482	-4000	4000	1197
chr1	92242402	92250402	92244365	8000	92246402	-4000	4000	-2037
chr1	230686776	230694776	230687059	8000	230690776	-4000	4000	-3717
chr1	92828737	92836737	92832894	8000	92832737	-4000	4000	157
chr1	32675906	32683906	32679796	8000	32679906	-4000	4000	-110
chr1	172662876	172670876	172665640	8000	172666876	-4000	4000	-1236
chr1	78536701	78544701	78536799	8000	78540701	-4000	4000	-3902
chr1	153419222	153427222	153419328	8000	153423222	-4000	4000	-3894
chr1	64829229	64837229	64834651	8000	64833229	-4000	4000	1422
chr1	154940076	154948076	154945908	8000	154944076	-4000	4000	1832
chr1	155243205	155251205	155250860	8000	155247205	-4000	4000	3655
chr1	161035251	161043251	161040648	8000	161039251	-4000	4000	1397
chr1	173899549	173907549	173903816	8000	173903549	-4000	4000	267
chr1	179916077	179924077	179918325	8000	179920077	-4000	4000	-1752
chr1	200965390	200973390	200972795	8000	200969390	-4000	4000	3405
chr1	145955441	145963441	145961364	8000	145959441	-4000	4000	1923
chr1	201888587	201896587	201889504	8000	201892587	-4000	4000	-3083
chr1	236548981	236556981	236556136	8000	236552981	-4000	4000	3155
chr1	149880459	149888459	149886215	8000	149884459	-4000	4000	1756
chr1	149924651	149932651	149931422	8000	149928651	-4000	4000	2771
chr1	155014520	155022520	155014520	8000	155018520	-4000	4000	-4000
chr1	171281978	171289978	171285433	8000	171285978	-4000	4000	-545
chr1	241591642	241599642	241592051	8000	241595642	-4000	4000	-3591
chr1	92180725	92188725	92184144	8000	92184725	-4000	4000	-581
chr1	151534692	151542692	151536821	8000	151538692	-4000	4000	-1871
chr1	154958298	154966298	154963788	8000	154962298	-4000	4000	1490
chr1	177278422	177286422	177281180	8000	177282422	-4000	4000	-1242
chr1	190093658	190101658	190099034	8000	190097658	-4000	4000	1376
chr1	109729932	109737932	109736995	8000	109733932	-4000	4000	3063
chr1	236217865	236225865	236225137	8000	236221865	-4000	4000	3272
chr1	17823063	17831063	17826570	8000	17827063	-4000	4000	-493
chr1	156136081	156144081	156136858	8000	156140081	-4000	4000	-3223
chr1	149880459	149888459	149886087	8000	149884459	-4000	4000	1628
chr1	154202696	154210696	154207625	8000	154206696	-4000	4000	929
chr1	13111488	13119488	13116119	8000	13115488	-4000	4000	631
chr1	46039661	46047661	46046590	8000	46043661	-4000	4000	2929
chr1	112907847	112915847	112914144	8000	112911847	-4000	4000	2297
chr1	216499246	216507246	216506860	8000	216503246	-4000	4000	3614
chr1	154940076	154948076	154945737	8000	154944076	-4000	4000	1661
chr1	202315781	202323781	202318490	8000	202319781	-4000	4000	-1291
chr1	156912429	156920429	156914832	8000	156916429	-4000	4000	-1597
chr1	200911742	200919742	200913731	8000	200915742	-4000	4000	-2011
chr1	156664763	156672763	156669566	8000	156668763	-4000	4000	803
chr1	109275556	109283556	109281924	8000	109279556	-4000	4000	2368
chr1	111458773	111466773	111459576	8000	111462773	-4000	4000	-3197
chr1	16010028	16018028	16015435	8000	16014028	-4000	4000	1407
chr1	84234498	84242498	84235329	8000	84238498	-4000	4000	-3169
chr1	150261399	150269399	150262594	8000	150265399	-4000	4000	-2805
chr1	155165409	155173409	155173381	8000	155169409	-4000	4000	3972
chr1	205079129	205087129	205084202	8000	205083129	-4000	4000	1073
chr1	223001995	223009995	223004205	8000	223005995	-4000	4000	-1790
chr1	46670659	46678659	46678292	8000	46674659	-4000	4000	3633
chr1	224158047	224166047	224158458	8000	224162047	-4000	4000	-3589
chr1	40236921	40244921	40237926	8000	40240921	-4000	4000	-2995
chr1	149050027	149058027	149055868	8000	149054027	-4000	4000	1841
chr1	16193854	16201854	16198526	8000	16197854	-4000	4000	672
chr1	169392540	169400540	169395189	8000	169396540	-4000	4000	-1351
chr1	169845631	169853631	169852935	8000	169849631	-4000	4000	3304
chr1	161035251	161043251	161039827	8000	161039251	-4000	4000	576
chr1	169584849	169592849	169586501	8000	169588849	-4000	4000	-2348
chr1	34782369	34790369	34785232	8000	34786369	-4000	4000	-1137
chr1	92837924	92845924	92841894	8000	92841924	-4000	4000	-30
chr1	89102132	89110132	89109795	8000	89106132	-4000	4000	3663
chr1	158290774	158298774	158291383	8000	158294774	-4000	4000	-3391
chr1	159199313	159207313	159206451	8000	159203313	-4000	4000	3138
chr1	155610951	155618951	155611480	8000	155614951	-4000	4000	-3471
chr1	27375176	27383176	27379884	8000	27379176	-4000	4000	708
chr1	64177498	64185498	64177665	8000	64181498	-4000	4000	-3833
chr1	154940076	154948076	154947639	8000	154944076	-4000	4000	3563
chr1	91521764	91529764	91524186	8000	91525764	-4000	4000	-1578
chr1	223105404	223113404	223112750	8000	223109404	-4000	4000	3346
chr1	156286089	156294089	156293519	8000	156290089	-4000	4000	3430
chr1	248915946	248923946	248916707	8000	248919946	-4000	4000	-3239
chr1	212722153	212730153	212727047	8000	212726153	-4000	4000	894
chr1	196828189	196836189	196830506	8000	196832189	-4000	4000	-1683
chr1	40236921	40244921	40240557	8000	40240921	-4000	4000	-364
chr1	23187895	23195895	23193167	8000	23191895	-4000	4000	1272
chr1	8348397	8356397	8354669	8000	8352397	-4000	4000	2272
chr1	101239713	101247713	101239928	8000	101243713	-4000	4000	-3785
chr1	211312385	211320385	211313572	8000	211316385	-4000	4000	-2813
chr1	155745659	155753659	155749552	8000	155749659	-4000	4000	-107
chr1	29115429	29123429	29119360	8000	29119429	-4000	4000	-69
chr1	100516277	100524277	100518783	8000	100520277	-4000	4000	-1494
chr1	149880459	149888459	149886428	8000	149884459	-4000	4000	1969
chr1	160674746	160682746	160678945	8000	160678746	-4000	4000	199
chr1	197149682	197157682	197154221	8000	197153682	-4000	4000	539
chr1	202720495	202728495	202727491	8000	202724495	-4000	4000	2996
chr1	225841536	225849536	225842384	8000	225845536	-4000	4000	-3152
chr1	53210197	53218197	53214663	8000	53214197	-4000	4000	466
chr1	160284594	160292594	160291858	8000	160288594	-4000	4000	3264
chr1	232805929	232813929	232808569	8000	232809929	-4000	4000	-1360
chr1	245745342	245753342	245749536	8000	245749342	-4000	4000	194
chr1	149880459	149888459	149886569	8000	149884459	-4000	4000	2110
chr1	153052120	153060120	153056273	8000	153056120	-4000	4000	153
chr1	190093658	190101658	190098593	8000	190097658	-4000	4000	935
chr1	225786468	225794468	225789399	8000	225790468	-4000	4000	-1069
chr1	241586102	241594102	241586703	8000	241590102	-4000	4000	-3399
chr1	6620030	6628030	6622503	8000	6624030	-4000	4000	-1527
chr1	31723117	31731117	31731103	8000	31727117	-4000	4000	3986
chr1	40236921	40244921	40238770	8000	40240921	-4000	4000	-2151
chr1	61677046	61685046	61681145	8000	61681046	-4000	4000	99
chr1	100146496	100154496	100147917	8000	100150496	-4000	4000	-2579
chr1	109488804	109496804	109490285	8000	109492804	-4000	4000	-2519
chr1	113910086	113918086	113911845	8000	113914086	-4000	4000	-2241
chr1	114578848	114586848	114581552	8000	114582848	-4000	4000	-1296
chr1	149880459	149888459	149886378	8000	149884459	-4000	4000	1919
chr1	150694060	150702060	150698712	8000	150698060	-4000	4000	652
chr1	151155748	151163748	151159454	8000	151159748	-4000	4000	-294
chr1	152298165	152306165	152305612	8000	152302165	-4000	4000	3447
chr1	155134857	155142857	155140252	8000	155138857	-4000	4000	1395
chr1	161042946	161050946	161047819	8000	161046946	-4000	4000	873
chr1	180110875	180118875	180112872	8000	180114875	-4000	4000	-2003
chr1	186186949	186194949	186189690	8000	186190949	-4000	4000	-1259
chr1	202327657	202335657	202333465	8000	202331657	-4000	4000	1808
chr1	207077024	207085024	207077646	8000	207081024	-4000	4000	-3378
chr1	216499246	216507246	216503680	8000	216503246	-4000	4000	434
chr1	227777826	227785826	227780577	8000	227781826	-4000	4000	-1249
chr1	234387313	234395313	234393675	8000	234391313	-4000	4000	2362
chr1	116570399	116578399	116577458	8000	116574399	-4000	4000	3059
chr1	156732960	156740960	156736639	8000	156736960	-4000	4000	-321
chr1	159778543	159786543	159782228	8000	159782543	-4000	4000	-315
chr1	159778543	159786543	159782432	8000	159782543	-4000	4000	-111
chr1	202315781	202323781	202318714	8000	202319781	-4000	4000	-1067
chr1	158353553	158361553	158355307	8000	158357553	-4000	4000	-2246
chr1	84639706	84647706	84647347	8000	84643706	-4000	4000	3641
chr1	149778689	149786689	149784253	8000	149782689	-4000	4000	1564
chr1	153052120	153060120	153056439	8000	153056120	-4000	4000	319
chr1	159812257	159820257	159815581	8000	159816257	-4000	4000	-676
chr1	203850999	203858999	203852206	8000	203854999	-4000	4000	-2793
chr1	26032464	26040464	26036211	8000	26036464	-4000	4000	-253
chr1	207791513	207799513	207793632	8000	207795513	-4000	4000	-1881
chr1	215233090	215241090	215236609	8000	215237090	-4000	4000	-481
chr1	48291373	48299373	48298676	8000	48295373	-4000	4000	3303
chr1	180968712	180976712	180976520	8000	180972712	-4000	4000	3808
chr1	207140972	207148972	207143826	8000	207144972	-4000	4000	-1146
chr1	24669281	24677281	24672566	8000	24673281	-4000	4000	-715
chr1	68041886	68049886	68047001	8000	68045886	-4000	4000	1115
chr1	155285848	155293848	155287200	8000	155289848	-4000	4000	-2648
chr1	192576024	192584024	192576828	8000	192580024	-4000	4000	-3196
chr1	246536561	246544561	246540918	8000	246540561	-4000	4000	357
chr1	7765706	7773706	7766852	8000	7769706	-4000	4000	-2854
chr1	186186949	186194949	186190886	8000	186190949	-4000	4000	-63
chr1	95243225	95251225	95244606	8000	95247225	-4000	4000	-2619
chr1	23376909	23384909	23381324	8000	23380909	-4000	4000	415
chr1	158254269	158262269	158254527	8000	158258269	-4000	4000	-3742
chr1	202327657	202335657	202335651	8000	202331657	-4000	4000	3994
chr1	248915946	248923946	248918134	8000	248919946	-4000	4000	-1812
chr1	74564117	74572117	74570359	8000	74568117	-4000	4000	2242
chr1	3881429	3889429	3883608	8000	3885429	-4000	4000	-1821
chr1	183925854	183933854	183928173	8000	183929854	-4000	4000	-1681
chr1	145973811	145981811	145978435	8000	145977811	-4000	4000	624
chr1	154577695	154585695	154585329	8000	154581695	-4000	4000	3634
chr1	23187895	23195895	23192561	8000	23191895	-4000	4000	666
chr1	44811585	44819585	44813032	8000	44815585	-4000	4000	-2553
chr1	52416836	52424836	52423775	8000	52420836	-4000	4000	2939
chr1	168310426	168318426	168314330	8000	168314426	-4000	4000	-96
chr1	205332061	205340061	205336529	8000	205336061	-4000	4000	468
chr1	235657041	235665041	235662844	8000	235661041	-4000	4000	1803
chr1	186667791	186675791	186675356	8000	186671791	-4000	4000	3565
chr1	241591642	241599642	241592187	8000	241595642	-4000	4000	-3455
chr1	116765229	116773229	116768503	8000	116769229	-4000	4000	-726
chr1	145988435	145996435	145993423	8000	145992435	-4000	4000	988
chr1	207077024	207085024	207079346	8000	207081024	-4000	4000	-1678
chr1	15486832	15494832	15491124	8000	15490832	-4000	4000	292
chr1	16456078	16464078	16458961	8000	16460078	-4000	4000	-1117
chr1	16981958	16989958	16988156	8000	16985958	-4000	4000	2198
chr1	17280233	17288233	17280743	8000	17284233	-4000	4000	-3490
chr1	23758059	23766059	23759549	8000	23762059	-4000	4000	-2510
chr1	24150168	24158168	24157785	8000	24154168	-4000	4000	3617
chr1	25828942	25836942	25835678	8000	25832942	-4000	4000	2736
chr1	26032464	26040464	26039150	8000	26036464	-4000	4000	2686
chr1	32194285	32202285	32202037	8000	32198285	-4000	4000	3752
chr1	33141399	33149399	33147494	8000	33145399	-4000	4000	2095
chr1	40236921	40244921	40236924	8000	40240921	-4000	4000	-3997
chr1	101239713	101247713	101240007	8000	101243713	-4000	4000	-3706
chr1	117107060	117115060	117112332	8000	117111060	-4000	4000	1272
chr1	120886530	120894530	120889826	8000	120890530	-4000	4000	-704
chr1	153557108	153565108	153563834	8000	153561108	-4000	4000	2726
chr1	161042946	161050946	161047895	8000	161046946	-4000	4000	949
chr1	201888587	201896587	201890493	8000	201892587	-4000	4000	-2094
chr1	205079129	205087129	205083613	8000	205083129	-4000	4000	484
chr1	205785094	205793094	205791655	8000	205789094	-4000	4000	2561
chr1	205909048	205917048	205914954	8000	205913048	-4000	4000	1906
chr1	209610870	209618870	209615362	8000	209614870	-4000	4000	492
chr1	223001995	223009995	223004476	8000	223005995	-4000	4000	-1519
chr1	224189441	224197441	224192367	8000	224193441	-4000	4000	-1074
chr1	247095962	247103962	247102003	8000	247099962	-4000	4000	2041
chr1	145988435	145996435	145994992	8000	145992435	-4000	4000	2557
chr1	40492343	40500343	40495611	8000	40496343	-4000	4000	-732
chr1	45011575	45019575	45013558	8000	45015575	-4000	4000	-2017
chr1	10416511	10424511	10417010	8000	10420511	-4000	4000	-3501
chr1	20802292	20810292	20807000	8000	20806292	-4000	4000	708
chr1	23355448	23363448	23361338	8000	23359448	-4000	4000	1890
chr1	25828942	25836942	25832379	8000	25832942	-4000	4000	-563
chr1	26571030	26579030	26572059	8000	26575030	-4000	4000	-2971
chr1	27662064	27670064	27669329	8000	27666064	-4000	4000	3265
chr1	32241397	32249397	32241516	8000	32245397	-4000	4000	-3881
chr1	32854875	32862875	32856105	8000	32858875	-4000	4000	-2770
chr1	33119492	33127492	33120055	8000	33123492	-4000	4000	-3437
chr1	34754512	34762512	34761897	8000	34758512	-4000	4000	3385
chr1	40616680	40624680	40621029	8000	40620680	-4000	4000	349
chr1	44815844	44823844	44823353	8000	44819844	-4000	4000	3509
chr1	46815413	46823413	46818733	8000	46819413	-4000	4000	-680
chr1	81989932	81997932	81990414	8000	81993932	-4000	4000	-3518
chr1	84234498	84242498	84236632	8000	84238498	-4000	4000	-1866
chr1	85314481	85322481	85318754	8000	85318481	-4000	4000	273
chr1	109926992	109934992	109929002	8000	109930992	-4000	4000	-1990
chr1	109926992	109934992	109929309	8000	109930992	-4000	4000	-1683
chr1	117949590	117957590	117950065	8000	117953590	-4000	4000	-3525
chr1	157670321	157678321	157676755	8000	157674321	-4000	4000	2434
chr1	183551562	183559562	183553117	8000	183555562	-4000	4000	-2445
chr1	184686237	184694237	184692999	8000	184690237	-4000	4000	2762
chr1	205653851	205661851	205658790	8000	205657851	-4000	4000	939
chr1	206460436	206468436	206462504	8000	206464436	-4000	4000	-1932
chr1	216499246	216507246	216507062	8000	216503246	-4000	4000	3816
chr1	153657852	153665852	153659499	8000	153661852	-4000	4000	-2353
chr1	209775208	209783208	209777442	8000	209779208	-4000	4000	-1766
chr1	244053476	244061476	244054759	8000	244057476	-4000	4000	-2717
chr1	32675906	32683906	32680907	8000	32679906	-4000	4000	1001
chr1	32858268	32866268	32863059	8000	32862268	-4000	4000	791
chr1	155881199	155889199	155884430	8000	155885199	-4000	4000	-769
chr1	156664763	156672763	156671631	8000	156668763	-4000	4000	2868
chr1	170735421	170743421	170737099	8000	170739421	-4000	4000	-2322
chr1	204613170	204621170	204618558	8000	204617170	-4000	4000	1388
chr1	213270774	213278774	213273290	8000	213274774	-4000	4000	-1484
chr1	233381148	233389148	233383453	8000	233385148	-4000	4000	-1695
chr1	248915946	248923946	248918092	8000	248919946	-4000	4000	-1854
chr1	2561382	2569382	2561704	8000	2565382	-4000	4000	-3678
chr1	111181104	111189104	111188362	8000	111185104	-4000	4000	3258
chr1	156664763	156672763	156672759	8000	156668763	-4000	4000	3996
chr1	94514666	94522666	94517115	8000	94518666	-4000	4000	-1551
chr1	151802071	151810071	151807633	8000	151806071	-4000	4000	1562
chr1	154347304	154355304	154349138	8000	154351304	-4000	4000	-2166
chr1	5858811	5866811	5866378	8000	5862811	-4000	4000	3567
chr1	34791747	34799747	34794460	8000	34795747	-4000	4000	-1287
chr1	39619435	39627435	39626842	8000	39623435	-4000	4000	3407
chr1	158254269	158262269	158254509	8000	158258269	-4000	4000	-3760
chr1	226356210	226364210	226361440	8000	226360210	-4000	4000	1230
chr1	32241397	32249397	32247498	8000	32245397	-4000	4000	2101
chr1	150261399	150269399	150263067	8000	150265399	-4000	4000	-2332
chr1	247876138	247884138	247876199	8000	247880138	-4000	4000	-3939
chr1	147752199	147760199	147758958	8000	147756199	-4000	4000	2759
chr1	21818244	21826244	21823523	8000	21822244	-4000	4000	1279
chr1	23187895	23195895	23193411	8000	23191895	-4000	4000	1516
chr1	32201453	32209453	32207899	8000	32205453	-4000	4000	2446
chr1	32282165	32290165	32285605	8000	32286165	-4000	4000	-560
chr1	34754512	34762512	34761905	8000	34758512	-4000	4000	3393
chr1	51283258	51291258	51290572	8000	51287258	-4000	4000	3314
chr1	84234498	84242498	84235310	8000	84238498	-4000	4000	-3188
chr1	102872467	102880467	102878145	8000	102876467	-4000	4000	1678
chr1	145666650	145674650	145671473	8000	145670650	-4000	4000	823
chr1	145929423	145937423	145936387	8000	145933423	-4000	4000	2964
chr1	149924651	149932651	149928751	8000	149928651	-4000	4000	100
chr1	151155748	151163748	151161004	8000	151159748	-4000	4000	1256
chr1	151397937	151405937	151405810	8000	151401937	-4000	4000	3873
chr1	151843101	151851101	151851074	8000	151847101	-4000	4000	3973
chr1	155745659	155753659	155750685	8000	155749659	-4000	4000	1026
chr1	162382812	162390812	162383763	8000	162386812	-4000	4000	-3049
chr1	177278422	177286422	177280971	8000	177282422	-4000	4000	-1451
chr1	215233090	215241090	215235071	8000	215237090	-4000	4000	-2019
chr1	221697424	221705424	221702492	8000	221701424	-4000	4000	1068
chr1	225978702	225986702	225985483	8000	225982702	-4000	4000	2781
chr1	248915946	248923946	248918338	8000	248919946	-4000	4000	-1608
chr1	5858811	5866811	5865172	8000	5862811	-4000	4000	2361
chr1	21818244	21826244	21824031	8000	21822244	-4000	4000	1787
chr1	148527385	148535385	148533112	8000	148531385	-4000	4000	1727
chr1	150503602	150511602	150510155	8000	150507602	-4000	4000	2553
chr1	158845506	158853506	158845969	8000	158849506	-4000	4000	-3537
chr1	161619196	161627196	161626265	8000	161623196	-4000	4000	3069
chr1	179916077	179924077	179917865	8000	179920077	-4000	4000	-2212
chr1	190093658	190101658	190097914	8000	190097658	-4000	4000	256
chr1	223001995	223009995	223003974	8000	223005995	-4000	4000	-2021
chr1	223216819	223224819	223223552	8000	223220819	-4000	4000	2733
chr1	1698379	1706379	1704690	8000	1702379	-4000	4000	2311
chr1	1698379	1706379	1705003	8000	1702379	-4000	4000	2624
chr1	23841077	23849077	23845700	8000	23845077	-4000	4000	623
chr1	23841077	23849077	23846103	8000	23845077	-4000	4000	1026
chr1	32675906	32683906	32680326	8000	32679906	-4000	4000	420
chr1	32858268	32866268	32863361	8000	32862268	-4000	4000	1093
chr1	35418058	35426058	35421172	8000	35422058	-4000	4000	-886
chr1	43270002	43278002	43270594	8000	43274002	-4000	4000	-3408
chr1	43619666	43627666	43620488	8000	43623666	-4000	4000	-3178
chr1	51794427	51802427	51794824	8000	51798427	-4000	4000	-3603
chr1	53210197	53218197	53210955	8000	53214197	-4000	4000	-3242
chr1	54605181	54613181	54611704	8000	54609181	-4000	4000	2523
chr1	64689058	64697058	64691619	8000	64693058	-4000	4000	-1439
chr1	71059291	71067291	71063870	8000	71063291	-4000	4000	579
chr1	92828737	92836737	92833631	8000	92832737	-4000	4000	894
chr1	99305590	99313590	99309183	8000	99309590	-4000	4000	-407
chr1	113890194	113898194	113895293	8000	113894194	-4000	4000	1099
chr1	113910086	113918086	113912069	8000	113914086	-4000	4000	-2017
chr1	152298165	152306165	152303551	8000	152302165	-4000	4000	1386
chr1	154271875	154279875	154274956	8000	154275875	-4000	4000	-919
chr1	154958298	154966298	154964237	8000	154962298	-4000	4000	1939
chr1	155610951	155618951	155614854	8000	155614951	-4000	4000	-97
chr1	155881199	155889199	155881289	8000	155885199	-4000	4000	-3910
chr1	156068013	156076013	156074954	8000	156072013	-4000	4000	2941
chr1	156459727	156467727	156464436	8000	156463727	-4000	4000	709
chr1	159199313	159207313	159201291	8000	159203313	-4000	4000	-2022
chr1	160087340	160095340	160087581	8000	160091340	-4000	4000	-3759
chr1	160481030	160489030	160485909	8000	160485030	-4000	4000	879
chr1	161979192	161987192	161984998	8000	161983192	-4000	4000	1806
chr1	167912675	167920675	167918197	8000	167916675	-4000	4000	1522
chr1	169128531	169136531	169132607	8000	169132531	-4000	4000	76
chr1	179916077	179924077	179918440	8000	179920077	-4000	4000	-1637
chr1	200173420	200181420	200175402	8000	200177420	-4000	4000	-2018
chr1	204418628	204426628	204422642	8000	204422628	-4000	4000	14
chr1	204418628	204426628	204422818	8000	204422628	-4000	4000	190
chr1	210242631	210250631	210242643	8000	210246631	-4000	4000	-3988
chr1	211936399	211944399	211942087	8000	211940399	-4000	4000	1688
chr1	221697424	221705424	221702373	8000	221701424	-4000	4000	949
chr1	231328753	231336753	231333916	8000	231332753	-4000	4000	1163
chr1	12205228	12213228	12206897	8000	12209228	-4000	4000	-2331
chr1	37992770	38000770	37997523	8000	37996770	-4000	4000	753
chr1	43964022	43972022	43971502	8000	43968022	-4000	4000	3480
chr1	47179582	47187582	47187358	8000	47183582	-4000	4000	3776
chr1	89929250	89937250	89935172	8000	89933250	-4000	4000	1922
chr1	111239440	111247440	111242297	8000	111243440	-4000	4000	-1143
chr1	145734868	145742868	145736090	8000	145738868	-4000	4000	-2778
chr1	149924651	149932651	149929170	8000	149928651	-4000	4000	519
chr1	151155748	151163748	151161956	8000	151159748	-4000	4000	2208
chr1	159058484	159066484	159066181	8000	159062484	-4000	4000	3697
chr1	159304224	159312224	159306008	8000	159308224	-4000	4000	-2216
chr1	190093658	190101658	190098556	8000	190097658	-4000	4000	898
chr1	200173420	200181420	200174215	8000	200177420	-4000	4000	-3205
chr1	200856704	200864704	200857776	8000	200860704	-4000	4000	-2928
chr1	203163405	203171405	203169357	8000	203167405	-4000	4000	1952
chr1	228102679	228110679	228108002	8000	228106679	-4000	4000	1323
chr1	232805929	232813929	232807845	8000	232809929	-4000	4000	-2084
chr1	241591642	241599642	241592083	8000	241595642	-4000	4000	-3559
chr1	26425728	26433728	26429396	8000	26429728	-4000	4000	-332
chr1	145887208	145895208	145892339	8000	145891208	-4000	4000	1131
chr1	166852359	166860359	166853430	8000	166856359	-4000	4000	-2929
chr1	244404494	244412494	244411381	8000	244408494	-4000	4000	2887
chr1	17014722	17022722	17018820	8000	17018722	-4000	4000	98
chr1	150642230	150650230	150648311	8000	150646230	-4000	4000	2081
chr1	34791747	34799747	34795153	8000	34795747	-4000	4000	-594
chr1	230686776	230694776	230688428	8000	230690776	-4000	4000	-2348
chr1	190093658	190101658	190098358	8000	190097658	-4000	4000	700
chr1	247876138	247884138	247876368	8000	247880138	-4000	4000	-3770
chr1	155655443	155663443	155660550	8000	155659443	-4000	4000	1107
chr1	26357634	26365634	26362170	8000	26361634	-4000	4000	536
chr1	233381148	233389148	233382346	8000	233385148	-4000	4000	-2802
chr1	36084275	36092275	36085205	8000	36088275	-4000	4000	-3070
chr1	160750821	160758821	160753295	8000	160754821	-4000	4000	-1526
chr1	201892456	201900456	201899886	8000	201896456	-4000	4000	3430
chr1	216499246	216507246	216506909	8000	216503246	-4000	4000	3663
chr1	222518258	222526258	222522593	8000	222522258	-4000	4000	335
chr1	5858811	5866811	5864478	8000	5862811	-4000	4000	1667
chr1	177278422	177286422	177278595	8000	177282422	-4000	4000	-3827
chr1	22599595	22607595	22603346	8000	22603595	-4000	4000	-249
chr1	172662876	172670876	172666630	8000	172666876	-4000	4000	-246
chr1	209672390	209680390	209675688	8000	209676390	-4000	4000	-702
chr1	119740218	119748218	119744171	8000	119744218	-4000	4000	-47
chr1	21818244	21826244	21822179	8000	21822244	-4000	4000	-65
chr1	43160175	43168175	43164244	8000	43164175	-4000	4000	69
chr1	63434553	63442553	63437111	8000	63438553	-4000	4000	-1442
chr1	158290774	158298774	158291357	8000	158294774	-4000	4000	-3417
chr1	179687272	179695272	179690755	8000	179691272	-4000	4000	-517
chr1	48291373	48299373	48298802	8000	48295373	-4000	4000	3429
chr1	77558416	77566416	77565643	8000	77562416	-4000	4000	3227
chr1	111410319	111418319	111414574	8000	111414319	-4000	4000	255
chr1	232979435	232987435	232984407	8000	232983435	-4000	4000	972
chr1	86452553	86460553	86453565	8000	86456553	-4000	4000	-2988
chr1	241493511	241501511	241497683	8000	241497511	-4000	4000	172
chr1	223772018	223780018	223772219	8000	223776018	-4000	4000	-3799
chr1	3885125	3893125	3890056	8000	3889125	-4000	4000	931
chr1	196828189	196836189	196831866	8000	196832189	-4000	4000	-323
chr1	37856697	37864697	37857414	8000	37860697	-4000	4000	-3283
chr1	119907553	119915553	119915524	8000	119911553	-4000	4000	3971
chr1	158254269	158262269	158254589	8000	158258269	-4000	4000	-3680
chr1	202887116	202895116	202893407	8000	202891116	-4000	4000	2291
chr1	1369730	1377730	1374747	8000	1373730	-4000	4000	1017
chr1	74701482	74709482	74706450	8000	74705482	-4000	4000	968
chr1	175152986	175160986	175160860	8000	175156986	-4000	4000	3874
chr1	200173420	200181420	200174394	8000	200177420	-4000	4000	-3026
chr1	13111488	13119488	13116458	8000	13115488	-4000	4000	970
chr1	236760631	236768631	236761089	8000	236764631	-4000	4000	-3542
chr1	247445108	247453108	247451385	8000	247449108	-4000	4000	2277
chr1	158973059	158981059	158973738	8000	158977059	-4000	4000	-3321
chr1	156802243	156810243	156809793	8000	156806243	-4000	4000	3550
chr1	53210197	53218197	53210869	8000	53214197	-4000	4000	-3328
chr1	153530599	153538599	153534797	8000	153534599	-4000	4000	198
chr1	159051155	159059155	159051735	8000	159055155	-4000	4000	-3420
chr1	28496364	28504364	28496542	8000	28500364	-4000	4000	-3822
chr1	12843377	12851377	12847529	8000	12847377	-4000	4000	152
chr1	171113819	171121819	171114127	8000	171117819	-4000	4000	-3692
chr1	185098603	185106603	185101373	8000	185102603	-4000	4000	-1230
chr1	109234182	109242182	109236423	8000	109238182	-4000	4000	-1759
chr1	117624389	117632389	117627811	8000	117628389	-4000	4000	-578
chr1	200965390	200973390	200970164	8000	200969390	-4000	4000	774
chr1	155610951	155618951	155614881	8000	155614951	-4000	4000	-70
chr1	190093658	190101658	190098984	8000	190097658	-4000	4000	1326
chr1	40236921	40244921	40239382	8000	40240921	-4000	4000	-1539
chr1	150790880	150798880	150796721	8000	150794880	-4000	4000	1841
chr1	205763986	205771986	205770781	8000	205767986	-4000	4000	2795
chr1	112519514	112527514	112525924	8000	112523514	-4000	4000	2410
chr1	7841177	7849177	7847679	8000	7845177	-4000	4000	2502
chr1	151534692	151542692	151536849	8000	151538692	-4000	4000	-1843
chr1	53761478	53769478	53768026	8000	53765478	-4000	4000	2548
chr1	19299965	19307965	19304167	8000	19303965	-4000	4000	202
chr1	74564117	74572117	74571663	8000	74568117	-4000	4000	3546
chr1	90911298	90919298	90918056	8000	90915298	-4000	4000	2758
chr1	117107060	117115060	117112203	8000	117111060	-4000	4000	1143
chr1	89929250	89937250	89934649	8000	89933250	-4000	4000	1399
chr1	184786724	184794724	184791134	8000	184790724	-4000	4000	410
chr1	51794427	51802427	51794518	8000	51798427	-4000	4000	-3909
chr1	145988435	145996435	145996330	8000	145992435	-4000	4000	3895
chr1	226985865	226993865	226990751	8000	226989865	-4000	4000	886
chr1	7777432	7785432	7779845	8000	7781432	-4000	4000	-1587
chr1	13613957	13621957	13615912	8000	13617957	-4000	4000	-2045
chr1	71059291	71067291	71066922	8000	71063291	-4000	4000	3631
chr1	223216819	223224819	223223399	8000	223220819	-4000	4000	2580
chr1	25828942	25836942	25835768	8000	25832942	-4000	4000	2826
chr1	201888587	201896587	201890480	8000	201892587	-4000	4000	-2107
chr1	150509789	150517789	150513465	8000	150513789	-4000	4000	-324
chr1	21592221	21600221	21597979	8000	21596221	-4000	4000	1758
chr1	160087340	160095340	160093933	8000	160091340	-4000	4000	2593
chr1	231014958	231022958	231019805	8000	231018958	-4000	4000	847
chr1	39891426	39899426	39897627	8000	39895426	-4000	4000	2201
chr1	155180971	155188971	155187728	8000	155184971	-4000	4000	2757
chr1	211312385	211320385	211312907	8000	211316385	-4000	4000	-3478
chr1	145973811	145981811	145977779	8000	145977811	-4000	4000	-32
chr1	156521405	156529405	156529011	8000	156525405	-4000	4000	3606
chr1	202143013	202151013	202150413	8000	202147013	-4000	4000	3400
chr1	204613170	204621170	204619028	8000	204617170	-4000	4000	1858
chr1	232979435	232987435	232986131	8000	232983435	-4000	4000	2696
chr1	53222900	53230900	53226998	8000	53226900	-4000	4000	98
chr1	89929250	89937250	89933912	8000	89933250	-4000	4000	662
chr1	21574410	21582410	21577520	8000	21578410	-4000	4000	-890
chr1	10416511	10424511	10417004	8000	10420511	-4000	4000	-3507
chr1	74022015	74030015	74026956	8000	74026015	-4000	4000	941
chr1	156664763	156672763	156670493	8000	156668763	-4000	4000	1730
chr1	163072802	163080802	163074413	8000	163076802	-4000	4000	-2389
chr1	40767603	40775603	40770665	8000	40771603	-4000	4000	-938
chr1	10377603	10385603	10378247	8000	10381603	-4000	4000	-3356
chr1	16981958	16989958	16987198	8000	16985958	-4000	4000	1240
chr1	43359398	43367398	43362303	8000	43363398	-4000	4000	-1095
chr1	43974295	43982295	43975151	8000	43978295	-4000	4000	-3144
chr1	161167310	161175310	161168104	8000	161171310	-4000	4000	-3206
chr1	223534007	223542007	223541739	8000	223538007	-4000	4000	3732
chr1	37562857	37570857	37569174	8000	37566857	-4000	4000	2317
chr1	159833492	159841492	159835151	8000	159837492	-4000	4000	-2341
chr1	37530449	37538449	37537401	8000	37534449	-4000	4000	2952
chr1	158353553	158361553	158356774	8000	158357553	-4000	4000	-779
chr1	167018214	167026214	167022130	8000	167022214	-4000	4000	-84
chr1	178845535	178853535	178852789	8000	178849535	-4000	4000	3254
chr1	160284594	160292594	160291860	8000	160288594	-4000	4000	3266
chr1	5858811	5866811	5865131	8000	5862811	-4000	4000	2320
chr1	37798945	37806945	37799912	8000	37802945	-4000	4000	-3033
chr1	42742335	42750335	42750281	8000	42746335	-4000	4000	3946
chr1	47179582	47187582	47185044	8000	47183582	-4000	4000	1462
chr1	52890998	52898998	52896584	8000	52894998	-4000	4000	1586
chr1	168198109	168206109	168198921	8000	168202109	-4000	4000	-3188
chr1	168198109	168206109	168199926	8000	168202109	-4000	4000	-2183
chr1	222731196	222739196	222732659	8000	222735196	-4000	4000	-2537
chr1	159304224	159312224	159307907	8000	159308224	-4000	4000	-317
chr1	27662064	27670064	27666361	8000	27666064	-4000	4000	297
chr1	45489866	45497866	45497365	8000	45493866	-4000	4000	3499
chr1	46032122	46040122	46034597	8000	46036122	-4000	4000	-1525
chr1	52605051	52613051	52608295	8000	52609051	-4000	4000	-756
chr1	65411871	65419871	65412951	8000	65415871	-4000	4000	-2920
chr1	119027216	119035216	119033117	8000	119031216	-4000	4000	1901
chr1	145988435	145996435	145995501	8000	145992435	-4000	4000	3066
chr1	151766107	151774107	151768078	8000	151770107	-4000	4000	-2029
chr1	161066998	161074998	161074693	8000	161070998	-4000	4000	3695
chr1	161710352	161718352	161713323	8000	161714352	-4000	4000	-1029
chr1	167704696	167712696	167704732	8000	167708696	-4000	4000	-3964
chr1	180110875	180118875	180112660	8000	180114875	-4000	4000	-2215
chr1	208018242	208026242	208022639	8000	208022242	-4000	4000	397
chr1	47212290	47220290	47219981	8000	47216290	-4000	4000	3691
chr1	52680449	52688449	52687676	8000	52684449	-4000	4000	3227
chr1	171589511	171597511	171591801	8000	171593511	-4000	4000	-1710
chr1	161066998	161074998	161072721	8000	161070998	-4000	4000	1723
chr1	232805929	232813929	232807894	8000	232809929	-4000	4000	-2035
chr1	155745659	155753659	155746916	8000	155749659	-4000	4000	-2743
chr1	155745659	155753659	155749429	8000	155749659	-4000	4000	-230
chr1	224189441	224197441	224189641	8000	224193441	-4000	4000	-3800
chr1	225395292	225403292	225403185	8000	225399292	-4000	4000	3893
chr1	232393965	232401965	232398978	8000	232397965	-4000	4000	1013
chr1	232805929	232813929	232806737	8000	232809929	-4000	4000	-3192
chr1	155230452	155238452	155237500	8000	155234452	-4000	4000	3048
chr1	150261399	150269399	150263148	8000	150265399	-4000	4000	-2251
chr1	156664763	156672763	156672280	8000	156668763	-4000	4000	3517
chr1	205528793	205536793	205529095	8000	205532793	-4000	4000	-3698
chr1	205528793	205536793	205530297	8000	205532793	-4000	4000	-2496
chr1	229426365	229434365	229431627	8000	229430365	-4000	4000	1262
chr1	229589121	229597121	229594818	8000	229593121	-4000	4000	1697
chr1	74022015	74030015	74026793	8000	74026015	-4000	4000	778
chr1	158845506	158853506	158847733	8000	158849506	-4000	4000	-1773
chr1	34754512	34762512	34758020	8000	34758512	-4000	4000	-492
chr1	155165409	155173409	155173311	8000	155169409	-4000	4000	3902
chr1	190093658	190101658	190098979	8000	190097658	-4000	4000	1321
chr1	232805929	232813929	232806491	8000	232809929	-4000	4000	-3438
chr1	185292388	185300388	185299547	8000	185296388	-4000	4000	3159
chr1	161520013	161528013	161525458	8000	161524013	-4000	4000	1445
chr1	212682417	212690417	212686942	8000	212686417	-4000	4000	525
chr1	22657637	22665637	22660910	8000	22661637	-4000	4000	-727
chr1	145988435	145996435	145996069	8000	145992435	-4000	4000	3634
chr1	169845631	169853631	169849586	8000	169849631	-4000	4000	-45
chr1	70249052	70257052	70250791	8000	70253052	-4000	4000	-2261
chr1	43964022	43972022	43971025	8000	43968022	-4000	4000	3003
chr1	147171351	147179351	147179229	8000	147175351	-4000	4000	3878
chr1	209781617	209789617	209782738	8000	209785617	-4000	4000	-2879
chr1	240485573	240493573	240493396	8000	240489573	-4000	4000	3823
chr1	89002679	89010679	89007328	8000	89006679	-4000	4000	649
chr1	207637765	207645765	207639413	8000	207641765	-4000	4000	-2352
chr1	42699805	42707805	42700837	8000	42703805	-4000	4000	-2968
chr1	53210197	53218197	53210878	8000	53214197	-4000	4000	-3319
chr1	165658216	165666216	165665119	8000	165662216	-4000	4000	2903
chr1	43987170	43995170	43990956	8000	43991170	-4000	4000	-214
chr1	70254999	70262999	70261717	8000	70258999	-4000	4000	2718
chr1	107567161	107575161	107571875	8000	107571161	-4000	4000	714
chr1	151767334	151775334	151775127	8000	151771334	-4000	4000	3793
chr1	225882696	225890696	225886505	8000	225886696	-4000	4000	-191
chr1	232805929	232813929	232805957	8000	232809929	-4000	4000	-3972
chr1	115044011	115052011	115050270	8000	115048011	-4000	4000	2259
chr1	151833819	151841819	151839171	8000	151837819	-4000	4000	1352
chr1	27759116	27767116	27759644	8000	27763116	-4000	4000	-3472
chr1	158353553	158361553	158355333	8000	158357553	-4000	4000	-2220
chr1	158353553	158361553	158355335	8000	158357553	-4000	4000	-2218
chr1	223001995	223009995	223004557	8000	223005995	-4000	4000	-1438
chr1	225882696	225890696	225886401	8000	225886696	-4000	4000	-295
chr1	32932445	32940445	32936716	8000	32936445	-4000	4000	271
chr1	31583686	31591686	31585868	8000	31587686	-4000	4000	-1818
chr1	158845506	158853506	158849416	8000	158849506	-4000	4000	-90
chr1	92180725	92188725	92182043	8000	92184725	-4000	4000	-2682
chr1	151796264	151804264	151802350	8000	151800264	-4000	4000	2086
chr1	169507951	169515951	169515576	8000	169511951	-4000	4000	3625
chr1	81989932	81997932	81991095	8000	81993932	-4000	4000	-2837
chr1	197903367	197911367	197905888	8000	197907367	-4000	4000	-1479
chr1	44774779	44782779	44775576	8000	44778779	-4000	4000	-3203
chr1	152298165	152306165	152305524	8000	152302165	-4000	4000	3359
chr1	206730281	206738281	206732725	8000	206734281	-4000	4000	-1556
chr1	206730281	206738281	206732726	8000	206734281	-4000	4000	-1555
chr1	151534692	151542692	151536790	8000	151538692	-4000	4000	-1902
chr1	160087340	160095340	160093812	8000	160091340	-4000	4000	2472
chr1	170549834	170557834	170552113	8000	170553834	-4000	4000	-1721
chr1	240485573	240493573	240493080	8000	240489573	-4000	4000	3507
chr1	99305590	99313590	99307375	8000	99309590	-4000	4000	-2215
chr1	161979192	161987192	161983725	8000	161983192	-4000	4000	533
chr1	162366475	162374475	162374105	8000	162370475	-4000	4000	3630
chr1	212988182	212996182	212994772	8000	212992182	-4000	4000	2590
chr1	1698379	1706379	1704495	8000	1702379	-4000	4000	2116
chr1	2561382	2569382	2563040	8000	2565382	-4000	4000	-2342
chr1	2561382	2569382	2563296	8000	2565382	-4000	4000	-2086
chr1	5858811	5866811	5864419	8000	5862811	-4000	4000	1608
chr1	6260269	6268269	6264593	8000	6264269	-4000	4000	324
chr1	11533551	11541551	11536357	8000	11537551	-4000	4000	-1194
chr1	15486832	15494832	15491164	8000	15490832	-4000	4000	332
chr1	15486832	15494832	15493192	8000	15490832	-4000	4000	2360
chr1	19971431	19979431	19978835	8000	19975431	-4000	4000	3404
chr1	22599595	22607595	22600969	8000	22603595	-4000	4000	-2626
chr1	23841077	23849077	23845798	8000	23845077	-4000	4000	721
chr1	24052035	24060035	24057606	8000	24056035	-4000	4000	1571
chr1	24669281	24677281	24672304	8000	24673281	-4000	4000	-977
chr1	26467306	26475306	26473810	8000	26471306	-4000	4000	2504
chr1	26571030	26579030	26572090	8000	26575030	-4000	4000	-2940
chr1	27882685	27890685	27882776	8000	27886685	-4000	4000	-3909
chr1	28496364	28504364	28496561	8000	28500364	-4000	4000	-3803
chr1	29115429	29123429	29120958	8000	29119429	-4000	4000	1529
chr1	32596172	32604172	32600313	8000	32600172	-4000	4000	141
chr1	34754512	34762512	34761653	8000	34758512	-4000	4000	3141
chr1	34754512	34762512	34761936	8000	34758512	-4000	4000	3424
chr1	35111859	35119859	35113616	8000	35115859	-4000	4000	-2243
chr1	40236921	40244921	40239824	8000	40240921	-4000	4000	-1097
chr1	40767603	40775603	40770827	8000	40771603	-4000	4000	-776
chr1	43619666	43627666	43620841	8000	43623666	-4000	4000	-2825
chr1	45011575	45019575	45019204	8000	45015575	-4000	4000	3629
chr1	45489866	45497866	45494984	8000	45493866	-4000	4000	1118
chr1	46039661	46047661	46043841	8000	46043661	-4000	4000	180
chr1	47246139	47254139	47251628	8000	47250139	-4000	4000	1489
chr1	52404282	52412282	52404721	8000	52408282	-4000	4000	-3561
chr1	53761478	53769478	53767976	8000	53765478	-4000	4000	2498
chr1	66370579	66378579	66372498	8000	66374579	-4000	4000	-2081
chr1	66984619	66992619	66984936	8000	66988619	-4000	4000	-3683
chr1	67394724	67402724	67395775	8000	67398724	-4000	4000	-2949
chr1	74564117	74572117	74571269	8000	74568117	-4000	4000	3152
chr1	78660078	78668078	78663762	8000	78664078	-4000	4000	-316
chr1	85245953	85253953	85252615	8000	85249953	-4000	4000	2662
chr1	88931773	88939773	88936138	8000	88935773	-4000	4000	365
chr1	89002679	89010679	89007474	8000	89006679	-4000	4000	795
chr1	92180725	92188725	92182152	8000	92184725	-4000	4000	-2573
chr1	92828737	92836737	92836195	8000	92832737	-4000	4000	3458
chr1	109305568	109313568	109306916	8000	109309568	-4000	4000	-2652
chr1	109705551	109713551	109713271	8000	109709551	-4000	4000	3720
chr1	110668465	110676465	110673244	8000	110672465	-4000	4000	779
chr1	112459456	112467456	112467428	8000	112463456	-4000	4000	3972
chr1	113681923	113689923	113682243	8000	113685923	-4000	4000	-3680
chr1	145988435	145996435	145996261	8000	145992435	-4000	4000	3826
chr1	145988435	145996435	145996358	8000	145992435	-4000	4000	3923
chr1	148478548	148486548	148483114	8000	148482548	-4000	4000	566
chr1	149880459	149888459	149886228	8000	149884459	-4000	4000	1769
chr1	149880459	149888459	149886593	8000	149884459	-4000	4000	2134
chr1	149933812	149941812	149936725	8000	149937812	-4000	4000	-1087
chr1	150992549	151000549	151000465	8000	150996549	-4000	4000	3916
chr1	151127685	151135685	151135165	8000	151131685	-4000	4000	3480
chr1	151534692	151542692	151536850	8000	151538692	-4000	4000	-1842
chr1	152298165	152306165	152304561	8000	152302165	-4000	4000	2396
chr1	153453744	153461744	153459014	8000	153457744	-4000	4000	1270
chr1	153977617	153985617	153982801	8000	153981617	-4000	4000	1184
chr1	154940076	154948076	154946660	8000	154944076	-4000	4000	2584
chr1	155014520	155022520	155014684	8000	155018520	-4000	4000	-3836
chr1	155082807	155090807	155086427	8000	155086807	-4000	4000	-380
chr1	155165409	155173409	155172388	8000	155169409	-4000	4000	2979
chr1	155316666	155324666	155320531	8000	155320666	-4000	4000	-135
chr1	155610951	155618951	155611441	8000	155614951	-4000	4000	-3510
chr1	155610951	155618951	155612209	8000	155614951	-4000	4000	-2742
chr1	158254269	158262269	158256088	8000	158258269	-4000	4000	-2181
chr1	159923039	159931039	159930300	8000	159927039	-4000	4000	3261
chr1	160354952	160362952	160355722	8000	160358952	-4000	4000	-3230
chr1	160354952	160362952	160358211	8000	160358952	-4000	4000	-741
chr1	161042946	161050946	161043280	8000	161046946	-4000	4000	-3666
chr1	169686665	169694665	169691740	8000	169690665	-4000	4000	1075
chr1	171113819	171121819	171114016	8000	171117819	-4000	4000	-3803
chr1	171113819	171121819	171117464	8000	171117819	-4000	4000	-355
chr1	171281978	171289978	171285471	8000	171285978	-4000	4000	-507
chr1	173795550	173803550	173803208	8000	173799550	-4000	4000	3658
chr1	182883982	182891982	182884632	8000	182887982	-4000	4000	-3350
chr1	192808275	192816275	192811644	8000	192812275	-4000	4000	-631
chr1	197903367	197911367	197907235	8000	197907367	-4000	4000	-132
chr1	200547497	200555497	200553423	8000	200551497	-4000	4000	1926
chr1	203867152	203875152	203870033	8000	203871152	-4000	4000	-1119
chr1	205079129	205087129	205083508	8000	205083129	-4000	4000	379
chr1	205909048	205917048	205915225	8000	205913048	-4000	4000	2177
chr1	207014522	207022522	207022483	8000	207018522	-4000	4000	3961
chr1	207791513	207799513	207793775	8000	207795513	-4000	4000	-1738
chr1	209775208	209783208	209775387	8000	209779208	-4000	4000	-3821
chr1	209775208	209783208	209775658	8000	209779208	-4000	4000	-3550
chr1	209775208	209783208	209779583	8000	209779208	-4000	4000	375
chr1	215233090	215241090	215235038	8000	215237090	-4000	4000	-2052
chr1	216499246	216507246	216506903	8000	216503246	-4000	4000	3657
chr1	221697424	221705424	221702365	8000	221701424	-4000	4000	941
chr1	222518258	222526258	222522638	8000	222522258	-4000	4000	380
chr1	223001995	223009995	223005127	8000	223005995	-4000	4000	-868
chr1	223001995	223009995	223005656	8000	223005995	-4000	4000	-339
chr1	223105404	223113404	223110967	8000	223109404	-4000	4000	1563
chr1	234320511	234328511	234323210	8000	234324511	-4000	4000	-1301
chr1	240485573	240493573	240493440	8000	240489573	-4000	4000	3867
chr1	244841057	244849057	244841855	8000	244845057	-4000	4000	-3202
chr1	246835098	246843098	246840860	8000	246839098	-4000	4000	1762
chr1	248845517	248853517	248847241	8000	248849517	-4000	4000	-2276
chr1	26121555	26129555	26122498	8000	26125555	-4000	4000	-3057
chr1	85314481	85322481	85318589	8000	85318481	-4000	4000	108
chr1	152298165	152306165	152303124	8000	152302165	-4000	4000	959
chr1	190093658	190101658	190098673	8000	190097658	-4000	4000	1015
chr1	78885764	78893764	78891012	8000	78889764	-4000	4000	1248
chr1	18744866	18752866	18745189	8000	18748866	-4000	4000	-3677
chr1	54605181	54613181	54609231	8000	54609181	-4000	4000	50
chr1	64689058	64697058	64691837	8000	64693058	-4000	4000	-1221
chr1	155130899	155138899	155133764	8000	155134899	-4000	4000	-1135
chr1	206585448	206593448	206589024	8000	206589448	-4000	4000	-424
chr1	161225666	161233666	161228746	8000	161229666	-4000	4000	-920
chr1	169507951	169515951	169515533	8000	169511951	-4000	4000	3582
chr1	228095212	228103212	228097876	8000	228099212	-4000	4000	-1336
chr1	40492343	40500343	40495494	8000	40496343	-4000	4000	-849
chr1	185287781	185295781	185290894	8000	185291781	-4000	4000	-887
chr1	156655532	156663532	156658674	8000	156659532	-4000	4000	-858
chr1	200856704	200864704	200857751	8000	200860704	-4000	4000	-2953
chr1	13111488	13119488	13115562	8000	13115488	-4000	4000	74
chr1	16120337	16128337	16125218	8000	16124337	-4000	4000	881
chr1	23355448	23363448	23362347	8000	23359448	-4000	4000	2899
chr1	31786422	31794422	31790712	8000	31790422	-4000	4000	290
chr1	78134444	78142444	78135657	8000	78138444	-4000	4000	-2787
chr1	23355448	23363448	23362500	8000	23359448	-4000	4000	3052
chr1	23355448	23363448	23363030	8000	23359448	-4000	4000	3582
chr1	46670659	46678659	46678618	8000	46674659	-4000	4000	3959
chr1	108930545	108938545	108937189	8000	108934545	-4000	4000	2644
chr1	149880459	149888459	149886419	8000	149884459	-4000	4000	1960
chr1	151127685	151135685	151135248	8000	151131685	-4000	4000	3563
chr1	153557108	153565108	153561380	8000	153561108	-4000	4000	272
chr1	155251979	155259979	155254725	8000	155255979	-4000	4000	-1254
chr1	9981501	9989501	9982611	8000	9985501	-4000	4000	-2890
chr1	231351023	231359023	231353274	8000	231355023	-4000	4000	-1749
chr1	93550661	93558661	93554170	8000	93554661	-4000	4000	-491
chr1	113973869	113981869	113981370	8000	113977869	-4000	4000	3501
chr1	152298165	152306165	152304456	8000	152302165	-4000	4000	2291
chr1	153657852	153665852	153664062	8000	153661852	-4000	4000	2210
chr1	39483177	39491177	39484731	8000	39487177	-4000	4000	-2446
chr1	155046930	155054930	155052535	8000	155050930	-4000	4000	1605
chr1	197149682	197157682	197157499	8000	197153682	-4000	4000	3817
chr1	158353553	158361553	158356770	8000	158357553	-4000	4000	-783
chr1	29322813	29330813	29325654	8000	29326813	-4000	4000	-1159
chr1	160087340	160095340	160095092	8000	160091340	-4000	4000	3752
chr1	160139591	160147591	160141496	8000	160143591	-4000	4000	-2095
chr1	26571030	26579030	26571936	8000	26575030	-4000	4000	-3094
chr1	10448153	10456153	10451590	8000	10452153	-4000	4000	-563
chr1	12205228	12213228	12206925	8000	12209228	-4000	4000	-2303
chr1	21574410	21582410	21575921	8000	21578410	-4000	4000	-2489
chr1	25496209	25504209	25498317	8000	25500209	-4000	4000	-1892
chr1	27365110	27373110	27370678	8000	27369110	-4000	4000	1568
chr1	28143166	28151166	28150287	8000	28147166	-4000	4000	3121
chr1	28143166	28151166	28150965	8000	28147166	-4000	4000	3799
chr1	32858268	32866268	32864181	8000	32862268	-4000	4000	1913
chr1	36089932	36097932	36097764	8000	36093932	-4000	4000	3832
chr1	36387238	36395238	36394006	8000	36391238	-4000	4000	2768
chr1	36411827	36419827	36418160	8000	36415827	-4000	4000	2333
chr1	40236921	40244921	40237010	8000	40240921	-4000	4000	-3911
chr1	40236921	40244921	40239074	8000	40240921	-4000	4000	-1847
chr1	40459718	40467718	40463300	8000	40463718	-4000	4000	-418
chr1	42426329	42434329	42430491	8000	42430329	-4000	4000	162
chr1	45623304	45631304	45628191	8000	45627304	-4000	4000	887
chr1	45623304	45631304	45629633	8000	45627304	-4000	4000	2329
chr1	46039661	46047661	46043608	8000	46043661	-4000	4000	-53
chr1	46181962	46189962	46184636	8000	46185962	-4000	4000	-1326
chr1	46409848	46417848	46411614	8000	46413848	-4000	4000	-2234
chr1	46815413	46823413	46818160	8000	46819413	-4000	4000	-1253
chr1	53081501	53089501	53088212	8000	53085501	-4000	4000	2711
chr1	53761478	53769478	53767766	8000	53765478	-4000	4000	2288
chr1	56714789	56722789	56720212	8000	56718789	-4000	4000	1423
chr1	68041886	68049886	68046638	8000	68045886	-4000	4000	752
chr1	74022015	74030015	74026962	8000	74026015	-4000	4000	947
chr1	75198129	75206129	75203517	8000	75202129	-4000	4000	1388
chr1	85152889	85160889	85159046	8000	85156889	-4000	4000	2157
chr1	88832255	88840255	88833393	8000	88836255	-4000	4000	-2862
chr1	89047882	89055882	89053432	8000	89051882	-4000	4000	1550
chr1	89929250	89937250	89934049	8000	89933250	-4000	4000	799
chr1	89929250	89937250	89934255	8000	89933250	-4000	4000	1005
chr1	89929250	89937250	89934386	8000	89933250	-4000	4000	1136
chr1	89929250	89937250	89934755	8000	89933250	-4000	4000	1505
chr1	93550661	93558661	93551078	8000	93554661	-4000	4000	-3583
chr1	97073743	97081743	97079057	8000	97077743	-4000	4000	1314
chr1	101239713	101247713	101239942	8000	101243713	-4000	4000	-3771
chr1	103754726	103762726	103754768	8000	103758726	-4000	4000	-3958
chr1	110668465	110676465	110673836	8000	110672465	-4000	4000	1371
chr1	110668465	110676465	110674341	8000	110672465	-4000	4000	1876
chr1	111410319	111418319	111415298	8000	111414319	-4000	4000	979
chr1	111458773	111466773	111461145	8000	111462773	-4000	4000	-1628
chr1	112667616	112675616	112670078	8000	112671616	-4000	4000	-1538
chr1	113890194	113898194	113895706	8000	113894194	-4000	4000	1512
chr1	113973869	113981869	113980588	8000	113977869	-4000	4000	2719
chr1	113973869	113981869	113981687	8000	113977869	-4000	4000	3818
chr1	116510534	116518534	116514813	8000	116514534	-4000	4000	279
chr1	119027216	119035216	119033036	8000	119031216	-4000	4000	1820
chr1	145988435	145996435	145995010	8000	145992435	-4000	4000	2575
chr1	147171351	147179351	147179099	8000	147175351	-4000	4000	3748
chr1	147171351	147179351	147179291	8000	147175351	-4000	4000	3940
chr1	149787675	149795675	149788474	8000	149791675	-4000	4000	-3201
chr1	149787675	149795675	149791348	8000	149791675	-4000	4000	-327
chr1	150141329	150149329	150144733	8000	150145329	-4000	4000	-596
chr1	150694060	150702060	150700163	8000	150698060	-4000	4000	2103
chr1	151155748	151163748	151159030	8000	151159748	-4000	4000	-718
chr1	151766107	151774107	151767204	8000	151770107	-4000	4000	-2903
chr1	151796264	151804264	151802068	8000	151800264	-4000	4000	1804
chr1	151833819	151841819	151838041	8000	151837819	-4000	4000	222
chr1	153539613	153547613	153541625	8000	153543613	-4000	4000	-1988
chr1	154544577	154552577	154547585	8000	154548577	-4000	4000	-992
chr1	154577695	154585695	154585010	8000	154581695	-4000	4000	3315
chr1	155165409	155173409	155172458	8000	155169409	-4000	4000	3049
chr1	155316666	155324666	155320616	8000	155320666	-4000	4000	-50
chr1	156664763	156672763	156671754	8000	156668763	-4000	4000	2991
chr1	156664763	156672763	156672275	8000	156668763	-4000	4000	3512
chr1	158254269	158262269	158256921	8000	158258269	-4000	4000	-1348
chr1	158353553	158361553	158354019	8000	158357553	-4000	4000	-3534
chr1	158845506	158853506	158845686	8000	158849506	-4000	4000	-3820
chr1	159833492	159841492	159840864	8000	159837492	-4000	4000	3372
chr1	159923039	159931039	159928586	8000	159927039	-4000	4000	1547
chr1	160182980	160190980	160186833	8000	160186980	-4000	4000	-147
chr1	160284594	160292594	160290162	8000	160288594	-4000	4000	1568
chr1	160284594	160292594	160292071	8000	160288594	-4000	4000	3477
chr1	161096346	161104346	161100633	8000	161100346	-4000	4000	287
chr1	161674654	161682654	161677758	8000	161678654	-4000	4000	-896
chr1	161710352	161718352	161713485	8000	161714352	-4000	4000	-867
chr1	161979192	161987192	161983827	8000	161983192	-4000	4000	635
chr1	161979192	161987192	161984192	8000	161983192	-4000	4000	1000
chr1	168691468	168699468	168696561	8000	168695468	-4000	4000	1093
chr1	169128531	169136531	169131293	8000	169132531	-4000	4000	-1238
chr1	169845631	169853631	169847695	8000	169849631	-4000	4000	-1936
chr1	169850080	169858080	169854391	8000	169854080	-4000	4000	311
chr1	177278422	177286422	177280940	8000	177282422	-4000	4000	-1482
chr1	177278422	177286422	177281132	8000	177282422	-4000	4000	-1290
chr1	185098603	185106603	185099870	8000	185102603	-4000	4000	-2733
chr1	185287781	185295781	185290896	8000	185291781	-4000	4000	-885
chr1	190093658	190101658	190098799	8000	190097658	-4000	4000	1141
chr1	206924522	206932522	206930380	8000	206928522	-4000	4000	1858
chr1	207140972	207148972	207141157	8000	207144972	-4000	4000	-3815
chr1	211370946	211378946	211372731	8000	211374946	-4000	4000	-2215
chr1	212357853	212365853	212365032	8000	212361853	-4000	4000	3179
chr1	220660461	220668461	220662170	8000	220664461	-4000	4000	-2291
chr1	223001995	223009995	223003515	8000	223005995	-4000	4000	-2480
chr1	223001995	223009995	223003959	8000	223005995	-4000	4000	-2036
chr1	223001995	223009995	223004243	8000	223005995	-4000	4000	-1752
chr1	223105404	223113404	223110461	8000	223109404	-4000	4000	1057
chr1	223105404	223113404	223112462	8000	223109404	-4000	4000	3058
chr1	224189441	224197441	224192483	8000	224193441	-4000	4000	-958
chr1	226227149	226235149	226233089	8000	226231149	-4000	4000	1940
chr1	226356210	226364210	226361534	8000	226360210	-4000	4000	1324
chr1	226627690	226635690	226634610	8000	226631690	-4000	4000	2920
chr1	229426365	229434365	229431408	8000	229430365	-4000	4000	1043
chr1	230686776	230694776	230687064	8000	230690776	-4000	4000	-3712
chr1	231273973	231281973	231275311	8000	231277973	-4000	4000	-2662
chr1	231273973	231281973	231277569	8000	231277973	-4000	4000	-404
chr1	231351023	231359023	231351579	8000	231355023	-4000	4000	-3444
chr1	236545005	236553005	236548356	8000	236549005	-4000	4000	-649
chr1	241591642	241599642	241597791	8000	241595642	-4000	4000	2149
chr1	244841057	244849057	244843085	8000	244845057	-4000	4000	-1972
chr1	247095962	247103962	247100466	8000	247099962	-4000	4000	504
chr1	1698379	1706379	1704265	8000	1702379	-4000	4000	1886
chr1	35709877	35717877	35716000	8000	35713877	-4000	4000	2123
chr1	37856697	37864697	37857629	8000	37860697	-4000	4000	-3068
chr1	39483177	39491177	39484676	8000	39487177	-4000	4000	-2501
chr1	42840991	42848991	42843248	8000	42844991	-4000	4000	-1743
chr1	43969369	43977369	43972155	8000	43973369	-4000	4000	-1214
chr1	111771602	111779602	111776056	8000	111775602	-4000	4000	454
chr1	113910086	113918086	113911459	8000	113914086	-4000	4000	-2627
chr1	149924651	149932651	149926722	8000	149928651	-4000	4000	-1929
chr1	152298165	152306165	152302663	8000	152302165	-4000	4000	498
chr1	155014520	155022520	155014668	8000	155018520	-4000	4000	-3852
chr1	156208796	156216796	156210509	8000	156212796	-4000	4000	-2287
chr1	159833492	159841492	159835151	8000	159837492	-4000	4000	-2341
chr1	160674746	160682746	160681260	8000	160678746	-4000	4000	2514
chr1	175152986	175160986	175160690	8000	175156986	-4000	4000	3704
chr1	203163405	203171405	203165656	8000	203167405	-4000	4000	-1749
chr1	215617807	215625807	215619260	8000	215621807	-4000	4000	-2547
chr1	237829988	237837988	237831530	8000	237833988	-4000	4000	-2458
chr1	113890194	113898194	113896180	8000	113894194	-4000	4000	1986
chr1	119027216	119035216	119033310	8000	119031216	-4000	4000	2094
chr1	171281978	171289978	171285274	8000	171285978	-4000	4000	-704
chr1	149787675	149795675	149790145	8000	149791675	-4000	4000	-1530
chr1	207637765	207645765	207645167	8000	207641765	-4000	4000	3402
chr1	155655443	155663443	155660613	8000	155659443	-4000	4000	1170
chr1	85245953	85253953	85252583	8000	85249953	-4000	4000	2630
chr1	153028900	153036900	153032681	8000	153032900	-4000	4000	-219
chr1	161161723	161169723	161164539	8000	161165723	-4000	4000	-1184
chr1	209610870	209618870	209612910	8000	209614870	-4000	4000	-1960
chr1	159199313	159207313	159206266	8000	159203313	-4000	4000	2953
chr1	116066054	116074054	116066706	8000	116070054	-4000	4000	-3348
chr1	224223334	224231334	224227670	8000	224227334	-4000	4000	336
chr1	148478548	148486548	148483114	8000	148482548	-4000	4000	566
chr1	212988182	212996182	212994772	8000	212992182	-4000	4000	2590
chr1	225978702	225986702	225985475	8000	225982702	-4000	4000	2773
chr1	169306992	169314992	169310058	8000	169310992	-4000	4000	-934
chr1	12843377	12851377	12847985	8000	12847377	-4000	4000	608
chr1	160211376	160219376	160214949	8000	160215376	-4000	4000	-427
chr1	198753476	198761476	198756230	8000	198757476	-4000	4000	-1246
chr1	201892456	201900456	201898351	8000	201896456	-4000	4000	1895
chr1	203163405	203171405	203165249	8000	203167405	-4000	4000	-2156
chr1	35111859	35119859	35115317	8000	35115859	-4000	4000	-542
chr1	40492343	40500343	40495456	8000	40496343	-4000	4000	-887
chr1	113681923	113689923	113683076	8000	113685923	-4000	4000	-2847
chr1	150509789	150517789	150513471	8000	150513789	-4000	4000	-318
chr1	201892456	201900456	201900085	8000	201896456	-4000	4000	3629
chr1	209781617	209789617	209782840	8000	209785617	-4000	4000	-2777
chr1	223001995	223009995	223004694	8000	223005995	-4000	4000	-1301
chr1	44647724	44655724	44654651	8000	44651724	-4000	4000	2927
chr1	220660461	220668461	220661891	8000	220664461	-4000	4000	-2570
chr1	229301894	229309894	229304984	8000	229305894	-4000	4000	-910
chr1	152298165	152306165	152302758	8000	152302165	-4000	4000	593
chr1	203174931	203182931	203182793	8000	203178931	-4000	4000	3862
chr1	160087340	160095340	160093933	8000	160091340	-4000	4000	2593
chr1	205082142	205090142	205088617	8000	205086142	-4000	4000	2475
chr1	220660461	220668461	220661936	8000	220664461	-4000	4000	-2525
chr1	232979435	232987435	232986031	8000	232983435	-4000	4000	2596
chr1	185114101	185122101	185119908	8000	185118101	-4000	4000	1807
chr1	18481974	18489974	18483220	8000	18485974	-4000	4000	-2754
chr1	47179582	47187582	47187390	8000	47183582	-4000	4000	3808
chr1	66370579	66378579	66374140	8000	66374579	-4000	4000	-439
chr1	100538021	100546021	100540698	8000	100542021	-4000	4000	-1323
chr1	101239713	101247713	101240728	8000	101243713	-4000	4000	-2985
chr1	117624389	117632389	117626423	8000	117628389	-4000	4000	-1966
chr1	151796264	151804264	151802339	8000	151800264	-4000	4000	2075
chr1	201376833	201384833	201381357	8000	201380833	-4000	4000	524
chr1	26467306	26475306	26475197	8000	26471306	-4000	4000	3891
chr1	40236921	40244921	40236966	8000	40240921	-4000	4000	-3955
chr1	152999856	153007856	153003618	8000	153003856	-4000	4000	-238
chr1	156930840	156938840	156935855	8000	156934840	-4000	4000	1015
chr1	201888587	201896587	201889444	8000	201892587	-4000	4000	-3143
chr1	93881199	93889199	93888577	8000	93885199	-4000	4000	3378
chr1	156930840	156938840	156937334	8000	156934840	-4000	4000	2494
chr1	158254269	158262269	158256183	8000	158258269	-4000	4000	-2086
chr1	152298165	152306165	152304928	8000	152302165	-4000	4000	2763
chr1	45489866	45497866	45494998	8000	45493866	-4000	4000	1132
chr1	145887208	145895208	145892691	8000	145891208	-4000	4000	1483
chr1	145988435	145996435	145993540	8000	145992435	-4000	4000	1105
chr1	233381148	233389148	233382458	8000	233385148	-4000	4000	-2690
chr1	147752199	147760199	147758535	8000	147756199	-4000	4000	2336
chr1	207014522	207022522	207022092	8000	207018522	-4000	4000	3570
chr1	44846522	44854522	44850876	8000	44850522	-4000	4000	354
chr1	27662064	27670064	27669338	8000	27666064	-4000	4000	3274
chr1	77084989	77092989	77092238	8000	77088989	-4000	4000	3249
chr1	147752199	147760199	147758473	8000	147756199	-4000	4000	2274
chr1	160087340	160095340	160093893	8000	160091340	-4000	4000	2553
chr1	244841057	244849057	244842286	8000	244845057	-4000	4000	-2771
chr1	228403935	228411935	228408508	8000	228407935	-4000	4000	573
chr1	171113819	171121819	171117418	8000	171117819	-4000	4000	-401
chr1	223105404	223113404	223112008	8000	223109404	-4000	4000	2604
chr1	150991634	150999634	150997334	8000	150995634	-4000	4000	1700
chr1	26425728	26433728	26426301	8000	26429728	-4000	4000	-3427
chr1	145988435	145996435	145993822	8000	145992435	-4000	4000	1387
chr1	243120428	243128428	243126574	8000	243124428	-4000	4000	2146
chr1	35111859	35119859	35115317	8000	35115859	-4000	4000	-542
chr1	223105404	223113404	223112900	8000	223109404	-4000	4000	3496
chr1	13111488	13119488	13115870	8000	13115488	-4000	4000	382
chr1	231351023	231359023	231351344	8000	231355023	-4000	4000	-3679
chr1	247445108	247453108	247451271	8000	247449108	-4000	4000	2163
chr1	74022015	74030015	74026684	8000	74026015	-4000	4000	669
chr1	169686665	169694665	169691592	8000	169690665	-4000	4000	927
chr1	172607833	172615833	172610396	8000	172611833	-4000	4000	-1437
chr1	171281978	171289978	171282244	8000	171285978	-4000	4000	-3734
chr1	108805523	108813523	108809131	8000	108809523	-4000	4000	-392
chr1	228102679	228110679	228107865	8000	228106679	-4000	4000	1186
chr1	172607833	172615833	172610033	8000	172611833	-4000	4000	-1800
chr1	209610870	209618870	209617542	8000	209614870	-4000	4000	2672
chr1	153977617	153985617	153982426	8000	153981617	-4000	4000	809
chr1	209781617	209789617	209782867	8000	209785617	-4000	4000	-2750
chr1	36084275	36092275	36091640	8000	36088275	-4000	4000	3365
chr1	155082807	155090807	155086499	8000	155086807	-4000	4000	-308
chr1	206924522	206932522	206930412	8000	206928522	-4000	4000	1890
chr1	43277877	43285877	43282361	8000	43281877	-4000	4000	484
chr1	192576024	192584024	192578631	8000	192580024	-4000	4000	-1393
chr1	244841057	244849057	244842417	8000	244845057	-4000	4000	-2640
chr1	17280233	17288233	17280368	8000	17284233	-4000	4000	-3865
chr1	160750821	160758821	160753117	8000	160754821	-4000	4000	-1704
chr1	247876138	247884138	247876267	8000	247880138	-4000	4000	-3871
chr1	70249052	70257052	70250505	8000	70253052	-4000	4000	-2547
chr1	111771602	111779602	111778439	8000	111775602	-4000	4000	2837
chr1	52344671	52352671	52346100	8000	52348671	-4000	4000	-2571
chr1	78885764	78893764	78893131	8000	78889764	-4000	4000	3367
chr1	28143166	28151166	28150839	8000	28147166	-4000	4000	3673
chr1	32682211	32690211	32684391	8000	32686211	-4000	4000	-1820
chr1	200173420	200181420	200174022	8000	200177420	-4000	4000	-3398
chr1	11022523	11030523	11026750	8000	11026523	-4000	4000	227
chr1	12205228	12213228	12206933	8000	12209228	-4000	4000	-2295
chr1	16193854	16201854	16199250	8000	16197854	-4000	4000	1396
chr1	17062761	17070761	17069093	8000	17066761	-4000	4000	2332
chr1	27332400	27340400	27334024	8000	27336400	-4000	4000	-2376
chr1	27608064	27616064	27613017	8000	27612064	-4000	4000	953
chr1	42426329	42434329	42430649	8000	42430329	-4000	4000	320
chr1	43379917	43387917	43384437	8000	43383917	-4000	4000	520
chr1	54605181	54613181	54607995	8000	54609181	-4000	4000	-1186
chr1	64829229	64837229	64834635	8000	64833229	-4000	4000	1406
chr1	94525173	94533173	94530413	8000	94529173	-4000	4000	1240
chr1	101239713	101247713	101239714	8000	101243713	-4000	4000	-3999
chr1	113890194	113898194	113897923	8000	113894194	-4000	4000	3729
chr1	113910086	113918086	113911196	8000	113914086	-4000	4000	-2890
chr1	113973869	113981869	113979424	8000	113977869	-4000	4000	1555
chr1	119390130	119398130	119393843	8000	119394130	-4000	4000	-287
chr1	149880459	149888459	149886247	8000	149884459	-4000	4000	1788
chr1	149924651	149932651	149931299	8000	149928651	-4000	4000	2648
chr1	153977617	153985617	153982047	8000	153981617	-4000	4000	430
chr1	154940076	154948076	154945841	8000	154944076	-4000	4000	1765
chr1	155251979	155259979	155254664	8000	155255979	-4000	4000	-1315
chr1	155942851	155950851	155950413	8000	155946851	-4000	4000	3562
chr1	156286089	156294089	156286398	8000	156290089	-4000	4000	-3691
chr1	159058484	159066484	159063507	8000	159062484	-4000	4000	1023
chr1	160139591	160147591	160139946	8000	160143591	-4000	4000	-3645
chr1	161619196	161627196	161624381	8000	161623196	-4000	4000	1185
chr1	169788529	169796529	169793074	8000	169792529	-4000	4000	545
chr1	178845535	178853535	178850965	8000	178849535	-4000	4000	1430
chr1	185287781	185295781	185290780	8000	185291781	-4000	4000	-1001
chr1	190093658	190101658	190097973	8000	190097658	-4000	4000	315
chr1	209781617	209789617	209788316	8000	209785617	-4000	4000	2699
chr1	219208865	219216865	219211702	8000	219212865	-4000	4000	-1163
chr1	222664013	222672013	222669803	8000	222668013	-4000	4000	1790
chr1	229426365	229434365	229432364	8000	229430365	-4000	4000	1999
chr1	230996733	231004733	230997227	8000	231000733	-4000	4000	-3506
chr1	231351023	231359023	231351394	8000	231355023	-4000	4000	-3629
chr1	235443190	235451190	235450026	8000	235447190	-4000	4000	2836
chr1	245123164	245131164	245123686	8000	245127164	-4000	4000	-3478
chr1	40236921	40244921	40237308	8000	40240921	-4000	4000	-3613
chr1	41474775	41482775	41482547	8000	41478775	-4000	4000	3772
chr1	95243225	95251225	95244478	8000	95247225	-4000	4000	-2747
chr1	43619666	43627666	43620841	8000	43623666	-4000	4000	-2825
chr1	11102535	11110535	11108184	8000	11106535	-4000	4000	1649
chr1	156664763	156672763	156670482	8000	156668763	-4000	4000	1719
chr1	152907886	152915886	152911229	8000	152911886	-4000	4000	-657
chr1	232805929	232813929	232807066	8000	232809929	-4000	4000	-2863
chr1	203336628	203344628	203342235	8000	203340628	-4000	4000	1607
chr1	13111488	13119488	13116462	8000	13115488	-4000	4000	974
chr1	46312776	46320776	46316767	8000	46316776	-4000	4000	-9
chr1	100079563	100087563	100082000	8000	100083563	-4000	4000	-1563
chr1	150503602	150511602	150505643	8000	150507602	-4000	4000	-1959
chr1	158254269	158262269	158255321	8000	158258269	-4000	4000	-2948
chr1	168071843	168079843	168075379	8000	168075843	-4000	4000	-464
chr1	186307652	186315652	186313785	8000	186311652	-4000	4000	2133
chr1	41474775	41482775	41479372	8000	41478775	-4000	4000	597
chr1	99305590	99313590	99305972	8000	99309590	-4000	4000	-3618
chr1	209781617	209789617	209788282	8000	209785617	-4000	4000	2665
chr1	39030636	39038636	39034400	8000	39034636	-4000	4000	-236
chr1	161520013	161528013	161526342	8000	161524013	-4000	4000	2329
chr1	202957873	202965873	202962549	8000	202961873	-4000	4000	676
chr1	156289185	156297185	156294150	8000	156293185	-4000	4000	965
chr1	155209824	155217824	155217373	8000	155213824	-4000	4000	3549
chr1	162366475	162374475	162373751	8000	162370475	-4000	4000	3276
chr1	206924522	206932522	206931520	8000	206928522	-4000	4000	2998
chr1	215233090	215241090	215235026	8000	215237090	-4000	4000	-2064
chr1	222518258	222526258	222522582	8000	222522258	-4000	4000	324
chr1	1698379	1706379	1703847	8000	1702379	-4000	4000	1468
chr1	19678240	19686240	19682530	8000	19682240	-4000	4000	290
chr1	46184683	46192683	46190784	8000	46188683	-4000	4000	2101
chr1	150261399	150269399	150261520	8000	150265399	-4000	4000	-3879
chr1	154271875	154279875	154275636	8000	154275875	-4000	4000	-239
chr1	161167310	161175310	161168125	8000	161171310	-4000	4000	-3185
chr1	171113819	171121819	171114038	8000	171117819	-4000	4000	-3781
chr1	211567568	211575568	211575481	8000	211571568	-4000	4000	3913
chr1	40236921	40244921	40240106	8000	40240921	-4000	4000	-815
chr1	43964022	43972022	43970266	8000	43968022	-4000	4000	2244
chr1	53210197	53218197	53210834	8000	53214197	-4000	4000	-3363
chr1	116066054	116074054	116067188	8000	116070054	-4000	4000	-2866
chr1	156664763	156672763	156669526	8000	156668763	-4000	4000	763
chr1	156664763	156672763	156671814	8000	156668763	-4000	4000	3051
chr1	156664763	156672763	156671913	8000	156668763	-4000	4000	3150
chr1	179687272	179695272	179690846	8000	179691272	-4000	4000	-426
chr1	224189441	224197441	224190314	8000	224193441	-4000	4000	-3127
chr1	94525173	94533173	94530436	8000	94529173	-4000	4000	1263
chr1	64177498	64185498	64177620	8000	64181498	-4000	4000	-3878
chr1	28591449	28599449	28593816	8000	28595449	-4000	4000	-1633
chr1	78885764	78893764	78891642	8000	78889764	-4000	4000	1878
chr1	111474512	111482512	111478146	8000	111478512	-4000	4000	-366
chr1	20614903	20622903	20618548	8000	20618903	-4000	4000	-355
chr1	53210197	53218197	53210297	8000	53214197	-4000	4000	-3900
chr1	23079689	23087689	23083363	8000	23083689	-4000	4000	-326
chr1	109271751	109279751	109274629	8000	109275751	-4000	4000	-1122
chr1	119615377	119623377	119623040	8000	119619377	-4000	4000	3663
chr1	161035251	161043251	161039881	8000	161039251	-4000	4000	630
chr1	154544577	154552577	154544931	8000	154548577	-4000	4000	-3646
chr1	113681923	113689923	113683509	8000	113685923	-4000	4000	-2414
chr1	155165409	155173409	155172864	8000	155169409	-4000	4000	3455
chr1	161161723	161169723	161163559	8000	161165723	-4000	4000	-2164
chr1	46039661	46047661	46043467	8000	46043661	-4000	4000	-194
chr1	248845517	248853517	248847470	8000	248849517	-4000	4000	-2047
chr1	37798945	37806945	37803949	8000	37802945	-4000	4000	1004
chr1	26032464	26040464	26036224	8000	26036464	-4000	4000	-240
chr1	158353553	158361553	158356587	8000	158357553	-4000	4000	-966
chr1	62450298	62458298	62457586	8000	62454298	-4000	4000	3288
chr1	158353553	158361553	158354403	8000	158357553	-4000	4000	-3150
chr1	232805929	232813929	232807803	8000	232809929	-4000	4000	-2126
chr1	228095212	228103212	228097913	8000	228099212	-4000	4000	-1299
chr1	39759914	39767914	39763166	8000	39763914	-4000	4000	-748
chr1	145973811	145981811	145978551	8000	145977811	-4000	4000	740
chr1	155165409	155173409	155172759	8000	155169409	-4000	4000	3350
chr1	156208796	156216796	156210243	8000	156212796	-4000	4000	-2553
chr1	169128531	169136531	169132241	8000	169132531	-4000	4000	-290
chr1	34754512	34762512	34758049	8000	34758512	-4000	4000	-463
chr1	152999856	153007856	153003620	8000	153003856	-4000	4000	-236
chr1	201888587	201896587	201889605	8000	201892587	-4000	4000	-2982
chr1	247095962	247103962	247100504	8000	247099962	-4000	4000	542
chr1	26277328	26285328	26284359	8000	26281328	-4000	4000	3031
chr1	66370579	66378579	66372332	8000	66374579	-4000	4000	-2247
chr1	169850080	169858080	169854727	8000	169854080	-4000	4000	647
chr1	245745342	245753342	245749633	8000	245749342	-4000	4000	291
chr1	111181104	111189104	111182208	8000	111185104	-4000	4000	-2896
chr1	152999856	153007856	153003422	8000	153003856	-4000	4000	-434
chr1	155893808	155901808	155900438	8000	155897808	-4000	4000	2630
chr1	1414420	1422420	1420868	8000	1418420	-4000	4000	2448
chr1	23553926	23561926	23559051	8000	23557926	-4000	4000	1125
chr1	44811585	44819585	44813470	8000	44815585	-4000	4000	-2115
chr1	66984619	66992619	66984625	8000	66988619	-4000	4000	-3994
chr1	116066054	116074054	116067088	8000	116070054	-4000	4000	-2966
chr1	158353553	158361553	158356842	8000	158357553	-4000	4000	-711
chr1	158290774	158298774	158291256	8000	158294774	-4000	4000	-3518
chr1	40544167	40552167	40546659	8000	40548167	-4000	4000	-1508
chr1	109705551	109713551	109713281	8000	109709551	-4000	4000	3730
chr1	116066054	116074054	116067203	8000	116070054	-4000	4000	-2851
chr1	171631417	171639417	171636125	8000	171635417	-4000	4000	708
chr1	36411827	36419827	36418099	8000	36415827	-4000	4000	2272
chr1	64177498	64185498	64177875	8000	64181498	-4000	4000	-3623
chr1	206460436	206468436	206461043	8000	206464436	-4000	4000	-3393
chr1	247876138	247884138	247876600	8000	247880138	-4000	4000	-3538
chr1	85245953	85253953	85252530	8000	85249953	-4000	4000	2577
chr1	247095962	247103962	247102092	8000	247099962	-4000	4000	2130
chr1	12205228	12213228	12206895	8000	12209228	-4000	4000	-2333
chr1	24052035	24060035	24057266	8000	24056035	-4000	4000	1231
chr1	179094023	179102023	179095330	8000	179098023	-4000	4000	-2693
chr1	155165409	155173409	155173207	8000	155169409	-4000	4000	3798
chr1	155893808	155901808	155899476	8000	155897808	-4000	4000	1668
chr1	161710352	161718352	161710877	8000	161714352	-4000	4000	-3475
chr1	36132570	36140570	36137970	8000	36136570	-4000	4000	1400
chr1	78885764	78893764	78891528	8000	78889764	-4000	4000	1764
chr1	151155748	151163748	151158768	8000	151159748	-4000	4000	-980
chr1	151534692	151542692	151536870	8000	151538692	-4000	4000	-1822
chr1	154940076	154948076	154944877	8000	154944076	-4000	4000	801
chr1	158290774	158298774	158291337	8000	158294774	-4000	4000	-3437
chr1	160182980	160190980	160186305	8000	160186980	-4000	4000	-675
chr1	190093658	190101658	190098870	8000	190097658	-4000	4000	1212
chr1	196828189	196836189	196830546	8000	196832189	-4000	4000	-1643
chr1	244053476	244061476	244054286	8000	244057476	-4000	4000	-3190
chr1	196828189	196836189	196831911	8000	196832189	-4000	4000	-278
chr1	205763986	205771986	205770734	8000	205767986	-4000	4000	2748
chr1	225395292	225403292	225399135	8000	225399292	-4000	4000	-157
chr1	42426329	42434329	42433211	8000	42430329	-4000	4000	2882
chr1	228403935	228411935	228409187	8000	228407935	-4000	4000	1252
chr1	19211660	19219660	19219429	8000	19215660	-4000	4000	3769
chr1	152907886	152915886	152910865	8000	152911886	-4000	4000	-1021
chr1	161724143	161732143	161727490	8000	161728143	-4000	4000	-653
chr1	207014522	207022522	207021982	8000	207018522	-4000	4000	3460
chr1	23553926	23561926	23558041	8000	23557926	-4000	4000	115
chr1	52086716	52094716	52086935	8000	52090716	-4000	4000	-3781
chr1	156459727	156467727	156464385	8000	156463727	-4000	4000	658
chr1	160750821	160758821	160753226	8000	160754821	-4000	4000	-1595
chr1	40544167	40552167	40547166	8000	40548167	-4000	4000	-1001
chr1	209610870	209618870	209611479	8000	209614870	-4000	4000	-3391
chr1	156912429	156920429	156914022	8000	156916429	-4000	4000	-2407
chr1	205653851	205661851	205659259	8000	205657851	-4000	4000	1408
chr1	209775208	209783208	209777368	8000	209779208	-4000	4000	-1840
chr1	241591642	241599642	241594382	8000	241595642	-4000	4000	-1260
chr1	156664763	156672763	156671923	8000	156668763	-4000	4000	3160
chr1	197149682	197157682	197155458	8000	197153682	-4000	4000	1776
chr1	13821079	13829079	13824233	8000	13825079	-4000	4000	-846
chr1	192576024	192584024	192579205	8000	192580024	-4000	4000	-819
chr1	161979192	161987192	161984861	8000	161983192	-4000	4000	1669
chr1	113681923	113689923	113683350	8000	113685923	-4000	4000	-2573
chr1	163072802	163080802	163074780	8000	163076802	-4000	4000	-2022
chr1	156136081	156144081	156137705	8000	156140081	-4000	4000	-2376
chr1	75783575	75791575	75786236	8000	75787575	-4000	4000	-1339
chr1	112907847	112915847	112914109	8000	112911847	-4000	4000	2262
chr1	160087340	160095340	160092313	8000	160091340	-4000	4000	973
chr1	36176849	36184849	36180061	8000	36180849	-4000	4000	-788
chr1	223001995	223009995	223004267	8000	223005995	-4000	4000	-1728
chr1	247445108	247453108	247451945	8000	247449108	-4000	4000	2837
chr1	7839083	7847083	7842877	8000	7843083	-4000	4000	-206
chr1	244841057	244849057	244843144	8000	244845057	-4000	4000	-1913
chr1	155942851	155950851	155947921	8000	155946851	-4000	4000	1070
chr1	193086866	193094866	193091678	8000	193090866	-4000	4000	812
chr1	216499246	216507246	216504570	8000	216503246	-4000	4000	1324
chr1	13613957	13621957	13615958	8000	13617957	-4000	4000	-1999
chr1	152298165	152306165	152305933	8000	152302165	-4000	4000	3768
chr1	145955441	145963441	145961186	8000	145959441	-4000	4000	1745
chr1	247095962	247103962	247100384	8000	247099962	-4000	4000	422
chr1	23692835	23700835	23696006	8000	23696835	-4000	4000	-829
chr1	150642230	150650230	150648726	8000	150646230	-4000	4000	2496
chr1	151796264	151804264	151801269	8000	151800264	-4000	4000	1005
chr1	156289185	156297185	156294473	8000	156293185	-4000	4000	1288
chr1	21481005	21489005	21483362	8000	21485005	-4000	4000	-1643
chr1	46628737	46636737	46635482	8000	46632737	-4000	4000	2745
chr1	171281978	171289978	171282194	8000	171285978	-4000	4000	-3784
chr1	54752898	54760898	54759031	8000	54756898	-4000	4000	2133
chr1	171631417	171639417	171635859	8000	171635417	-4000	4000	442
chr1	223001995	223009995	223003054	8000	223005995	-4000	4000	-2941
chr1	152298165	152306165	152304617	8000	152302165	-4000	4000	2452
chr1	156289185	156297185	156294134	8000	156293185	-4000	4000	949
chr1	54845627	54853627	54852163	8000	54849627	-4000	4000	2536
chr1	160182980	160190980	160190846	8000	160186980	-4000	4000	3866
chr1	205079129	205087129	205084414	8000	205083129	-4000	4000	1285
chr1	222664013	222672013	222670228	8000	222668013	-4000	4000	2215
chr1	43277877	43285877	43283069	8000	43281877	-4000	4000	1192
chr1	109705551	109713551	109713174	8000	109709551	-4000	4000	3623
chr1	113973869	113981869	113980400	8000	113977869	-4000	4000	2531
chr1	118879046	118887046	118884776	8000	118883046	-4000	4000	1730
chr1	118879046	118887046	118885381	8000	118883046	-4000	4000	2335
chr1	160824261	160832261	160831361	8000	160828261	-4000	4000	3100
chr1	161042946	161050946	161048554	8000	161046946	-4000	4000	1608
chr1	23355448	23363448	23362983	8000	23359448	-4000	4000	3535
chr1	25358361	25366361	25360770	8000	25362361	-4000	4000	-1591
chr1	100538021	100546021	100539143	8000	100542021	-4000	4000	-2878
chr1	145973811	145981811	145977505	8000	145977811	-4000	4000	-306
chr1	147989592	147997592	147994173	8000	147993592	-4000	4000	581
chr1	155209824	155217824	155217571	8000	155213824	-4000	4000	3747
chr1	169850080	169858080	169855905	8000	169854080	-4000	4000	1825
chr1	231273973	231281973	231275308	8000	231277973	-4000	4000	-2665
chr1	203772372	203780372	203773928	8000	203776372	-4000	4000	-2444
chr1	31625866	31633866	31633252	8000	31629866	-4000	4000	3386
chr1	117949590	117957590	117952002	8000	117953590	-4000	4000	-1588
chr1	150503602	150511602	150510064	8000	150507602	-4000	4000	2462
chr1	92242402	92250402	92245759	8000	92246402	-4000	4000	-643
chr1	46181962	46189962	46185584	8000	46185962	-4000	4000	-378
chr1	92469043	92477043	92475953	8000	92473043	-4000	4000	2910
chr1	205138505	205146505	205143705	8000	205142505	-4000	4000	1200
chr1	230278122	230286122	230279384	8000	230282122	-4000	4000	-2738
chr1	2317253	2325253	2321445	8000	2321253	-4000	4000	192
chr1	39619435	39627435	39626957	8000	39623435	-4000	4000	3522
chr1	44811585	44819585	44813198	8000	44815585	-4000	4000	-2387
chr1	54752898	54760898	54758711	8000	54756898	-4000	4000	1813
chr1	111771602	111779602	111777058	8000	111775602	-4000	4000	1456
chr1	150694060	150702060	150698704	8000	150698060	-4000	4000	644
chr1	151755647	151763647	151760159	8000	151759647	-4000	4000	512
chr1	155134857	155142857	155140176	8000	155138857	-4000	4000	1319
chr1	161096346	161104346	161100107	8000	161100346	-4000	4000	-239
chr1	161724143	161732143	161725997	8000	161728143	-4000	4000	-2146
chr1	209781617	209789617	209783376	8000	209785617	-4000	4000	-2241
chr1	234320511	234328511	234323123	8000	234324511	-4000	4000	-1388
chr1	67394724	67402724	67396343	8000	67398724	-4000	4000	-2381
chr1	155285848	155293848	155287215	8000	155289848	-4000	4000	-2633
chr1	207140972	207148972	207144592	8000	207144972	-4000	4000	-380
chr1	244404494	244412494	244408880	8000	244408494	-4000	4000	386
chr1	150805713	150813713	150811308	8000	150809713	-4000	4000	1595
chr1	196743504	196751504	196743511	8000	196747504	-4000	4000	-3993
chr1	11971538	11979538	11974738	8000	11975538	-4000	4000	-800
chr1	13111488	13119488	13116396	8000	13115488	-4000	4000	908
chr1	17823063	17831063	17823249	8000	17827063	-4000	4000	-3814
chr1	21592221	21600221	21599539	8000	21596221	-4000	4000	3318
chr1	34782369	34790369	34785408	8000	34786369	-4000	4000	-961
chr1	34791747	34799747	34794696	8000	34795747	-4000	4000	-1051
chr1	43964022	43972022	43971096	8000	43968022	-4000	4000	3074
chr1	46181962	46189962	46185308	8000	46185962	-4000	4000	-654
chr1	56714789	56722789	56719607	8000	56718789	-4000	4000	818
chr1	64177498	64185498	64178010	8000	64181498	-4000	4000	-3488
chr1	93862284	93870284	93869937	8000	93866284	-4000	4000	3653
chr1	115694224	115702224	115701341	8000	115698224	-4000	4000	3117
chr1	147752199	147760199	147758509	8000	147756199	-4000	4000	2310
chr1	149778689	149786689	149784156	8000	149782689	-4000	4000	1467
chr1	150304979	150312979	150308092	8000	150308979	-4000	4000	-887
chr1	151155748	151163748	151159271	8000	151159748	-4000	4000	-477
chr1	152298165	152306165	152304010	8000	152302165	-4000	4000	1845
chr1	156304968	156312968	156309031	8000	156308968	-4000	4000	63
chr1	158353553	158361553	158356201	8000	158357553	-4000	4000	-1352
chr1	160424670	160432670	160425241	8000	160428670	-4000	4000	-3429
chr1	161979192	161987192	161983897	8000	161983192	-4000	4000	705
chr1	170549834	170557834	170552671	8000	170553834	-4000	4000	-1163
chr1	205763986	205771986	205771499	8000	205767986	-4000	4000	3513
chr1	214660571	214668571	214663697	8000	214664571	-4000	4000	-874
chr1	220144041	220152041	220147845	8000	220148041	-4000	4000	-196
chr1	224189441	224197441	224189760	8000	224193441	-4000	4000	-3681
chr1	22599595	22607595	22602854	8000	22603595	-4000	4000	-741
chr1	160354952	160362952	160356333	8000	160358952	-4000	4000	-2619
chr1	200911742	200919742	200913672	8000	200915742	-4000	4000	-2070
chr1	149880459	149888459	149886147	8000	149884459	-4000	4000	1688
chr1	183241127	183249127	183243455	8000	183245127	-4000	4000	-1672
chr1	236760631	236768631	236761131	8000	236764631	-4000	4000	-3500
chr1	236760631	236768631	236762489	8000	236764631	-4000	4000	-2142
chr1	51283258	51291258	51288899	8000	51287258	-4000	4000	1641
chr1	149924651	149932651	149930750	8000	149928651	-4000	4000	2099
chr1	156930840	156938840	156935921	8000	156934840	-4000	4000	1081
chr1	205298063	205306063	205303451	8000	205302063	-4000	4000	1388
chr1	159051155	159059155	159053532	8000	159055155	-4000	4000	-1623
chr1	230686776	230694776	230691541	8000	230690776	-4000	4000	765
chr1	15730769	15738769	15731989	8000	15734769	-4000	4000	-2780
chr1	108218464	108226464	108223673	8000	108222464	-4000	4000	1209
chr1	119907553	119915553	119915238	8000	119911553	-4000	4000	3685
chr1	150503602	150511602	150509751	8000	150507602	-4000	4000	2149
chr1	150642230	150650230	150647802	8000	150646230	-4000	4000	1572
chr1	151360304	151368304	151366779	8000	151364304	-4000	4000	2475
chr1	153052120	153060120	153056437	8000	153056120	-4000	4000	317
chr1	160993957	161001957	160997657	8000	160997957	-4000	4000	-300
chr1	200173420	200181420	200174250	8000	200177420	-4000	4000	-3170
chr1	216499246	216507246	216505640	8000	216503246	-4000	4000	2394
chr1	26467306	26475306	26474009	8000	26471306	-4000	4000	2703
chr1	38020820	38028820	38023655	8000	38024820	-4000	4000	-1165
chr1	152298165	152306165	152306096	8000	152302165	-4000	4000	3931
chr1	153977617	153985617	153982589	8000	153981617	-4000	4000	972
chr1	39891426	39899426	39897697	8000	39895426	-4000	4000	2271
chr1	74564117	74572117	74571389	8000	74568117	-4000	4000	3272
chr1	111458773	111466773	111460948	8000	111462773	-4000	4000	-1825
chr1	153977617	153985617	153981910	8000	153981617	-4000	4000	293
chr2	159767851	159775851	159771745	8000	159771851	-4000	4000	-106
chr2	10050836	10058836	10052353	8000	10054836	-4000	4000	-2483
chr2	1539711	1547711	1542470	8000	1543711	-4000	4000	-1241
chr2	53771196	53779196	53774496	8000	53775196	-4000	4000	-700
chr2	95382077	95390077	95385853	8000	95386077	-4000	4000	-224
chr2	108505415	108513415	108507688	8000	108509415	-4000	4000	-1727
chr2	210018260	210026260	210023065	8000	210022260	-4000	4000	805
chr2	138012364	138020364	138014544	8000	138016364	-4000	4000	-1820
chr2	5697385	5705385	5698425	8000	5701385	-4000	4000	-2960
chr2	197564224	197572224	197572121	8000	197568224	-4000	4000	3897
chr2	15630346	15638346	15630778	8000	15634346	-4000	4000	-3568
chr2	23704611	23712611	23706502	8000	23708611	-4000	4000	-2109
chr2	28640142	28648142	28643117	8000	28644142	-4000	4000	-1025
chr2	86139932	86147932	86144411	8000	86143932	-4000	4000	479
chr2	127179832	127187832	127187265	8000	127183832	-4000	4000	3433
chr2	132639286	132647286	132645228	8000	132643286	-4000	4000	1942
chr2	108261351	108269351	108265255	8000	108265351	-4000	4000	-96
chr2	127857630	127865630	127863256	8000	127861630	-4000	4000	1626
chr2	10566754	10574754	10571929	8000	10570754	-4000	4000	1175
chr2	30640225	30648225	30640652	8000	30644225	-4000	4000	-3573
chr2	63115559	63123559	63121831	8000	63119559	-4000	4000	2272
chr2	75648000	75656000	75652150	8000	75652000	-4000	4000	150
chr2	96180859	96188859	96186885	8000	96184859	-4000	4000	2026
chr2	136110349	136118349	136115496	8000	136114349	-4000	4000	1147
chr2	177544998	177552998	177551421	8000	177548998	-4000	4000	2423
chr2	70291975	70299975	70297307	8000	70295975	-4000	4000	1332
chr2	197384515	197392515	197392145	8000	197388515	-4000	4000	3630
chr2	95180317	95188317	95182110	8000	95184317	-4000	4000	-2207
chr2	20244691	20252691	20251506	8000	20248691	-4000	4000	2815
chr2	30156533	30164533	30158832	8000	30160533	-4000	4000	-1701
chr2	157410619	157418619	157416002	8000	157414619	-4000	4000	1383
chr2	191025576	191033576	191029716	8000	191029576	-4000	4000	140
chr2	1539711	1547711	1542642	8000	1543711	-4000	4000	-1069
chr2	219612451	219620451	219614533	8000	219616451	-4000	4000	-1918
chr2	169123109	169131109	169128551	8000	169127109	-4000	4000	1442
chr2	219637980	219645980	219638782	8000	219641980	-4000	4000	-3198
chr2	19347485	19355485	19352288	8000	19351485	-4000	4000	803
chr2	174427571	174435571	174427720	8000	174431571	-4000	4000	-3851
chr2	100992829	101000829	100995682	8000	100996829	-4000	4000	-1147
chr2	47806063	47814063	47807681	8000	47810063	-4000	4000	-2382
chr2	152645826	152653826	152647854	8000	152649826	-4000	4000	-1972
chr2	27578720	27586720	27581560	8000	27582720	-4000	4000	-1160
chr2	218446251	218454251	218449377	8000	218450251	-4000	4000	-874
chr2	187337964	187345964	187345401	8000	187341964	-4000	4000	3437
chr2	43763987	43771987	43767043	8000	43767987	-4000	4000	-944
chr2	130135287	130143287	130142971	8000	130139287	-4000	4000	3684
chr2	165388310	165396310	165388796	8000	165392310	-4000	4000	-3514
chr2	37197612	37205612	37202104	8000	37201612	-4000	4000	492
chr2	106074155	106082155	106077885	8000	106078155	-4000	4000	-270
chr2	172078430	172086430	172080406	8000	172082430	-4000	4000	-2024
chr2	58155243	58163243	58159703	8000	58159243	-4000	4000	460
chr2	241223264	241231264	241230840	8000	241227264	-4000	4000	3576
chr2	227813564	227821564	227815477	8000	227817564	-4000	4000	-2087
chr2	102024544	102032544	102028236	8000	102028544	-4000	4000	-308
chr2	189873629	189881629	189877398	8000	189877629	-4000	4000	-231
chr2	74522645	74530645	74528935	8000	74526645	-4000	4000	2290
chr2	37246502	37254502	37248327	8000	37250502	-4000	4000	-2175
chr2	26186635	26194635	26187551	8000	26190635	-4000	4000	-3084
chr2	135835626	135843626	135836899	8000	135839626	-4000	4000	-2727
chr2	173264015	173272015	173266081	8000	173268015	-4000	4000	-1934
chr2	27487883	27495883	27493936	8000	27491883	-4000	4000	2053
chr2	96701929	96709929	96707222	8000	96705929	-4000	4000	1293
chr2	36547135	36555135	36549978	8000	36551135	-4000	4000	-1157
chr2	84817650	84825650	84824026	8000	84821650	-4000	4000	2376
chr2	205794133	205802133	205794830	8000	205798133	-4000	4000	-3303
chr2	38063142	38071142	38071064	8000	38067142	-4000	4000	3922
chr2	38958206	38966206	38960062	8000	38962206	-4000	4000	-2144
chr2	18551545	18559545	18555624	8000	18555545	-4000	4000	79
chr2	138012364	138020364	138014237	8000	138016364	-4000	4000	-2127
chr2	219534954	219542954	219535261	8000	219538954	-4000	4000	-3693
chr2	84815589	84823589	84819446	8000	84819589	-4000	4000	-143
chr2	131349709	131357709	131353057	8000	131353709	-4000	4000	-652
chr2	210018260	210026260	210020391	8000	210022260	-4000	4000	-1869
chr2	24766702	24774702	24768386	8000	24770702	-4000	4000	-2316
chr2	72888158	72896158	72888369	8000	72892158	-4000	4000	-3789
chr2	108683246	108691246	108683962	8000	108687246	-4000	4000	-3284
chr2	233769300	233777300	233772349	8000	233773300	-4000	4000	-951
chr2	172078430	172086430	172080169	8000	172082430	-4000	4000	-2261
chr2	205794133	205802133	205795011	8000	205798133	-4000	4000	-3122
chr2	197704395	197712395	197706553	8000	197708395	-4000	4000	-1842
chr2	67408089	67416089	67409921	8000	67412089	-4000	4000	-2168
chr2	73223221	73231221	73228380	8000	73227221	-4000	4000	1159
chr2	171779405	171787405	171785159	8000	171783405	-4000	4000	1754
chr2	201476846	201484846	201477686	8000	201480846	-4000	4000	-3160
chr2	218086581	218094581	218089865	8000	218090581	-4000	4000	-716
chr2	96820526	96828526	96825159	8000	96824526	-4000	4000	633
chr2	177544998	177552998	177552301	8000	177548998	-4000	4000	3303
chr2	199924913	199932913	199925071	8000	199928913	-4000	4000	-3842
chr2	230399732	230407732	230401347	8000	230403732	-4000	4000	-2385
chr2	10910225	10918225	10912850	8000	10914225	-4000	4000	-1375
chr2	27213178	27221178	27213283	8000	27217178	-4000	4000	-3895
chr2	27578720	27586720	27578958	8000	27582720	-4000	4000	-3762
chr2	68127238	68135238	68131393	8000	68131238	-4000	4000	155
chr2	96139169	96147169	96144259	8000	96143169	-4000	4000	1090
chr2	112025561	112033561	112028414	8000	112029561	-4000	4000	-1147
chr2	130187745	130195745	130191968	8000	130191745	-4000	4000	223
chr2	201616184	201624184	201618982	8000	201620184	-4000	4000	-1202
chr2	227679763	227687763	227687375	8000	227683763	-4000	4000	3612
chr2	113130016	113138016	113132687	8000	113134016	-4000	4000	-1329
chr2	219637980	219645980	219641890	8000	219641980	-4000	4000	-90
chr2	28640142	28648142	28642984	8000	28644142	-4000	4000	-1158
chr2	38781002	38789002	38781691	8000	38785002	-4000	4000	-3311
chr2	70935318	70943318	70935925	8000	70939318	-4000	4000	-3393
chr2	165388310	165396310	165388864	8000	165392310	-4000	4000	-3446
chr2	10423617	10431617	10426928	8000	10427617	-4000	4000	-689
chr2	47806063	47814063	47808415	8000	47810063	-4000	4000	-1648
chr2	73725104	73733104	73732238	8000	73729104	-4000	4000	3134
chr2	130069535	130077535	130075376	8000	130073535	-4000	4000	1841
chr2	130187745	130195745	130195085	8000	130191745	-4000	4000	3340
chr2	189008746	189016746	189010212	8000	189012746	-4000	4000	-2534
chr2	237320003	237328003	237325567	8000	237324003	-4000	4000	1564
chr2	187460230	187468230	187467847	8000	187464230	-4000	4000	3617
chr2	166399573	166407573	166405681	8000	166403573	-4000	4000	2108
chr2	165388310	165396310	165389438	8000	165392310	-4000	4000	-2872
chr2	158678879	158686879	158680575	8000	158682879	-4000	4000	-2304
chr2	171979686	171987686	171983197	8000	171983686	-4000	4000	-489
chr2	127857630	127865630	127865189	8000	127861630	-4000	4000	3559
chr2	27619217	27627217	27622885	8000	27623217	-4000	4000	-332
chr2	156320437	156328437	156326731	8000	156324437	-4000	4000	2294
chr2	157410619	157418619	157416092	8000	157414619	-4000	4000	1473
chr2	209730118	209738118	209734023	8000	209734118	-4000	4000	-95
chr2	190961552	190969552	190962993	8000	190965552	-4000	4000	-2559
chr2	73915865	73923865	73919524	8000	73919865	-4000	4000	-341
chr2	112025561	112033561	112028774	8000	112029561	-4000	4000	-787
chr2	178521989	178529989	178526793	8000	178525989	-4000	4000	804
chr2	10910225	10918225	10912914	8000	10914225	-4000	4000	-1311
chr2	121333776	121341776	121340870	8000	121337776	-4000	4000	3094
chr2	130187745	130195745	130194135	8000	130191745	-4000	4000	2390
chr2	61183463	61191463	61190538	8000	61187463	-4000	4000	3075
chr2	19347485	19355485	19352344	8000	19351485	-4000	4000	859
chr2	27646809	27654809	27650898	8000	27650809	-4000	4000	89
chr2	74553883	74561883	74558858	8000	74557883	-4000	4000	975
chr2	24815169	24823169	24817747	8000	24819169	-4000	4000	-1422
chr2	119434504	119442504	119437275	8000	119438504	-4000	4000	-1229
chr2	169808064	169816064	169812357	8000	169812064	-4000	4000	293
chr2	108305915	108313915	108308580	8000	108309915	-4000	4000	-1335
chr2	88552741	88560741	88558917	8000	88556741	-4000	4000	2176
chr2	85601254	85609254	85608928	8000	85605254	-4000	4000	3674
chr2	24815169	24823169	24816663	8000	24819169	-4000	4000	-2506
chr2	27578720	27586720	27580547	8000	27582720	-4000	4000	-2173
chr2	38062973	38070973	38070910	8000	38066973	-4000	4000	3937
chr2	101890690	101898690	101891797	8000	101894690	-4000	4000	-2893
chr2	110633528	110641528	110641157	8000	110637528	-4000	4000	3629
chr2	236578354	236586354	236581042	8000	236582354	-4000	4000	-1312
chr2	30156533	30164533	30156656	8000	30160533	-4000	4000	-3877
chr2	54968025	54976025	54970337	8000	54972025	-4000	4000	-1688
chr2	54968025	54976025	54973128	8000	54972025	-4000	4000	1103
chr2	70145885	70153885	70150403	8000	70149885	-4000	4000	518
chr2	74104176	74112176	74106570	8000	74108176	-4000	4000	-1606
chr2	74104176	74112176	74108001	8000	74108176	-4000	4000	-175
chr2	96326517	96334517	96328231	8000	96330517	-4000	4000	-2286
chr2	99396475	99404475	99396818	8000	99400475	-4000	4000	-3657
chr2	135835626	135843626	135836654	8000	135839626	-4000	4000	-2972
chr2	181531041	181539041	181535429	8000	181535041	-4000	4000	388
chr2	201476846	201484846	201480143	8000	201480846	-4000	4000	-703
chr2	219637980	219645980	219640927	8000	219641980	-4000	4000	-1053
chr2	231169116	231177116	231170605	8000	231173116	-4000	4000	-2511
chr2	238240044	238248044	238246473	8000	238244044	-4000	4000	2429
chr2	207576631	207584631	207577639	8000	207580631	-4000	4000	-2992
chr2	218342793	218350793	218346607	8000	218346793	-4000	4000	-186
chr2	99157427	99165427	99162464	8000	99161427	-4000	4000	1037
chr2	42763089	42771089	42767624	8000	42767089	-4000	4000	535
chr2	214406501	214414501	214410319	8000	214410501	-4000	4000	-182
chr2	174344022	174352022	174349152	8000	174348022	-4000	4000	1130
chr2	5697385	5705385	5698402	8000	5701385	-4000	4000	-2983
chr2	70291975	70299975	70293696	8000	70295975	-4000	4000	-2279
chr2	132639286	132647286	132645356	8000	132643286	-4000	4000	2070
chr2	207576631	207584631	207576683	8000	207580631	-4000	4000	-3948
chr2	74553883	74561883	74556465	8000	74557883	-4000	4000	-1418
chr2	130135287	130143287	130139896	8000	130139287	-4000	4000	609
chr2	172095438	172103438	172102498	8000	172099438	-4000	4000	3060
chr2	186761959	186769959	186762103	8000	186765959	-4000	4000	-3856
chr2	106387290	106395290	106391165	8000	106391290	-4000	4000	-125
chr2	174743592	174751592	174748036	8000	174747592	-4000	4000	444
chr2	72938036	72946036	72944951	8000	72942036	-4000	4000	2915
chr2	241669857	241677857	241676084	8000	241673857	-4000	4000	2227
chr2	237809682	237817682	237813593	8000	237813682	-4000	4000	-89
chr2	15162914	15170914	15167310	8000	15166914	-4000	4000	396
chr2	190961552	190969552	190962956	8000	190965552	-4000	4000	-2596
chr2	118838171	118846171	118842241	8000	118842171	-4000	4000	70
chr2	127044027	127052027	127048411	8000	127048027	-4000	4000	384
chr2	112115318	112123318	112116163	8000	112119318	-4000	4000	-3155
chr2	159228659	159236659	159232263	8000	159232659	-4000	4000	-396
chr2	132639286	132647286	132645423	8000	132643286	-4000	4000	2137
chr2	206110817	206118817	206116155	8000	206114817	-4000	4000	1338
chr2	37212193	37220193	37216399	8000	37216193	-4000	4000	206
chr2	173364997	173372997	173367761	8000	173368997	-4000	4000	-1236
chr2	66569869	66577869	66571357	8000	66573869	-4000	4000	-2512
chr2	95081369	95089369	95087492	8000	95085369	-4000	4000	2123
chr2	25155135	25163135	25161252	8000	25159135	-4000	4000	2117
chr2	16545459	16553459	16552743	8000	16549459	-4000	4000	3284
chr2	42763089	42771089	42767327	8000	42767089	-4000	4000	238
chr2	200904977	200912977	200911089	8000	200908977	-4000	4000	2112
chr2	68651862	68659862	68655410	8000	68655862	-4000	4000	-452
chr2	219509898	219517898	219514946	8000	219513898	-4000	4000	1048
chr2	47806063	47814063	47806545	8000	47810063	-4000	4000	-3518
chr2	135835626	135843626	135836824	8000	135839626	-4000	4000	-2802
chr2	132667788	132675788	132673219	8000	132671788	-4000	4000	1431
chr2	27578720	27586720	27580249	8000	27582720	-4000	4000	-2471
chr2	74529332	74537332	74535716	8000	74533332	-4000	4000	2384
chr2	96017946	96025946	96023348	8000	96021946	-4000	4000	1402
chr2	176169102	176177102	176169485	8000	176173102	-4000	4000	-3617
chr2	131478934	131486934	131482931	8000	131482934	-4000	4000	-3
chr2	118990660	118998660	118994626	8000	118994660	-4000	4000	-34
chr2	27126812	27134812	27132725	8000	27130812	-4000	4000	1913
chr2	19347485	19355485	19352157	8000	19351485	-4000	4000	672
chr2	43806010	43814010	43813130	8000	43810010	-4000	4000	3120
chr2	112115318	112123318	112116127	8000	112119318	-4000	4000	-3191
chr2	169808064	169816064	169810972	8000	169812064	-4000	4000	-1092
chr2	171979686	171987686	171983299	8000	171983686	-4000	4000	-387
chr2	174344022	174352022	174348736	8000	174348022	-4000	4000	714
chr2	199265500	199273500	199272531	8000	199269500	-4000	4000	3031
chr2	85694852	85702852	85696001	8000	85698852	-4000	4000	-2851
chr2	120290710	120298710	120293517	8000	120294710	-4000	4000	-1193
chr2	191830310	191838310	191836049	8000	191834310	-4000	4000	1739
chr2	165388310	165396310	165389122	8000	165392310	-4000	4000	-3188
chr2	85589406	85597406	85591744	8000	85593406	-4000	4000	-1662
chr2	55232595	55240595	55240140	8000	55236595	-4000	4000	3545
chr2	201616184	201624184	201619083	8000	201620184	-4000	4000	-1101
chr2	218342793	218350793	218344893	8000	218346793	-4000	4000	-1900
chr2	224374698	224382698	224380047	8000	224378698	-4000	4000	1349
chr2	149565637	149573637	149569862	8000	149569637	-4000	4000	225
chr2	74679853	74687853	74680046	8000	74683853	-4000	4000	-3807
chr2	101020032	101028032	101022395	8000	101024032	-4000	4000	-1637
chr2	47806063	47814063	47808393	8000	47810063	-4000	4000	-1670
chr2	127634381	127642381	127642166	8000	127638381	-4000	4000	3785
chr2	197704395	197712395	197705880	8000	197708395	-4000	4000	-2515
chr2	206158928	206166928	206162880	8000	206162928	-4000	4000	-48
chr2	27578720	27586720	27579072	8000	27582720	-4000	4000	-3648
chr2	33395509	33403509	33397258	8000	33399509	-4000	4000	-2251
chr2	55232595	55240595	55232665	8000	55236595	-4000	4000	-3930
chr2	109500634	109508634	109501641	8000	109504634	-4000	4000	-2993
chr2	127857630	127865630	127864151	8000	127861630	-4000	4000	2521
chr2	157410619	157418619	157415759	8000	157414619	-4000	4000	1140
chr2	208354746	208362746	208356649	8000	208358746	-4000	4000	-2097
chr2	218633184	218641184	218638347	8000	218637184	-4000	4000	1163
chr2	230030982	230038982	230035923	8000	230034982	-4000	4000	941
chr2	64589005	64597005	64592011	8000	64593005	-4000	4000	-994
chr2	70826211	70834211	70833741	8000	70830211	-4000	4000	3530
chr2	156320437	156328437	156327981	8000	156324437	-4000	4000	3544
chr2	189027898	189035898	189035114	8000	189031898	-4000	4000	3216
chr2	219637980	219645980	219639723	8000	219641980	-4000	4000	-2257
chr2	74104176	74112176	74105593	8000	74108176	-4000	4000	-2583
chr2	108305915	108313915	108308569	8000	108309915	-4000	4000	-1346
chr2	19988052	19996052	19990072	8000	19992052	-4000	4000	-1980
chr2	206171316	206179316	206176959	8000	206175316	-4000	4000	1643
chr2	218392894	218400894	218394705	8000	218396894	-4000	4000	-2189
chr2	210675107	210683107	210675763	8000	210679107	-4000	4000	-3344
chr2	213730	221730	218826	8000	217730	-4000	4000	1096
chr2	108261351	108269351	108265312	8000	108265351	-4000	4000	-39
chr2	55232595	55240595	55236788	8000	55236595	-4000	4000	193
chr2	219246337	219254337	219251682	8000	219250337	-4000	4000	1345
chr2	212995691	213003691	213003193	8000	212999691	-4000	4000	3502
chr2	9484486	9492486	9488319	8000	9488486	-4000	4000	-167
chr2	241490841	241498841	241498746	8000	241494841	-4000	4000	3905
chr2	44942071	44950071	44942685	8000	44946071	-4000	4000	-3386
chr2	44942071	44950071	44942686	8000	44946071	-4000	4000	-3385
chr2	15162914	15170914	15166997	8000	15166914	-4000	4000	83
chr2	27023219	27031219	27024240	8000	27027219	-4000	4000	-2979
chr2	43763987	43771987	43765855	8000	43767987	-4000	4000	-2132
chr2	74501043	74509043	74506797	8000	74505043	-4000	4000	1754
chr2	74501043	74509043	74506798	8000	74505043	-4000	4000	1755
chr2	206171316	206179316	206176804	8000	206175316	-4000	4000	1488
chr2	74207604	74215604	74209961	8000	74211604	-4000	4000	-1643
chr2	127634381	127642381	127640893	8000	127638381	-4000	4000	2512
chr2	232475827	232483827	232483107	8000	232479827	-4000	4000	3280
chr2	10910225	10918225	10913539	8000	10914225	-4000	4000	-686
chr2	24073433	24081433	24080905	8000	24077433	-4000	4000	3472
chr2	131529666	131537666	131532705	8000	131533666	-4000	4000	-961
chr2	178427292	178435292	178432162	8000	178431292	-4000	4000	870
chr2	187460230	187468230	187467924	8000	187464230	-4000	4000	3694
chr2	10910225	10918225	10913537	8000	10914225	-4000	4000	-688
chr2	74501043	74509043	74507061	8000	74505043	-4000	4000	2018
chr2	74889359	74897359	74890802	8000	74893359	-4000	4000	-2557
chr2	42763089	42771089	42770180	8000	42767089	-4000	4000	3091
chr2	84817650	84825650	84824159	8000	84821650	-4000	4000	2509
chr2	110633528	110641528	110641135	8000	110637528	-4000	4000	3607
chr2	230030982	230038982	230037213	8000	230034982	-4000	4000	2231
chr2	230399732	230407732	230400266	8000	230403732	-4000	4000	-3466
chr2	38793729	38801729	38798230	8000	38797729	-4000	4000	501
chr2	182829275	182837275	182834708	8000	182833275	-4000	4000	1433
chr2	172085677	172093677	172088191	8000	172089677	-4000	4000	-1486
chr2	43882224	43890224	43888593	8000	43886224	-4000	4000	2369
chr2	189027898	189035898	189034213	8000	189031898	-4000	4000	2315
chr2	27440377	27448377	27440692	8000	27444377	-4000	4000	-3685
chr2	238166402	238174402	238170650	8000	238170402	-4000	4000	248
chr2	238166402	238174402	238170651	8000	238170402	-4000	4000	249
chr2	181531041	181539041	181538124	8000	181535041	-4000	4000	3083
chr2	27646809	27654809	27652860	8000	27650809	-4000	4000	2051
chr2	96548634	96556634	96552117	8000	96552634	-4000	4000	-517
chr2	73954961	73962961	73957136	8000	73958961	-4000	4000	-1825
chr2	112184218	112192218	112187248	8000	112188218	-4000	4000	-970
chr2	151376046	151384046	151379596	8000	151380046	-4000	4000	-450
chr2	176169102	176177102	176169133	8000	176173102	-4000	4000	-3969
chr2	186761959	186769959	186762122	8000	186765959	-4000	4000	-3837
chr2	210675107	210683107	210678077	8000	210679107	-4000	4000	-1030
chr2	230399732	230407732	230403041	8000	230403732	-4000	4000	-691
chr2	26186635	26194635	26194603	8000	26190635	-4000	4000	3968
chr2	101266316	101274316	101273283	8000	101270316	-4000	4000	2967
chr2	10779391	10787391	10784444	8000	10783391	-4000	4000	1053
chr2	63053836	63061836	63056342	8000	63057836	-4000	4000	-1494
chr2	88552741	88560741	88557698	8000	88556741	-4000	4000	957
chr2	9492543	9500543	9494643	8000	9496543	-4000	4000	-1900
chr2	74514131	74522131	74515659	8000	74518131	-4000	4000	-2472
chr2	20196797	20204797	20204001	8000	20200797	-4000	4000	3204
chr2	199924913	199932913	199925740	8000	199928913	-4000	4000	-3173
chr2	199924913	199932913	199926026	8000	199928913	-4000	4000	-2887
chr2	223592940	223600940	223597334	8000	223596940	-4000	4000	394
chr2	131529666	131537666	131530586	8000	131533666	-4000	4000	-3080
chr2	231169116	231177116	231170662	8000	231173116	-4000	4000	-2454
chr2	27305492	27313492	27309974	8000	27309492	-4000	4000	482
chr2	84815589	84823589	84819306	8000	84819589	-4000	4000	-283
chr2	118838171	118846171	118842992	8000	118842171	-4000	4000	821
chr2	162263074	162271074	162267207	8000	162267074	-4000	4000	133
chr2	230309215	230317215	230312738	8000	230313215	-4000	4000	-477
chr2	102710630	102718630	102718540	8000	102714630	-4000	4000	3910
chr2	200484958	200492958	200490114	8000	200488958	-4000	4000	1156
chr2	42054517	42062517	42057661	8000	42058517	-4000	4000	-856
chr2	70935318	70943318	70936013	8000	70939318	-4000	4000	-3305
chr2	159228659	159236659	159229612	8000	159232659	-4000	4000	-3047
chr2	223971045	223979045	223975870	8000	223975045	-4000	4000	825
chr2	241845884	241853884	241851209	8000	241849884	-4000	4000	1325
chr2	27578720	27586720	27581333	8000	27582720	-4000	4000	-1387
chr2	241580405	241588405	241584625	8000	241584405	-4000	4000	220
chr2	149470138	149478138	149471078	8000	149474138	-4000	4000	-3060
chr2	32220379	32228379	32220387	8000	32224379	-4000	4000	-3992
chr2	191025576	191033576	191033551	8000	191029576	-4000	4000	3975
chr2	24766702	24774702	24770527	8000	24770702	-4000	4000	-175
chr2	27777379	27785379	27779669	8000	27781379	-4000	4000	-1710
chr2	113130016	113138016	113131137	8000	113134016	-4000	4000	-2879
chr2	26946351	26954351	26946920	8000	26950351	-4000	4000	-3431
chr2	42763089	42771089	42770183	8000	42767089	-4000	4000	3094
chr2	84902671	84910671	84906483	8000	84906671	-4000	4000	-188
chr2	96326517	96334517	96327719	8000	96330517	-4000	4000	-2798
chr2	186505361	186513361	186506716	8000	186509361	-4000	4000	-2645
chr2	212995691	213003691	213003402	8000	212999691	-4000	4000	3711
chr2	227813564	227821564	227815557	8000	227817564	-4000	4000	-2007
chr2	241490841	241498841	241498653	8000	241494841	-4000	4000	3812
chr2	97735862	97743862	97738078	8000	97739862	-4000	4000	-1784
chr2	68651862	68659862	68655273	8000	68655862	-4000	4000	-589
chr2	46382697	46390697	46384595	8000	46386697	-4000	4000	-2102
chr2	218811293	218819293	218812953	8000	218815293	-4000	4000	-2340
chr2	11638788	11646788	11640475	8000	11642788	-4000	4000	-2313
chr2	19906263	19914263	19914213	8000	19910263	-4000	4000	3950
chr2	224374698	224382698	224380189	8000	224378698	-4000	4000	1491
chr2	73249021	73257021	73249145	8000	73253021	-4000	4000	-3876
chr2	241813413	241821413	241816753	8000	241817413	-4000	4000	-660
chr2	63888146	63896146	63890153	8000	63892146	-4000	4000	-1993
chr2	27777379	27785379	27781696	8000	27781379	-4000	4000	317
chr2	38958206	38966206	38960561	8000	38962206	-4000	4000	-1645
chr2	30906467	30914467	30910752	8000	30910467	-4000	4000	285
chr2	24059321	24067321	24063045	8000	24063321	-4000	4000	-276
chr2	241845884	241853884	241852729	8000	241849884	-4000	4000	2845
chr2	24815169	24823169	24817713	8000	24819169	-4000	4000	-1456
chr2	65083004	65091004	65088598	8000	65087004	-4000	4000	1594
chr2	191025576	191033576	191031487	8000	191029576	-4000	4000	1911
chr2	106387290	106395290	106391185	8000	106391290	-4000	4000	-105
chr2	118990660	118998660	118993258	8000	118994660	-4000	4000	-1402
chr2	149211262	149219262	149214789	8000	149215262	-4000	4000	-473
chr2	219546595	219554595	219554584	8000	219550595	-4000	4000	3989
chr2	109500634	109508634	109501508	8000	109504634	-4000	4000	-3126
chr2	61134034	61142034	61134211	8000	61138034	-4000	4000	-3823
chr2	85541281	85549281	85542131	8000	85545281	-4000	4000	-3150
chr2	119434504	119442504	119437050	8000	119438504	-4000	4000	-1454
chr2	223592940	223600940	223598750	8000	223596940	-4000	4000	1810
chr2	132639286	132647286	132645490	8000	132643286	-4000	4000	2204
chr2	42763089	42771089	42769919	8000	42767089	-4000	4000	2830
chr2	27621638	27629638	27628829	8000	27625638	-4000	4000	3191
chr2	203869965	203877965	203870886	8000	203873965	-4000	4000	-3079
chr2	113130016	113138016	113131131	8000	113134016	-4000	4000	-2885
chr2	206171316	206179316	206177112	8000	206175316	-4000	4000	1796
chr2	65083004	65091004	65088561	8000	65087004	-4000	4000	1557
chr2	171554129	171562129	171554793	8000	171558129	-4000	4000	-3336
chr2	62496218	62504218	62502473	8000	62500218	-4000	4000	2255
chr2	130069535	130077535	130075463	8000	130073535	-4000	4000	1928
chr2	130135287	130143287	130143283	8000	130139287	-4000	4000	3996
chr2	129978738	129986738	129980852	8000	129982738	-4000	4000	-1886
chr2	189666831	189674831	189670586	8000	189670831	-4000	4000	-245
chr2	218870233	218878233	218871188	8000	218874233	-4000	4000	-3045
chr2	10052473	10060473	10058919	8000	10056473	-4000	4000	2446
chr2	165388310	165396310	165388828	8000	165392310	-4000	4000	-3482
chr2	230161186	230169186	230169132	8000	230165186	-4000	4000	3946
chr2	26946351	26954351	26947203	8000	26950351	-4000	4000	-3148
chr2	46382697	46390697	46384925	8000	46386697	-4000	4000	-1772
chr2	150464195	150472195	150471632	8000	150468195	-4000	4000	3437
chr2	102394777	102402777	102396716	8000	102398777	-4000	4000	-2061
chr2	206158928	206166928	206161387	8000	206162928	-4000	4000	-1541
chr2	161988245	161996245	161993077	8000	161992245	-4000	4000	832
chr2	164488417	164496417	164492885	8000	164492417	-4000	4000	468
chr2	99397326	99405326	99401201	8000	99401326	-4000	4000	-125
chr2	218811293	218819293	218814990	8000	218815293	-4000	4000	-303
chr2	206310427	206318427	206310996	8000	206314427	-4000	4000	-3431
chr2	10052473	10060473	10058928	8000	10056473	-4000	4000	2455
chr2	12738734	12746734	12741368	8000	12742734	-4000	4000	-1366
chr2	64088652	64096652	64094682	8000	64092652	-4000	4000	2030
chr2	69453997	69461997	69460482	8000	69457997	-4000	4000	2485
chr2	108261351	108269351	108264998	8000	108265351	-4000	4000	-353
chr2	127857630	127865630	127864009	8000	127861630	-4000	4000	2379
chr2	176115937	176123937	176117512	8000	176119937	-4000	4000	-2425
chr2	176169102	176177102	176172403	8000	176173102	-4000	4000	-699
chr2	68393453	68401453	68394118	8000	68397453	-4000	4000	-3335
chr2	189008746	189016746	189009173	8000	189012746	-4000	4000	-3573
chr2	96701929	96709929	96702722	8000	96705929	-4000	4000	-3207
chr2	25922598	25930598	25928037	8000	25926598	-4000	4000	1439
chr2	8680461	8688461	8682419	8000	8684461	-4000	4000	-2042
chr2	172085677	172093677	172086680	8000	172089677	-4000	4000	-2997
chr2	10779391	10787391	10784391	8000	10783391	-4000	4000	1000
chr2	96701929	96709929	96703209	8000	96705929	-4000	4000	-2720
chr2	218629329	218637329	218632247	8000	218633329	-4000	4000	-1082
chr2	236578354	236586354	236580963	8000	236582354	-4000	4000	-1391
chr2	15943007	15951007	15945903	8000	15947007	-4000	4000	-1104
chr2	85541281	85549281	85542369	8000	85545281	-4000	4000	-2912
chr2	127634381	127642381	127639127	8000	127638381	-4000	4000	746
chr2	186505361	186513361	186505788	8000	186509361	-4000	4000	-3573
chr2	72171984	72179984	72179360	8000	72175984	-4000	4000	3376
chr2	129978738	129986738	129980065	8000	129982738	-4000	4000	-2673
chr2	206110817	206118817	206116379	8000	206114817	-4000	4000	1562
chr2	238166402	238174402	238167377	8000	238170402	-4000	4000	-3025
chr2	178427292	178435292	178432077	8000	178431292	-4000	4000	785
chr2	85833120	85841120	85840473	8000	85837120	-4000	4000	3353
chr2	218751416	218759416	218752809	8000	218755416	-4000	4000	-2607
chr2	118838171	118846171	118843011	8000	118842171	-4000	4000	840
chr2	127634381	127642381	127637398	8000	127638381	-4000	4000	-983
chr2	127634381	127642381	127637399	8000	127638381	-4000	4000	-982
chr2	190199484	190207484	190203219	8000	190203484	-4000	4000	-265
chr2	238240044	238248044	238244371	8000	238244044	-4000	4000	327
chr2	85387752	85395752	85389749	8000	85391752	-4000	4000	-2003
chr2	71075808	71083808	71076633	8000	71079808	-4000	4000	-3175
chr2	170651171	170659171	170653032	8000	170655171	-4000	4000	-2139
chr2	171481052	171489052	171481066	8000	171485052	-4000	4000	-3986
chr2	43882224	43890224	43888460	8000	43886224	-4000	4000	2236
chr2	12738734	12746734	12740712	8000	12742734	-4000	4000	-2022
chr2	27126812	27134812	27133296	8000	27130812	-4000	4000	2484
chr2	27578720	27586720	27579653	8000	27582720	-4000	4000	-3067
chr2	37197612	37205612	37201684	8000	37201612	-4000	4000	72
chr2	37249403	37257403	37256791	8000	37253403	-4000	4000	3388
chr2	84817650	84825650	84823970	8000	84821650	-4000	4000	2320
chr2	95180317	95188317	95182324	8000	95184317	-4000	4000	-1993
chr2	97651939	97659939	97657488	8000	97655939	-4000	4000	1549
chr2	177544998	177552998	177552181	8000	177548998	-4000	4000	3183
chr2	205794133	205802133	205795022	8000	205798133	-4000	4000	-3111
chr2	215356440	215364440	215361587	8000	215360440	-4000	4000	1147
chr2	218270197	218278197	218272620	8000	218274197	-4000	4000	-1577
chr2	218446251	218454251	218449276	8000	218450251	-4000	4000	-975
chr2	230817075	230825075	230818950	8000	230821075	-4000	4000	-2125
chr2	24939636	24947636	24944613	8000	24943636	-4000	4000	977
chr2	70291975	70299975	70297307	8000	70295975	-4000	4000	1332
chr2	95382077	95390077	95385787	8000	95386077	-4000	4000	-290
chr2	96701929	96709929	96704491	8000	96705929	-4000	4000	-1438
chr2	106089308	106097308	106096739	8000	106093308	-4000	4000	3431
chr2	134955342	134963342	134956790	8000	134959342	-4000	4000	-2552
chr2	171779405	171787405	171785392	8000	171783405	-4000	4000	1987
chr2	174794809	174802809	174799939	8000	174798809	-4000	4000	1130
chr2	177619244	177627244	177626217	8000	177623244	-4000	4000	2973
chr2	219534954	219542954	219541675	8000	219538954	-4000	4000	2721
chr2	189556590	189564590	189563865	8000	189560590	-4000	4000	3275
chr2	164488417	164496417	164492885	8000	164492417	-4000	4000	468
chr2	179437982	179445982	179443364	8000	179441982	-4000	4000	1382
chr2	190199484	190207484	190205129	8000	190203484	-4000	4000	1645
chr2	10910225	10918225	10912738	8000	10914225	-4000	4000	-1487
chr2	97651939	97659939	97658433	8000	97655939	-4000	4000	2494
chr2	55541079	55549079	55548842	8000	55545079	-4000	4000	3763
chr2	27578720	27586720	27582028	8000	27582720	-4000	4000	-692
chr2	165388310	165396310	165389265	8000	165392310	-4000	4000	-3045
chr2	197704395	197712395	197706828	8000	197708395	-4000	4000	-1567
chr2	10910225	10918225	10913236	8000	10914225	-4000	4000	-989
chr2	62496218	62504218	62501196	8000	62500218	-4000	4000	978
chr2	62496218	62504218	62501412	8000	62500218	-4000	4000	1194
chr2	68280171	68288171	68284433	8000	68284171	-4000	4000	262
chr2	100992829	101000829	100995646	8000	100996829	-4000	4000	-1183
chr2	102707355	102715355	102708356	8000	102711355	-4000	4000	-2999
chr2	118106997	118114997	118107118	8000	118110997	-4000	4000	-3879
chr2	157410619	157418619	157415632	8000	157414619	-4000	4000	1013
chr2	176115937	176123937	176116920	8000	176119937	-4000	4000	-3017
chr2	189742660	189750660	189750621	8000	189746660	-4000	4000	3961
chr2	206310427	206318427	206310640	8000	206314427	-4000	4000	-3787
chr2	206310427	206318427	206311620	8000	206314427	-4000	4000	-2807
chr2	227813564	227821564	227817285	8000	227817564	-4000	4000	-279
chr2	69956089	69964089	69960704	8000	69960089	-4000	4000	615
chr2	69956089	69964089	69961051	8000	69960089	-4000	4000	962
chr2	88552741	88560741	88557823	8000	88556741	-4000	4000	1082
chr2	159314979	159322979	159320345	8000	159318979	-4000	4000	1366
chr2	190367665	190375665	190371354	8000	190371665	-4000	4000	-311
chr2	219246337	219254337	219251226	8000	219250337	-4000	4000	889
chr2	15943007	15951007	15945984	8000	15947007	-4000	4000	-1023
chr2	18551545	18559545	18555545	8000	18555545	-4000	4000	0
chr2	24025347	24033347	24029934	8000	24029347	-4000	4000	587
chr2	25155135	25163135	25161562	8000	25159135	-4000	4000	2427
chr2	26186635	26194635	26188270	8000	26190635	-4000	4000	-2365
chr2	36547135	36555135	36549738	8000	36551135	-4000	4000	-1397
chr2	38289954	38297954	38296689	8000	38293954	-4000	4000	2735
chr2	74679853	74687853	74681897	8000	74683853	-4000	4000	-1956
chr2	86209790	86217790	86210633	8000	86213790	-4000	4000	-3157
chr2	86209790	86217790	86214094	8000	86213790	-4000	4000	304
chr2	109538799	109546799	109546222	8000	109542799	-4000	4000	3423
chr2	127697027	127705027	127703102	8000	127701027	-4000	4000	2075
chr2	127697027	127705027	127704285	8000	127701027	-4000	4000	3258
chr2	127697027	127705027	127704574	8000	127701027	-4000	4000	3547
chr2	127857630	127865630	127864204	8000	127861630	-4000	4000	2574
chr2	127857630	127865630	127864458	8000	127861630	-4000	4000	2828
chr2	127857630	127865630	127865181	8000	127861630	-4000	4000	3551
chr2	129978738	129986738	129981041	8000	129982738	-4000	4000	-1697
chr2	134955342	134963342	134956191	8000	134959342	-4000	4000	-3151
chr2	134955342	134963342	134956740	8000	134959342	-4000	4000	-2602
chr2	134955342	134963342	134956925	8000	134959342	-4000	4000	-2417
chr2	135781056	135789056	135784600	8000	135785056	-4000	4000	-456
chr2	165388310	165396310	165390547	8000	165392310	-4000	4000	-1763
chr2	175068250	175076250	175074628	8000	175072250	-4000	4000	2378
chr2	190199484	190207484	190202643	8000	190203484	-4000	4000	-841
chr2	229353629	229361629	229358287	8000	229357629	-4000	4000	658
chr2	236578354	236586354	236580879	8000	236582354	-4000	4000	-1475
chr2	240613705	240621705	240617391	8000	240617705	-4000	4000	-314
chr2	241669857	241677857	241672110	8000	241673857	-4000	4000	-1747
chr2	9401683	9409683	9406845	8000	9405683	-4000	4000	1162
chr2	42054517	42062517	42055317	8000	42058517	-4000	4000	-3200
chr2	60446520	60454520	60452455	8000	60450520	-4000	4000	1935
chr2	61820848	61828848	61826565	8000	61824848	-4000	4000	1717
chr2	74104176	74112176	74105893	8000	74108176	-4000	4000	-2283
chr2	113639396	113647396	113642238	8000	113643396	-4000	4000	-1158
chr2	118990660	118998660	118994423	8000	118994660	-4000	4000	-237
chr2	127701242	127709242	127708809	8000	127705242	-4000	4000	3567
chr2	150464195	150472195	150470188	8000	150468195	-4000	4000	1993
chr2	160095667	160103667	160101759	8000	160099667	-4000	4000	2092
chr2	169521922	169529922	169529797	8000	169525922	-4000	4000	3875
chr2	171779405	171787405	171785440	8000	171783405	-4000	4000	2035
chr2	218446251	218454251	218449292	8000	218450251	-4000	4000	-959
chr2	241490841	241498841	241498618	8000	241494841	-4000	4000	3777
chr2	86209790	86217790	86216886	8000	86213790	-4000	4000	3096
chr2	214721646	214729646	214728871	8000	214725646	-4000	4000	3225
chr2	157410619	157418619	157415916	8000	157414619	-4000	4000	1297
chr2	72171984	72179984	72179409	8000	72175984	-4000	4000	3425
chr2	229353629	229361629	229358440	8000	229357629	-4000	4000	811
chr2	96373091	96381091	96373488	8000	96377091	-4000	4000	-3603
chr2	110118311	110126311	110125679	8000	110122311	-4000	4000	3368
chr2	218811293	218819293	218813048	8000	218815293	-4000	4000	-2245
chr2	162166684	162174684	162173201	8000	162170684	-4000	4000	2517
chr2	226995215	227003215	226995523	8000	226999215	-4000	4000	-3692
chr2	84817650	84825650	84824041	8000	84821650	-4000	4000	2391
chr2	88023205	88031205	88028527	8000	88027205	-4000	4000	1322
chr2	74679853	74687853	74679862	8000	74683853	-4000	4000	-3991
chr2	147926396	147934396	147927677	8000	147930396	-4000	4000	-2719
chr2	27578720	27586720	27581609	8000	27582720	-4000	4000	-1111
chr2	206110817	206118817	206116082	8000	206114817	-4000	4000	1265
chr2	203869965	203877965	203872726	8000	203873965	-4000	4000	-1239
chr2	112537739	112545739	112542384	8000	112541739	-4000	4000	645
chr2	130135287	130143287	130141266	8000	130139287	-4000	4000	1979
chr2	135721270	135729270	135725199	8000	135725270	-4000	4000	-71
chr2	118106997	118114997	118107111	8000	118110997	-4000	4000	-3886
chr2	181926738	181934738	181929566	8000	181930738	-4000	4000	-1172
chr2	206171316	206179316	206176528	8000	206175316	-4000	4000	1212
chr2	86488716	86496716	86490992	8000	86492716	-4000	4000	-1724
chr2	165388310	165396310	165389087	8000	165392310	-4000	4000	-3223
chr2	44942071	44950071	44942771	8000	44946071	-4000	4000	-3300
chr2	178458102	178466102	178458525	8000	178462102	-4000	4000	-3577
chr2	178458102	178466102	178460383	8000	178462102	-4000	4000	-1719
chr2	27578720	27586720	27579146	8000	27582720	-4000	4000	-3574
chr2	32220453	32228453	32220618	8000	32224453	-4000	4000	-3835
chr2	75686851	75694851	75687977	8000	75690851	-4000	4000	-2874
chr2	86488716	86496716	86489434	8000	86492716	-4000	4000	-3282
chr2	201081750	201089750	201085598	8000	201085750	-4000	4000	-152
chr2	131529666	131537666	131532696	8000	131533666	-4000	4000	-970
chr2	54968025	54976025	54972946	8000	54972025	-4000	4000	921
chr2	62143247	62151247	62146838	8000	62147247	-4000	4000	-409
chr2	32153637	32161637	32154456	8000	32157637	-4000	4000	-3181
chr2	174743592	174751592	174748634	8000	174747592	-4000	4000	1042
chr2	9401683	9409683	9407083	8000	9405683	-4000	4000	1400
chr2	143764352	143772352	143768112	8000	143768352	-4000	4000	-240
chr2	9492543	9500543	9493817	8000	9496543	-4000	4000	-2726
chr2	84815589	84823589	84821839	8000	84819589	-4000	4000	2250
chr2	19347485	19355485	19351638	8000	19351485	-4000	4000	153
chr2	27578720	27586720	27581252	8000	27582720	-4000	4000	-1468
chr2	182829275	182837275	182834751	8000	182833275	-4000	4000	1476
chr2	165388310	165396310	165389540	8000	165392310	-4000	4000	-2770
chr2	101890690	101898690	101891719	8000	101894690	-4000	4000	-2971
chr2	143764352	143772352	143768197	8000	143768352	-4000	4000	-155
chr2	105353712	105361712	105361355	8000	105357712	-4000	4000	3643
chr2	74529332	74537332	74535676	8000	74533332	-4000	4000	2344
chr2	189556590	189564590	189563875	8000	189560590	-4000	4000	3285
chr2	69956089	69964089	69961165	8000	69960089	-4000	4000	1076
chr2	85694852	85702852	85695332	8000	85698852	-4000	4000	-3520
chr2	119298225	119306225	119302540	8000	119302225	-4000	4000	315
chr2	176128695	176136695	176131549	8000	176132695	-4000	4000	-1146
chr2	49914503	49922503	49922234	8000	49918503	-4000	4000	3731
chr2	206617127	206625127	206617610	8000	206621127	-4000	4000	-3517
chr2	95180317	95188317	95181806	8000	95184317	-4000	4000	-2511
chr2	101266316	101274316	101269323	8000	101270316	-4000	4000	-993
chr2	143764352	143772352	143768025	8000	143768352	-4000	4000	-327
chr2	241813413	241821413	241816221	8000	241817413	-4000	4000	-1192
chr2	38958206	38966206	38966129	8000	38962206	-4000	4000	3923
chr2	20196797	20204797	20202780	8000	20200797	-4000	4000	1983
chr2	179437982	179445982	179443244	8000	179441982	-4000	4000	1262
chr2	186761959	186769959	186762606	8000	186765959	-4000	4000	-3353
chr2	218593080	218601080	218593830	8000	218597080	-4000	4000	-3250
chr2	191830310	191838310	191836560	8000	191834310	-4000	4000	2250
chr2	95180317	95188317	95181385	8000	95184317	-4000	4000	-2932
chr2	119261652	119269652	119263082	8000	119265652	-4000	4000	-2570
chr2	130135287	130143287	130141179	8000	130139287	-4000	4000	1892
chr2	181534940	181542940	181539105	8000	181538940	-4000	4000	165
chr2	189873629	189881629	189877340	8000	189877629	-4000	4000	-289
chr2	219167897	219175897	219173441	8000	219171897	-4000	4000	1544
chr2	173264015	173272015	173266565	8000	173268015	-4000	4000	-1450
chr2	186505361	186513361	186505816	8000	186509361	-4000	4000	-3545
chr2	219489629	219497629	219492156	8000	219493629	-4000	4000	-1473
chr2	174344022	174352022	174348613	8000	174348022	-4000	4000	591
chr2	10052473	10060473	10052629	8000	10056473	-4000	4000	-3844
chr2	46183990	46191990	46186236	8000	46187990	-4000	4000	-1754
chr2	46382697	46390697	46386450	8000	46386697	-4000	4000	-247
chr2	54968025	54976025	54972256	8000	54972025	-4000	4000	231
chr2	85589406	85597406	85591736	8000	85593406	-4000	4000	-1670
chr2	85833120	85841120	85840391	8000	85837120	-4000	4000	3271
chr2	189008746	189016746	189009220	8000	189012746	-4000	4000	-3526
chr2	210018260	210026260	210019757	8000	210022260	-4000	4000	-2503
chr2	214406501	214414501	214414266	8000	214410501	-4000	4000	3765
chr2	63042487	63050487	63045672	8000	63046487	-4000	4000	-815
chr2	186761959	186769959	186762083	8000	186765959	-4000	4000	-3876
chr2	101020032	101028032	101021720	8000	101024032	-4000	4000	-2312
chr2	218342793	218350793	218346583	8000	218346793	-4000	4000	-210
chr2	112659825	112667825	112663529	8000	112663825	-4000	4000	-296
chr2	214721646	214729646	214728650	8000	214725646	-4000	4000	3004
chr2	169521922	169529922	169525637	8000	169525922	-4000	4000	-285
chr2	215938584	215946584	215944787	8000	215942584	-4000	4000	2203
chr2	85541281	85549281	85542256	8000	85545281	-4000	4000	-3025
chr2	112184218	112192218	112187460	8000	112188218	-4000	4000	-758
chr2	24073433	24081433	24081014	8000	24077433	-4000	4000	3581
chr2	165388310	165396310	165389674	8000	165392310	-4000	4000	-2636
chr2	127044027	127052027	127048601	8000	127048027	-4000	4000	574
chr2	173364997	173372997	173365545	8000	173368997	-4000	4000	-3452
chr2	105260391	105268391	105267416	8000	105264391	-4000	4000	3025
chr2	37637882	37645882	37645629	8000	37641882	-4000	4000	3747
chr2	206310427	206318427	206311212	8000	206314427	-4000	4000	-3215
chr2	230309215	230317215	230312702	8000	230313215	-4000	4000	-513
chr2	1539711	1547711	1542619	8000	1543711	-4000	4000	-1092
chr2	10207725	10215725	10210333	8000	10211725	-4000	4000	-1392
chr2	19347485	19355485	19353334	8000	19351485	-4000	4000	1849
chr2	24073433	24081433	24079462	8000	24077433	-4000	4000	2029
chr2	24198864	24206864	24204378	8000	24202864	-4000	4000	1514
chr2	27126812	27134812	27133200	8000	27130812	-4000	4000	2388
chr2	27305492	27313492	27309931	8000	27309492	-4000	4000	439
chr2	27442481	27450481	27449734	8000	27446481	-4000	4000	3253
chr2	27578720	27586720	27581597	8000	27582720	-4000	4000	-1123
chr2	27578720	27586720	27582362	8000	27582720	-4000	4000	-358
chr2	36547135	36555135	36553042	8000	36551135	-4000	4000	1907
chr2	38063142	38071142	38070998	8000	38067142	-4000	4000	3856
chr2	38289954	38297954	38296087	8000	38293954	-4000	4000	2133
chr2	47806063	47814063	47806650	8000	47810063	-4000	4000	-3413
chr2	49914503	49922503	49922227	8000	49918503	-4000	4000	3724
chr2	61047990	61055990	61048672	8000	61051990	-4000	4000	-3318
chr2	67408089	67416089	67410137	8000	67412089	-4000	4000	-1952
chr2	68172238	68180238	68174791	8000	68176238	-4000	4000	-1447
chr2	69392113	69400113	69396253	8000	69396113	-4000	4000	140
chr2	70291975	70299975	70293647	8000	70295975	-4000	4000	-2328
chr2	71075808	71083808	71078379	8000	71079808	-4000	4000	-1429
chr2	74514131	74522131	74515651	8000	74518131	-4000	4000	-2480
chr2	74553883	74561883	74554797	8000	74557883	-4000	4000	-3086
chr2	87751960	87759960	87756862	8000	87755960	-4000	4000	902
chr2	96326517	96334517	96327222	8000	96330517	-4000	4000	-3295
chr2	96701929	96709929	96704293	8000	96705929	-4000	4000	-1636
chr2	99397326	99405326	99399333	8000	99401326	-4000	4000	-1993
chr2	109538799	109546799	109546073	8000	109542799	-4000	4000	3274
chr2	120988653	120996653	120990451	8000	120992653	-4000	4000	-2202
chr2	130135287	130143287	130140020	8000	130139287	-4000	4000	733
chr2	130147392	130155392	130153139	8000	130151392	-4000	4000	1747
chr2	136110349	136118349	136115730	8000	136114349	-4000	4000	1381
chr2	156320437	156328437	156325679	8000	156324437	-4000	4000	1242
chr2	159767851	159775851	159771874	8000	159771851	-4000	4000	23
chr2	162367595	162375595	162371995	8000	162371595	-4000	4000	400
chr2	168861514	168869514	168862008	8000	168865514	-4000	4000	-3506
chr2	169808064	169816064	169808871	8000	169812064	-4000	4000	-3193
chr2	171554129	171562129	171554753	8000	171558129	-4000	4000	-3376
chr2	174427571	174435571	174427983	8000	174431571	-4000	4000	-3588
chr2	175068250	175076250	175074821	8000	175072250	-4000	4000	2571
chr2	189008746	189016746	189010278	8000	189012746	-4000	4000	-2468
chr2	189008746	189016746	189011926	8000	189012746	-4000	4000	-820
chr2	189471552	189479552	189475358	8000	189475552	-4000	4000	-194
chr2	191025576	191033576	191029608	8000	191029576	-4000	4000	32
chr2	191025576	191033576	191031474	8000	191029576	-4000	4000	1898
chr2	197546726	197554726	197550722	8000	197550726	-4000	4000	-4
chr2	197564224	197572224	197572172	8000	197568224	-4000	4000	3948
chr2	202034441	202042441	202036143	8000	202038441	-4000	4000	-2298
chr2	203390345	203398345	203391100	8000	203394345	-4000	4000	-3245
chr2	203443728	203451728	203448812	8000	203447728	-4000	4000	1084
chr2	208232229	208240229	208239212	8000	208236229	-4000	4000	2983
chr2	214406501	214414501	214414193	8000	214410501	-4000	4000	3692
chr2	216479053	216487053	216482785	8000	216483053	-4000	4000	-268
chr2	218270197	218278197	218272570	8000	218274197	-4000	4000	-1627
chr2	219205651	219213651	219213255	8000	219209651	-4000	4000	3604
chr2	230399732	230407732	230401341	8000	230403732	-4000	4000	-2391
chr2	230399732	230407732	230402954	8000	230403732	-4000	4000	-778
chr2	231169116	231177116	231170659	8000	231173116	-4000	4000	-2457
chr2	236578354	236586354	236580564	8000	236582354	-4000	4000	-1790
chr2	240613705	240621705	240616420	8000	240617705	-4000	4000	-1285
chr2	171554129	171562129	171554839	8000	171558129	-4000	4000	-3290
chr2	200849009	200857009	200853945	8000	200853009	-4000	4000	936
chr2	200849009	200857009	200853946	8000	200853009	-4000	4000	937
chr2	20244691	20252691	20250378	8000	20248691	-4000	4000	1687
chr2	96326517	96334517	96327950	8000	96330517	-4000	4000	-2567
chr2	169806081	169814081	169807039	8000	169810081	-4000	4000	-3042
chr2	219489629	219497629	219490892	8000	219493629	-4000	4000	-2737
chr2	9401683	9409683	9404913	8000	9405683	-4000	4000	-770
chr2	53860069	53868069	53865013	8000	53864069	-4000	4000	944
chr2	85787383	85795383	85787899	8000	85791383	-4000	4000	-3484
chr2	230399732	230407732	230400361	8000	230403732	-4000	4000	-3371
chr2	71682763	71690763	71686486	8000	71686763	-4000	4000	-277
chr2	189742660	189750660	189746471	8000	189746660	-4000	4000	-189
chr2	70826211	70834211	70832999	8000	70830211	-4000	4000	2788
chr2	223592940	223600940	223597518	8000	223596940	-4000	4000	578
chr2	15162914	15170914	15166979	8000	15166914	-4000	4000	65
chr2	45001182	45009182	45008980	8000	45005182	-4000	4000	3798
chr2	74553883	74561883	74556793	8000	74557883	-4000	4000	-1090
chr2	48511391	48519391	48514722	8000	48515391	-4000	4000	-669
chr2	177219958	177227958	177220304	8000	177223958	-4000	4000	-3654
chr2	241102099	241110099	241106715	8000	241106099	-4000	4000	616
chr2	1627887	1635887	1633908	8000	1631887	-4000	4000	2021
chr2	74104176	74112176	74105627	8000	74108176	-4000	4000	-2549
chr2	233291674	233299674	233295406	8000	233295674	-4000	4000	-268
chr2	230309215	230317215	230311561	8000	230313215	-4000	4000	-1654
chr2	9469101	9477101	9471389	8000	9473101	-4000	4000	-1712
chr2	10910225	10918225	10913741	8000	10914225	-4000	4000	-484
chr2	11440375	11448375	11447732	8000	11444375	-4000	4000	3357
chr2	12738734	12746734	12740619	8000	12742734	-4000	4000	-2115
chr2	19347485	19355485	19353208	8000	19351485	-4000	4000	1723
chr2	23744664	23752664	23751920	8000	23748664	-4000	4000	3256
chr2	26946351	26954351	26946951	8000	26950351	-4000	4000	-3400
chr2	27440377	27448377	27445825	8000	27444377	-4000	4000	1448
chr2	27578720	27586720	27578975	8000	27582720	-4000	4000	-3745
chr2	27578720	27586720	27579272	8000	27582720	-4000	4000	-3448
chr2	27578720	27586720	27580902	8000	27582720	-4000	4000	-1818
chr2	27621638	27629638	27627325	8000	27625638	-4000	4000	1687
chr2	38793729	38801729	38798129	8000	38797729	-4000	4000	400
chr2	39713963	39721963	39717331	8000	39717963	-4000	4000	-632
chr2	43882224	43890224	43888604	8000	43886224	-4000	4000	2380
chr2	44312281	44320281	44314053	8000	44316281	-4000	4000	-2228
chr2	47383601	47391601	47386687	8000	47387601	-4000	4000	-914
chr2	61820848	61828848	61826570	8000	61824848	-4000	4000	1722
chr2	63053836	63061836	63054067	8000	63057836	-4000	4000	-3769
chr2	65267253	65275253	65268730	8000	65271253	-4000	4000	-2523
chr2	74522645	74530645	74522766	8000	74526645	-4000	4000	-3879
chr2	84815589	84823589	84821881	8000	84819589	-4000	4000	2292
chr2	85578031	85586031	85581746	8000	85582031	-4000	4000	-285
chr2	85694852	85702852	85698665	8000	85698852	-4000	4000	-187
chr2	98614515	98622515	98616210	8000	98618515	-4000	4000	-2305
chr2	98614515	98622515	98621548	8000	98618515	-4000	4000	3033
chr2	99157427	99165427	99162149	8000	99161427	-4000	4000	722
chr2	101266316	101274316	101269471	8000	101270316	-4000	4000	-845
chr2	101890690	101898690	101891618	8000	101894690	-4000	4000	-3072
chr2	102024544	102032544	102024695	8000	102028544	-4000	4000	-3849
chr2	102175874	102183874	102176753	8000	102179874	-4000	4000	-3121
chr2	108305915	108313915	108308545	8000	108309915	-4000	4000	-1370
chr2	112659825	112667825	112663036	8000	112663825	-4000	4000	-789
chr2	112825751	112833751	112830275	8000	112829751	-4000	4000	524
chr2	117828377	117836377	117829390	8000	117832377	-4000	4000	-2987
chr2	119368550	119376550	119372300	8000	119372550	-4000	4000	-250
chr2	120290710	120298710	120293179	8000	120294710	-4000	4000	-1531
chr2	120988653	120996653	120990450	8000	120992653	-4000	4000	-2203
chr2	127179832	127187832	127187178	8000	127183832	-4000	4000	3346
chr2	129978738	129986738	129980790	8000	129982738	-4000	4000	-1948
chr2	130187745	130195745	130193954	8000	130191745	-4000	4000	2209
chr2	132639286	132647286	132645368	8000	132643286	-4000	4000	2082
chr2	136110349	136118349	136115324	8000	136114349	-4000	4000	975
chr2	150464195	150472195	150470196	8000	150468195	-4000	4000	2001
chr2	151266470	151274470	151271722	8000	151270470	-4000	4000	1252
chr2	158167073	158175073	158172220	8000	158171073	-4000	4000	1147
chr2	166399573	166407573	166405507	8000	166403573	-4000	4000	1934
chr2	169808064	169816064	169810282	8000	169812064	-4000	4000	-1782
chr2	172078430	172086430	172080340	8000	172082430	-4000	4000	-2090
chr2	174794809	174802809	174800269	8000	174798809	-4000	4000	1460
chr2	177544998	177552998	177551507	8000	177548998	-4000	4000	2509
chr2	178427292	178435292	178432079	8000	178431292	-4000	4000	787
chr2	186761959	186769959	186762735	8000	186765959	-4000	4000	-3224
chr2	189666831	189674831	189667825	8000	189670831	-4000	4000	-3006
chr2	189666831	189674831	189670620	8000	189670831	-4000	4000	-211
chr2	190199484	190207484	190200263	8000	190203484	-4000	4000	-3221
chr2	190199484	190207484	190204941	8000	190203484	-4000	4000	1457
chr2	203734912	203742912	203735069	8000	203738912	-4000	4000	-3843
chr2	206310427	206318427	206311574	8000	206314427	-4000	4000	-2853
chr2	214406501	214414501	214414392	8000	214410501	-4000	4000	3891
chr2	218250356	218258356	218254104	8000	218254356	-4000	4000	-252
chr2	218698716	218706716	218702141	8000	218702716	-4000	4000	-575
chr2	219167897	219175897	219174852	8000	219171897	-4000	4000	2955
chr2	227813564	227821564	227813896	8000	227817564	-4000	4000	-3668
chr2	230875248	230883248	230875641	8000	230879248	-4000	4000	-3607
chr2	233769300	233777300	233772637	8000	233773300	-4000	4000	-663
chr2	236578354	236586354	236580483	8000	236582354	-4000	4000	-1871
chr2	238396897	238404897	238398909	8000	238400897	-4000	4000	-1988
chr2	9401683	9409683	9406944	8000	9405683	-4000	4000	1261
chr2	16545459	16553459	16552899	8000	16549459	-4000	4000	3440
chr2	27690976	27698976	27694645	8000	27694976	-4000	4000	-331
chr2	38289954	38297954	38296701	8000	38293954	-4000	4000	2747
chr2	62496218	62504218	62501134	8000	62500218	-4000	4000	916
chr2	86780610	86788610	86788551	8000	86784610	-4000	4000	3941
chr2	200484958	200492958	200490351	8000	200488958	-4000	4000	1393
chr2	240613705	240621705	240617022	8000	240617705	-4000	4000	-683
chr2	9469101	9477101	9472931	8000	9473101	-4000	4000	-170
chr2	70961373	70969373	70964437	8000	70965373	-4000	4000	-936
chr2	235051714	235059714	235054154	8000	235055714	-4000	4000	-1560
chr2	191830310	191838310	191836655	8000	191834310	-4000	4000	2345
chr2	64088652	64096652	64094803	8000	64092652	-4000	4000	2151
chr2	97735862	97743862	97738041	8000	97739862	-4000	4000	-1821
chr2	105095960	105103960	105097303	8000	105099960	-4000	4000	-2657
chr2	206310427	206318427	206311057	8000	206314427	-4000	4000	-3370
chr2	130069535	130077535	130075262	8000	130073535	-4000	4000	1727
chr2	190199484	190207484	190205229	8000	190203484	-4000	4000	1745
chr2	72938036	72946036	72943590	8000	72942036	-4000	4000	1554
chr2	154854354	154862354	154854765	8000	154858354	-4000	4000	-3589
chr2	112659825	112667825	112663068	8000	112663825	-4000	4000	-757
chr2	86488716	86496716	86490997	8000	86492716	-4000	4000	-1719
chr2	101266316	101274316	101269580	8000	101270316	-4000	4000	-736
chr2	209730118	209738118	209731472	8000	209734118	-4000	4000	-2646
chr2	199265500	199273500	199272560	8000	199269500	-4000	4000	3060
chr2	219232679	219240679	219237940	8000	219236679	-4000	4000	1261
chr2	219167897	219175897	219175624	8000	219171897	-4000	4000	3727
chr2	231728433	231736433	231732996	8000	231732433	-4000	4000	563
chr2	74553883	74561883	74556597	8000	74557883	-4000	4000	-1286
chr2	189556590	189564590	189562024	8000	189560590	-4000	4000	1434
chr2	96017946	96025946	96023054	8000	96021946	-4000	4000	1108
chr2	72125238	72133238	72133205	8000	72129238	-4000	4000	3967
chr2	200904977	200912977	200911387	8000	200908977	-4000	4000	2410
chr2	219282898	219290898	219290559	8000	219286898	-4000	4000	3661
chr2	197482584	197490584	197489133	8000	197486584	-4000	4000	2549
chr2	97735862	97743862	97738040	8000	97739862	-4000	4000	-1822
chr2	199924913	199932913	199925845	8000	199928913	-4000	4000	-3068
chr2	232475827	232483827	232482606	8000	232479827	-4000	4000	2779
chr2	237551322	237559322	237552404	8000	237555322	-4000	4000	-2918
chr2	38062973	38070973	38067926	8000	38066973	-4000	4000	953
chr2	159228659	159236659	159230902	8000	159232659	-4000	4000	-1757
chr2	85387752	85395752	85390230	8000	85391752	-4000	4000	-1522
chr2	241845884	241853884	241851118	8000	241849884	-4000	4000	1234
chr2	67408089	67416089	67410122	8000	67412089	-4000	4000	-1967
chr2	38793729	38801729	38798369	8000	38797729	-4000	4000	640
chr2	219534954	219542954	219541058	8000	219538954	-4000	4000	2104
chr2	140227423	140235423	140233268	8000	140231423	-4000	4000	1845
chr2	219571711	219579711	219572507	8000	219575711	-4000	4000	-3204
chr2	65083004	65091004	65088362	8000	65087004	-4000	4000	1358
chr2	71075808	71083808	71078558	8000	71079808	-4000	4000	-1250
chr2	74148528	74156528	74156512	8000	74152528	-4000	4000	3984
chr2	96326517	96334517	96328176	8000	96330517	-4000	4000	-2341
chr2	173264015	173272015	173266840	8000	173268015	-4000	4000	-1175
chr2	190505205	190513205	190510407	8000	190509205	-4000	4000	1202
chr2	39713963	39721963	39717398	8000	39717963	-4000	4000	-565
chr2	74553883	74561883	74556693	8000	74557883	-4000	4000	-1190
chr2	206310427	206318427	206311591	8000	206314427	-4000	4000	-2836
chr2	131356492	131364492	131363285	8000	131360492	-4000	4000	2793
chr2	112585275	112593275	112586009	8000	112589275	-4000	4000	-3266
chr2	11440375	11448375	11447672	8000	11444375	-4000	4000	3297
chr2	27239943	27247943	27242764	8000	27243943	-4000	4000	-1179
chr2	27377195	27385195	27383976	8000	27381195	-4000	4000	2781
chr2	47806063	47814063	47807147	8000	47810063	-4000	4000	-2916
chr2	74131400	74139400	74135517	8000	74135400	-4000	4000	117
chr2	99157427	99165427	99162809	8000	99161427	-4000	4000	1382
chr2	112732349	112740349	112738815	8000	112736349	-4000	4000	2466
chr2	118106997	118114997	118108316	8000	118110997	-4000	4000	-2681
chr2	136110349	136118349	136115555	8000	136114349	-4000	4000	1206
chr2	172095438	172103438	172101403	8000	172099438	-4000	4000	1965
chr2	199265500	199273500	199272341	8000	199269500	-4000	4000	2841
chr2	202299661	202307661	202303540	8000	202303661	-4000	4000	-121
chr2	206617127	206625127	206617737	8000	206621127	-4000	4000	-3390
chr2	218633184	218641184	218635869	8000	218637184	-4000	4000	-1315
chr2	219167897	219175897	219172977	8000	219171897	-4000	4000	1080
chr2	230009119	230017119	230011128	8000	230013119	-4000	4000	-1991
chr2	233769300	233777300	233772421	8000	233773300	-4000	4000	-879
chr2	118990660	118998660	118993200	8000	118994660	-4000	4000	-1460
chr2	101003228	101011228	101007972	8000	101007228	-4000	4000	744
chr2	164488417	164496417	164492885	8000	164492417	-4000	4000	468
chr2	12738734	12746734	12740511	8000	12742734	-4000	4000	-2223
chr2	70145885	70153885	70150430	8000	70149885	-4000	4000	545
chr2	71075808	71083808	71078345	8000	71079808	-4000	4000	-1463
chr2	96139169	96147169	96144341	8000	96143169	-4000	4000	1172
chr2	177544998	177552998	177552013	8000	177548998	-4000	4000	3015
chr2	169808064	169816064	169812319	8000	169812064	-4000	4000	255
chr2	161988245	161996245	161993362	8000	161992245	-4000	4000	1117
chr2	205794133	205802133	205797762	8000	205798133	-4000	4000	-371
chr2	126692667	126700667	126696163	8000	126696667	-4000	4000	-504
chr2	233769300	233777300	233772280	8000	233773300	-4000	4000	-1020
chr2	26946351	26954351	26947019	8000	26950351	-4000	4000	-3332
chr2	26946351	26954351	26947365	8000	26950351	-4000	4000	-2986
chr2	97752333	97760333	97759001	8000	97756333	-4000	4000	2668
chr2	37249403	37257403	37253207	8000	37253403	-4000	4000	-196
chr2	38289954	38297954	38296700	8000	38293954	-4000	4000	2746
chr2	68651862	68659862	68654918	8000	68655862	-4000	4000	-944
chr2	169092167	169100167	169095810	8000	169096167	-4000	4000	-357
chr2	31863809	31871809	31868487	8000	31867809	-4000	4000	678
chr2	55861967	55869967	55867107	8000	55865967	-4000	4000	1140
chr2	106387290	106395290	106387665	8000	106391290	-4000	4000	-3625
chr2	108781809	108789809	108788054	8000	108785809	-4000	4000	2245
chr2	219546595	219554595	219552178	8000	219550595	-4000	4000	1583
chr2	237809682	237817682	237817040	8000	237813682	-4000	4000	3358
chr2	25922598	25930598	25927129	8000	25926598	-4000	4000	531
chr2	101003228	101011228	101008021	8000	101007228	-4000	4000	793
chr2	130069535	130077535	130074258	8000	130073535	-4000	4000	723
chr2	101890690	101898690	101891272	8000	101894690	-4000	4000	-3418
chr2	216660436	216668436	216663770	8000	216664436	-4000	4000	-666
chr2	191830310	191838310	191836181	8000	191834310	-4000	4000	1871
chr2	227679763	227687763	227687232	8000	227683763	-4000	4000	3469
chr2	12738734	12746734	12740470	8000	12742734	-4000	4000	-2264
chr2	181531041	181539041	181534368	8000	181535041	-4000	4000	-673
chr2	190367665	190375665	190371312	8000	190371665	-4000	4000	-353
chr2	43763987	43771987	43765516	8000	43767987	-4000	4000	-2471
chr2	97699066	97707066	97702666	8000	97703066	-4000	4000	-400
chr2	106387290	106395290	106391317	8000	106391290	-4000	4000	27
chr2	10910225	10918225	10913425	8000	10914225	-4000	4000	-800
chr2	108781809	108789809	108783672	8000	108785809	-4000	4000	-2137
chr2	229759837	229767837	229767318	8000	229763837	-4000	4000	3481
chr2	74529332	74537332	74534561	8000	74533332	-4000	4000	1229
chr2	27619217	27627217	27626987	8000	27623217	-4000	4000	3770
chr2	101266316	101274316	101269619	8000	101270316	-4000	4000	-697
chr2	121722945	121730945	121730802	8000	121726945	-4000	4000	3857
chr2	189556590	189564590	189563796	8000	189560590	-4000	4000	3206
chr2	70291975	70299975	70296011	8000	70295975	-4000	4000	36
chr2	233203903	233211903	233204320	8000	233207903	-4000	4000	-3583
chr2	197482584	197490584	197487944	8000	197486584	-4000	4000	1360
chr2	10050836	10058836	10052454	8000	10054836	-4000	4000	-2382
chr2	106387290	106395290	106391063	8000	106391290	-4000	4000	-227
chr2	187460230	187468230	187467043	8000	187464230	-4000	4000	2813
chr2	25155135	25163135	25160982	8000	25159135	-4000	4000	1847
chr2	84817650	84825650	84823990	8000	84821650	-4000	4000	2340
chr2	210427249	210435249	210434446	8000	210431249	-4000	4000	3197
chr2	232475827	232483827	232482433	8000	232479827	-4000	4000	2606
chr2	73758184	73766184	73762742	8000	73762184	-4000	4000	558
chr2	232475827	232483827	232480751	8000	232479827	-4000	4000	924
chr2	203443728	203451728	203444942	8000	203447728	-4000	4000	-2786
chr2	49914503	49922503	49921993	8000	49918503	-4000	4000	3490
chr2	27442481	27450481	27450079	8000	27446481	-4000	4000	3598
chr2	135835626	135843626	135840836	8000	135839626	-4000	4000	1210
chr2	274283	282283	279771	8000	278283	-4000	4000	1488
chr2	55861967	55869967	55866762	8000	55865967	-4000	4000	795
chr2	136110349	136118349	136116194	8000	136114349	-4000	4000	1845
chr2	172085677	172093677	172088685	8000	172089677	-4000	4000	-992
chr2	219489629	219497629	219491796	8000	219493629	-4000	4000	-1833
chr2	233769300	233777300	233772400	8000	233773300	-4000	4000	-900
chr2	238166402	238174402	238170459	8000	238170402	-4000	4000	57
chr2	27578720	27586720	27579661	8000	27582720	-4000	4000	-3059
chr2	164488417	164496417	164492885	8000	164492417	-4000	4000	468
chr2	27037694	27045694	27040363	8000	27041694	-4000	4000	-1331
chr2	149022759	149030759	149026641	8000	149026759	-4000	4000	-118
chr2	98789846	98797846	98794411	8000	98793846	-4000	4000	565
chr2	174344022	174352022	174350706	8000	174348022	-4000	4000	2684
chr2	177544998	177552998	177552356	8000	177548998	-4000	4000	3358
chr2	206310427	206318427	206311275	8000	206314427	-4000	4000	-3152
chr2	215356440	215364440	215361569	8000	215360440	-4000	4000	1129
chr2	60446520	60454520	60452524	8000	60450520	-4000	4000	2004
chr2	201225406	201233406	201229333	8000	201229406	-4000	4000	-73
chr2	69956089	69964089	69960562	8000	69960089	-4000	4000	473
chr2	171779405	171787405	171785426	8000	171783405	-4000	4000	2021
chr2	33395509	33403509	33397174	8000	33399509	-4000	4000	-2335
chr2	72125238	72133238	72132380	8000	72129238	-4000	4000	3142
chr2	18551545	18559545	18555254	8000	18555545	-4000	4000	-291
chr2	9484486	9492486	9490215	8000	9488486	-4000	4000	1729
chr2	222940639	222948639	222941500	8000	222944639	-4000	4000	-3139
chr2	8680461	8688461	8682075	8000	8684461	-4000	4000	-2386
chr2	95180317	95188317	95181554	8000	95184317	-4000	4000	-2763
chr2	237320003	237328003	237324698	8000	237324003	-4000	4000	695
chr2	189008746	189016746	189010812	8000	189012746	-4000	4000	-1934
chr2	191421389	191429389	191423986	8000	191425389	-4000	4000	-1403
chr2	230399732	230407732	230403127	8000	230403732	-4000	4000	-605
chr2	219571711	219579711	219574874	8000	219575711	-4000	4000	-837
chr2	9401683	9409683	9407025	8000	9405683	-4000	4000	1342
chr2	152758396	152766396	152759797	8000	152762396	-4000	4000	-2599
chr2	172085677	172093677	172086870	8000	172089677	-4000	4000	-2807
chr2	74457057	74465057	74463474	8000	74461057	-4000	4000	2417
chr2	112115318	112123318	112116141	8000	112119318	-4000	4000	-3177
chr2	219232679	219240679	219239673	8000	219236679	-4000	4000	2994
chr2	183157680	183165680	183158287	8000	183161680	-4000	4000	-3393
chr2	176169102	176177102	176169372	8000	176173102	-4000	4000	-3730
chr2	191025576	191033576	191031503	8000	191029576	-4000	4000	1927
chr2	96017946	96025946	96023398	8000	96021946	-4000	4000	1452
chr2	230399732	230407732	230402923	8000	230403732	-4000	4000	-809
chr2	206310427	206318427	206311211	8000	206314427	-4000	4000	-3216
chr2	218870233	218878233	218871703	8000	218874233	-4000	4000	-2530
chr2	24073433	24081433	24081011	8000	24077433	-4000	4000	3578
chr2	64088652	64096652	64094982	8000	64092652	-4000	4000	2330
chr2	240561256	240569256	240561350	8000	240565256	-4000	4000	-3906
chr2	152112801	152120801	152120697	8000	152116801	-4000	4000	3896
chr2	157732251	157740251	157737385	8000	157736251	-4000	4000	1134
chr2	233769300	233777300	233772633	8000	233773300	-4000	4000	-667
chr2	230399732	230407732	230401049	8000	230403732	-4000	4000	-2683
chr2	39732060	39740060	39736844	8000	39736060	-4000	4000	784
chr2	130135287	130143287	130140020	8000	130139287	-4000	4000	733
chr2	219571711	219579711	219575266	8000	219575711	-4000	4000	-445
chr2	119261652	119269652	119263290	8000	119265652	-4000	4000	-2362
chr2	12738734	12746734	12740804	8000	12742734	-4000	4000	-1930
chr2	98595314	98603314	98600605	8000	98599314	-4000	4000	1291
chr2	232856605	232864605	232856888	8000	232860605	-4000	4000	-3717
chr2	27094889	27102889	27101172	8000	27098889	-4000	4000	2283
chr2	27377195	27385195	27383440	8000	27381195	-4000	4000	2245
chr2	27442481	27450481	27449563	8000	27446481	-4000	4000	3082
chr2	86780610	86788610	86785789	8000	86784610	-4000	4000	1179
chr2	96326517	96334517	96326917	8000	96330517	-4000	4000	-3600
chr2	102024544	102032544	102024639	8000	102028544	-4000	4000	-3905
chr2	102707355	102715355	102708370	8000	102711355	-4000	4000	-2985
chr2	149211262	149219262	149214836	8000	149215262	-4000	4000	-426
chr2	174427571	174435571	174427895	8000	174431571	-4000	4000	-3676
chr2	186761959	186769959	186762801	8000	186765959	-4000	4000	-3158
chr2	218342793	218350793	218344564	8000	218346793	-4000	4000	-2229
chr2	218751416	218759416	218751704	8000	218755416	-4000	4000	-3712
chr2	241091568	241099568	241097333	8000	241095568	-4000	4000	1765
chr2	96017946	96025946	96023332	8000	96021946	-4000	4000	1386
chr2	74501043	74509043	74507207	8000	74505043	-4000	4000	2164
chr2	36810794	36818794	36814447	8000	36814794	-4000	4000	-347
chr2	30156533	30164533	30158973	8000	30160533	-4000	4000	-1560
chr2	55283842	55291842	55288438	8000	55287842	-4000	4000	596
chr2	74966128	74974128	74969570	8000	74970128	-4000	4000	-558
chr2	189742660	189750660	189746415	8000	189746660	-4000	4000	-245
chr2	239044168	239052168	239050877	8000	239048168	-4000	4000	2709
chr2	161988245	161996245	161993077	8000	161992245	-4000	4000	832
chr2	189008746	189016746	189011851	8000	189012746	-4000	4000	-895
chr3	11259557	11267557	11259653	8000	11263557	-4000	4000	-3904
chr3	179232691	179240691	179234297	8000	179236691	-4000	4000	-2394
chr3	52690486	52698486	52696597	8000	52694486	-4000	4000	2111
chr3	182917629	182925629	182918280	8000	182921629	-4000	4000	-3349
chr3	14930571	14938571	14932722	8000	14934571	-4000	4000	-1849
chr3	33146043	33154043	33153616	8000	33150043	-4000	4000	3573
chr3	179232691	179240691	179234297	8000	179236691	-4000	4000	-2394
chr3	32992609	33000609	32996989	8000	32996609	-4000	4000	380
chr3	39259495	39267495	39265654	8000	39263495	-4000	4000	2159
chr3	196828647	196836647	196829146	8000	196832647	-4000	4000	-3501
chr3	186101668	186109668	186108464	8000	186105668	-4000	4000	2796
chr3	179232691	179240691	179234297	8000	179236691	-4000	4000	-2394
chr3	179232691	179240691	179234297	8000	179236691	-4000	4000	-2394
chr3	49353176	49361176	49360170	8000	49357176	-4000	4000	2994
chr3	69102092	69110092	69108878	8000	69106092	-4000	4000	2786
chr3	169835172	169843172	169839987	8000	169839172	-4000	4000	815
chr3	179232691	179240691	179234302	8000	179236691	-4000	4000	-2389
chr3	196239178	196247178	196241951	8000	196243178	-4000	4000	-1227
chr3	138057990	138065990	138062838	8000	138061990	-4000	4000	848
chr3	3140628	3148628	3147464	8000	3144628	-4000	4000	2836
chr3	15663236	15671236	15670391	8000	15667236	-4000	4000	3155
chr3	17086604	17094604	17089894	8000	17090604	-4000	4000	-710
chr3	39092599	39100599	39098812	8000	39096599	-4000	4000	2213
chr3	50284114	50292114	50286530	8000	50288114	-4000	4000	-1584
chr3	142445007	142453007	142451456	8000	142449007	-4000	4000	2449
chr3	151193832	151201832	151199256	8000	151197832	-4000	4000	1424
chr3	170301977	170309977	170303081	8000	170305977	-4000	4000	-2896
chr3	172626249	172634249	172633308	8000	172630249	-4000	4000	3059
chr3	195510428	195518428	195516718	8000	195514428	-4000	4000	2290
chr3	179232691	179240691	179234297	8000	179236691	-4000	4000	-2394
chr3	4313265	4321265	4313688	8000	4317265	-4000	4000	-3577
chr3	113283459	113291459	113285545	8000	113287459	-4000	4000	-1914
chr3	43051871	43059871	43053563	8000	43055871	-4000	4000	-2308
chr3	47342816	47350816	47343758	8000	47346816	-4000	4000	-3058
chr3	77645964	77653964	77646096	8000	77649964	-4000	4000	-3868
chr3	143120014	143128014	143122056	8000	143124014	-4000	4000	-1958
chr3	181710436	181718436	181712610	8000	181714436	-4000	4000	-1826
chr3	49801209	49809209	49807806	8000	49805209	-4000	4000	2597
chr3	179232691	179240691	179234297	8000	179236691	-4000	4000	-2394
chr3	46197711	46205711	46203263	8000	46201711	-4000	4000	1552
chr3	179232691	179240691	179234297	8000	179236691	-4000	4000	-2394
chr3	156535138	156543138	156536862	8000	156539138	-4000	4000	-2276
chr3	165768904	165776904	165773438	8000	165772904	-4000	4000	534
chr3	46356940	46364940	46358654	8000	46360940	-4000	4000	-2286
chr3	49172486	49180486	49174942	8000	49176486	-4000	4000	-1544
chr3	55070557	55078557	55073827	8000	55074557	-4000	4000	-730
chr3	3146879	3154879	3150954	8000	3150879	-4000	4000	75
chr3	113960137	113968137	113960995	8000	113964137	-4000	4000	-3142
chr3	190301707	190309707	190308239	8000	190305707	-4000	4000	2532
chr3	179232691	179240691	179234297	8000	179236691	-4000	4000	-2394
chr3	122905082	122913082	122912043	8000	122909082	-4000	4000	2961
chr3	129973935	129981935	129976806	8000	129977935	-4000	4000	-1129
chr3	15446133	15454133	15451110	8000	15450133	-4000	4000	977
chr3	24113153	24121153	24118591	8000	24117153	-4000	4000	1438
chr3	46356940	46364940	46358231	8000	46360940	-4000	4000	-2709
chr3	123606049	123614049	123614026	8000	123610049	-4000	4000	3977
chr3	154268546	154276546	154275753	8000	154272546	-4000	4000	3207
chr3	4313265	4321265	4316300	8000	4317265	-4000	4000	-965
chr3	15718311	15726311	15724411	8000	15722311	-4000	4000	2100
chr3	179232691	179240691	179234296	8000	179236691	-4000	4000	-2395
chr3	149314498	149322498	149321194	8000	149318498	-4000	4000	2696
chr3	179232691	179240691	179234297	8000	179236691	-4000	4000	-2394
chr3	154253827	154261827	154254740	8000	154257827	-4000	4000	-3087
chr3	179232691	179240691	179234176	8000	179236691	-4000	4000	-2515
chr3	179232691	179240691	179234297	8000	179236691	-4000	4000	-2394
chr3	190301707	190309707	190308213	8000	190305707	-4000	4000	2506
chr3	111588900	111596900	111593895	8000	111592900	-4000	4000	995
chr3	111588900	111596900	111593896	8000	111592900	-4000	4000	996
chr3	179232691	179240691	179234297	8000	179236691	-4000	4000	-2394
chr3	37046846	37054846	37053634	8000	37050846	-4000	4000	2788
chr3	179232691	179240691	179234297	8000	179236691	-4000	4000	-2394
chr3	10281796	10289796	10287051	8000	10285796	-4000	4000	1255
chr3	185186624	185194624	185193266	8000	185190624	-4000	4000	2642
chr3	39179210	39187210	39186991	8000	39183210	-4000	4000	3781
chr3	154268546	154276546	154276197	8000	154272546	-4000	4000	3651
chr3	151322312	151330312	151328308	8000	151326312	-4000	4000	1996
chr3	44910990	44918990	44913801	8000	44914990	-4000	4000	-1189
chr3	112116839	112124839	112116844	8000	112120839	-4000	4000	-3995
chr3	184578408	184586408	184580798	8000	184582408	-4000	4000	-1610
chr3	11553665	11561665	11557264	8000	11557665	-4000	4000	-401
chr3	45078277	45086277	45086068	8000	45082277	-4000	4000	3791
chr3	183118215	183126215	183123678	8000	183122215	-4000	4000	1463
chr3	123606049	123614049	123613846	8000	123610049	-4000	4000	3797
chr3	122905082	122913082	122912872	8000	122909082	-4000	4000	3790
chr3	49019495	49027495	49022530	8000	49023495	-4000	4000	-965
chr3	125524858	125532858	125529336	8000	125528858	-4000	4000	478
chr3	158641822	158649822	158646918	8000	158645822	-4000	4000	1096
chr3	179232691	179240691	179234297	8000	179236691	-4000	4000	-2394
chr3	49273144	49281144	49274119	8000	49277144	-4000	4000	-3025
chr3	97937818	97945818	97942778	8000	97941818	-4000	4000	960
chr3	122735999	122743999	122740823	8000	122739999	-4000	4000	824
chr3	97937818	97945818	97942778	8000	97941818	-4000	4000	960
chr3	141922549	141930549	141925705	8000	141926549	-4000	4000	-844
chr3	9890349	9898349	9893024	8000	9894349	-4000	4000	-1325
chr3	52690486	52698486	52693226	8000	52694486	-4000	4000	-1260
chr3	46356940	46364940	46358373	8000	46360940	-4000	4000	-2567
chr3	50316027	50324027	50319639	8000	50320027	-4000	4000	-388
chr3	73378431	73386431	73383733	8000	73382431	-4000	4000	1302
chr3	147382046	147390046	147388799	8000	147386046	-4000	4000	2753
chr3	179232691	179240691	179234297	8000	179236691	-4000	4000	-2394
chr3	49883002	49891002	49887427	8000	49887002	-4000	4000	425
chr3	113283459	113291459	113284562	8000	113287459	-4000	4000	-2897
chr3	179232691	179240691	179234297	8000	179236691	-4000	4000	-2394
chr3	100745156	100753156	100752803	8000	100749156	-4000	4000	3647
chr3	171596404	171604404	171603085	8000	171600404	-4000	4000	2681
chr3	196550177	196558177	196554538	8000	196554177	-4000	4000	361
chr3	127676926	127684926	127680113	8000	127680926	-4000	4000	-813
chr3	179232691	179240691	179234297	8000	179236691	-4000	4000	-2394
chr3	10097932	10105932	10104750	8000	10101932	-4000	4000	2818
chr3	142445007	142453007	142450671	8000	142449007	-4000	4000	1664
chr3	161079883	161087883	161086242	8000	161083883	-4000	4000	2359
chr3	170081392	170089392	170084314	8000	170085392	-4000	4000	-1078
chr3	192792815	192800815	192798931	8000	192796815	-4000	4000	2116
chr3	33146043	33154043	33152561	8000	33150043	-4000	4000	2518
chr3	150737125	150745125	150742084	8000	150741125	-4000	4000	959
chr3	149158410	149166410	149160126	8000	149162410	-4000	4000	-2284
chr3	184578408	184586408	184581610	8000	184582408	-4000	4000	-798
chr3	3845834	3853834	3846659	8000	3849834	-4000	4000	-3175
chr3	43051871	43059871	43053679	8000	43055871	-4000	4000	-2192
chr3	45078277	45086277	45085679	8000	45082277	-4000	4000	3402
chr3	46356940	46364940	46357543	8000	46360940	-4000	4000	-3397
chr3	49117114	49125114	49122729	8000	49121114	-4000	4000	1615
chr3	122523924	122531924	122528636	8000	122527924	-4000	4000	712
chr3	146188335	146196335	146194336	8000	146192335	-4000	4000	2001
chr3	160430954	160438954	160438049	8000	160434954	-4000	4000	3095
chr3	133393775	133401775	133400362	8000	133397775	-4000	4000	2587
chr3	46012990	46020990	46020972	8000	46016990	-4000	4000	3982
chr3	48560073	48568073	48565185	8000	48564073	-4000	4000	1112
chr3	49117114	49125114	49122810	8000	49121114	-4000	4000	1696
chr3	49720294	49728294	49727204	8000	49724294	-4000	4000	2910
chr3	53861794	53869794	53868796	8000	53865794	-4000	4000	3002
chr3	73378431	73386431	73384569	8000	73382431	-4000	4000	2138
chr3	135256467	135264467	135259156	8000	135260467	-4000	4000	-1311
chr3	146065440	146073440	146071099	8000	146069440	-4000	4000	1659
chr3	160430954	160438954	160438821	8000	160434954	-4000	4000	3867
chr3	184578408	184586408	184581608	8000	184582408	-4000	4000	-800
chr3	169079499	169087499	169084948	8000	169083499	-4000	4000	1449
chr3	172626249	172634249	172634058	8000	172630249	-4000	4000	3809
chr3	51953454	51961454	51958937	8000	51957454	-4000	4000	1483
chr3	25790534	25798534	25791969	8000	25794534	-4000	4000	-2565
chr3	146065440	146073440	146073327	8000	146069440	-4000	4000	3887
chr3	179232691	179240691	179234297	8000	179236691	-4000	4000	-2394
chr3	32992609	33000609	32996848	8000	32996609	-4000	4000	239
chr3	39179210	39187210	39185748	8000	39183210	-4000	4000	2538
chr3	73378431	73386431	73384794	8000	73382431	-4000	4000	2363
chr3	108851005	108859005	108853749	8000	108855005	-4000	4000	-1256
chr3	120680938	120688938	120682316	8000	120684938	-4000	4000	-2622
chr3	130673044	130681044	130675559	8000	130677044	-4000	4000	-1485
chr3	142709664	142717664	142711966	8000	142713664	-4000	4000	-1698
chr3	149365022	149373022	149371684	8000	149369022	-4000	4000	2662
chr3	155179704	155187704	155180599	8000	155183704	-4000	4000	-3105
chr3	169789003	169797003	169795339	8000	169793003	-4000	4000	2336
chr3	182917629	182925629	182918224	8000	182921629	-4000	4000	-3405
chr3	187116948	187124948	187120988	8000	187120948	-4000	4000	40
chr3	48286722	48294722	48294685	8000	48290722	-4000	4000	3963
chr3	179232691	179240691	179234297	8000	179236691	-4000	4000	-2394
chr3	179232691	179240691	179234297	8000	179236691	-4000	4000	-2394
chr3	43075229	43083229	43080042	8000	43079229	-4000	4000	813
chr3	156702770	156710770	156704888	8000	156706770	-4000	4000	-1882
chr3	179236093	179244093	179242830	8000	179240093	-4000	4000	2737
chr3	58560117	58568117	58567244	8000	58564117	-4000	4000	3127
chr3	3053959	3061959	3057718	8000	3057959	-4000	4000	-241
chr3	50350750	50358750	50355109	8000	50354750	-4000	4000	359
chr3	38003188	38011188	38010503	8000	38007188	-4000	4000	3315
chr3	192792815	192800815	192797181	8000	192796815	-4000	4000	366
chr3	120779069	120787069	120781461	8000	120783069	-4000	4000	-1608
chr3	101562446	101570446	101565611	8000	101566446	-4000	4000	-835
chr3	138648698	138656698	138655451	8000	138652698	-4000	4000	2753
chr3	160430954	160438954	160437937	8000	160434954	-4000	4000	2983
chr3	9784219	9792219	9789945	8000	9788219	-4000	4000	1726
chr3	98817201	98825201	98819357	8000	98821201	-4000	4000	-1844
chr3	52541352	52549352	52547895	8000	52545352	-4000	4000	2543
chr3	139513434	139521434	139517646	8000	139517434	-4000	4000	212
chr3	184238301	184246301	184245768	8000	184242301	-4000	4000	3467
chr3	27368721	27376721	27376632	8000	27372721	-4000	4000	3911
chr3	142803888	142811888	142806433	8000	142807888	-4000	4000	-1455
chr3	108545864	108553864	108551286	8000	108549864	-4000	4000	1422
chr3	160430954	160438954	160438696	8000	160434954	-4000	4000	3742
chr3	187116948	187124948	187121142	8000	187120948	-4000	4000	194
chr3	119585945	119593945	119587847	8000	119589945	-4000	4000	-2098
chr3	9744019	9752019	9750183	8000	9748019	-4000	4000	2164
chr3	39179210	39187210	39186712	8000	39183210	-4000	4000	3502
chr3	43075229	43083229	43081285	8000	43079229	-4000	4000	2056
chr3	128475427	128483427	128481005	8000	128479427	-4000	4000	1578
chr3	14930571	14938571	14933243	8000	14934571	-4000	4000	-1328
chr3	33146043	33154043	33153223	8000	33150043	-4000	4000	3180
chr3	46356940	46364940	46358473	8000	46360940	-4000	4000	-2467
chr3	142811922	142819922	142818424	8000	142815922	-4000	4000	2502
chr3	50343330	50351330	50348728	8000	50347330	-4000	4000	1398
chr3	53861794	53869794	53868752	8000	53865794	-4000	4000	2958
chr3	113438718	113446718	113445261	8000	113442718	-4000	4000	2543
chr3	122635047	122643047	122636033	8000	122639047	-4000	4000	-3014
chr3	189893276	189901276	189894348	8000	189897276	-4000	4000	-2928
chr3	126338635	126346635	126343759	8000	126342635	-4000	4000	1124
chr3	179232691	179240691	179234297	8000	179236691	-4000	4000	-2394
chr3	186101668	186109668	186105304	8000	186105668	-4000	4000	-364
chr3	49117114	49125114	49124888	8000	49121114	-4000	4000	3774
chr3	111588900	111596900	111593925	8000	111592900	-4000	4000	1025
chr3	185186624	185194624	185192380	8000	185190624	-4000	4000	1756
chr3	46197711	46205711	46203749	8000	46201711	-4000	4000	2038
chr3	179232691	179240691	179234297	8000	179236691	-4000	4000	-2394
chr3	186785880	186793880	186786163	8000	186789880	-4000	4000	-3717
chr3	179232691	179240691	179234297	8000	179236691	-4000	4000	-2394
chr3	45078277	45086277	45085621	8000	45082277	-4000	4000	3344
chr3	179232691	179240691	179234297	8000	179236691	-4000	4000	-2394
chr3	179232691	179240691	179234297	8000	179236691	-4000	4000	-2394
chr3	197885077	197893077	197892643	8000	197889077	-4000	4000	3566
chr3	52250434	52258434	52256479	8000	52254434	-4000	4000	2045
chr3	121627399	121635399	121631842	8000	121631399	-4000	4000	443
chr3	113960137	113968137	113965097	8000	113964137	-4000	4000	960
chr3	179232691	179240691	179234297	8000	179236691	-4000	4000	-2394
chr3	36544007	36552007	36546332	8000	36548007	-4000	4000	-1675
chr3	129273773	129281773	129279823	8000	129277773	-4000	4000	2050
chr3	49531618	49539618	49534021	8000	49535618	-4000	4000	-1597
chr3	112127004	112135004	112130395	8000	112131004	-4000	4000	-609
chr3	186785880	186793880	186789778	8000	186789880	-4000	4000	-102
chr3	179232691	179240691	179234297	8000	179236691	-4000	4000	-2394
chr3	12188032	12196032	12190951	8000	12192032	-4000	4000	-1081
chr3	149027775	149035775	149032250	8000	149031775	-4000	4000	475
chr3	52829121	52837121	52833406	8000	52833121	-4000	4000	285
chr3	179232691	179240691	179234297	8000	179236691	-4000	4000	-2394
chr3	89478134	89486134	89479978	8000	89482134	-4000	4000	-2156
chr3	9912402	9920402	9917414	8000	9916402	-4000	4000	1012
chr3	142445007	142453007	142451516	8000	142449007	-4000	4000	2509
chr3	47558238	47566238	47562432	8000	47562238	-4000	4000	194
chr3	122726840	122734840	122728448	8000	122730840	-4000	4000	-2392
chr3	40308424	40316424	40312169	8000	40312424	-4000	4000	-255
chr3	122905082	122913082	122910946	8000	122909082	-4000	4000	1864
chr3	184180214	184188214	184187957	8000	184184214	-4000	4000	3743
chr3	194685037	194693037	194687123	8000	194689037	-4000	4000	-1914
chr3	48221491	48229491	48223500	8000	48225491	-4000	4000	-1991
chr3	112358812	112366812	112361812	8000	112362812	-4000	4000	-1000
chr3	39259495	39267495	39266311	8000	39263495	-4000	4000	2816
chr3	122117139	122125139	122118050	8000	122121139	-4000	4000	-3089
chr3	120160645	120168645	120167865	8000	120164645	-4000	4000	3220
chr3	9744019	9752019	9750397	8000	9748019	-4000	4000	2378
chr3	172501508	172509508	172506651	8000	172505508	-4000	4000	1143
chr3	196702277	196710277	196707585	8000	196706277	-4000	4000	1308
chr3	113283459	113291459	113286811	8000	113287459	-4000	4000	-648
chr3	197884436	197892436	197891522	8000	197888436	-4000	4000	3086
chr3	150582016	150590016	150583242	8000	150586016	-4000	4000	-2774
chr3	3140628	3148628	3147655	8000	3144628	-4000	4000	3027
chr3	38489142	38497142	38489417	8000	38493142	-4000	4000	-3725
chr3	38489142	38497142	38492376	8000	38493142	-4000	4000	-766
chr3	143120014	143128014	143121301	8000	143124014	-4000	4000	-2713
chr3	143120014	143128014	143121302	8000	143124014	-4000	4000	-2712
chr3	179232691	179240691	179234297	8000	179236691	-4000	4000	-2394
chr3	184386736	184394736	184389433	8000	184390736	-4000	4000	-1303
chr3	58498360	58506360	58501648	8000	58502360	-4000	4000	-712
chr3	179232691	179240691	179234297	8000	179236691	-4000	4000	-2394
chr3	122905082	122913082	122911501	8000	122909082	-4000	4000	2419
chr3	129273773	129281773	129277293	8000	129277773	-4000	4000	-480
chr3	9912402	9920402	9917891	8000	9916402	-4000	4000	1489
chr3	33492245	33500245	33497407	8000	33496245	-4000	4000	1162
chr3	39179210	39187210	39184962	8000	39183210	-4000	4000	1752
chr3	47581269	47589269	47587206	8000	47585269	-4000	4000	1937
chr3	47581269	47589269	47587352	8000	47585269	-4000	4000	2083
chr3	111588900	111596900	111594772	8000	111592900	-4000	4000	1872
chr3	122735999	122743999	122740545	8000	122739999	-4000	4000	546
chr3	126433601	126441601	126439696	8000	126437601	-4000	4000	2095
chr3	138294384	138302384	138301487	8000	138298384	-4000	4000	3103
chr3	190655750	190663750	190656560	8000	190659750	-4000	4000	-3190
chr3	198039720	198047720	198043578	8000	198043720	-4000	4000	-142
chr3	45819316	45827316	45826216	8000	45823316	-4000	4000	2900
chr3	49025707	49033707	49033202	8000	49029707	-4000	4000	3495
chr3	179232691	179240691	179234297	8000	179236691	-4000	4000	-2394
chr3	184367935	184375935	184368317	8000	184371935	-4000	4000	-3618
chr3	11259557	11267557	11259953	8000	11263557	-4000	4000	-3604
chr3	44719831	44727831	44721521	8000	44723831	-4000	4000	-2310
chr3	58498360	58506360	58501075	8000	58502360	-4000	4000	-1285
chr3	177015340	177023340	177022839	8000	177019340	-4000	4000	3499
chr3	179232691	179240691	179234297	8000	179236691	-4000	4000	-2394
chr3	183680519	183688519	183684344	8000	183684519	-4000	4000	-175
chr3	179232691	179240691	179234297	8000	179236691	-4000	4000	-2394
chr3	172397669	172405669	172398863	8000	172401669	-4000	4000	-2806
chr3	32952349	32960349	32954205	8000	32956349	-4000	4000	-2144
chr3	38003188	38011188	38006188	8000	38007188	-4000	4000	-1000
chr3	190301707	190309707	190308238	8000	190305707	-4000	4000	2531
chr3	10077317	10085317	10078135	8000	10081317	-4000	4000	-3182
chr3	56617837	56625837	56619365	8000	56621837	-4000	4000	-2472
chr3	69050730	69058730	69052060	8000	69054730	-4000	4000	-2670
chr3	49801209	49809209	49808098	8000	49805209	-4000	4000	2889
chr3	129397321	129405321	129401661	8000	129401321	-4000	4000	340
chr3	149026127	149034127	149026498	8000	149030127	-4000	4000	-3629
chr3	38139022	38147022	38141360	8000	38143022	-4000	4000	-1662
chr3	119625811	119633811	119629445	8000	119629811	-4000	4000	-366
chr3	179232691	179240691	179234287	8000	179236691	-4000	4000	-2404
chr3	48286722	48294722	48294645	8000	48290722	-4000	4000	3923
chr3	156535138	156543138	156536864	8000	156539138	-4000	4000	-2274
chr3	156535553	156543553	156543206	8000	156539553	-4000	4000	3653
chr3	179232691	179240691	179234297	8000	179236691	-4000	4000	-2394
chr3	33146043	33154043	33152561	8000	33150043	-4000	4000	2518
chr3	170081392	170089392	170084346	8000	170085392	-4000	4000	-1046
chr3	183011218	183019218	183015405	8000	183015218	-4000	4000	187
chr3	50645291	50653291	50646822	8000	50649291	-4000	4000	-2469
chr3	179232691	179240691	179234297	8000	179236691	-4000	4000	-2394
chr3	101320205	101328205	101327740	8000	101324205	-4000	4000	3535
chr3	151880619	151888619	151880667	8000	151884619	-4000	4000	-3952
chr3	179232691	179240691	179234297	8000	179236691	-4000	4000	-2394
chr3	132364298	132372298	132368191	8000	132368298	-4000	4000	-107
chr3	179232691	179240691	179234297	8000	179236691	-4000	4000	-2394
chr3	179232691	179240691	179234297	8000	179236691	-4000	4000	-2394
chr3	179232691	179240691	179234297	8000	179236691	-4000	4000	-2394
chr3	179232691	179240691	179234297	8000	179236691	-4000	4000	-2394
chr3	39179210	39187210	39186127	8000	39183210	-4000	4000	2917
chr3	127668802	127676802	127676299	8000	127672802	-4000	4000	3497
chr3	190655750	190663750	190656164	8000	190659750	-4000	4000	-3586
chr3	88140660	88148660	88142344	8000	88144660	-4000	4000	-2316
chr3	142709664	142717664	142712670	8000	142713664	-4000	4000	-994
chr3	179232691	179240691	179234297	8000	179236691	-4000	4000	-2394
chr3	132554142	132562142	132559006	8000	132558142	-4000	4000	864
chr3	196464783	196472783	196472723	8000	196468783	-4000	4000	3940
chr3	72745277	72753277	72750245	8000	72749277	-4000	4000	968
chr3	187368076	187376076	187371001	8000	187372076	-4000	4000	-1075
chr3	58168251	58176251	58168475	8000	58172251	-4000	4000	-3776
chr3	196702277	196710277	196707709	8000	196706277	-4000	4000	1432
chr3	27711949	27719949	27718854	8000	27715949	-4000	4000	2905
chr3	48621723	48629723	48627966	8000	48625723	-4000	4000	2243
chr3	179232691	179240691	179234297	8000	179236691	-4000	4000	-2394
chr3	98817201	98825201	98819275	8000	98821201	-4000	4000	-1926
chr3	23887640	23895640	23893232	8000	23891640	-4000	4000	1592
chr3	46197711	46205711	46203928	8000	46201711	-4000	4000	2217
chr3	149169732	149177732	149173730	8000	149173732	-4000	4000	-2
chr3	15663236	15671236	15670395	8000	15667236	-4000	4000	3159
chr3	52690486	52698486	52690752	8000	52694486	-4000	4000	-3734
chr3	133586261	133594261	133588210	8000	133590261	-4000	4000	-2051
chr3	168004689	168012689	168010817	8000	168008689	-4000	4000	2128
chr3	186785880	186793880	186789210	8000	186789880	-4000	4000	-670
chr3	50316027	50324027	50319897	8000	50320027	-4000	4000	-130
chr3	10097932	10105932	10104504	8000	10101932	-4000	4000	2572
chr3	101644889	101652889	101651357	8000	101648889	-4000	4000	2468
chr3	126956420	126964420	126957439	8000	126960420	-4000	4000	-2981
chr3	150737125	150745125	150741414	8000	150741125	-4000	4000	289
chr3	49883002	49891002	49887165	8000	49887002	-4000	4000	163
chr3	142803888	142811888	142806250	8000	142807888	-4000	4000	-1638
chr3	150626436	150634436	150627785	8000	150630436	-4000	4000	-2651
chr3	192792815	192800815	192799272	8000	192796815	-4000	4000	2457
chr3	58498360	58506360	58501015	8000	58502360	-4000	4000	-1345
chr3	46356940	46364940	46358518	8000	46360940	-4000	4000	-2422
chr3	122905082	122913082	122910031	8000	122909082	-4000	4000	949
chr3	179232691	179240691	179234297	8000	179236691	-4000	4000	-2394
chr3	151322312	151330312	151329509	8000	151326312	-4000	4000	3197
chr3	180613828	180621828	180615075	8000	180617828	-4000	4000	-2753
chr3	46356940	46364940	46358488	8000	46360940	-4000	4000	-2452
chr3	179232691	179240691	179234297	8000	179236691	-4000	4000	-2394
chr3	9890349	9898349	9893449	8000	9894349	-4000	4000	-900
chr3	48621723	48629723	48627048	8000	48625723	-4000	4000	1325
chr3	180979697	180987697	180984666	8000	180983697	-4000	4000	969
chr3	151322312	151330312	151328627	8000	151326312	-4000	4000	2315
chr3	190655750	190663750	190656512	8000	190659750	-4000	4000	-3238
chr3	52690486	52698486	52692922	8000	52694486	-4000	4000	-1564
chr3	52690486	52698486	52695945	8000	52694486	-4000	4000	1459
chr3	184180214	184188214	184187955	8000	184184214	-4000	4000	3741
chr3	73378431	73386431	73384627	8000	73382431	-4000	4000	2196
chr3	151193832	151201832	151199312	8000	151197832	-4000	4000	1480
chr3	66374797	66382797	66380818	8000	66378797	-4000	4000	2021
chr3	179232691	179240691	179234297	8000	179236691	-4000	4000	-2394
chr3	142445007	142453007	142451327	8000	142449007	-4000	4000	2320
chr3	49091932	49099932	49098671	8000	49095932	-4000	4000	2739
chr3	179232691	179240691	179234297	8000	179236691	-4000	4000	-2394
chr3	4313265	4321265	4313668	8000	4317265	-4000	4000	-3597
chr3	112358812	112366812	112361812	8000	112362812	-4000	4000	-1000
chr3	102475841	102483841	102477443	8000	102479841	-4000	4000	-2398
chr3	23887640	23895640	23890515	8000	23891640	-4000	4000	-1125
chr3	119424949	119432949	119432083	8000	119428949	-4000	4000	3134
chr3	138490344	138498344	138498046	8000	138494344	-4000	4000	3702
chr3	131346465	131354465	131349647	8000	131350465	-4000	4000	-818
chr3	129036742	129044742	129037015	8000	129040742	-4000	4000	-3727
chr3	151208117	151216117	151212643	8000	151212117	-4000	4000	526
chr3	179232691	179240691	179234296	8000	179236691	-4000	4000	-2395
chr3	151433072	151441072	151436840	8000	151437072	-4000	4000	-232
chr3	184578408	184586408	184580796	8000	184582408	-4000	4000	-1612
chr3	184578408	184586408	184581359	8000	184582408	-4000	4000	-1049
chr3	48560073	48568073	48567603	8000	48564073	-4000	4000	3530
chr3	89478134	89486134	89479695	8000	89482134	-4000	4000	-2439
chr3	161079883	161087883	161086508	8000	161083883	-4000	4000	2625
chr3	179232691	179240691	179234297	8000	179236691	-4000	4000	-2394
chr3	179232691	179240691	179234286	8000	179236691	-4000	4000	-2405
chr3	179232691	179240691	179234297	8000	179236691	-4000	4000	-2394
chr3	69015827	69023827	69023189	8000	69019827	-4000	4000	3362
chr3	37046846	37054846	37047678	8000	37050846	-4000	4000	-3168
chr3	179232691	179240691	179234297	8000	179236691	-4000	4000	-2394
chr3	179232691	179240691	179234297	8000	179236691	-4000	4000	-2394
chr3	28321142	28329142	28323582	8000	28325142	-4000	4000	-1560
chr3	42701756	42709756	42708970	8000	42705756	-4000	4000	3214
chr3	185639130	185647130	185643861	8000	185643130	-4000	4000	731
chr3	138156988	138164988	138163983	8000	138160988	-4000	4000	2995
chr3	39259495	39267495	39265156	8000	39263495	-4000	4000	1661
chr3	69050730	69058730	69052169	8000	69054730	-4000	4000	-2561
chr3	129973935	129981935	129977040	8000	129977935	-4000	4000	-895
chr3	39393351	39401351	39394551	8000	39397351	-4000	4000	-2800
chr3	179232691	179240691	179234297	8000	179236691	-4000	4000	-2394
chr3	33146043	33154043	33152762	8000	33150043	-4000	4000	2719
chr3	3845834	3853834	3846420	8000	3849834	-4000	4000	-3414
chr3	146065440	146073440	146070854	8000	146069440	-4000	4000	1414
chr3	179232691	179240691	179234297	8000	179236691	-4000	4000	-2394
chr3	101644889	101652889	101651460	8000	101648889	-4000	4000	2571
chr3	158091905	158099905	158098052	8000	158095905	-4000	4000	2147
chr3	185186624	185194624	185192174	8000	185190624	-4000	4000	1550
chr3	170884418	170892418	170889659	8000	170888418	-4000	4000	1241
chr3	119585945	119593945	119587476	8000	119589945	-4000	4000	-2469
chr3	179232691	179240691	179234297	8000	179236691	-4000	4000	-2394
chr3	179232691	179240691	179234297	8000	179236691	-4000	4000	-2394
chr3	179232691	179240691	179234297	8000	179236691	-4000	4000	-2394
chr3	149158410	149166410	149162861	8000	149162410	-4000	4000	451
chr3	169789003	169797003	169796061	8000	169793003	-4000	4000	3058
chr3	179232691	179240691	179234297	8000	179236691	-4000	4000	-2394
chr3	179232691	179240691	179234169	8000	179236691	-4000	4000	-2522
chr3	179232691	179240691	179234297	8000	179236691	-4000	4000	-2394
chr3	56616132	56624132	56617260	8000	56620132	-4000	4000	-2872
chr3	62394346	62402346	62399566	8000	62398346	-4000	4000	1220
chr3	101644889	101652889	101651505	8000	101648889	-4000	4000	2616
chr3	184386736	184394736	184386849	8000	184390736	-4000	4000	-3887
chr3	39092599	39100599	39095152	8000	39096599	-4000	4000	-1447
chr3	46408997	46416997	46409106	8000	46412997	-4000	4000	-3891
chr3	179232691	179240691	179234297	8000	179236691	-4000	4000	-2394
chr3	179232691	179240691	179234297	8000	179236691	-4000	4000	-2394
chr3	185629551	185637551	185630057	8000	185633551	-4000	4000	-3494
chr3	186785880	186793880	186787887	8000	186789880	-4000	4000	-1993
chr3	179232691	179240691	179234297	8000	179236691	-4000	4000	-2394
chr3	179232691	179240691	179234297	8000	179236691	-4000	4000	-2394
chr3	119207732	119215732	119212310	8000	119211732	-4000	4000	578
chr3	50350750	50358750	50355353	8000	50354750	-4000	4000	603
chr3	142709664	142717664	142711583	8000	142713664	-4000	4000	-2081
chr3	120160645	120168645	120167189	8000	120164645	-4000	4000	2544
chr3	122905082	122913082	122910054	8000	122909082	-4000	4000	972
chr3	45751449	45759449	45759042	8000	45755449	-4000	4000	3593
chr3	25593984	25601984	25596883	8000	25597984	-4000	4000	-1101
chr3	38489142	38497142	38489587	8000	38493142	-4000	4000	-3555
chr3	47342816	47350816	47343633	8000	47346816	-4000	4000	-3183
chr3	158825719	158833719	158826053	8000	158829719	-4000	4000	-3666
chr3	32164709	32172709	32167394	8000	32168709	-4000	4000	-1315
chr3	50316027	50324027	50320084	8000	50320027	-4000	4000	57
chr3	108039091	108047091	108046314	8000	108043091	-4000	4000	3223
chr3	112917205	112925205	112923754	8000	112921205	-4000	4000	2549
chr3	122408334	122416334	122416014	8000	122412334	-4000	4000	3680
chr3	169785716	169793716	169786918	8000	169789716	-4000	4000	-2798
chr3	44719831	44727831	44721796	8000	44723831	-4000	4000	-2035
chr3	133586261	133594261	133587996	8000	133590261	-4000	4000	-2265
chr3	132535032	132543032	132538216	8000	132539032	-4000	4000	-816
chr3	179232691	179240691	179234297	8000	179236691	-4000	4000	-2394
chr3	39134903	39142903	39136396	8000	39138903	-4000	4000	-2507
chr3	46372206	46380206	46373303	8000	46376206	-4000	4000	-2903
chr3	47409435	47417435	47414278	8000	47413435	-4000	4000	843
chr3	8746381	8754381	8752492	8000	8750381	-4000	4000	2111
chr3	30690142	30698142	30691657	8000	30694142	-4000	4000	-2485
chr3	38003188	38011188	38006656	8000	38007188	-4000	4000	-532
chr3	52899572	52907572	52904716	8000	52903572	-4000	4000	1144
chr3	73378431	73386431	73384643	8000	73382431	-4000	4000	2212
chr3	58188257	58196257	58192695	8000	58192257	-4000	4000	438
chr3	179232691	179240691	179234297	8000	179236691	-4000	4000	-2394
chr3	12510934	12518934	12516656	8000	12514934	-4000	4000	1722
chr3	112459966	112467966	112466252	8000	112463966	-4000	4000	2286
chr3	135256467	135264467	135259133	8000	135260467	-4000	4000	-1334
chr3	52071226	52079226	52075933	8000	52075226	-4000	4000	707
chr3	183174041	183182041	183180086	8000	183178041	-4000	4000	2045
chr3	135256467	135264467	135259988	8000	135260467	-4000	4000	-479
chr3	187074553	187082553	187076989	8000	187078553	-4000	4000	-1564
chr3	11035247	11043247	11037221	8000	11039247	-4000	4000	-2026
chr3	120680938	120688938	120682146	8000	120684938	-4000	4000	-2792
chr3	25593984	25601984	25596537	8000	25597984	-4000	4000	-1447
chr3	179232691	179240691	179234297	8000	179236691	-4000	4000	-2394
chr3	3146879	3154879	3150810	8000	3150879	-4000	4000	-69
chr3	9744019	9752019	9745831	8000	9748019	-4000	4000	-2188
chr3	23587794	23595794	23590097	8000	23591794	-4000	4000	-1697
chr3	45751449	45759449	45759035	8000	45755449	-4000	4000	3586
chr3	46431645	46439645	46437948	8000	46435645	-4000	4000	2303
chr3	49883002	49891002	49890552	8000	49887002	-4000	4000	3550
chr3	50217486	50225486	50220095	8000	50221486	-4000	4000	-1391
chr3	55070557	55078557	55074502	8000	55074557	-4000	4000	-55
chr3	57264342	57272342	57268461	8000	57268342	-4000	4000	119
chr3	97937818	97945818	97944963	8000	97941818	-4000	4000	3145
chr3	105651461	105659461	105659001	8000	105655461	-4000	4000	3540
chr3	119625811	119633811	119628700	8000	119629811	-4000	4000	-1111
chr3	121940188	121948188	121940837	8000	121944188	-4000	4000	-3351
chr3	122726840	122734840	122728403	8000	122730840	-4000	4000	-2437
chr3	136144917	136152917	136152179	8000	136148917	-4000	4000	3262
chr3	146511180	146519180	146515955	8000	146515180	-4000	4000	775
chr3	151322312	151330312	151328194	8000	151326312	-4000	4000	1882
chr3	179232691	179240691	179234302	8000	179236691	-4000	4000	-2389
chr3	179232691	179240691	179234297	8000	179236691	-4000	4000	-2394
chr3	179232691	179240691	179234297	8000	179236691	-4000	4000	-2394
chr3	179232691	179240691	179234297	8000	179236691	-4000	4000	-2394
chr3	30690142	30698142	30691458	8000	30694142	-4000	4000	-2684
chr3	5215958	5223958	5216882	8000	5219958	-4000	4000	-3076
chr3	40308424	40316424	40312159	8000	40312424	-4000	4000	-265
chr3	48982382	48990382	48983429	8000	48986382	-4000	4000	-2953
chr3	69102092	69110092	69108562	8000	69106092	-4000	4000	2470
chr3	93869051	93877051	93874188	8000	93873051	-4000	4000	1137
chr3	97937818	97945818	97944679	8000	97941818	-4000	4000	2861
chr3	113283459	113291459	113285507	8000	113287459	-4000	4000	-1952
chr3	122408334	122416334	122416007	8000	122412334	-4000	4000	3673
chr3	129083575	129091575	129091257	8000	129087575	-4000	4000	3682
chr3	133928701	133936701	133932807	8000	133932701	-4000	4000	106
chr3	138057990	138065990	138064655	8000	138061990	-4000	4000	2665
chr3	151290086	151298086	151294393	8000	151294086	-4000	4000	307
chr3	172397669	172405669	172398327	8000	172401669	-4000	4000	-3342
chr3	181710436	181718436	181712483	8000	181714436	-4000	4000	-1953
chr3	186785880	186793880	186786241	8000	186789880	-4000	4000	-3639
chr3	196464783	196472783	196472395	8000	196468783	-4000	4000	3612
chr3	196930714	196938714	196931877	8000	196934714	-4000	4000	-2837
chr3	179232691	179240691	179234297	8000	179236691	-4000	4000	-2394
chr3	55070557	55078557	55073495	8000	55074557	-4000	4000	-1062
chr3	9744019	9752019	9750183	8000	9748019	-4000	4000	2164
chr3	14108077	14116077	14112481	8000	14112077	-4000	4000	404
chr3	15038460	15046460	15042805	8000	15042460	-4000	4000	345
chr3	136144917	136152917	136151932	8000	136148917	-4000	4000	3015
chr3	151332843	151340843	151338485	8000	151336843	-4000	4000	1642
chr3	179232691	179240691	179234297	8000	179236691	-4000	4000	-2394
chr3	128475427	128483427	128480752	8000	128479427	-4000	4000	1325
chr3	194398672	194406672	194404074	8000	194402672	-4000	4000	1402
chr3	44656791	44664791	44659730	8000	44660791	-4000	4000	-1061
chr3	72367825	72375825	72374710	8000	72371825	-4000	4000	2885
chr3	39259495	39267495	39265168	8000	39263495	-4000	4000	1673
chr3	195564705	195572705	195571351	8000	195568705	-4000	4000	2646
chr3	40424744	40432744	40427528	8000	40428744	-4000	4000	-1216
chr3	44733083	44741083	44734544	8000	44737083	-4000	4000	-2539
chr3	45078277	45086277	45085745	8000	45082277	-4000	4000	3468
chr3	49355139	49363139	49362531	8000	49359139	-4000	4000	3392
chr3	119424949	119432949	119432155	8000	119428949	-4000	4000	3206
chr3	129163827	129171827	129170292	8000	129167827	-4000	4000	2465
chr3	197884436	197892436	197889523	8000	197888436	-4000	4000	1087
chr3	169789003	169797003	169796061	8000	169793003	-4000	4000	3058
chr3	179232691	179240691	179234297	8000	179236691	-4000	4000	-2394
chr3	179232691	179240691	179234230	8000	179236691	-4000	4000	-2461
chr3	11786442	11794442	11790520	8000	11790442	-4000	4000	78
chr3	185472496	185480496	185480289	8000	185476496	-4000	4000	3793
chr3	23587794	23595794	23590270	8000	23591794	-4000	4000	-1524
chr3	25790534	25798534	25791244	8000	25794534	-4000	4000	-3290
chr3	33492245	33500245	33497894	8000	33496245	-4000	4000	1649
chr3	40514736	40522736	40516545	8000	40518736	-4000	4000	-2191
chr3	44733083	44741083	44735146	8000	44737083	-4000	4000	-1937
chr3	44733083	44741083	44736001	8000	44737083	-4000	4000	-1082
chr3	45819316	45827316	45825994	8000	45823316	-4000	4000	2678
chr3	47581269	47589269	47586910	8000	47585269	-4000	4000	1641
chr3	49801209	49809209	49804875	8000	49805209	-4000	4000	-334
chr3	51380198	51388198	51382381	8000	51384198	-4000	4000	-1817
chr3	57264342	57272342	57267797	8000	57268342	-4000	4000	-545
chr3	72745277	72753277	72750562	8000	72749277	-4000	4000	1285
chr3	119585945	119593945	119587819	8000	119589945	-4000	4000	-2126
chr3	122635047	122643047	122636082	8000	122639047	-4000	4000	-2965
chr3	126002357	126010357	126008787	8000	126006357	-4000	4000	2430
chr3	138294384	138302384	138296052	8000	138298384	-4000	4000	-2332
chr3	150737125	150745125	150741833	8000	150741125	-4000	4000	708
chr3	151322312	151330312	151328767	8000	151326312	-4000	4000	2455
chr3	161340798	161348798	161346130	8000	161344798	-4000	4000	1332
chr3	180613828	180621828	180616560	8000	180617828	-4000	4000	-1268
chr3	182917629	182925629	182918797	8000	182921629	-4000	4000	-2832
chr3	195859364	195867364	195864182	8000	195863364	-4000	4000	818
chr3	179232691	179240691	179234297	8000	179236691	-4000	4000	-2394
chr3	129273773	129281773	129275292	8000	129277773	-4000	4000	-2481
chr3	51953454	51961454	51961158	8000	51957454	-4000	4000	3704
chr3	99795226	99803226	99795969	8000	99799226	-4000	4000	-3257
chr3	120624172	120632172	120628492	8000	120628172	-4000	4000	320
chr3	122571203	122579203	122577794	8000	122575203	-4000	4000	2591
chr3	122735999	122743999	122740427	8000	122739999	-4000	4000	428
chr3	132364298	132372298	132367970	8000	132368298	-4000	4000	-328
chr3	135256467	135264467	135259112	8000	135260467	-4000	4000	-1355
chr3	142445007	142453007	142452170	8000	142449007	-4000	4000	3163
chr3	148739008	148747008	148741415	8000	148743008	-4000	4000	-1593
chr3	151332843	151340843	151337771	8000	151336843	-4000	4000	928
chr3	151433072	151441072	151436898	8000	151437072	-4000	4000	-174
chr3	186542067	186550067	186544375	8000	186546067	-4000	4000	-1692
chr3	194398672	194406672	194406028	8000	194402672	-4000	4000	3356
chr3	179232691	179240691	179234297	8000	179236691	-4000	4000	-2394
chr3	157255742	157263742	157261229	8000	157259742	-4000	4000	1487
chr3	184578408	184586408	184579913	8000	184582408	-4000	4000	-2495
chr3	184578408	184586408	184581075	8000	184582408	-4000	4000	-1333
chr3	179232691	179240691	179234297	8000	179236691	-4000	4000	-2394
chr3	50337110	50345110	50341628	8000	50341110	-4000	4000	518
chr3	46197711	46205711	46203951	8000	46201711	-4000	4000	2240
chr3	136144917	136152917	136151900	8000	136148917	-4000	4000	2983
chr3	56617837	56625837	56619503	8000	56621837	-4000	4000	-2334
chr3	69164782	69172782	69171749	8000	69168782	-4000	4000	2967
chr3	142811922	142819922	142818112	8000	142815922	-4000	4000	2190
chr3	73378431	73386431	73383412	8000	73382431	-4000	4000	981
chr3	179232691	179240691	179234297	8000	179236691	-4000	4000	-2394
chr3	28321142	28329142	28324161	8000	28325142	-4000	4000	-981
chr3	190655750	190663750	190656563	8000	190659750	-4000	4000	-3187
chr3	126002357	126010357	126008866	8000	126006357	-4000	4000	2509
chr3	38003188	38011188	38007070	8000	38007188	-4000	4000	-118
chr3	132675794	132683794	132681753	8000	132679794	-4000	4000	1959
chr3	189952728	189960728	189957938	8000	189956728	-4000	4000	1210
chr3	179232691	179240691	179234176	8000	179236691	-4000	4000	-2515
chr3	52829121	52837121	52833413	8000	52833121	-4000	4000	292
chr3	111972517	111980517	111975772	8000	111976517	-4000	4000	-745
chr3	50602489	50610489	50607940	8000	50606489	-4000	4000	1451
chr3	48632463	48640463	48640444	8000	48636463	-4000	4000	3981
chr3	179232691	179240691	179234286	8000	179236691	-4000	4000	-2405
chr3	143120014	143128014	143121910	8000	143124014	-4000	4000	-2104
chr3	53861794	53869794	53865261	8000	53865794	-4000	4000	-533
chr3	179232691	179240691	179234297	8000	179236691	-4000	4000	-2394
chr3	98791941	98799941	98799462	8000	98795941	-4000	4000	3521
chr3	161079883	161087883	161086382	8000	161083883	-4000	4000	2499
chr3	195064284	195072284	195069975	8000	195068284	-4000	4000	1691
chr3	50185075	50193075	50186612	8000	50189075	-4000	4000	-2463
chr3	125979454	125987454	125982300	8000	125983454	-4000	4000	-1154
chr3	136144917	136152917	136152357	8000	136148917	-4000	4000	3440
chr3	146188335	146196335	146194443	8000	146192335	-4000	4000	2108
chr3	44656791	44664791	44659305	8000	44660791	-4000	4000	-1486
chr3	46356940	46364940	46358424	8000	46360940	-4000	4000	-2516
chr3	44719831	44727831	44721607	8000	44723831	-4000	4000	-2224
chr3	179232691	179240691	179234297	8000	179236691	-4000	4000	-2394
chr3	179232691	179240691	179234297	8000	179236691	-4000	4000	-2394
chr3	108545864	108553864	108552373	8000	108549864	-4000	4000	2509
chr3	179232691	179240691	179234297	8000	179236691	-4000	4000	-2394
chr3	9775967	9783967	9780451	8000	9779967	-4000	4000	484
chr3	51944867	51952867	51948640	8000	51948867	-4000	4000	-227
chr3	74258568	74266568	74264406	8000	74262568	-4000	4000	1838
chr3	123964521	123972521	123970064	8000	123968521	-4000	4000	1543
chr3	167821569	167829569	167824522	8000	167825569	-4000	4000	-1047
chr3	186785880	186793880	186790329	8000	186789880	-4000	4000	449
chr3	58168251	58176251	58168610	8000	58172251	-4000	4000	-3641
chr3	129036742	129044742	129039805	8000	129040742	-4000	4000	-937
chr3	179232691	179240691	179234297	8000	179236691	-4000	4000	-2394
chr3	98817201	98825201	98820269	8000	98821201	-4000	4000	-932
chr3	126433601	126441601	126434280	8000	126437601	-4000	4000	-3321
chr3	129083575	129091575	129091233	8000	129087575	-4000	4000	3658
chr3	112358812	112366812	112361576	8000	112362812	-4000	4000	-1236
chr3	185472496	185480496	185473669	8000	185476496	-4000	4000	-2827
chr3	50096045	50104045	50100156	8000	50100045	-4000	4000	111
chr3	179232691	179240691	179234297	8000	179236691	-4000	4000	-2394
chr3	179232691	179240691	179234297	8000	179236691	-4000	4000	-2394
chr3	10097932	10105932	10104493	8000	10101932	-4000	4000	2561
chr3	25714944	25722944	25720045	8000	25718944	-4000	4000	1101
chr3	99795226	99803226	99795463	8000	99799226	-4000	4000	-3763
chr3	142445007	142453007	142451211	8000	142449007	-4000	4000	2204
chr3	157439633	157447633	157442480	8000	157443633	-4000	4000	-1153
chr3	46197711	46205711	46203398	8000	46201711	-4000	4000	1687
chr3	179232691	179240691	179234297	8000	179236691	-4000	4000	-2394
chr3	179232691	179240691	179234169	8000	179236691	-4000	4000	-2522
chr3	197884436	197892436	197889513	8000	197888436	-4000	4000	1077
chr3	183808624	183816624	183810627	8000	183812624	-4000	4000	-1997
chr3	50217486	50225486	50220331	8000	50221486	-4000	4000	-1155
chr3	130673044	130681044	130675360	8000	130677044	-4000	4000	-1684
chr3	48302842	48310842	48309930	8000	48306842	-4000	4000	3088
chr3	179232691	179240691	179234297	8000	179236691	-4000	4000	-2394
chr3	49824601	49832601	49829727	8000	49828601	-4000	4000	1126
chr3	113011060	113019060	113011128	8000	113015060	-4000	4000	-3932
chr3	131009875	131017875	131013948	8000	131013875	-4000	4000	73
chr3	138648698	138656698	138656177	8000	138652698	-4000	4000	3479
chr3	3053959	3061959	3056338	8000	3057959	-4000	4000	-1621
chr3	49117114	49125114	49124703	8000	49121114	-4000	4000	3589
chr3	40514736	40522736	40516031	8000	40518736	-4000	4000	-2705
chr3	43075229	43083229	43080655	8000	43079229	-4000	4000	1426
chr3	48852926	48860926	48857674	8000	48856926	-4000	4000	748
chr3	51944867	51952867	51946302	8000	51948867	-4000	4000	-2565
chr3	58560117	58568117	58566708	8000	58564117	-4000	4000	2591
chr3	112116839	112124839	112123721	8000	112120839	-4000	4000	2882
chr3	186785880	186793880	186789237	8000	186789880	-4000	4000	-643
chr3	44719831	44727831	44721749	8000	44723831	-4000	4000	-2082
chr3	151322312	151330312	151329005	8000	151326312	-4000	4000	2693
chr3	179232691	179240691	179234297	8000	179236691	-4000	4000	-2394
chr3	3146879	3154879	3150753	8000	3150879	-4000	4000	-126
chr3	52250434	52258434	52257495	8000	52254434	-4000	4000	3061
chr3	49412476	49420476	49412624	8000	49416476	-4000	4000	-3852
chr3	149158410	149166410	149162326	8000	149162410	-4000	4000	-84
chr3	179232691	179240691	179234297	8000	179236691	-4000	4000	-2394
chr3	52429035	52437035	52435888	8000	52433035	-4000	4000	2853
chr3	31987723	31995723	31989214	8000	31991723	-4000	4000	-2509
chr3	179232691	179240691	179234297	8000	179236691	-4000	4000	-2394
chr3	170081392	170089392	170084367	8000	170085392	-4000	4000	-1025
chr3	88140660	88148660	88141737	8000	88144660	-4000	4000	-2923
chr3	149027775	149035775	149032271	8000	149031775	-4000	4000	496
chr3	179232691	179240691	179234297	8000	179236691	-4000	4000	-2394
chr3	23976617	23984617	23977363	8000	23980617	-4000	4000	-3254
chr3	25714944	25722944	25720149	8000	25718944	-4000	4000	1205
chr3	120598507	120606507	120601512	8000	120602507	-4000	4000	-995
chr3	10097932	10105932	10104429	8000	10101932	-4000	4000	2497
chr3	161079883	161087883	161086671	8000	161083883	-4000	4000	2788
chr3	43075229	43083229	43081243	8000	43079229	-4000	4000	2014
chr3	50096045	50104045	50100565	8000	50100045	-4000	4000	520
chr3	179232691	179240691	179234297	8000	179236691	-4000	4000	-2394
chr3	196239178	196247178	196242030	8000	196243178	-4000	4000	-1148
chr3	58422127	58430127	58428167	8000	58426127	-4000	4000	2040
chr3	101590465	101598465	101593600	8000	101594465	-4000	4000	-865
chr3	179232691	179240691	179234169	8000	179236691	-4000	4000	-2522
chr3	50554025	50562025	50561051	8000	50558025	-4000	4000	3026
chr3	50343330	50351330	50350424	8000	50347330	-4000	4000	3094
chr3	119585945	119593945	119587858	8000	119589945	-4000	4000	-2087
chr3	157255742	157263742	157260964	8000	157259742	-4000	4000	1222
chr3	185472496	185480496	185480405	8000	185476496	-4000	4000	3909
chr3	8746381	8754381	8752557	8000	8750381	-4000	4000	2176
chr3	119424949	119432949	119431922	8000	119428949	-4000	4000	2973
chr3	179232691	179240691	179234297	8000	179236691	-4000	4000	-2394
chr3	179232691	179240691	179234297	8000	179236691	-4000	4000	-2394
chr3	184238301	184246301	184238694	8000	184242301	-4000	4000	-3607
chr3	44656791	44664791	44660194	8000	44660791	-4000	4000	-597
chr3	184190012	184198012	184191218	8000	184194012	-4000	4000	-2794
chr3	100745156	100753156	100748493	8000	100749156	-4000	4000	-663
chr3	3845834	3853834	3846933	8000	3849834	-4000	4000	-2901
chr3	142709664	142717664	142713262	8000	142713664	-4000	4000	-402
chr3	51944867	51952867	51947799	8000	51948867	-4000	4000	-1068
chr3	120680938	120688938	120682313	8000	120684938	-4000	4000	-2625
chr3	157042129	157050129	157045464	8000	157046129	-4000	4000	-665
chr3	185186624	185194624	185193385	8000	185190624	-4000	4000	2761
chr3	158641822	158649822	158646776	8000	158645822	-4000	4000	954
chr3	405417	413417	405585	8000	409417	-4000	4000	-3832
chr3	143120014	143128014	143121583	8000	143124014	-4000	4000	-2431
chr3	119521090	119529090	119524003	8000	119525090	-4000	4000	-1087
chr3	126099562	126107562	126105778	8000	126103562	-4000	4000	2216
chr3	169762921	169770921	169768076	8000	169766921	-4000	4000	1155
chr3	9744019	9752019	9750245	8000	9748019	-4000	4000	2226
chr3	9890349	9898349	9893131	8000	9894349	-4000	4000	-1218
chr3	12188032	12196032	12190586	8000	12192032	-4000	4000	-1446
chr3	12893043	12901043	12899337	8000	12897043	-4000	4000	2294
chr3	15663236	15671236	15670142	8000	15667236	-4000	4000	2906
chr3	15718311	15726311	15724384	8000	15722311	-4000	4000	2073
chr3	17153162	17161162	17161128	8000	17157162	-4000	4000	3966
chr3	23887640	23895640	23887663	8000	23891640	-4000	4000	-3977
chr3	27711949	27719949	27717385	8000	27715949	-4000	4000	1436
chr3	32521974	32529974	32528543	8000	32525974	-4000	4000	2569
chr3	33146043	33154043	33153691	8000	33150043	-4000	4000	3648
chr3	38003188	38011188	38007810	8000	38007188	-4000	4000	622
chr3	43051871	43059871	43056368	8000	43055871	-4000	4000	497
chr3	44656791	44664791	44659146	8000	44660791	-4000	4000	-1645
chr3	44910990	44918990	44911317	8000	44914990	-4000	4000	-3673
chr3	44910990	44918990	44913699	8000	44914990	-4000	4000	-1291
chr3	45078277	45086277	45085792	8000	45082277	-4000	4000	3515
chr3	49011488	49019488	49012281	8000	49015488	-4000	4000	-3207
chr3	49091932	49099932	49098033	8000	49095932	-4000	4000	2101
chr3	49117114	49125114	49117813	8000	49121114	-4000	4000	-3301
chr3	50316027	50324027	50320319	8000	50320027	-4000	4000	292
chr3	50325782	50333782	50326431	8000	50329782	-4000	4000	-3351
chr3	50343330	50351330	50350739	8000	50347330	-4000	4000	3409
chr3	51944867	51952867	51944997	8000	51948867	-4000	4000	-3870
chr3	52250434	52258434	52256586	8000	52254434	-4000	4000	2152
chr3	52419641	52427641	52422812	8000	52423641	-4000	4000	-829
chr3	56617837	56625837	56623525	8000	56621837	-4000	4000	1688
chr3	57264342	57272342	57269855	8000	57268342	-4000	4000	1513
chr3	72745277	72753277	72750502	8000	72749277	-4000	4000	1225
chr3	73378431	73386431	73384628	8000	73382431	-4000	4000	2197
chr3	97937818	97945818	97943435	8000	97941818	-4000	4000	1617
chr3	101562446	101570446	101565065	8000	101566446	-4000	4000	-1381
chr3	111972517	111980517	111974630	8000	111976517	-4000	4000	-1887
chr3	112528510	112536510	112536472	8000	112532510	-4000	4000	3962
chr3	119424949	119432949	119431971	8000	119428949	-4000	4000	3022
chr3	120160645	120168645	120167771	8000	120164645	-4000	4000	3126
chr3	126002357	126010357	126007159	8000	126006357	-4000	4000	802
chr3	126338635	126346635	126343872	8000	126342635	-4000	4000	1237
chr3	128475427	128483427	128481916	8000	128479427	-4000	4000	2489
chr3	136143894	136151894	136151278	8000	136147894	-4000	4000	3384
chr3	142803888	142811888	142804026	8000	142807888	-4000	4000	-3862
chr3	142811922	142819922	142818386	8000	142815922	-4000	4000	2464
chr3	148739008	148747008	148741785	8000	148743008	-4000	4000	-1223
chr3	148856187	148864187	148859946	8000	148860187	-4000	4000	-241
chr3	154268546	154276546	154276227	8000	154272546	-4000	4000	3681
chr3	169762921	169770921	169767737	8000	169766921	-4000	4000	816
chr3	169762921	169770921	169768128	8000	169766921	-4000	4000	1207
chr3	169762921	169770921	169769480	8000	169766921	-4000	4000	2559
chr3	179232691	179240691	179234122	8000	179236691	-4000	4000	-2569
chr3	180613828	180621828	180616546	8000	180617828	-4000	4000	-1282
chr3	180613828	180621828	180616684	8000	180617828	-4000	4000	-1144
chr3	183294504	183302504	183299912	8000	183298504	-4000	4000	1408
chr3	184386736	184394736	184388673	8000	184390736	-4000	4000	-2063
chr3	185048614	185056614	185052154	8000	185052614	-4000	4000	-460
chr3	185639130	185647130	185645609	8000	185643130	-4000	4000	2479
chr3	186785880	186793880	186789152	8000	186789880	-4000	4000	-728
chr3	186785880	186793880	186790157	8000	186789880	-4000	4000	277
chr3	187074553	187082553	187075705	8000	187078553	-4000	4000	-2848
chr3	187116948	187124948	187121150	8000	187120948	-4000	4000	202
chr3	196702277	196710277	196707791	8000	196706277	-4000	4000	1514
chr3	197884436	197892436	197889486	8000	197888436	-4000	4000	1050
chr3	179232691	179240691	179234297	8000	179236691	-4000	4000	-2394
chr3	136333896	136341896	136337115	8000	136337896	-4000	4000	-781
chr3	186785880	186793880	186787544	8000	186789880	-4000	4000	-2336
chr3	49717529	49725529	49720530	8000	49721529	-4000	4000	-999
chr3	113625575	113633575	113626211	8000	113629575	-4000	4000	-3364
chr3	136851888	136859888	136855371	8000	136855888	-4000	4000	-517
chr3	9890349	9898349	9890651	8000	9894349	-4000	4000	-3698
chr3	10097932	10105932	10104334	8000	10101932	-4000	4000	2402
chr3	113808056	113816056	113811980	8000	113812056	-4000	4000	-76
chr3	128475427	128483427	128481220	8000	128479427	-4000	4000	1793
chr3	180979697	180987697	180984641	8000	180983697	-4000	4000	944
chr3	179232691	179240691	179234297	8000	179236691	-4000	4000	-2394
chr3	179232691	179240691	179234297	8000	179236691	-4000	4000	-2394
chr3	9475240	9483240	9475742	8000	9479240	-4000	4000	-3498
chr3	179232691	179240691	179234297	8000	179236691	-4000	4000	-2394
chr3	179232691	179240691	179234297	8000	179236691	-4000	4000	-2394
chr3	44719831	44727831	44720923	8000	44723831	-4000	4000	-2908
chr3	179232691	179240691	179234297	8000	179236691	-4000	4000	-2394
chr3	28321142	28329142	28324081	8000	28325142	-4000	4000	-1061
chr3	39259495	39267495	39265952	8000	39263495	-4000	4000	2457
chr3	101644889	101652889	101651040	8000	101648889	-4000	4000	2151
chr3	114084422	114092422	114085921	8000	114088422	-4000	4000	-2501
chr3	128615969	128623969	128620124	8000	128619969	-4000	4000	155
chr3	25593984	25601984	25597718	8000	25597984	-4000	4000	-266
chr3	88047944	88055944	88052256	8000	88051944	-4000	4000	312
chr3	129426947	129434947	129428482	8000	129430947	-4000	4000	-2465
chr3	151433072	151441072	151437835	8000	151437072	-4000	4000	763
chr3	194685037	194693037	194688381	8000	194689037	-4000	4000	-656
chr3	197505783	197513783	197512176	8000	197509783	-4000	4000	2393
chr3	69964336	69972336	69966202	8000	69968336	-4000	4000	-2134
chr3	151322312	151330312	151328583	8000	151326312	-4000	4000	2271
chr3	39179210	39187210	39185553	8000	39183210	-4000	4000	2343
chr3	3053959	3061959	3056352	8000	3057959	-4000	4000	-1607
chr3	9744019	9752019	9751785	8000	9748019	-4000	4000	3766
chr3	10077317	10085317	10081336	8000	10081317	-4000	4000	19
chr3	10097932	10105932	10104176	8000	10101932	-4000	4000	2244
chr3	20156593	20164593	20161010	8000	20160593	-4000	4000	417
chr3	31987723	31995723	31989306	8000	31991723	-4000	4000	-2417
chr3	33146043	33154043	33153190	8000	33150043	-4000	4000	3147
chr3	39134903	39142903	39136430	8000	39138903	-4000	4000	-2473
chr3	44719831	44727831	44721270	8000	44723831	-4000	4000	-2561
chr3	44719831	44727831	44721479	8000	44723831	-4000	4000	-2352
chr3	46356940	46364940	46357561	8000	46360940	-4000	4000	-3379
chr3	46356940	46364940	46358340	8000	46360940	-4000	4000	-2600
chr3	48302842	48310842	48306874	8000	48306842	-4000	4000	32
chr3	48560073	48568073	48563021	8000	48564073	-4000	4000	-1052
chr3	50295890	50303890	50302788	8000	50299890	-4000	4000	2898
chr3	50337110	50345110	50342553	8000	50341110	-4000	4000	1443
chr3	50554025	50562025	50561021	8000	50558025	-4000	4000	2996
chr3	52419641	52427641	52421703	8000	52423641	-4000	4000	-1938
chr3	52520495	52528495	52527670	8000	52524495	-4000	4000	3175
chr3	52690486	52698486	52697883	8000	52694486	-4000	4000	3397
chr3	62394346	62402346	62399512	8000	62398346	-4000	4000	1166
chr3	64006550	64014550	64013542	8000	64010550	-4000	4000	2992
chr3	78593239	78601239	78600180	8000	78597239	-4000	4000	2941
chr3	100321251	100329251	100323692	8000	100325251	-4000	4000	-1559
chr3	100573444	100581444	100577059	8000	100577444	-4000	4000	-385
chr3	100745156	100753156	100748291	8000	100749156	-4000	4000	-865
chr3	101562446	101570446	101565415	8000	101566446	-4000	4000	-1031
chr3	101644889	101652889	101651548	8000	101648889	-4000	4000	2659
chr3	111972517	111980517	111974609	8000	111976517	-4000	4000	-1908
chr3	112127004	112135004	112133110	8000	112131004	-4000	4000	2106
chr3	113943174	113951174	113945546	8000	113947174	-4000	4000	-1628
chr3	114306288	114314288	114308091	8000	114310288	-4000	4000	-2197
chr3	120779069	120787069	120781544	8000	120783069	-4000	4000	-1525
chr3	122407846	122415846	122409758	8000	122411846	-4000	4000	-2088
chr3	125442650	125450650	125447636	8000	125446650	-4000	4000	986
chr3	125979454	125987454	125982381	8000	125983454	-4000	4000	-1073
chr3	129426947	129434947	129432531	8000	129430947	-4000	4000	1584
chr3	129516510	129524510	129519118	8000	129520510	-4000	4000	-1392
chr3	129643792	129651792	129651543	8000	129647792	-4000	4000	3751
chr3	138648698	138656698	138655458	8000	138652698	-4000	4000	2760
chr3	139356497	139364497	139359333	8000	139360497	-4000	4000	-1164
chr3	148739008	148747008	148741412	8000	148743008	-4000	4000	-1596
chr3	148739008	148747008	148741535	8000	148743008	-4000	4000	-1473
chr3	160430954	160438954	160438345	8000	160434954	-4000	4000	3391
chr3	169835172	169843172	169840068	8000	169839172	-4000	4000	896
chr3	179232691	179240691	179234219	8000	179236691	-4000	4000	-2472
chr3	179584407	179592407	179588925	8000	179588407	-4000	4000	518
chr3	180979697	180987697	180985955	8000	180983697	-4000	4000	2258
chr3	184578408	184586408	184581358	8000	184582408	-4000	4000	-1050
chr3	186785880	186793880	186789978	8000	186789880	-4000	4000	98
chr3	196239178	196247178	196242006	8000	196243178	-4000	4000	-1172
chr3	197038560	197046560	197044456	8000	197042560	-4000	4000	1896
chr3	197885077	197893077	197892635	8000	197889077	-4000	4000	3558
chr3	3140628	3148628	3148185	8000	3144628	-4000	4000	3557
chr3	32952349	32960349	32954023	8000	32956349	-4000	4000	-2326
chr3	48852926	48860926	48859104	8000	48856926	-4000	4000	2178
chr3	51944867	51952867	51944874	8000	51948867	-4000	4000	-3993
chr3	52707148	52715148	52711807	8000	52711148	-4000	4000	659
chr3	112917205	112925205	112925150	8000	112921205	-4000	4000	3945
chr3	158091905	158099905	158098090	8000	158095905	-4000	4000	2185
chr3	186101668	186109668	186105853	8000	186105668	-4000	4000	185
chr3	190655750	190663750	190656080	8000	190659750	-4000	4000	-3670
chr3	193270789	193278789	193275141	8000	193274789	-4000	4000	352
chr3	196464783	196472783	196472315	8000	196468783	-4000	4000	3532
chr3	196464783	196472783	196472486	8000	196468783	-4000	4000	3703
chr3	149513235	149521235	149520645	8000	149517235	-4000	4000	3410
chr3	195742765	195750765	195749050	8000	195746765	-4000	4000	2285
chr3	98791941	98799941	98799187	8000	98795941	-4000	4000	3246
chr3	9862711	9870711	9869956	8000	9866711	-4000	4000	3245
chr3	179232691	179240691	179234297	8000	179236691	-4000	4000	-2394
chr3	57926003	57934003	57927859	8000	57930003	-4000	4000	-2144
chr3	10097932	10105932	10099073	8000	10101932	-4000	4000	-2859
chr3	15446133	15454133	15453901	8000	15450133	-4000	4000	3768
chr3	122735999	122743999	122741037	8000	122739999	-4000	4000	1038
chr3	46356940	46364940	46358289	8000	46360940	-4000	4000	-2651
chr3	113011060	113019060	113013133	8000	113015060	-4000	4000	-1927
chr3	179390936	179398936	179392098	8000	179394936	-4000	4000	-2838
chr3	132554142	132562142	132559015	8000	132558142	-4000	4000	873
chr3	186854463	186862463	186854686	8000	186858463	-4000	4000	-3777
chr3	39259495	39267495	39266034	8000	39263495	-4000	4000	2539
chr3	179232691	179240691	179234297	8000	179236691	-4000	4000	-2394
chr3	48852926	48860926	48857683	8000	48856926	-4000	4000	757
chr3	133586261	133594261	133588183	8000	133590261	-4000	4000	-2078
chr3	179232691	179240691	179234297	8000	179236691	-4000	4000	-2394
chr3	179232691	179240691	179234297	8000	179236691	-4000	4000	-2394
chr3	179232691	179240691	179234297	8000	179236691	-4000	4000	-2394
chr3	45751449	45759449	45759048	8000	45755449	-4000	4000	3599
chr3	185186624	185194624	185193166	8000	185190624	-4000	4000	2542
chr3	186785880	186793880	186789560	8000	186789880	-4000	4000	-320
chr3	51391867	51399867	51394616	8000	51395867	-4000	4000	-1251
chr3	179232691	179240691	179234297	8000	179236691	-4000	4000	-2394
chr3	49172486	49180486	49174268	8000	49176486	-4000	4000	-2218
chr3	179232691	179240691	179234297	8000	179236691	-4000	4000	-2394
chr3	179232691	179240691	179234297	8000	179236691	-4000	4000	-2394
chr3	12149068	12157068	12153416	8000	12153068	-4000	4000	348
chr3	39179210	39187210	39185398	8000	39183210	-4000	4000	2188
chr3	179232691	179240691	179234297	8000	179236691	-4000	4000	-2394
chr3	5215958	5223958	5216082	8000	5219958	-4000	4000	-3876
chr3	15663236	15671236	15670503	8000	15667236	-4000	4000	3267
chr3	57926003	57934003	57927511	8000	57930003	-4000	4000	-2492
chr3	114084422	114092422	114086022	8000	114088422	-4000	4000	-2400
chr3	185186624	185194624	185192374	8000	185190624	-4000	4000	1750
chr3	113712458	113720458	113719158	8000	113716458	-4000	4000	2700
chr3	50325782	50333782	50331818	8000	50329782	-4000	4000	2036
chr3	179232691	179240691	179234297	8000	179236691	-4000	4000	-2394
chr3	179232691	179240691	179234297	8000	179236691	-4000	4000	-2394
chr3	38003188	38011188	38010158	8000	38007188	-4000	4000	2970
chr3	27711949	27719949	27718590	8000	27715949	-4000	4000	2641
chr3	131009875	131017875	131016454	8000	131013875	-4000	4000	2579
chr3	149365022	149373022	149370119	8000	149369022	-4000	4000	1097
chr3	149365022	149373022	149370120	8000	149369022	-4000	4000	1098
chr3	182917629	182925629	182918271	8000	182921629	-4000	4000	-3358
chr3	52690486	52698486	52690787	8000	52694486	-4000	4000	-3699
chr3	78593239	78601239	78598610	8000	78597239	-4000	4000	1371
chr3	186785880	186793880	186789229	8000	186789880	-4000	4000	-651
chr3	113438718	113446718	113445315	8000	113442718	-4000	4000	2597
chr3	17086604	17094604	17090085	8000	17090604	-4000	4000	-519
chr3	37046846	37054846	37050651	8000	37050846	-4000	4000	-195
chr3	39134903	39142903	39137372	8000	39138903	-4000	4000	-1531
chr3	48428164	48436164	48432449	8000	48432164	-4000	4000	285
chr3	93869051	93877051	93874218	8000	93873051	-4000	4000	1167
chr3	120160645	120168645	120167581	8000	120164645	-4000	4000	2936
chr3	122407846	122415846	122414473	8000	122411846	-4000	4000	2627
chr3	124901442	124909442	124908160	8000	124905442	-4000	4000	2718
chr3	126099562	126107562	126103789	8000	126103562	-4000	4000	227
chr3	142445007	142453007	142450216	8000	142449007	-4000	4000	1209
chr3	151290086	151298086	151294947	8000	151294086	-4000	4000	861
chr3	151322312	151330312	151327833	8000	151326312	-4000	4000	1521
chr3	181710436	181718436	181712826	8000	181714436	-4000	4000	-1610
chr3	196550177	196558177	196554380	8000	196554177	-4000	4000	203
chr3	169789003	169797003	169796258	8000	169793003	-4000	4000	3255
chr3	179232691	179240691	179234297	8000	179236691	-4000	4000	-2394
chr3	44733083	44741083	44734605	8000	44737083	-4000	4000	-2478
chr3	73378431	73386431	73384137	8000	73382431	-4000	4000	1706
chr3	179232691	179240691	179234297	8000	179236691	-4000	4000	-2394
chr3	126002357	126010357	126008859	8000	126006357	-4000	4000	2502
chr3	179232691	179240691	179234297	8000	179236691	-4000	4000	-2394
chr3	33492245	33500245	33498671	8000	33496245	-4000	4000	2426
chr3	39179210	39187210	39186898	8000	39183210	-4000	4000	3688
chr3	101320205	101328205	101327672	8000	101324205	-4000	4000	3467
chr3	146188335	146196335	146194272	8000	146192335	-4000	4000	1937
chr3	120388293	120396293	120395822	8000	120392293	-4000	4000	3529
chr3	179232691	179240691	179234266	8000	179236691	-4000	4000	-2425
chr3	184578408	184586408	184579708	8000	184582408	-4000	4000	-2700
chr3	44719831	44727831	44721568	8000	44723831	-4000	4000	-2263
chr3	50350750	50358750	50355466	8000	50354750	-4000	4000	716
chr3	52829121	52837121	52829145	8000	52833121	-4000	4000	-3976
chr3	169789003	169797003	169793611	8000	169793003	-4000	4000	608
chr3	179232691	179240691	179234297	8000	179236691	-4000	4000	-2394
chr3	9912402	9920402	9914510	8000	9916402	-4000	4000	-1892
chr3	52899572	52907572	52905228	8000	52903572	-4000	4000	1656
chr3	44644471	44652471	44651196	8000	44648471	-4000	4000	2725
chr3	195859364	195867364	195864150	8000	195863364	-4000	4000	786
chr3	128905866	128913866	128912512	8000	128909866	-4000	4000	2646
chr3	179232691	179240691	179234297	8000	179236691	-4000	4000	-2394
chr3	73378431	73386431	73384795	8000	73382431	-4000	4000	2364
chr3	179232691	179240691	179234297	8000	179236691	-4000	4000	-2394
chr3	138490344	138498344	138494902	8000	138494344	-4000	4000	558
chr3	179232691	179240691	179234297	8000	179236691	-4000	4000	-2394
chr3	121627399	121635399	121633148	8000	121631399	-4000	4000	1749
chr3	25714944	25722944	25719393	8000	25718944	-4000	4000	449
chr3	179232691	179240691	179234297	8000	179236691	-4000	4000	-2394
chr3	185186624	185194624	185192630	8000	185190624	-4000	4000	2006
chr3	49011488	49019488	49012057	8000	49015488	-4000	4000	-3431
chr3	185472496	185480496	185480407	8000	185476496	-4000	4000	3911
chr3	50217486	50225486	50218395	8000	50221486	-4000	4000	-3091
chr3	179232691	179240691	179234297	8000	179236691	-4000	4000	-2394
chr3	44656791	44664791	44659342	8000	44660791	-4000	4000	-1449
chr3	179232691	179240691	179234297	8000	179236691	-4000	4000	-2394
chr3	179232691	179240691	179234297	8000	179236691	-4000	4000	-2394
chr3	11259557	11267557	11259672	8000	11263557	-4000	4000	-3885
chr3	39092599	39100599	39094726	8000	39096599	-4000	4000	-1873
chr3	179232691	179240691	179234297	8000	179236691	-4000	4000	-2394
chr3	129643792	129651792	129651608	8000	129647792	-4000	4000	3816
chr3	179232691	179240691	179234297	8000	179236691	-4000	4000	-2394
chr3	129036742	129044742	129039791	8000	129040742	-4000	4000	-951
chr3	179232691	179240691	179234297	8000	179236691	-4000	4000	-2394
chr3	52429035	52437035	52435804	8000	52433035	-4000	4000	2769
chr3	48560073	48568073	48564153	8000	48564073	-4000	4000	80
chr3	51391867	51399867	51393748	8000	51395867	-4000	4000	-2119
chr3	17153162	17161162	17161130	8000	17157162	-4000	4000	3968
chr3	147382046	147390046	147388823	8000	147386046	-4000	4000	2777
chr3	193394967	193402967	193402861	8000	193398967	-4000	4000	3894
chr3	52690486	52698486	52690608	8000	52694486	-4000	4000	-3878
chr3	111972517	111980517	111974594	8000	111976517	-4000	4000	-1923
chr3	112528510	112536510	112534006	8000	112532510	-4000	4000	1496
chr3	15446133	15454133	15450379	8000	15450133	-4000	4000	246
chr3	23887640	23895640	23893248	8000	23891640	-4000	4000	1608
chr3	179232691	179240691	179234297	8000	179236691	-4000	4000	-2394
chr3	179232691	179240691	179234295	8000	179236691	-4000	4000	-2396
chr3	179232691	179240691	179234297	8000	179236691	-4000	4000	-2394
chr3	56617837	56625837	56623389	8000	56621837	-4000	4000	1552
chr3	48852926	48860926	48858569	8000	48856926	-4000	4000	1643
chr3	186785880	186793880	186786241	8000	186789880	-4000	4000	-3639
chr3	136143894	136151894	136150635	8000	136147894	-4000	4000	2741
chr3	160430954	160438954	160431186	8000	160434954	-4000	4000	-3768
chr3	179232691	179240691	179234297	8000	179236691	-4000	4000	-2394
chr3	196210222	196218222	196210662	8000	196214222	-4000	4000	-3560
chr3	44656791	44664791	44659818	8000	44660791	-4000	4000	-973
chr3	9382791	9390791	9384261	8000	9386791	-4000	4000	-2530
chr3	179232691	179240691	179234297	8000	179236691	-4000	4000	-2394
chr3	179232691	179240691	179234287	8000	179236691	-4000	4000	-2404
chr3	5176911	5184911	5178667	8000	5180911	-4000	4000	-2244
chr3	33146043	33154043	33153021	8000	33150043	-4000	4000	2978
chr3	151433072	151441072	151436886	8000	151437072	-4000	4000	-186
chr3	195564705	195572705	195568853	8000	195568705	-4000	4000	148
chr3	126099562	126107562	126103741	8000	126103562	-4000	4000	179
chr3	142445007	142453007	142450232	8000	142449007	-4000	4000	1225
chr3	5215958	5223958	5216221	8000	5219958	-4000	4000	-3737
chr3	98791941	98799941	98799451	8000	98795941	-4000	4000	3510
chr3	149734472	149742472	149741477	8000	149738472	-4000	4000	3005
chr3	125524858	125532858	125530400	8000	125528858	-4000	4000	1542
chr3	33146043	33154043	33153123	8000	33150043	-4000	4000	3080
chr3	13634422	13642422	13637942	8000	13638422	-4000	4000	-480
chr3	50554025	50562025	50558941	8000	50558025	-4000	4000	916
chr3	143261222	143269222	143265886	8000	143265222	-4000	4000	664
chr3	122877139	122885139	122879397	8000	122881139	-4000	4000	-1742
chr3	88140660	88148660	88142059	8000	88144660	-4000	4000	-2601
chr3	151208117	151216117	151213602	8000	151212117	-4000	4000	1485
chr3	121427431	121435431	121432305	8000	121431431	-4000	4000	874
chr3	50295890	50303890	50303036	8000	50299890	-4000	4000	3146
chr3	121659199	121667199	121664328	8000	121663199	-4000	4000	1129
chr3	3053959	3061959	3056331	8000	3057959	-4000	4000	-1628
chr3	125524858	125532858	125530436	8000	125528858	-4000	4000	1578
chr3	143261222	143269222	143266402	8000	143265222	-4000	4000	1180
chr3	49117114	49125114	49121999	8000	49121114	-4000	4000	885
chr3	179232691	179240691	179234297	8000	179236691	-4000	4000	-2394
chr3	179232691	179240691	179234297	8000	179236691	-4000	4000	-2394
chr3	3140628	3148628	3147453	8000	3144628	-4000	4000	2825
chr3	33146043	33154043	33152667	8000	33150043	-4000	4000	2624
chr3	113438718	113446718	113445292	8000	113442718	-4000	4000	2574
chr3	37046846	37054846	37050508	8000	37050846	-4000	4000	-338
chr3	128475427	128483427	128481014	8000	128479427	-4000	4000	1587
chr3	180613828	180621828	180616837	8000	180617828	-4000	4000	-991
chr3	15556699	15564699	15563461	8000	15560699	-4000	4000	2762
chr3	122337969	122345969	122341549	8000	122341969	-4000	4000	-420
chr3	169762921	169770921	169769470	8000	169766921	-4000	4000	2549
chr3	179232691	179240691	179234297	8000	179236691	-4000	4000	-2394
chr3	179232691	179240691	179234297	8000	179236691	-4000	4000	-2394
chr3	138057990	138065990	138062863	8000	138061990	-4000	4000	873
chr3	184190012	184198012	184191252	8000	184194012	-4000	4000	-2760
chr3	38139022	38147022	38141265	8000	38143022	-4000	4000	-1757
chr3	179232691	179240691	179234297	8000	179236691	-4000	4000	-2394
chr3	3845834	3853834	3845980	8000	3849834	-4000	4000	-3854
chr3	71752496	71760496	71754948	8000	71756496	-4000	4000	-1548
chr3	196239178	196247178	196242002	8000	196243178	-4000	4000	-1176
chr3	14930571	14938571	14933734	8000	14934571	-4000	4000	-837
chr3	149158410	149166410	149160163	8000	149162410	-4000	4000	-2247
chr3	179232691	179240691	179234297	8000	179236691	-4000	4000	-2394
chr3	9833849	9841849	9840606	8000	9837849	-4000	4000	2757
chr3	36822819	36830819	36828230	8000	36826819	-4000	4000	1411
chr3	48513684	48521684	48519790	8000	48517684	-4000	4000	2106
chr3	101562446	101570446	101565721	8000	101566446	-4000	4000	-725
chr3	179232691	179240691	179234297	8000	179236691	-4000	4000	-2394
chr3	186785880	186793880	186787858	8000	186789880	-4000	4000	-2022
chr3	67007210	67015210	67008224	8000	67011210	-4000	4000	-2986
chr3	52210327	52218327	52214093	8000	52214327	-4000	4000	-234
chr3	98791941	98799941	98793701	8000	98795941	-4000	4000	-2240
chr3	128905866	128913866	128912516	8000	128909866	-4000	4000	2650
chr3	156535553	156543553	156543140	8000	156539553	-4000	4000	3587
chr3	169789003	169797003	169793901	8000	169793003	-4000	4000	898
chr3	172626249	172634249	172633520	8000	172630249	-4000	4000	3271
chr3	184331358	184339358	184334749	8000	184335358	-4000	4000	-609
chr3	187368076	187376076	187368465	8000	187372076	-4000	4000	-3611
chr3	3053959	3061959	3056210	8000	3057959	-4000	4000	-1749
chr3	69964336	69972336	69968267	8000	69968336	-4000	4000	-69
chr3	132675794	132683794	132676610	8000	132679794	-4000	4000	-3184
chr3	187074553	187082553	187076989	8000	187078553	-4000	4000	-1564
chr3	197783596	197791596	197791445	8000	197787596	-4000	4000	3849
chr3	128615969	128623969	128622169	8000	128619969	-4000	4000	2200
chr3	68971217	68979217	68977755	8000	68975217	-4000	4000	2538
chr3	52250434	52258434	52256623	8000	52254434	-4000	4000	2189
chr3	158091905	158099905	158098078	8000	158095905	-4000	4000	2173
chr3	169785716	169793716	169786459	8000	169789716	-4000	4000	-3257
chr3	112116839	112124839	112123411	8000	112120839	-4000	4000	2572
chr3	136143894	136151894	136151180	8000	136147894	-4000	4000	3286
chr4	17630105	17638105	17633926	8000	17634105	-4000	4000	-179
chr4	37586800	37594800	37590158	8000	37590800	-4000	4000	-642
chr4	108031241	108039241	108034504	8000	108035241	-4000	4000	-737
chr4	147633785	147641785	147638573	8000	147637785	-4000	4000	788
chr4	185366185	185374185	185370811	8000	185370185	-4000	4000	626
chr4	121031613	121039613	121036836	8000	121035613	-4000	4000	1223
chr4	75810286	75818286	75813341	8000	75814286	-4000	4000	-945
chr4	106917802	106925802	106922078	8000	106921802	-4000	4000	276
chr4	154227742	154235742	154235356	8000	154231742	-4000	4000	3614
chr4	3036760	3044760	3038486	8000	3040760	-4000	4000	-2274
chr4	75637849	75645849	75645661	8000	75641849	-4000	4000	3812
chr4	173520969	173528969	173528750	8000	173524969	-4000	4000	3781
chr4	54736783	54744783	54740364	8000	54740783	-4000	4000	-419
chr4	6880170	6888170	6882835	8000	6884170	-4000	4000	-1335
chr4	2728573	2736573	2731824	8000	2732573	-4000	4000	-749
chr4	38768238	38776238	38775087	8000	38772238	-4000	4000	2849
chr4	73417482	73425482	73419641	8000	73421482	-4000	4000	-1841
chr4	73867308	73875308	73870519	8000	73871308	-4000	4000	-789
chr4	94294535	94302535	94299469	8000	94298535	-4000	4000	934
chr4	110613423	110621423	110621202	8000	110617423	-4000	4000	3779
chr4	108031241	108039241	108034393	8000	108035241	-4000	4000	-848
chr4	89110901	89118901	89113094	8000	89114901	-4000	4000	-1807
chr4	107949461	107957461	107950353	8000	107953461	-4000	4000	-3108
chr4	185366185	185374185	185370745	8000	185370185	-4000	4000	560
chr4	15066153	15074153	15066319	8000	15070153	-4000	4000	-3834
chr4	52862835	52870835	52865539	8000	52866835	-4000	4000	-1296
chr4	1807479	1815479	1808445	8000	1811479	-4000	4000	-3034
chr4	102881048	102889048	102887435	8000	102885048	-4000	4000	2387
chr4	15442167	15450167	15442850	8000	15446167	-4000	4000	-3317
chr4	109684622	109692622	109689386	8000	109688622	-4000	4000	764
chr4	40242967	40250967	40243407	8000	40246967	-4000	4000	-3560
chr4	121820329	121828329	121822496	8000	121824329	-4000	4000	-1833
chr4	109684622	109692622	109690897	8000	109688622	-4000	4000	2275
chr4	3435913	3443913	3439531	8000	3439913	-4000	4000	-382
chr4	73867308	73875308	73869978	8000	73871308	-4000	4000	-1330
chr4	110009766	110017766	110011416	8000	110013766	-4000	4000	-2350
chr4	155213078	155221078	155214861	8000	155217078	-4000	4000	-2217
chr4	112438621	112446621	112439753	8000	112442621	-4000	4000	-2868
chr4	6316578	6324578	6320688	8000	6320578	-4000	4000	110
chr4	69291050	69299050	69294556	8000	69295050	-4000	4000	-494
chr4	182799024	182807024	182799854	8000	182803024	-4000	4000	-3170
chr4	121812444	121820444	121819430	8000	121816444	-4000	4000	2986
chr4	163319962	163327962	163326027	8000	163323962	-4000	4000	2065
chr4	55591229	55599229	55592157	8000	55595229	-4000	4000	-3072
chr4	152975671	152983671	152975965	8000	152979671	-4000	4000	-3706
chr4	122740942	122748942	122743099	8000	122744942	-4000	4000	-1843
chr4	20616561	20624561	20617472	8000	20620561	-4000	4000	-3089
chr4	183445064	183453064	183446790	8000	183449064	-4000	4000	-2274
chr4	70478997	70486997	70481284	8000	70482997	-4000	4000	-1713
chr4	152975671	152983671	152976603	8000	152979671	-4000	4000	-3068
chr4	70247474	70255474	70249489	8000	70251474	-4000	4000	-1985
chr4	10435880	10443880	10443175	8000	10439880	-4000	4000	3295
chr4	165339164	165347164	165340539	8000	165343164	-4000	4000	-2625
chr4	184690963	184698963	184691706	8000	184694963	-4000	4000	-3257
chr4	105678627	105686627	105679254	8000	105682627	-4000	4000	-3373
chr4	13536830	13544830	13542289	8000	13540830	-4000	4000	1459
chr4	134192333	134200333	134200229	8000	134196333	-4000	4000	3896
chr4	163319962	163327962	163324343	8000	163323962	-4000	4000	381
chr4	184623696	184631696	184631065	8000	184627696	-4000	4000	3369
chr4	87979532	87987532	87982647	8000	87983532	-4000	4000	-885
chr4	117079554	117087554	117084712	8000	117083554	-4000	4000	1158
chr4	117079554	117087554	117084714	8000	117083554	-4000	4000	1160
chr4	75997275	76005275	76003518	8000	76001275	-4000	4000	2243
chr4	47589999	47597999	47595659	8000	47593999	-4000	4000	1660
chr4	117079554	117087554	117085073	8000	117083554	-4000	4000	1519
chr4	76110659	76118659	76117667	8000	76114659	-4000	4000	3008
chr4	183316777	183324777	183319758	8000	183320777	-4000	4000	-1019
chr4	121812444	121820444	121813991	8000	121816444	-4000	4000	-2453
chr4	154227742	154235742	154235710	8000	154231742	-4000	4000	3968
chr4	155213078	155221078	155213943	8000	155217078	-4000	4000	-3135
chr4	38135175	38143175	38137433	8000	38139175	-4000	4000	-1742
chr4	82479170	82487170	82485463	8000	82483170	-4000	4000	2293
chr4	159356174	159364174	159358160	8000	159360174	-4000	4000	-2014
chr4	89110901	89118901	89113753	8000	89114901	-4000	4000	-1148
chr4	121812444	121820444	121816691	8000	121816444	-4000	4000	247
chr4	70642824	70650824	70644373	8000	70646824	-4000	4000	-2451
chr4	74093040	74101040	74099105	8000	74097040	-4000	4000	2065
chr4	173520969	173528969	173528786	8000	173524969	-4000	4000	3817
chr4	5810305	5818305	5811128	8000	5814305	-4000	4000	-3177
chr4	83257536	83265536	83264241	8000	83261536	-4000	4000	2705
chr4	81083370	81091370	81089801	8000	81087370	-4000	4000	2431
chr4	102247080	102255080	102253387	8000	102251080	-4000	4000	2307
chr4	122894236	122902236	122897428	8000	122898236	-4000	4000	-808
chr4	165494547	165502547	165497657	8000	165498547	-4000	4000	-890
chr4	37586800	37594800	37591050	8000	37590800	-4000	4000	250
chr4	87979532	87987532	87982877	8000	87983532	-4000	4000	-655
chr4	7961310	7969310	7967060	8000	7965310	-4000	4000	1750
chr4	70363158	70371158	70366709	8000	70367158	-4000	4000	-449
chr4	99272369	99280369	99279476	8000	99276369	-4000	4000	3107
chr4	100181870	100189870	100187776	8000	100185870	-4000	4000	1906
chr4	110613423	110621423	110618644	8000	110617423	-4000	4000	1221
chr4	121663946	121671946	121668330	8000	121667946	-4000	4000	384
chr4	139712753	139720753	139719484	8000	139716753	-4000	4000	2731
chr4	184383729	184391729	184388819	8000	184387729	-4000	4000	1090
chr4	119291518	119299518	119292769	8000	119295518	-4000	4000	-2749
chr4	25674748	25682748	25676214	8000	25678748	-4000	4000	-2534
chr4	110613423	110621423	110618578	8000	110617423	-4000	4000	1155
chr4	16497541	16505541	16503076	8000	16501541	-4000	4000	1535
chr4	25743433	25751433	25748440	8000	25747433	-4000	4000	1007
chr4	182799024	182807024	182799727	8000	182803024	-4000	4000	-3297
chr4	118276038	118284038	118283058	8000	118280038	-4000	4000	3020
chr4	55423903	55431903	55425576	8000	55427903	-4000	4000	-2327
chr4	82915969	82923969	82918276	8000	82919969	-4000	4000	-1693
chr4	108031241	108039241	108033190	8000	108035241	-4000	4000	-2051
chr4	185155665	185163665	185162624	8000	185159665	-4000	4000	2959
chr4	7961310	7969310	7967019	8000	7965310	-4000	4000	1709
chr4	125488932	125496932	125490865	8000	125492932	-4000	4000	-2067
chr4	70642824	70650824	70642926	8000	70646824	-4000	4000	-3898
chr4	174486175	174494175	174491573	8000	174490175	-4000	4000	1398
chr4	105678627	105686627	105680114	8000	105682627	-4000	4000	-2513
chr4	87979532	87987532	87981541	8000	87983532	-4000	4000	-1991
chr4	25743433	25751433	25748230	8000	25747433	-4000	4000	797
chr4	15442167	15450167	15442703	8000	15446167	-4000	4000	-3464
chr4	75637849	75645849	75645516	8000	75641849	-4000	4000	3667
chr4	151666504	151674504	151671161	8000	151670504	-4000	4000	657
chr4	118276038	118284038	118283068	8000	118280038	-4000	4000	3030
chr4	16497541	16505541	16502775	8000	16501541	-4000	4000	1234
chr4	15686447	15694447	15688632	8000	15690447	-4000	4000	-1815
chr4	154579128	154587128	154584303	8000	154583128	-4000	4000	1175
chr4	7961310	7969310	7966387	8000	7965310	-4000	4000	1077
chr4	38768238	38776238	38775028	8000	38772238	-4000	4000	2790
chr4	163319962	163327962	163325876	8000	163323962	-4000	4000	1914
chr4	102070812	102078812	102071275	8000	102074812	-4000	4000	-3537
chr4	121820329	121828329	121822607	8000	121824329	-4000	4000	-1722
chr4	4859936	4867936	4862698	8000	4863936	-4000	4000	-1238
chr4	139712753	139720753	139719522	8000	139716753	-4000	4000	2769
chr4	127895224	127903224	127898584	8000	127899224	-4000	4000	-640
chr4	155213078	155221078	155214470	8000	155217078	-4000	4000	-2608
chr4	70478997	70486997	70481598	8000	70482997	-4000	4000	-1399
chr4	70478997	70486997	70481599	8000	70482997	-4000	4000	-1398
chr4	150253438	150261438	150257344	8000	150257438	-4000	4000	-94
chr4	89950629	89958629	89953151	8000	89954629	-4000	4000	-1478
chr4	117079554	117087554	117084538	8000	117083554	-4000	4000	984
chr4	117079554	117087554	117084539	8000	117083554	-4000	4000	985
chr4	185396628	185404628	185396948	8000	185400628	-4000	4000	-3680
chr4	17840865	17848865	17845729	8000	17844865	-4000	4000	864
chr4	125488932	125496932	125490272	8000	125492932	-4000	4000	-2660
chr4	121820329	121828329	121828059	8000	121824329	-4000	4000	3730
chr4	89110901	89118901	89113094	8000	89114901	-4000	4000	-1807
chr4	47931977	47939977	47936669	8000	47935977	-4000	4000	692
chr4	173520969	173528969	173528951	8000	173524969	-4000	4000	3982
chr4	123399760	123407760	123402465	8000	123403760	-4000	4000	-1295
chr4	70386244	70394244	70389693	8000	70390244	-4000	4000	-551
chr4	185396628	185404628	185396908	8000	185400628	-4000	4000	-3720
chr4	69476165	69484165	69480645	8000	69480165	-4000	4000	480
chr4	147633785	147641785	147638662	8000	147637785	-4000	4000	877
chr4	47931977	47939977	47936405	8000	47935977	-4000	4000	428
chr4	106917802	106925802	106924276	8000	106921802	-4000	4000	2474
chr4	15686447	15694447	15689095	8000	15690447	-4000	4000	-1352
chr4	114674225	114682225	114676562	8000	114678225	-4000	4000	-1663
chr4	169090259	169098259	169095286	8000	169094259	-4000	4000	1027
chr4	182799024	182807024	182802215	8000	182803024	-4000	4000	-809
chr4	76110659	76118659	76115437	8000	76114659	-4000	4000	778
chr4	15686447	15694447	15689269	8000	15690447	-4000	4000	-1178
chr4	38768238	38776238	38775476	8000	38772238	-4000	4000	3238
chr4	169090259	169098259	169096657	8000	169094259	-4000	4000	2398
chr4	52016706	52024706	52017470	8000	52020706	-4000	4000	-3236
chr4	78540269	78548269	78540884	8000	78544269	-4000	4000	-3385
chr4	140384453	140392453	140392309	8000	140388453	-4000	4000	3856
chr4	76017118	76025118	76022807	8000	76021118	-4000	4000	1689
chr4	158705127	158713127	158709551	8000	158709127	-4000	4000	424
chr4	165319156	165327156	165322131	8000	165323156	-4000	4000	-1025
chr4	4859936	4867936	4862758	8000	4863936	-4000	4000	-1178
chr4	87332515	87340515	87337332	8000	87336515	-4000	4000	817
chr4	153702260	153710260	153704905	8000	153706260	-4000	4000	-1355
chr4	87979532	87987532	87983067	8000	87983532	-4000	4000	-465
chr4	154227742	154235742	154234466	8000	154231742	-4000	4000	2724
chr4	147540954	147548954	147542626	8000	147544954	-4000	4000	-2328
chr4	109536896	109544896	109539655	8000	109540896	-4000	4000	-1241
chr4	112270537	112278537	112278366	8000	112274537	-4000	4000	3829
chr4	68493604	68501604	68497135	8000	68497604	-4000	4000	-469
chr4	75637849	75645849	75645615	8000	75641849	-4000	4000	3766
chr4	48493357	48501357	48494141	8000	48497357	-4000	4000	-3216
chr4	82915969	82923969	82918520	8000	82919969	-4000	4000	-1449
chr4	421815	429815	426702	8000	425815	-4000	4000	887
chr4	105678627	105686627	105679776	8000	105682627	-4000	4000	-2851
chr4	47589999	47597999	47595893	8000	47593999	-4000	4000	1894
chr4	183316777	183324777	183318561	8000	183320777	-4000	4000	-2216
chr4	102790383	102798383	102797384	8000	102794383	-4000	4000	3001
chr4	128218931	128226931	128222451	8000	128222931	-4000	4000	-480
chr4	174329380	174337380	174331637	8000	174333380	-4000	4000	-1743
chr4	3036760	3044760	3037409	8000	3040760	-4000	4000	-3351
chr4	10435880	10443880	10443592	8000	10439880	-4000	4000	3712
chr4	73739716	73747716	73741670	8000	73743716	-4000	4000	-2046
chr4	125488932	125496932	125490873	8000	125492932	-4000	4000	-2059
chr4	70386244	70394244	70389970	8000	70390244	-4000	4000	-274
chr4	84208	92208	86681	8000	88208	-4000	4000	-1527
chr4	112535333	112543333	112539930	8000	112539333	-4000	4000	597
chr4	183508429	183516429	183510711	8000	183512429	-4000	4000	-1718
chr4	185396628	185404628	185399920	8000	185400628	-4000	4000	-708
chr4	186583794	186591794	186588455	8000	186587794	-4000	4000	661
chr4	87808435	87816435	87811925	8000	87812435	-4000	4000	-510
chr4	182799024	182807024	182799954	8000	182803024	-4000	4000	-3070
chr4	140384453	140392453	140389155	8000	140388453	-4000	4000	702
chr4	122884697	122892697	122892216	8000	122888697	-4000	4000	3519
chr4	69476165	69484165	69480487	8000	69480165	-4000	4000	322
chr4	70363158	70371158	70367074	8000	70367158	-4000	4000	-84
chr4	40806027	40814027	40808780	8000	40810027	-4000	4000	-1247
chr4	94294535	94302535	94302174	8000	94298535	-4000	4000	3639
chr4	158120474	158128474	158127408	8000	158124474	-4000	4000	2934
chr4	4859936	4867936	4862841	8000	4863936	-4000	4000	-1095
chr4	73069376	73077376	73076946	8000	73073376	-4000	4000	3570
chr4	15686447	15694447	15687878	8000	15690447	-4000	4000	-2569
chr4	3239957	3247957	3241480	8000	3243957	-4000	4000	-2477
chr4	75637849	75645849	75645166	8000	75641849	-4000	4000	3317
chr4	56520959	56528959	56523740	8000	56524959	-4000	4000	-1219
chr4	121663946	121671946	121668326	8000	121667946	-4000	4000	380
chr4	16497541	16505541	16502650	8000	16501541	-4000	4000	1109
chr4	27021381	27029381	27023103	8000	27025381	-4000	4000	-2278
chr4	74299099	74307099	74301755	8000	74303099	-4000	4000	-1344
chr4	26752223	26760223	26755103	8000	26756223	-4000	4000	-1120
chr4	54736783	54744783	54739954	8000	54740783	-4000	4000	-829
chr4	88439097	88447097	88442469	8000	88443097	-4000	4000	-628
chr4	186583794	186591794	186588375	8000	186587794	-4000	4000	581
chr4	8362282	8370282	8367066	8000	8366282	-4000	4000	784
chr4	39281810	39289810	39288407	8000	39285810	-4000	4000	2597
chr4	112535333	112543333	112539939	8000	112539333	-4000	4000	606
chr4	73069376	73077376	73076263	8000	73073376	-4000	4000	2887
chr4	99542709	99550709	99549170	8000	99546709	-4000	4000	2461
chr4	113896284	113904284	113902814	8000	113900284	-4000	4000	2530
chr4	168352735	168360735	168358081	8000	168356735	-4000	4000	1346
chr4	39818863	39826863	39825248	8000	39822863	-4000	4000	2385
chr4	175628934	175636934	175633261	8000	175632934	-4000	4000	327
chr4	5810305	5818305	5810394	8000	5814305	-4000	4000	-3911
chr4	15442167	15450167	15442596	8000	15446167	-4000	4000	-3571
chr4	185441182	185449182	185445458	8000	185445182	-4000	4000	276
chr4	117079554	117087554	117085071	8000	117083554	-4000	4000	1517
chr4	52862835	52870835	52865433	8000	52866835	-4000	4000	-1402
chr4	68642597	68650597	68647215	8000	68646597	-4000	4000	618
chr4	121812444	121820444	121817051	8000	121816444	-4000	4000	607
chr4	185581444	185589444	185586224	8000	185585444	-4000	4000	780
chr4	113380221	113388221	113381607	8000	113384221	-4000	4000	-2614
chr4	125488932	125496932	125491263	8000	125492932	-4000	4000	-1669
chr4	165273812	165281812	165279458	8000	165277812	-4000	4000	1646
chr4	127895224	127903224	127898516	8000	127899224	-4000	4000	-708
chr4	185496660	185504660	185502281	8000	185500660	-4000	4000	1621
chr4	3764526	3772526	3767967	8000	3768526	-4000	4000	-559
chr4	20724606	20732606	20730096	8000	20728606	-4000	4000	1490
chr4	82625539	82633539	82631357	8000	82629539	-4000	4000	1818
chr4	112535333	112543333	112539493	8000	112539333	-4000	4000	160
chr4	148074762	148082762	148081429	8000	148078762	-4000	4000	2667
chr4	151666504	151674504	151671007	8000	151670504	-4000	4000	503
chr4	121663946	121671946	121669701	8000	121667946	-4000	4000	1755
chr4	157362075	157370075	157363675	8000	157366075	-4000	4000	-2400
chr4	176679538	176687538	176683968	8000	176683538	-4000	4000	430
chr4	94664227	94672227	94666442	8000	94668227	-4000	4000	-1785
chr4	175628934	175636934	175634232	8000	175632934	-4000	4000	1298
chr4	137514918	137522918	137521396	8000	137518918	-4000	4000	2478
chr4	75637849	75645849	75645636	8000	75641849	-4000	4000	3787
chr4	125488932	125496932	125490765	8000	125492932	-4000	4000	-2167
chr4	15066153	15074153	15066475	8000	15070153	-4000	4000	-3678
chr4	87808435	87816435	87811967	8000	87812435	-4000	4000	-468
chr4	139712753	139720753	139719522	8000	139716753	-4000	4000	2769
chr4	3036760	3044760	3038374	8000	3040760	-4000	4000	-2386
chr4	421815	429815	426026	8000	425815	-4000	4000	211
chr4	17630105	17638105	17635066	8000	17634105	-4000	4000	961
chr4	140616782	140624782	140624355	8000	140620782	-4000	4000	3573
chr4	80200329	80208329	80202051	8000	80204329	-4000	4000	-2278
chr4	165273812	165281812	165278599	8000	165277812	-4000	4000	787
chr4	83455517	83463517	83462590	8000	83459517	-4000	4000	3073
chr4	163319962	163327962	163326533	8000	163323962	-4000	4000	2571
chr4	6880170	6888170	6880995	8000	6884170	-4000	4000	-3175
chr4	38135175	38143175	38137148	8000	38139175	-4000	4000	-2027
chr4	40242967	40250967	40243461	8000	40246967	-4000	4000	-3506
chr4	48493357	48501357	48494201	8000	48497357	-4000	4000	-3156
chr4	75810286	75818286	75813255	8000	75814286	-4000	4000	-1031
chr4	76017118	76025118	76021716	8000	76021118	-4000	4000	598
chr4	78540269	78548269	78540974	8000	78544269	-4000	4000	-3295
chr4	117079554	117087554	117084442	8000	117083554	-4000	4000	888
chr4	125488932	125496932	125490177	8000	125492932	-4000	4000	-2755
chr4	137514918	137522918	137521455	8000	137518918	-4000	4000	2537
chr4	169719673	169727673	169720014	8000	169723673	-4000	4000	-3659
chr4	173327376	173335376	173331892	8000	173331376	-4000	4000	516
chr4	185496660	185504660	185502359	8000	185500660	-4000	4000	1699
chr4	154568807	154576807	154570653	8000	154572807	-4000	4000	-2154
chr4	7961310	7969310	7965571	8000	7965310	-4000	4000	261
chr4	54736783	54744783	54739435	8000	54740783	-4000	4000	-1348
chr4	82418565	82426565	82425598	8000	82422565	-4000	4000	3033
chr4	119490397	119498397	119498356	8000	119494397	-4000	4000	3959
chr4	121820329	121828329	121823592	8000	121824329	-4000	4000	-737
chr4	122740942	122748942	122742394	8000	122744942	-4000	4000	-2548
chr4	150260435	150268435	150265033	8000	150264435	-4000	4000	598
chr4	154227742	154235742	154235290	8000	154231742	-4000	4000	3548
chr4	99944086	99952086	99949720	8000	99948086	-4000	4000	1634
chr4	54291272	54299272	54295128	8000	54295272	-4000	4000	-144
chr4	53455301	53463301	53461528	8000	53459301	-4000	4000	2227
chr4	121031613	121039613	121036073	8000	121035613	-4000	4000	460
chr4	84208	92208	86632	8000	88208	-4000	4000	-1576
chr4	44678200	44686200	44680531	8000	44682200	-4000	4000	-1669
chr4	110009766	110017766	110011454	8000	110013766	-4000	4000	-2312
chr4	165319156	165327156	165322113	8000	165323156	-4000	4000	-1043
chr4	55423903	55431903	55425395	8000	55427903	-4000	4000	-2508
chr4	76110659	76118659	76115213	8000	76114659	-4000	4000	554
chr4	85998668	86006668	86000545	8000	86002668	-4000	4000	-2123
chr4	87808435	87816435	87811940	8000	87812435	-4000	4000	-495
chr4	121031613	121039613	121037640	8000	121035613	-4000	4000	2027
chr4	55901086	55909086	55902440	8000	55905086	-4000	4000	-2646
chr4	25925813	25933813	25929190	8000	25929813	-4000	4000	-623
chr4	54291272	54299272	54295359	8000	54295272	-4000	4000	87
chr4	70200576	70208576	70203200	8000	70204576	-4000	4000	-1376
chr4	421815	429815	426385	8000	425815	-4000	4000	570
chr4	27021381	27029381	27023470	8000	27025381	-4000	4000	-1911
chr4	38135175	38143175	38137438	8000	38139175	-4000	4000	-1737
chr4	44678200	44686200	44678667	8000	44682200	-4000	4000	-3533
chr4	69291050	69299050	69294791	8000	69295050	-4000	4000	-259
chr4	71568087	71576087	71568194	8000	71572087	-4000	4000	-3893
chr4	75637849	75645849	75643381	8000	75641849	-4000	4000	1532
chr4	85998668	86006668	86000774	8000	86002668	-4000	4000	-1894
chr4	113380221	113388221	113382948	8000	113384221	-4000	4000	-1273
chr4	137514918	137522918	137519751	8000	137518918	-4000	4000	833
chr4	158705127	158713127	158706189	8000	158709127	-4000	4000	-2938
chr4	163347934	163355934	163351793	8000	163351934	-4000	4000	-141
chr4	165273812	165281812	165278493	8000	165277812	-4000	4000	681
chr4	177358936	177366936	177360652	8000	177362936	-4000	4000	-2284
chr4	421815	429815	427106	8000	425815	-4000	4000	1291
chr4	16156505	16164505	16163438	8000	16160505	-4000	4000	2933
chr4	20724606	20732606	20727380	8000	20728606	-4000	4000	-1226
chr4	37858937	37866937	37861820	8000	37862937	-4000	4000	-1117
chr4	54291272	54299272	54295225	8000	54295272	-4000	4000	-47
chr4	70642824	70650824	70643273	8000	70646824	-4000	4000	-3551
chr4	73417482	73425482	73420270	8000	73421482	-4000	4000	-1212
chr4	112438621	112446621	112440989	8000	112442621	-4000	4000	-1632
chr4	122360167	122368167	122362272	8000	122364167	-4000	4000	-1895
chr4	143553486	143561486	143560001	8000	143557486	-4000	4000	2515
chr4	173373532	173381532	173373943	8000	173377532	-4000	4000	-3589
chr4	74384749	74392749	74388640	8000	74388749	-4000	4000	-109
chr4	78912365	78920365	78919908	8000	78916365	-4000	4000	3543
chr4	153632711	153640711	153635567	8000	153636711	-4000	4000	-1144
chr4	154568807	154576807	154570483	8000	154572807	-4000	4000	-2324
chr4	88439097	88447097	88442396	8000	88443097	-4000	4000	-701
chr4	73867308	73875308	73869693	8000	73871308	-4000	4000	-1615
chr4	112653696	112661696	112654140	8000	112657696	-4000	4000	-3556
chr4	6316578	6324578	6323244	8000	6320578	-4000	4000	2666
chr4	110613423	110621423	110618303	8000	110617423	-4000	4000	880
chr4	108663820	108671820	108667752	8000	108667820	-4000	4000	-68
chr4	185496660	185504660	185502291	8000	185500660	-4000	4000	1631
chr4	140616782	140624782	140622425	8000	140620782	-4000	4000	1643
chr4	184751595	184759595	184757674	8000	184755595	-4000	4000	2079
chr4	117079554	117087554	117085316	8000	117083554	-4000	4000	1762
chr4	153702260	153710260	153703595	8000	153706260	-4000	4000	-2665
chr4	15686447	15694447	15688212	8000	15690447	-4000	4000	-2235
chr4	40242967	40250967	40243214	8000	40246967	-4000	4000	-3753
chr4	70200576	70208576	70202287	8000	70204576	-4000	4000	-2289
chr4	176679538	176687538	176687271	8000	176683538	-4000	4000	3733
chr4	137514918	137522918	137521211	8000	137518918	-4000	4000	2293
chr4	20724606	20732606	20730052	8000	20728606	-4000	4000	1446
chr4	44678200	44686200	44680841	8000	44682200	-4000	4000	-1359
chr4	106917802	106925802	106924045	8000	106921802	-4000	4000	2243
chr4	16497541	16505541	16502788	8000	16501541	-4000	4000	1247
chr4	70478997	70486997	70481303	8000	70482997	-4000	4000	-1694
chr4	70247474	70255474	70249009	8000	70251474	-4000	4000	-2465
chr4	154579128	154587128	154586547	8000	154583128	-4000	4000	3419
chr4	40419267	40427267	40425954	8000	40423267	-4000	4000	2687
chr4	69942574	69950574	69944987	8000	69946574	-4000	4000	-1587
chr4	83455517	83463517	83462331	8000	83459517	-4000	4000	2814
chr4	88721955	88729955	88728548	8000	88725955	-4000	4000	2593
chr4	163319962	163327962	163326129	8000	163323962	-4000	4000	2167
chr4	47446787	47454787	47451625	8000	47450787	-4000	4000	838
chr4	421815	429815	426299	8000	425815	-4000	4000	484
chr4	15686447	15694447	15687584	8000	15690447	-4000	4000	-2863
chr4	89110901	89118901	89113707	8000	89114901	-4000	4000	-1194
chr4	56520959	56528959	56523758	8000	56524959	-4000	4000	-1201
chr4	72276969	72284969	72283247	8000	72280969	-4000	4000	2278
chr4	99866190	99874190	99868292	8000	99870190	-4000	4000	-1898
chr4	110613423	110621423	110618024	8000	110617423	-4000	4000	601
chr4	109684622	109692622	109689434	8000	109688622	-4000	4000	812
chr4	70247474	70255474	70249366	8000	70251474	-4000	4000	-2108
chr4	55449397	55457397	55453674	8000	55453397	-4000	4000	277
chr4	154579128	154587128	154586796	8000	154583128	-4000	4000	3668
chr4	48493357	48501357	48499092	8000	48497357	-4000	4000	1735
chr4	17796655	17804655	17804107	8000	17800655	-4000	4000	3452
chr4	154579128	154587128	154585766	8000	154583128	-4000	4000	2638
chr4	154227742	154235742	154235526	8000	154231742	-4000	4000	3784
chr4	16497541	16505541	16502675	8000	16501541	-4000	4000	1134
chr4	147668044	147676044	147673720	8000	147672044	-4000	4000	1676
chr4	76308997	76316997	76313085	8000	76312997	-4000	4000	88
chr4	154227742	154235742	154234860	8000	154231742	-4000	4000	3118
chr4	48493357	48501357	48494278	8000	48497357	-4000	4000	-3079
chr4	100181870	100189870	100187695	8000	100185870	-4000	4000	1825
chr4	163319962	163327962	163325987	8000	163323962	-4000	4000	2025
chr4	70478997	70486997	70481505	8000	70482997	-4000	4000	-1492
chr4	121812444	121820444	121816435	8000	121816444	-4000	4000	-9
chr4	69951256	69959256	69957516	8000	69955256	-4000	4000	2260
chr4	154568807	154576807	154569534	8000	154572807	-4000	4000	-3273
chr4	117079554	117087554	117084488	8000	117083554	-4000	4000	934
chr4	173520969	173528969	173528627	8000	173524969	-4000	4000	3658
chr4	101019409	101027409	101025702	8000	101023409	-4000	4000	2293
chr4	16156505	16164505	16162441	8000	16160505	-4000	4000	1936
chr4	70642824	70650824	70644353	8000	70646824	-4000	4000	-2471
chr4	84208	92208	87066	8000	88208	-4000	4000	-1142
chr4	84208	92208	87161	8000	88208	-4000	4000	-1047
chr4	421815	429815	426410	8000	425815	-4000	4000	595
chr4	421815	429815	427062	8000	425815	-4000	4000	1247
chr4	1162932	1170932	1167616	8000	1166932	-4000	4000	684
chr4	3435913	3443913	3439607	8000	3439913	-4000	4000	-306
chr4	15686447	15694447	15686925	8000	15690447	-4000	4000	-3522
chr4	15686447	15694447	15688910	8000	15690447	-4000	4000	-1537
chr4	20616561	20624561	20618994	8000	20620561	-4000	4000	-1567
chr4	20616561	20624561	20619081	8000	20620561	-4000	4000	-1480
chr4	38768238	38776238	38775050	8000	38772238	-4000	4000	2812
chr4	40806027	40814027	40808986	8000	40810027	-4000	4000	-1041
chr4	55423903	55431903	55425442	8000	55427903	-4000	4000	-2461
chr4	70386244	70394244	70389717	8000	70390244	-4000	4000	-527
chr4	70642824	70650824	70644475	8000	70646824	-4000	4000	-2349
chr4	71018449	71026449	71022465	8000	71022449	-4000	4000	16
chr4	73069376	73077376	73076146	8000	73073376	-4000	4000	2770
chr4	76154737	76162737	76161484	8000	76158737	-4000	4000	2747
chr4	80200329	80208329	80202018	8000	80204329	-4000	4000	-2311
chr4	82479170	82487170	82485522	8000	82483170	-4000	4000	2352
chr4	82905973	82913973	82907784	8000	82909973	-4000	4000	-2189
chr4	82915969	82923969	82918160	8000	82919969	-4000	4000	-1809
chr4	83455517	83463517	83455716	8000	83459517	-4000	4000	-3801
chr4	83601875	83609875	83604814	8000	83605875	-4000	4000	-1061
chr4	104464308	104472308	104472222	8000	104468308	-4000	4000	3914
chr4	112270537	112278537	112277984	8000	112274537	-4000	4000	3447
chr4	112535333	112543333	112539586	8000	112539333	-4000	4000	253
chr4	118276038	118284038	118281933	8000	118280038	-4000	4000	1895
chr4	121031613	121039613	121036546	8000	121035613	-4000	4000	933
chr4	125488932	125496932	125490289	8000	125492932	-4000	4000	-2643
chr4	127895224	127903224	127898557	8000	127899224	-4000	4000	-667
chr4	137514918	137522918	137521038	8000	137518918	-4000	4000	2120
chr4	139041939	139049939	139045153	8000	139045939	-4000	4000	-786
chr4	139712753	139720753	139719787	8000	139716753	-4000	4000	3034
chr4	141729987	141737987	141732799	8000	141733987	-4000	4000	-1188
chr4	152975671	152983671	152975672	8000	152979671	-4000	4000	-3999
chr4	153776591	153784591	153781335	8000	153780591	-4000	4000	744
chr4	158705127	158713127	158710829	8000	158709127	-4000	4000	1702
chr4	163319962	163327962	163326470	8000	163323962	-4000	4000	2508
chr4	166100457	166108457	166100981	8000	166104457	-4000	4000	-3476
chr4	168352735	168360735	168358025	8000	168356735	-4000	4000	1290
chr4	168924457	168932457	168926368	8000	168928457	-4000	4000	-2089
chr4	173520969	173528969	173528782	8000	173524969	-4000	4000	3813
chr4	177426774	177434774	177431676	8000	177430774	-4000	4000	902
chr4	185366185	185374185	185370653	8000	185370185	-4000	4000	468
chr4	82479170	82487170	82485360	8000	82483170	-4000	4000	2190
chr4	20616561	20624561	20617131	8000	20620561	-4000	4000	-3430
chr4	153702260	153710260	153705099	8000	153706260	-4000	4000	-1161
chr4	73452174	73460174	73453859	8000	73456174	-4000	4000	-2315
chr4	99272369	99280369	99279446	8000	99276369	-4000	4000	3077
chr4	99272369	99280369	99279448	8000	99276369	-4000	4000	3079
chr4	153702260	153710260	153705109	8000	153706260	-4000	4000	-1151
chr4	173319967	173327967	173321719	8000	173323967	-4000	4000	-2248
chr4	87979532	87987532	87980071	8000	87983532	-4000	4000	-3461
chr4	112438621	112446621	112440970	8000	112442621	-4000	4000	-1651
chr4	421815	429815	426095	8000	425815	-4000	4000	280
chr4	4263701	4271701	4267920	8000	4267701	-4000	4000	219
chr4	5744084	5752084	5745299	8000	5748084	-4000	4000	-2785
chr4	8362282	8370282	8366971	8000	8366282	-4000	4000	689
chr4	15686447	15694447	15688962	8000	15690447	-4000	4000	-1485
chr4	17603972	17611972	17607437	8000	17607972	-4000	4000	-535
chr4	17837199	17845199	17839781	8000	17841199	-4000	4000	-1418
chr4	17840865	17848865	17842341	8000	17844865	-4000	4000	-2524
chr4	17840865	17848865	17843433	8000	17844865	-4000	4000	-1432
chr4	38768238	38776238	38774887	8000	38772238	-4000	4000	2649
chr4	39448587	39456587	39454596	8000	39452587	-4000	4000	2009
chr4	40806027	40814027	40809001	8000	40810027	-4000	4000	-1026
chr4	44678200	44686200	44680735	8000	44682200	-4000	4000	-1465
chr4	47931977	47939977	47936432	8000	47935977	-4000	4000	455
chr4	52016706	52024706	52024016	8000	52020706	-4000	4000	3310
chr4	56962808	56970808	56968401	8000	56966808	-4000	4000	1593
chr4	70231252	70239252	70233022	8000	70235252	-4000	4000	-2230
chr4	70478997	70486997	70481740	8000	70482997	-4000	4000	-1257
chr4	70642824	70650824	70644979	8000	70646824	-4000	4000	-1845
chr4	72276969	72284969	72283623	8000	72280969	-4000	4000	2654
chr4	73069376	73077376	73076167	8000	73073376	-4000	4000	2791
chr4	73739716	73747716	73742644	8000	73743716	-4000	4000	-1072
chr4	74093040	74101040	74098806	8000	74097040	-4000	4000	1766
chr4	75475033	75483033	75482410	8000	75479033	-4000	4000	3377
chr4	75810286	75818286	75813381	8000	75814286	-4000	4000	-905
chr4	82814509	82822509	82818985	8000	82818509	-4000	4000	476
chr4	89110901	89118901	89112889	8000	89114901	-4000	4000	-2012
chr4	89110901	89118901	89113274	8000	89114901	-4000	4000	-1627
chr4	89110901	89118901	89114271	8000	89114901	-4000	4000	-630
chr4	95154448	95162448	95154631	8000	95158448	-4000	4000	-3817
chr4	100181870	100189870	100187735	8000	100185870	-4000	4000	1865
chr4	100181870	100189870	100187868	8000	100185870	-4000	4000	1998
chr4	101019409	101027409	101026021	8000	101023409	-4000	4000	2612
chr4	102247080	102255080	102253271	8000	102251080	-4000	4000	2191
chr4	106917802	106925802	106924526	8000	106921802	-4000	4000	2724
chr4	108043545	108051545	108048513	8000	108047545	-4000	4000	968
chr4	112269110	112277110	112276356	8000	112273110	-4000	4000	3246
chr4	112270537	112278537	112278252	8000	112274537	-4000	4000	3715
chr4	112535333	112543333	112539503	8000	112539333	-4000	4000	170
chr4	113896284	113904284	113902692	8000	113900284	-4000	4000	2408
chr4	113896284	113904284	113903505	8000	113900284	-4000	4000	3221
chr4	114674225	114682225	114675989	8000	114678225	-4000	4000	-2236
chr4	114674225	114682225	114675990	8000	114678225	-4000	4000	-2235
chr4	121820329	121828329	121820982	8000	121824329	-4000	4000	-3347
chr4	128871224	128879224	128871721	8000	128875224	-4000	4000	-3503
chr4	139041939	139049939	139045355	8000	139045939	-4000	4000	-584
chr4	139262880	139270880	139267023	8000	139266880	-4000	4000	143
chr4	140384453	140392453	140390682	8000	140388453	-4000	4000	2229
chr4	141729987	141737987	141733048	8000	141733987	-4000	4000	-939
chr4	154227742	154235742	154234734	8000	154231742	-4000	4000	2992
chr4	154600134	154608134	154604223	8000	154604134	-4000	4000	89
chr4	154600134	154608134	154604960	8000	154604134	-4000	4000	826
chr4	157362075	157370075	157362920	8000	157366075	-4000	4000	-3155
chr4	166100457	166108457	166101005	8000	166104457	-4000	4000	-3452
chr4	176178818	176186818	176184670	8000	176182818	-4000	4000	1852
chr4	184623696	184631696	184629292	8000	184627696	-4000	4000	1596
chr4	184751595	184759595	184757685	8000	184755595	-4000	4000	2090
chr4	185359872	185367872	185363496	8000	185363872	-4000	4000	-376
chr4	185396628	185404628	185399825	8000	185400628	-4000	4000	-803
chr4	15686447	15694447	15688434	8000	15690447	-4000	4000	-2013
chr4	70231252	70239252	70233022	8000	70235252	-4000	4000	-2230
chr4	70642824	70650824	70644004	8000	70646824	-4000	4000	-2820
chr4	87156103	87164103	87163939	8000	87160103	-4000	4000	3836
chr4	105678627	105686627	105682954	8000	105682627	-4000	4000	327
chr4	122740942	122748942	122742981	8000	122744942	-4000	4000	-1961
chr4	127913799	127921799	127921541	8000	127917799	-4000	4000	3742
chr4	165273812	165281812	165277997	8000	165277812	-4000	4000	185
chr4	41696044	41704044	41697349	8000	41700044	-4000	4000	-2695
chr4	76029682	76037682	76035094	8000	76033682	-4000	4000	1412
chr4	71568087	71576087	71571544	8000	71572087	-4000	4000	-543
chr4	168924457	168932457	168926235	8000	168928457	-4000	4000	-2222
chr4	39481109	39489109	39481298	8000	39485109	-4000	4000	-3811
chr4	117079554	117087554	117085071	8000	117083554	-4000	4000	1517
chr4	83455517	83463517	83456015	8000	83459517	-4000	4000	-3502
chr4	87979532	87987532	87981578	8000	87983532	-4000	4000	-1954
chr4	112270537	112278537	112277890	8000	112274537	-4000	4000	3353
chr4	113896284	113904284	113902496	8000	113900284	-4000	4000	2212
chr4	1162932	1170932	1167586	8000	1166932	-4000	4000	654
chr4	25116014	25124014	25123925	8000	25120014	-4000	4000	3911
chr4	121031613	121039613	121037363	8000	121035613	-4000	4000	1750
chr4	185496660	185504660	185504580	8000	185500660	-4000	4000	3920
chr4	175628934	175636934	175634843	8000	175632934	-4000	4000	1909
chr4	75936950	75944950	75940248	8000	75940950	-4000	4000	-702
chr4	15066153	15074153	15066207	8000	15070153	-4000	4000	-3946
chr4	183445064	183453064	183446523	8000	183449064	-4000	4000	-2541
chr4	52016706	52024706	52017310	8000	52020706	-4000	4000	-3396
chr4	102626770	102634770	102631817	8000	102630770	-4000	4000	1047
chr4	118276038	118284038	118282114	8000	118280038	-4000	4000	2076
chr4	127913799	127921799	127921718	8000	127917799	-4000	4000	3919
chr4	38768238	38776238	38773958	8000	38772238	-4000	4000	1720
chr4	8303098	8311098	8304244	8000	8307098	-4000	4000	-2854
chr4	168924457	168932457	168925069	8000	168928457	-4000	4000	-3388
chr4	15066153	15074153	15066396	8000	15070153	-4000	4000	-3757
chr4	109820740	109828740	109824718	8000	109824740	-4000	4000	-22
chr4	155213078	155221078	155214773	8000	155217078	-4000	4000	-2305
chr4	75810286	75818286	75810481	8000	75814286	-4000	4000	-3805
chr4	99542709	99550709	99549220	8000	99546709	-4000	4000	2511
chr4	5496994	5504994	5499154	8000	5500994	-4000	4000	-1840
chr4	31142805	31150805	31143043	8000	31146805	-4000	4000	-3762
chr4	83455517	83463517	83461020	8000	83459517	-4000	4000	1503
chr4	87808435	87816435	87810615	8000	87812435	-4000	4000	-1820
chr4	88516998	88524998	88521770	8000	88520998	-4000	4000	772
chr4	110613423	110621423	110618622	8000	110617423	-4000	4000	1199
chr4	147633785	147641785	147633841	8000	147637785	-4000	4000	-3944
chr4	152975671	152983671	152975783	8000	152979671	-4000	4000	-3888
chr4	153702260	153710260	153703676	8000	153706260	-4000	4000	-2584
chr4	153702260	153710260	153704814	8000	153706260	-4000	4000	-1446
chr4	173520969	173528969	173528906	8000	173524969	-4000	4000	3937
chr4	47589999	47597999	47591215	8000	47593999	-4000	4000	-2784
chr4	80200329	80208329	80203494	8000	80204329	-4000	4000	-835
chr4	70478997	70486997	70480883	8000	70482997	-4000	4000	-2114
chr4	72276969	72284969	72283640	8000	72280969	-4000	4000	2671
chr4	84208	92208	86353	8000	88208	-4000	4000	-1855
chr4	102881048	102889048	102887435	8000	102885048	-4000	4000	2387
chr4	119291518	119299518	119292351	8000	119295518	-4000	4000	-3167
chr4	125488932	125496932	125490771	8000	125492932	-4000	4000	-2161
chr4	183316777	183324777	183319606	8000	183320777	-4000	4000	-1171
chr4	86811171	86819171	86814555	8000	86815171	-4000	4000	-616
chr4	84208	92208	87307	8000	88208	-4000	4000	-901
chr4	163347934	163355934	163351744	8000	163351934	-4000	4000	-190
chr4	173520969	173528969	173527029	8000	173524969	-4000	4000	2060
chr4	74093040	74101040	74097611	8000	74097040	-4000	4000	571
chr4	154227742	154235742	154235155	8000	154231742	-4000	4000	3413
chr4	1162932	1170932	1167466	8000	1166932	-4000	4000	534
chr4	48131783	48139783	48138994	8000	48135783	-4000	4000	3211
chr4	173520969	173528969	173528750	8000	173524969	-4000	4000	3781
chr4	166100457	166108457	166101022	8000	166104457	-4000	4000	-3435
chr4	421815	429815	426418	8000	425815	-4000	4000	603
chr4	38768238	38776238	38775241	8000	38772238	-4000	4000	3003
chr4	99944086	99952086	99950220	8000	99948086	-4000	4000	2134
chr4	139712753	139720753	139719494	8000	139716753	-4000	4000	2741
chr4	71568087	71576087	71568769	8000	71572087	-4000	4000	-3318
chr4	173319967	173327967	173322232	8000	173323967	-4000	4000	-1735
chr4	68493604	68501604	68497135	8000	68497604	-4000	4000	-469
chr4	82915969	82923969	82917716	8000	82919969	-4000	4000	-2253
chr4	89110901	89118901	89114472	8000	89114901	-4000	4000	-429
chr4	48493357	48501357	48494260	8000	48497357	-4000	4000	-3097
chr4	75810286	75818286	75813291	8000	75814286	-4000	4000	-995
chr4	105678627	105686627	105680038	8000	105682627	-4000	4000	-2589
chr4	69942574	69950574	69944922	8000	69946574	-4000	4000	-1652
chr4	184623696	184631696	184628942	8000	184627696	-4000	4000	1246
chr4	121812444	121820444	121816806	8000	121816444	-4000	4000	362
chr4	83455517	83463517	83456083	8000	83459517	-4000	4000	-3434
chr4	105678627	105686627	105683297	8000	105682627	-4000	4000	670
chr4	74093040	74101040	74098799	8000	74097040	-4000	4000	1759
chr4	89110901	89118901	89113729	8000	89114901	-4000	4000	-1172
chr4	101019409	101027409	101025862	8000	101023409	-4000	4000	2453
chr4	13536830	13544830	13542187	8000	13540830	-4000	4000	1357
chr4	110613423	110621423	110618490	8000	110617423	-4000	4000	1067
chr4	15442167	15450167	15442469	8000	15446167	-4000	4000	-3698
chr4	186583794	186591794	186588395	8000	186587794	-4000	4000	601
chr4	121031613	121039613	121037198	8000	121035613	-4000	4000	1585
chr4	47931977	47939977	47937271	8000	47935977	-4000	4000	1294
chr4	10435880	10443880	10443590	8000	10439880	-4000	4000	3710
chr4	40242967	40250967	40243922	8000	40246967	-4000	4000	-3045
chr4	73739716	73747716	73742593	8000	73743716	-4000	4000	-1123
chr4	69476165	69484165	69480892	8000	69480165	-4000	4000	727
chr4	74451005	74459005	74452619	8000	74455005	-4000	4000	-2386
chr4	117079554	117087554	117085071	8000	117083554	-4000	4000	1517
chr4	117079554	117087554	117085073	8000	117083554	-4000	4000	1519
chr4	154579128	154587128	154586551	8000	154583128	-4000	4000	3423
chr4	75046115	75054115	75046303	8000	75050115	-4000	4000	-3812
chr4	15959076	15967076	15963066	8000	15963076	-4000	4000	-10
chr4	77948785	77956785	77952554	8000	77952785	-4000	4000	-231
chr4	77036384	77044384	77037710	8000	77040384	-4000	4000	-2674
chr4	69476165	69484165	69480828	8000	69480165	-4000	4000	663
chr4	98439858	98447858	98442206	8000	98443858	-4000	4000	-1652
chr4	81083370	81091370	81089590	8000	81087370	-4000	4000	2220
chr4	143553486	143561486	143560012	8000	143557486	-4000	4000	2526
chr4	38941739	38949739	38943586	8000	38945739	-4000	4000	-2153
chr4	47931977	47939977	47936678	8000	47935977	-4000	4000	701
chr4	110613423	110621423	110621173	8000	110617423	-4000	4000	3750
chr4	10435880	10443880	10442997	8000	10439880	-4000	4000	3117
chr4	20616561	20624561	20617065	8000	20620561	-4000	4000	-3496
chr4	39481109	39489109	39481183	8000	39485109	-4000	4000	-3926
chr4	56959350	56967350	56963616	8000	56963350	-4000	4000	266
chr4	76017118	76025118	76022797	8000	76021118	-4000	4000	1679
chr4	88691913	88699913	88697511	8000	88695913	-4000	4000	1598
chr4	99300971	99308971	99307799	8000	99304971	-4000	4000	2828
chr4	114674225	114682225	114675928	8000	114678225	-4000	4000	-2297
chr4	163347934	163355934	163350421	8000	163351934	-4000	4000	-1513
chr4	185359872	185367872	185361934	8000	185363872	-4000	4000	-1938
chr4	16156505	16164505	16162447	8000	16160505	-4000	4000	1942
chr4	128871224	128879224	128871460	8000	128875224	-4000	4000	-3764
chr4	165273812	165281812	165278541	8000	165277812	-4000	4000	729
chr4	118276038	118284038	118279415	8000	118280038	-4000	4000	-623
chr4	145106838	145114838	145110148	8000	145110838	-4000	4000	-690
chr4	174486175	174494175	174491282	8000	174490175	-4000	4000	1107
chr4	176178818	176186818	176179569	8000	176182818	-4000	4000	-3249
chr4	17837199	17845199	17837295	8000	17841199	-4000	4000	-3904
chr4	108031241	108039241	108034296	8000	108035241	-4000	4000	-945
chr5	55108971	55116971	55110154	8000	55112971	-4000	4000	-2817
chr5	69346984	69354984	69351995	8000	69350984	-4000	4000	1011
chr5	141172383	141180383	141173798	8000	141176383	-4000	4000	-2585
chr5	132186147	132194147	132193011	8000	132190147	-4000	4000	2864
chr5	141172383	141180383	141179421	8000	141176383	-4000	4000	3038
chr5	74717206	74725206	74718870	8000	74721206	-4000	4000	-2336
chr5	116439555	116447555	116446480	8000	116443555	-4000	4000	2925
chr5	7855159	7863159	7859464	8000	7859159	-4000	4000	305
chr5	58449982	58457982	58454967	8000	58453982	-4000	4000	985
chr5	139383467	139391467	139387847	8000	139387467	-4000	4000	380
chr5	141094703	141102703	141095223	8000	141098703	-4000	4000	-3480
chr5	141149287	141157287	141150682	8000	141153287	-4000	4000	-2605
chr5	150049291	150057291	150050437	8000	150053291	-4000	4000	-2854
chr5	150109839	150117839	150115873	8000	150113839	-4000	4000	2034
chr5	160389148	160397148	160394035	8000	160393148	-4000	4000	887
chr5	181231808	181239808	181239273	8000	181235808	-4000	4000	3465
chr5	141099827	141107827	141103096	8000	141103827	-4000	4000	-731
chr5	33983174	33991174	33984504	8000	33987174	-4000	4000	-2670
chr5	42798439	42806439	42799876	8000	42802439	-4000	4000	-2563
chr5	95820383	95828383	95822736	8000	95824383	-4000	4000	-1647
chr5	132857181	132865181	132862378	8000	132861181	-4000	4000	1197
chr5	132857181	132865181	132864248	8000	132861181	-4000	4000	3067
chr5	141149287	141157287	141151624	8000	141153287	-4000	4000	-1663
chr5	141182226	141190226	141189797	8000	141186226	-4000	4000	3571
chr5	147876726	147884726	147882171	8000	147880726	-4000	4000	1445
chr5	163515354	163523354	163517485	8000	163519354	-4000	4000	-1869
chr5	176655054	176663054	176657515	8000	176659054	-4000	4000	-1539
chr5	161895981	161903981	161897276	8000	161899981	-4000	4000	-2705
chr5	76731770	76739770	76732478	8000	76735770	-4000	4000	-3292
chr5	40689735	40697735	40692459	8000	40693735	-4000	4000	-1276
chr5	62343284	62351284	62348096	8000	62347284	-4000	4000	812
chr5	37062413	37070413	37064963	8000	37066413	-4000	4000	-1450
chr5	141008347	141016347	141012312	8000	141012347	-4000	4000	-35
chr5	156848528	156856528	156850719	8000	156852528	-4000	4000	-1809
chr5	67165593	67173593	67166310	8000	67169593	-4000	4000	-3283
chr5	141172383	141180383	141178771	8000	141176383	-4000	4000	2388
chr5	141208571	141216571	141214860	8000	141212571	-4000	4000	2289
chr5	76831315	76839315	76832886	8000	76835315	-4000	4000	-2429
chr5	141172383	141180383	141174126	8000	141176383	-4000	4000	-2257
chr5	171857549	171865549	171863712	8000	171861549	-4000	4000	2163
chr5	134851133	134859133	134855288	8000	134855133	-4000	4000	155
chr5	149350583	149358583	149351223	8000	149354583	-4000	4000	-3360
chr5	155014141	155022141	155016591	8000	155018141	-4000	4000	-1550
chr5	153986148	153994148	153993011	8000	153990148	-4000	4000	2863
chr5	141172383	141180383	141174508	8000	141176383	-4000	4000	-1875
chr5	151177052	151185052	151184442	8000	151181052	-4000	4000	3390
chr5	123340890	123348890	123346301	8000	123344890	-4000	4000	1411
chr5	181231808	181239808	181238277	8000	181235808	-4000	4000	2469
chr5	115120762	115128762	115125014	8000	115124762	-4000	4000	252
chr5	15935795	15943795	15938882	8000	15939795	-4000	4000	-913
chr5	76731770	76739770	76733203	8000	76735770	-4000	4000	-2567
chr5	141214979	141222979	141216873	8000	141218979	-4000	4000	-2106
chr5	42717878	42725878	42721624	8000	42721878	-4000	4000	-254
chr5	141199779	141207779	141200275	8000	141203779	-4000	4000	-3504
chr5	31551053	31559053	31553019	8000	31555053	-4000	4000	-2034
chr5	142150440	142158440	142152064	8000	142154440	-4000	4000	-2376
chr5	157781743	157789743	157789427	8000	157785743	-4000	4000	3684
chr5	160343754	160351754	160349777	8000	160347754	-4000	4000	2023
chr5	40755389	40763389	40760190	8000	40759389	-4000	4000	801
chr5	69226158	69234158	69229389	8000	69230158	-4000	4000	-769
chr5	140125392	140133392	140126983	8000	140129392	-4000	4000	-2409
chr5	153809869	153817869	153811083	8000	153813869	-4000	4000	-2786
chr5	177094144	177102144	177095627	8000	177098144	-4000	4000	-2517
chr5	146335251	146343251	146339602	8000	146339251	-4000	4000	351
chr5	137613500	137621500	137618140	8000	137617500	-4000	4000	640
chr5	112842239	112850239	112843933	8000	112846239	-4000	4000	-2306
chr5	80079287	80087287	80082514	8000	80083287	-4000	4000	-773
chr5	141199779	141207779	141201858	8000	141203779	-4000	4000	-1921
chr5	109865625	109873625	109866936	8000	109869625	-4000	4000	-2689
chr5	140125392	140133392	140127559	8000	140129392	-4000	4000	-1833
chr5	141094703	141102703	141096042	8000	141098703	-4000	4000	-2661
chr5	149350583	149358583	149351033	8000	149354583	-4000	4000	-3550
chr5	123025354	123033354	123028527	8000	123029354	-4000	4000	-827
chr5	120683332	120691332	120686685	8000	120687332	-4000	4000	-647
chr5	69206357	69214357	69209841	8000	69210357	-4000	4000	-516
chr5	177368596	177376596	177372048	8000	177372596	-4000	4000	-548
chr5	81262398	81270398	81266138	8000	81266398	-4000	4000	-260
chr5	141121623	141129623	141122542	8000	141125623	-4000	4000	-3081
chr5	141214979	141222979	141215932	8000	141218979	-4000	4000	-3047
chr5	141849090	141857090	141854041	8000	141853090	-4000	4000	951
chr5	159282036	159290036	159284923	8000	159286036	-4000	4000	-1113
chr5	176876898	176884898	176881440	8000	176880898	-4000	4000	542
chr5	116439555	116447555	116446958	8000	116443555	-4000	4000	3403
chr5	83936554	83944554	83943334	8000	83940554	-4000	4000	2780
chr5	95601102	95609102	95603512	8000	95605102	-4000	4000	-1590
chr5	150704440	150712440	150711268	8000	150708440	-4000	4000	2828
chr5	53879942	53887942	53886606	8000	53883942	-4000	4000	2664
chr5	15935795	15943795	15936571	8000	15939795	-4000	4000	-3224
chr5	16447519	16455519	16453018	8000	16451519	-4000	4000	1499
chr5	115516908	115524908	115524670	8000	115520908	-4000	4000	3762
chr5	141208571	141216571	141209171	8000	141212571	-4000	4000	-3400
chr5	148824623	148832623	148827146	8000	148828623	-4000	4000	-1477
chr5	123613045	123621045	123614967	8000	123617045	-4000	4000	-2078
chr5	176876898	176884898	176880154	8000	176880898	-4000	4000	-744
chr5	141199779	141207779	141201306	8000	141203779	-4000	4000	-2473
chr5	100582741	100590741	100586187	8000	100586741	-4000	4000	-554
chr5	115910081	115918081	115913375	8000	115914081	-4000	4000	-706
chr5	179610178	179618178	179617635	8000	179614178	-4000	4000	3457
chr5	174726896	174734896	174729474	8000	174730896	-4000	4000	-1422
chr5	60747791	60755791	60754448	8000	60751791	-4000	4000	2657
chr5	141099827	141107827	141102971	8000	141103827	-4000	4000	-856
chr5	158691916	158699916	158699098	8000	158695916	-4000	4000	3182
chr5	132857181	132865181	132864510	8000	132861181	-4000	4000	3329
chr5	141008347	141016347	141011655	8000	141012347	-4000	4000	-692
chr5	140641408	140649408	140647588	8000	140645408	-4000	4000	2180
chr5	141172383	141180383	141176369	8000	141176383	-4000	4000	-14
chr5	141182226	141190226	141183486	8000	141186226	-4000	4000	-2740
chr5	141149287	141157287	141152381	8000	141153287	-4000	4000	-906
chr5	141208571	141216571	141211036	8000	141212571	-4000	4000	-1535
chr5	181231808	181239808	181238141	8000	181235808	-4000	4000	2333
chr5	96386333	96394333	96392726	8000	96390333	-4000	4000	2393
chr5	151657096	151665096	151662683	8000	151661096	-4000	4000	1587
chr5	130182634	130190634	130185036	8000	130186634	-4000	4000	-1598
chr5	160245083	160253083	160252727	8000	160249083	-4000	4000	3644
chr5	62577446	62585446	62580232	8000	62581446	-4000	4000	-1214
chr5	15935795	15943795	15936761	8000	15939795	-4000	4000	-3034
chr5	141149287	141157287	141157124	8000	141153287	-4000	4000	3837
chr5	132688628	132696628	132693048	8000	132692628	-4000	4000	420
chr5	141008347	141016347	141011232	8000	141012347	-4000	4000	-1115
chr5	141176539	141184539	141180422	8000	141180539	-4000	4000	-117
chr5	34901260	34909260	34908583	8000	34905260	-4000	4000	3323
chr5	37808677	37816677	37815807	8000	37812677	-4000	4000	3130
chr5	76611482	76619482	76618146	8000	76615482	-4000	4000	2664
chr5	128185677	128193677	128186647	8000	128189677	-4000	4000	-3030
chr5	131421891	131429891	131428971	8000	131425891	-4000	4000	3080
chr5	141008347	141016347	141011346	8000	141012347	-4000	4000	-1001
chr5	151266440	151274440	151267341	8000	151270440	-4000	4000	-3099
chr5	171453626	171461626	171456734	8000	171457626	-4000	4000	-892
chr5	180843611	180851611	180849755	8000	180847611	-4000	4000	2144
chr5	141191647	141199647	141193897	8000	141195647	-4000	4000	-1750
chr5	154813605	154821605	154814020	8000	154817605	-4000	4000	-3585
chr5	178598664	178606664	178603416	8000	178602664	-4000	4000	752
chr5	55215564	55223564	55220472	8000	55219564	-4000	4000	908
chr5	141182226	141190226	141185021	8000	141186226	-4000	4000	-1205
chr5	3597403	3605403	3601031	8000	3601403	-4000	4000	-372
chr5	179106853	179114853	179113926	8000	179110853	-4000	4000	3073
chr5	141121623	141129623	141123379	8000	141125623	-4000	4000	-2244
chr5	140554268	140562268	140560315	8000	140558268	-4000	4000	2047
chr5	35875603	35883603	35876168	8000	35879603	-4000	4000	-3435
chr5	160424739	160432739	160427729	8000	160428739	-4000	4000	-1010
chr5	141182226	141190226	141188564	8000	141186226	-4000	4000	2338
chr5	176591802	176599802	176599311	8000	176595802	-4000	4000	3509
chr5	96386333	96394333	96393018	8000	96390333	-4000	4000	2685
chr5	34921996	34929996	34923228	8000	34925996	-4000	4000	-2768
chr5	141182226	141190226	141184812	8000	141186226	-4000	4000	-1414
chr5	134723909	134731909	134725019	8000	134727909	-4000	4000	-2890
chr5	32787724	32795724	32789246	8000	32791724	-4000	4000	-2478
chr5	141172383	141180383	141173460	8000	141176383	-4000	4000	-2923
chr5	141172383	141180383	141174813	8000	141176383	-4000	4000	-1570
chr5	150438635	150446635	150445619	8000	150442635	-4000	4000	2984
chr5	141191647	141199647	141194874	8000	141195647	-4000	4000	-773
chr5	149365653	149373653	149368052	8000	149369653	-4000	4000	-1601
chr5	141649401	141657401	141654360	8000	141653401	-4000	4000	959
chr5	160389148	160397148	160395105	8000	160393148	-4000	4000	1957
chr5	111492033	111500033	111499987	8000	111496033	-4000	4000	3954
chr5	141199779	141207779	141200529	8000	141203779	-4000	4000	-3250
chr5	75021346	75029346	75029266	8000	75025346	-4000	4000	3920
chr5	94699690	94707690	94707380	8000	94703690	-4000	4000	3690
chr5	154883411	154891411	154888197	8000	154887411	-4000	4000	786
chr5	138248380	138256380	138253836	8000	138252380	-4000	4000	1456
chr5	179031064	179039064	179032847	8000	179035064	-4000	4000	-2217
chr5	139842779	139850779	139847858	8000	139846779	-4000	4000	1079
chr5	141149287	141157287	141156713	8000	141153287	-4000	4000	3426
chr5	141208571	141216571	141210430	8000	141212571	-4000	4000	-2141
chr5	141121623	141129623	141124282	8000	141125623	-4000	4000	-1341
chr5	132857181	132865181	132864551	8000	132861181	-4000	4000	3370
chr5	141134615	141142615	141136316	8000	141138615	-4000	4000	-2299
chr5	138281269	138289269	138285805	8000	138285269	-4000	4000	536
chr5	38941596	38949596	38944948	8000	38945596	-4000	4000	-648
chr5	66078546	66086546	66078962	8000	66082546	-4000	4000	-3584
chr5	73086522	73094522	73089292	8000	73090522	-4000	4000	-1230
chr5	73501667	73509667	73502501	8000	73505667	-4000	4000	-3166
chr5	78773209	78781209	78780340	8000	78777209	-4000	4000	3131
chr5	93590611	93598611	93593621	8000	93594611	-4000	4000	-990
chr5	115263190	115271190	115267869	8000	115267190	-4000	4000	679
chr5	156848528	156856528	156850621	8000	156852528	-4000	4000	-1907
chr5	156848528	156856528	156850718	8000	156852528	-4000	4000	-1810
chr5	156848528	156856528	156850951	8000	156852528	-4000	4000	-1577
chr5	163515354	163523354	163516871	8000	163519354	-4000	4000	-2483
chr5	179773283	179781283	179774274	8000	179777283	-4000	4000	-3009
chr5	138183650	138191650	138186353	8000	138187650	-4000	4000	-1297
chr5	141094703	141102703	141100645	8000	141098703	-4000	4000	1942
chr5	141094703	141102703	141101237	8000	141098703	-4000	4000	2534
chr5	146106566	146114566	146114223	8000	146110566	-4000	4000	3657
chr5	138549756	138557756	138555896	8000	138553756	-4000	4000	2140
chr5	60747791	60755791	60752308	8000	60751791	-4000	4000	517
chr5	141134615	141142615	141137480	8000	141138615	-4000	4000	-1135
chr5	79684246	79692246	79685856	8000	79688246	-4000	4000	-2390
chr5	141149287	141157287	141151263	8000	141153287	-4000	4000	-2024
chr5	134579230	134587230	134579738	8000	134583230	-4000	4000	-3492
chr5	141094703	141102703	141096506	8000	141098703	-4000	4000	-2197
chr5	179610178	179618178	179616880	8000	179614178	-4000	4000	2702
chr5	181231808	181239808	181237008	8000	181235808	-4000	4000	1200
chr5	141182226	141190226	141184995	8000	141186226	-4000	4000	-1231
chr5	163515354	163523354	163517556	8000	163519354	-4000	4000	-1798
chr5	7826081	7834081	7826814	8000	7830081	-4000	4000	-3267
chr5	33464091	33472091	33467721	8000	33468091	-4000	4000	-370
chr5	141149287	141157287	141151910	8000	141153287	-4000	4000	-1377
chr5	43440252	43448252	43446412	8000	43444252	-4000	4000	2160
chr5	55106252	55114252	55107794	8000	55110252	-4000	4000	-2458
chr5	123025354	123033354	123028621	8000	123029354	-4000	4000	-733
chr5	150890392	150898392	150895245	8000	150894392	-4000	4000	853
chr5	151266440	151274440	151267560	8000	151270440	-4000	4000	-2880
chr5	141134615	141142615	141137765	8000	141138615	-4000	4000	-850
chr5	141191647	141199647	141193773	8000	141195647	-4000	4000	-1874
chr5	129110028	129118028	129112906	8000	129114028	-4000	4000	-1122
chr5	42798439	42806439	42800417	8000	42802439	-4000	4000	-2022
chr5	81309297	81317297	81312841	8000	81313297	-4000	4000	-456
chr5	141134615	141142615	141136515	8000	141138615	-4000	4000	-2100
chr5	155014141	155022141	155016422	8000	155018141	-4000	4000	-1719
chr5	32120716	32128716	32126527	8000	32124716	-4000	4000	1811
chr5	36188589	36196589	36194992	8000	36192589	-4000	4000	2403
chr5	40980643	40988643	40981394	8000	40984643	-4000	4000	-3249
chr5	160389148	160397148	160395370	8000	160393148	-4000	4000	2222
chr5	185972	193972	192266	8000	189972	-4000	4000	2294
chr5	79796240	79804240	79799436	8000	79800240	-4000	4000	-804
chr5	151025945	151033945	151028195	8000	151029945	-4000	4000	-1750
chr5	160343754	160351754	160349456	8000	160347754	-4000	4000	1702
chr5	168515301	168523301	168519108	8000	168519301	-4000	4000	-193
chr5	172205646	172213646	172211970	8000	172209646	-4000	4000	2324
chr5	88713117	88721117	88721115	8000	88717117	-4000	4000	3998
chr5	115574642	115582642	115580699	8000	115578642	-4000	4000	2057
chr5	132818141	132826141	132824034	8000	132822141	-4000	4000	1893
chr5	134579230	134587230	134581031	8000	134583230	-4000	4000	-2199
chr5	31396494	31404494	31401506	8000	31400494	-4000	4000	1012
chr5	41726065	41734065	41731741	8000	41730065	-4000	4000	1676
chr5	94699690	94707690	94707437	8000	94703690	-4000	4000	3747
chr5	160343754	160351754	160349205	8000	160347754	-4000	4000	1451
chr5	141149287	141157287	141150195	8000	141153287	-4000	4000	-3092
chr5	132746819	132754819	132751145	8000	132750819	-4000	4000	326
chr5	141199779	141207779	141200050	8000	141203779	-4000	4000	-3729
chr5	1313752	1321752	1320710	8000	1317752	-4000	4000	2958
chr5	141149287	141157287	141151092	8000	141153287	-4000	4000	-2195
chr5	170242233	170250233	170248542	8000	170246233	-4000	4000	2309
chr5	179106853	179114853	179113887	8000	179110853	-4000	4000	3034
chr5	185972	193972	191592	8000	189972	-4000	4000	1620
chr5	36031021	36039021	36035864	8000	36035021	-4000	4000	843
chr5	155014141	155022141	155014247	8000	155018141	-4000	4000	-3894
chr5	32787724	32795724	32789508	8000	32791724	-4000	4000	-2216
chr5	34921996	34929996	34922885	8000	34925996	-4000	4000	-3111
chr5	77421970	77429970	77426686	8000	77425970	-4000	4000	716
chr5	109865625	109873625	109866956	8000	109869625	-4000	4000	-2669
chr5	141182226	141190226	141183245	8000	141186226	-4000	4000	-2981
chr5	141182226	141190226	141184680	8000	141186226	-4000	4000	-1546
chr5	177593242	177601242	177593652	8000	177597242	-4000	4000	-3590
chr5	141182226	141190226	141182764	8000	141186226	-4000	4000	-3462
chr5	141182226	141190226	141184717	8000	141186226	-4000	4000	-1509
chr5	126492494	126500494	126493211	8000	126496494	-4000	4000	-3283
chr5	72435903	72443903	72443853	8000	72439903	-4000	4000	3950
chr5	141094703	141102703	141102368	8000	141098703	-4000	4000	3665
chr5	138135770	138143770	138140838	8000	138139770	-4000	4000	1068
chr5	140328843	140336843	140333588	8000	140332843	-4000	4000	745
chr5	141214979	141222979	141215855	8000	141218979	-4000	4000	-3124
chr5	176876898	176884898	176881171	8000	176880898	-4000	4000	273
chr5	41726065	41734065	41731732	8000	41730065	-4000	4000	1667
chr5	175880021	175888021	175882344	8000	175884021	-4000	4000	-1677
chr5	663168	671168	666115	8000	667168	-4000	4000	-1053
chr5	38941596	38949596	38944499	8000	38945596	-4000	4000	-1097
chr5	172205646	172213646	172212030	8000	172209646	-4000	4000	2384
chr5	151096706	151104706	151103646	8000	151100706	-4000	4000	2940
chr5	43703405	43711405	43704314	8000	43707405	-4000	4000	-3091
chr5	132857181	132865181	132861809	8000	132861181	-4000	4000	628
chr5	141149287	141157287	141152490	8000	141153287	-4000	4000	-797
chr5	128185677	128193677	128187719	8000	128189677	-4000	4000	-1958
chr5	141214979	141222979	141215968	8000	141218979	-4000	4000	-3011
chr5	141182226	141190226	141184903	8000	141186226	-4000	4000	-1323
chr5	141214979	141222979	141215657	8000	141218979	-4000	4000	-3322
chr5	62577446	62585446	62580039	8000	62581446	-4000	4000	-1407
chr5	141182226	141190226	141183261	8000	141186226	-4000	4000	-2965
chr5	141214979	141222979	141215599	8000	141218979	-4000	4000	-3380
chr5	170079382	170087382	170080235	8000	170083382	-4000	4000	-3147
chr5	38461480	38469480	38464064	8000	38465480	-4000	4000	-1416
chr5	90511611	90519611	90519419	8000	90515611	-4000	4000	3808
chr5	149488982	149496982	149496813	8000	149492982	-4000	4000	3831
chr5	141094703	141102703	141097050	8000	141098703	-4000	4000	-1653
chr5	135003959	135011959	135010470	8000	135007959	-4000	4000	2511
chr5	141182226	141190226	141187586	8000	141186226	-4000	4000	1360
chr5	141149287	141157287	141151992	8000	141153287	-4000	4000	-1295
chr5	141134615	141142615	141137012	8000	141138615	-4000	4000	-1603
chr5	140641408	140649408	140647481	8000	140645408	-4000	4000	2073
chr5	141008347	141016347	141010130	8000	141012347	-4000	4000	-2217
chr5	141208571	141216571	141210038	8000	141212571	-4000	4000	-2533
chr5	141121623	141129623	141123660	8000	141125623	-4000	4000	-1963
chr5	149488982	149496982	149495793	8000	149492982	-4000	4000	2811
chr5	67165593	67173593	67165645	8000	67169593	-4000	4000	-3948
chr5	141172383	141180383	141179538	8000	141176383	-4000	4000	3155
chr5	135440226	135448226	135446905	8000	135444226	-4000	4000	2679
chr5	10675230	10683230	10681087	8000	10679230	-4000	4000	1857
chr5	76731770	76739770	76732463	8000	76735770	-4000	4000	-3307
chr5	155014141	155022141	155015988	8000	155018141	-4000	4000	-2153
chr5	139679882	139687882	139680989	8000	139683882	-4000	4000	-2893
chr5	132857181	132865181	132861571	8000	132861181	-4000	4000	390
chr5	69174245	69182245	69175064	8000	69178245	-4000	4000	-3181
chr5	136971298	136979298	136978716	8000	136975298	-4000	4000	3418
chr5	141134615	141142615	141136503	8000	141138615	-4000	4000	-2112
chr5	141208571	141216571	141214876	8000	141212571	-4000	4000	2305
chr5	141616876	141624876	141621171	8000	141620876	-4000	4000	295
chr5	32600079	32608079	32601079	8000	32604079	-4000	4000	-3000
chr5	161895981	161903981	161897176	8000	161899981	-4000	4000	-2805
chr5	141191647	141199647	141193670	8000	141195647	-4000	4000	-1977
chr5	168515301	168523301	168516842	8000	168519301	-4000	4000	-2459
chr5	155014141	155022141	155014560	8000	155018141	-4000	4000	-3581
chr5	77687166	77695166	77693281	8000	77691166	-4000	4000	2115
chr5	90454209	90462209	90460086	8000	90458209	-4000	4000	1877
chr5	174726896	174734896	174729266	8000	174730896	-4000	4000	-1630
chr5	140641408	140649408	140644701	8000	140645408	-4000	4000	-707
chr5	141191647	141199647	141193103	8000	141195647	-4000	4000	-2544
chr5	141172383	141180383	141179343	8000	141176383	-4000	4000	2960
chr5	141208571	141216571	141210962	8000	141212571	-4000	4000	-1609
chr5	141182226	141190226	141184796	8000	141186226	-4000	4000	-1430
chr5	91160437	91168437	91163975	8000	91164437	-4000	4000	-462
chr5	179031064	179039064	179032856	8000	179035064	-4000	4000	-2208
chr5	154872792	154880792	154875360	8000	154876792	-4000	4000	-1432
chr5	141172383	141180383	141173569	8000	141176383	-4000	4000	-2814
chr5	34828612	34836612	34832440	8000	34832612	-4000	4000	-172
chr5	35044756	35052756	35049317	8000	35048756	-4000	4000	561
chr5	36684334	36692334	36686386	8000	36688334	-4000	4000	-1948
chr5	141208571	141216571	141210180	8000	141212571	-4000	4000	-2391
chr5	146106566	146114566	146114041	8000	146110566	-4000	4000	3475
chr5	155014141	155022141	155014681	8000	155018141	-4000	4000	-3460
chr5	90511611	90519611	90518958	8000	90515611	-4000	4000	3347
chr5	130182634	130190634	130184709	8000	130186634	-4000	4000	-1925
chr5	192868	200868	195161	8000	196868	-4000	4000	-1707
chr5	31551053	31559053	31553020	8000	31555053	-4000	4000	-2033
chr5	141121623	141129623	141122543	8000	141125623	-4000	4000	-3080
chr5	128253909	128261909	128259265	8000	128257909	-4000	4000	1356
chr5	179834078	179842078	179840940	8000	179838078	-4000	4000	2862
chr5	35875603	35883603	35875691	8000	35879603	-4000	4000	-3912
chr5	40689735	40697735	40692004	8000	40693735	-4000	4000	-1731
chr5	83936554	83944554	83943061	8000	83940554	-4000	4000	2507
chr5	96386333	96394333	96390756	8000	96390333	-4000	4000	423
chr5	138281269	138289269	138286603	8000	138285269	-4000	4000	1334
chr5	180229143	180237143	180236360	8000	180233143	-4000	4000	3217
chr5	181231808	181239808	181237279	8000	181235808	-4000	4000	1471
chr5	138281269	138289269	138285781	8000	138285269	-4000	4000	512
chr5	178233476	178241476	178238556	8000	178237476	-4000	4000	1080
chr5	180843611	180851611	180849790	8000	180847611	-4000	4000	2179
chr5	141199779	141207779	141201994	8000	141203779	-4000	4000	-1785
chr5	141094703	141102703	141101204	8000	141098703	-4000	4000	2501
chr5	141214979	141222979	141216586	8000	141218979	-4000	4000	-2393
chr5	161284429	161292429	161289301	8000	161288429	-4000	4000	872
chr5	53483134	53491134	53483721	8000	53487134	-4000	4000	-3413
chr5	141172383	141180383	141179576	8000	141176383	-4000	4000	3193
chr5	83633805	83641805	83641459	8000	83637805	-4000	4000	3654
chr5	176655054	176663054	176657515	8000	176659054	-4000	4000	-1539
chr5	42717878	42725878	42719764	8000	42721878	-4000	4000	-2114
chr5	73548190	73556190	73552435	8000	73552190	-4000	4000	245
chr5	122071570	122079570	122075441	8000	122075570	-4000	4000	-129
chr5	141094703	141102703	141095831	8000	141098703	-4000	4000	-2872
chr5	141199779	141207779	141201562	8000	141203779	-4000	4000	-2217
chr5	40755389	40763389	40762956	8000	40759389	-4000	4000	3567
chr5	65661928	65669928	65669751	8000	65665928	-4000	4000	3823
chr5	122071570	122079570	122077509	8000	122075570	-4000	4000	1939
chr5	141191647	141199647	141192784	8000	141195647	-4000	4000	-2863
chr5	134851133	134859133	134855713	8000	134855133	-4000	4000	580
chr5	141121623	141129623	141122922	8000	141125623	-4000	4000	-2701
chr5	103544855	103552855	103552417	8000	103548855	-4000	4000	3562
chr5	62343284	62351284	62348070	8000	62347284	-4000	4000	786
chr5	141208571	141216571	141210695	8000	141212571	-4000	4000	-1876
chr5	141182226	141190226	141184962	8000	141186226	-4000	4000	-1264
chr5	192868	200868	195029	8000	196868	-4000	4000	-1839
chr5	55163297	55171297	55164230	8000	55167297	-4000	4000	-3067
chr5	58449982	58457982	58456558	8000	58453982	-4000	4000	2576
chr5	76731770	76739770	76732475	8000	76735770	-4000	4000	-3295
chr5	93590611	93598611	93593969	8000	93594611	-4000	4000	-642
chr5	96775595	96783595	96776868	8000	96779595	-4000	4000	-2727
chr5	112842239	112850239	112843117	8000	112846239	-4000	4000	-3122
chr5	130182634	130190634	130185536	8000	130186634	-4000	4000	-1098
chr5	132857181	132865181	132864567	8000	132861181	-4000	4000	3386
chr5	138183650	138191650	138184632	8000	138187650	-4000	4000	-3018
chr5	141099827	141107827	141103073	8000	141103827	-4000	4000	-754
chr5	146507961	146515961	146510487	8000	146511961	-4000	4000	-1474
chr5	172764096	172772096	172768584	8000	172768096	-4000	4000	488
chr5	133192455	133200455	133199271	8000	133196455	-4000	4000	2816
chr5	169600778	169608778	169601375	8000	169604778	-4000	4000	-3403
chr5	1313752	1321752	1320650	8000	1317752	-4000	4000	2898
chr5	13686328	13694328	13691962	8000	13690328	-4000	4000	1634
chr5	32106932	32114932	32109002	8000	32110932	-4000	4000	-1930
chr5	67175613	67183613	67182987	8000	67179613	-4000	4000	3374
chr5	67175613	67183613	67183453	8000	67179613	-4000	4000	3840
chr5	103274660	103282660	103277032	8000	103278660	-4000	4000	-1628
chr5	160389148	160397148	160394580	8000	160393148	-4000	4000	1432
chr5	180843611	180851611	180849354	8000	180847611	-4000	4000	1743
chr5	181231808	181239808	181238243	8000	181235808	-4000	4000	2435
chr5	181231808	181239808	181239078	8000	181235808	-4000	4000	3270
chr5	141172383	141180383	141175116	8000	141176383	-4000	4000	-1267
chr5	168526634	168534634	168530366	8000	168530634	-4000	4000	-268
chr5	134388108	134396108	134390882	8000	134392108	-4000	4000	-1226
chr5	160389148	160397148	160394005	8000	160393148	-4000	4000	857
chr5	161284429	161292429	161290060	8000	161288429	-4000	4000	1631
chr5	132269454	132277454	132272168	8000	132273454	-4000	4000	-1286
chr5	180574358	180582358	180574594	8000	180578358	-4000	4000	-3764
chr5	141094703	141102703	141095160	8000	141098703	-4000	4000	-3543
chr5	58449982	58457982	58455311	8000	58453982	-4000	4000	1329
chr5	75352345	75360345	75354535	8000	75356345	-4000	4000	-1810
chr5	132871395	132879395	132874033	8000	132875395	-4000	4000	-1362
chr5	151266440	151274440	151267144	8000	151270440	-4000	4000	-3296
chr5	40689735	40697735	40692291	8000	40693735	-4000	4000	-1444
chr5	663168	671168	665214	8000	667168	-4000	4000	-1954
chr5	6753044	6761044	6755167	8000	6757044	-4000	4000	-1877
chr5	55163297	55171297	55164108	8000	55167297	-4000	4000	-3189
chr5	55215564	55223564	55220714	8000	55219564	-4000	4000	1150
chr5	74718647	74726647	74726058	8000	74722647	-4000	4000	3411
chr5	77687166	77695166	77693086	8000	77691166	-4000	4000	1920
chr5	112842239	112850239	112843509	8000	112846239	-4000	4000	-2730
chr5	116439555	116447555	116444545	8000	116443555	-4000	4000	990
chr5	129110028	129118028	129113318	8000	129114028	-4000	4000	-710
chr5	141094703	141102703	141095505	8000	141098703	-4000	4000	-3198
chr5	141182226	141190226	141189572	8000	141186226	-4000	4000	3346
chr5	148438836	148446836	148440524	8000	148442836	-4000	4000	-2312
chr5	148438836	148446836	148442208	8000	148442836	-4000	4000	-628
chr5	148824623	148832623	148828444	8000	148828623	-4000	4000	-179
chr5	151500092	151508092	151507445	8000	151504092	-4000	4000	3353
chr5	62343284	62351284	62347137	8000	62347284	-4000	4000	-147
chr5	15935795	15943795	15936718	8000	15939795	-4000	4000	-3077
chr5	76731770	76739770	76732786	8000	76735770	-4000	4000	-2984
chr5	141172383	141180383	141180341	8000	141176383	-4000	4000	3958
chr5	141191647	141199647	141193415	8000	141195647	-4000	4000	-2232
chr5	150792734	150800734	150795592	8000	150796734	-4000	4000	-1142
chr5	38941596	38949596	38946513	8000	38945596	-4000	4000	917
chr5	55163297	55171297	55170696	8000	55167297	-4000	4000	3399
chr5	95820383	95828383	95822510	8000	95824383	-4000	4000	-1873
chr5	138442969	138450969	138445334	8000	138446969	-4000	4000	-1635
chr5	151266440	151274440	151267539	8000	151270440	-4000	4000	-2901
chr5	141182226	141190226	141188387	8000	141186226	-4000	4000	2161
chr5	33983174	33991174	33989265	8000	33987174	-4000	4000	2091
chr5	170248575	170256575	170250804	8000	170252575	-4000	4000	-1771
chr5	132871395	132879395	132875583	8000	132875395	-4000	4000	188
chr5	141094703	141102703	141101966	8000	141098703	-4000	4000	3263
chr5	78773209	78781209	78780316	8000	78777209	-4000	4000	3107
chr5	141094703	141102703	141095302	8000	141098703	-4000	4000	-3401
chr5	159153409	159161409	159158963	8000	159157409	-4000	4000	1554
chr5	33983174	33991174	33984398	8000	33987174	-4000	4000	-2776
chr5	171857549	171865549	171863274	8000	171861549	-4000	4000	1725
chr5	141208571	141216571	141210289	8000	141212571	-4000	4000	-2282
chr5	65583549	65591549	65590319	8000	65587549	-4000	4000	2770
chr5	79796240	79804240	79799482	8000	79800240	-4000	4000	-758
chr5	132857181	132865181	132862204	8000	132861181	-4000	4000	1023
chr5	138135770	138143770	138139948	8000	138139770	-4000	4000	178
chr5	140641408	140649408	140645663	8000	140645408	-4000	4000	255
chr5	177094144	177102144	177097386	8000	177098144	-4000	4000	-758
chr5	132688628	132696628	132693719	8000	132692628	-4000	4000	1091
chr5	42798439	42806439	42801008	8000	42802439	-4000	4000	-1431
chr5	83633805	83641805	83641458	8000	83637805	-4000	4000	3653
chr5	160343754	160351754	160349684	8000	160347754	-4000	4000	1930
chr5	135885770	135893770	135888032	8000	135889770	-4000	4000	-1738
chr5	96915703	96923703	96917516	8000	96919703	-4000	4000	-2187
chr5	150292343	150300343	150297811	8000	150296343	-4000	4000	1468
chr5	112842239	112850239	112844038	8000	112846239	-4000	4000	-2201
chr5	55163297	55171297	55164239	8000	55167297	-4000	4000	-3058
chr5	76611482	76619482	76617523	8000	76615482	-4000	4000	2041
chr5	141191647	141199647	141194076	8000	141195647	-4000	4000	-1571
chr5	32350350	32358350	32355897	8000	32354350	-4000	4000	1547
chr5	141172383	141180383	141179726	8000	141176383	-4000	4000	3343
chr5	34921996	34929996	34922960	8000	34925996	-4000	4000	-3036
chr5	147383855	147391855	147384100	8000	147387855	-4000	4000	-3755
chr5	50392192	50400192	50399286	8000	50396192	-4000	4000	3094
chr5	38941596	38949596	38944549	8000	38945596	-4000	4000	-1047
chr5	100582741	100590741	100586185	8000	100586741	-4000	4000	-556
chr5	178929212	178937212	178932172	8000	178933212	-4000	4000	-1040
chr5	140554268	140562268	140560660	8000	140558268	-4000	4000	2392
chr5	141134615	141142615	141137480	8000	141138615	-4000	4000	-1135
chr5	172205646	172213646	172211740	8000	172209646	-4000	4000	2094
chr5	179610178	179618178	179617054	8000	179614178	-4000	4000	2876
chr5	32222994	32230994	32230129	8000	32226994	-4000	4000	3135
chr5	55163297	55171297	55170653	8000	55167297	-4000	4000	3356
chr5	75670124	75678124	75677937	8000	75674124	-4000	4000	3813
chr5	76731770	76739770	76733068	8000	76735770	-4000	4000	-2702
chr5	141094703	141102703	141095661	8000	141098703	-4000	4000	-3042
chr5	181231808	181239808	181239297	8000	181235808	-4000	4000	3489
chr5	181231808	181239808	181239577	8000	181235808	-4000	4000	3769
chr5	6367874	6375874	6374380	8000	6371874	-4000	4000	2506
chr5	115516908	115524908	115524393	8000	115520908	-4000	4000	3485
chr5	134851133	134859133	134855106	8000	134855133	-4000	4000	-27
chr5	663168	671168	665142	8000	667168	-4000	4000	-2026
chr5	32106932	32114932	32108254	8000	32110932	-4000	4000	-2678
chr5	146077791	146085791	146084401	8000	146081791	-4000	4000	2610
chr5	42798439	42806439	42800830	8000	42802439	-4000	4000	-1609
chr5	138549756	138557756	138556496	8000	138553756	-4000	4000	2740
chr5	95747319	95755319	95748366	8000	95751319	-4000	4000	-2953
chr5	176591802	176599802	176598910	8000	176595802	-4000	4000	3108
chr5	141199779	141207779	141201136	8000	141203779	-4000	4000	-2643
chr5	116439555	116447555	116447254	8000	116443555	-4000	4000	3699
chr5	116439555	116447555	116447255	8000	116443555	-4000	4000	3700
chr5	141149287	141157287	141150792	8000	141153287	-4000	4000	-2495
chr5	111492033	111500033	111499957	8000	111496033	-4000	4000	3924
chr5	55252055	55260055	55256259	8000	55256055	-4000	4000	204
chr5	54542586	54550586	54543461	8000	54546586	-4000	4000	-3125
chr5	151266440	151274440	151267185	8000	151270440	-4000	4000	-3255
chr5	73440827	73448827	73446781	8000	73444827	-4000	4000	1954
chr5	141199779	141207779	141201861	8000	141203779	-4000	4000	-1918
chr5	178929212	178937212	178932014	8000	178933212	-4000	4000	-1198
chr5	116439555	116447555	116445169	8000	116443555	-4000	4000	1614
chr5	141172383	141180383	141173052	8000	141176383	-4000	4000	-3331
chr5	136059818	136067818	136060861	8000	136063818	-4000	4000	-2957
chr5	140641408	140649408	140644639	8000	140645408	-4000	4000	-769
chr5	141134615	141142615	141137696	8000	141138615	-4000	4000	-919
chr5	132818141	132826141	132823453	8000	132822141	-4000	4000	1312
chr5	141208571	141216571	141211186	8000	141212571	-4000	4000	-1385
chr5	116439555	116447555	116446970	8000	116443555	-4000	4000	3415
chr5	171453626	171461626	171456694	8000	171457626	-4000	4000	-932
chr5	73501667	73509667	73503015	8000	73505667	-4000	4000	-2652
chr5	151096706	151104706	151103654	8000	151100706	-4000	4000	2948
chr5	74776113	74784113	74783032	8000	74780113	-4000	4000	2919
chr5	141199779	141207779	141201484	8000	141203779	-4000	4000	-2295
chr5	141214979	141222979	141215757	8000	141218979	-4000	4000	-3222
chr5	33464091	33472091	33466907	8000	33468091	-4000	4000	-1184
chr5	35044756	35052756	35047972	8000	35048756	-4000	4000	-784
chr5	37102228	37110228	37108468	8000	37106228	-4000	4000	2240
chr5	38941596	38949596	38947358	8000	38945596	-4000	4000	1762
chr5	55106252	55114252	55108157	8000	55110252	-4000	4000	-2095
chr5	58449982	58457982	58455696	8000	58453982	-4000	4000	1714
chr5	61153704	61161704	61160189	8000	61157704	-4000	4000	2485
chr5	62577446	62585446	62579491	8000	62581446	-4000	4000	-1955
chr5	62577446	62585446	62580702	8000	62581446	-4000	4000	-744
chr5	70039113	70047113	70041709	8000	70043113	-4000	4000	-1404
chr5	70039113	70047113	70041954	8000	70043113	-4000	4000	-1159
chr5	75352345	75360345	75359196	8000	75356345	-4000	4000	2851
chr5	80079287	80087287	80082378	8000	80083287	-4000	4000	-909
chr5	83633805	83641805	83641576	8000	83637805	-4000	4000	3771
chr5	90454209	90462209	90461183	8000	90458209	-4000	4000	2974
chr5	96756810	96764810	96761832	8000	96760810	-4000	4000	1022
chr5	103025730	103033730	103028202	8000	103029730	-4000	4000	-1528
chr5	112842239	112850239	112844043	8000	112846239	-4000	4000	-2196
chr5	124632913	124640913	124639146	8000	124636913	-4000	4000	2233
chr5	132269454	132277454	132271419	8000	132273454	-4000	4000	-2035
chr5	132857181	132865181	132861878	8000	132861181	-4000	4000	697
chr5	135003959	135011959	135008969	8000	135007959	-4000	4000	1010
chr5	138183650	138191650	138185561	8000	138187650	-4000	4000	-2089
chr5	138549756	138557756	138556982	8000	138553756	-4000	4000	3226
chr5	141094703	141102703	141100456	8000	141098703	-4000	4000	1753
chr5	141121623	141129623	141123186	8000	141125623	-4000	4000	-2437
chr5	141134615	141142615	141136596	8000	141138615	-4000	4000	-2019
chr5	141172383	141180383	141178089	8000	141176383	-4000	4000	1706
chr5	141172383	141180383	141180199	8000	141176383	-4000	4000	3816
chr5	141182226	141190226	141183086	8000	141186226	-4000	4000	-3140
chr5	141182226	141190226	141183244	8000	141186226	-4000	4000	-2982
chr5	141208571	141216571	141214186	8000	141212571	-4000	4000	1615
chr5	147383855	147391855	147384170	8000	147387855	-4000	4000	-3685
chr5	149488982	149496982	149496686	8000	149492982	-4000	4000	3704
chr5	150890392	150898392	150896647	8000	150894392	-4000	4000	2255
chr5	153809869	153817869	153811058	8000	153813869	-4000	4000	-2811
chr5	160389148	160397148	160393677	8000	160393148	-4000	4000	529
chr5	170079382	170087382	170081880	8000	170083382	-4000	4000	-1502
chr5	171453626	171461626	171456682	8000	171457626	-4000	4000	-944
chr5	179610178	179618178	179616939	8000	179614178	-4000	4000	2761
chr5	181231808	181239808	181239282	8000	181235808	-4000	4000	3474
chr5	138433028	138441028	138435764	8000	138437028	-4000	4000	-1264
chr5	174726896	174734896	174729282	8000	174730896	-4000	4000	-1614
chr5	181250077	181258077	181257355	8000	181254077	-4000	4000	3278
chr5	132391613	132399613	132392606	8000	132395613	-4000	4000	-3007
chr5	139363196	139371196	139368912	8000	139367196	-4000	4000	1716
chr5	141134615	141142615	141137261	8000	141138615	-4000	4000	-1354
chr5	155014141	155022141	155015799	8000	155018141	-4000	4000	-2342
chr5	141094703	141102703	141095447	8000	141098703	-4000	4000	-3256
chr5	55108971	55116971	55110148	8000	55112971	-4000	4000	-2823
chr5	32120716	32128716	32126340	8000	32124716	-4000	4000	1624
chr5	140533340	140541340	140539537	8000	140537340	-4000	4000	2197
chr5	160397641	160405641	160403141	8000	160401641	-4000	4000	1500
chr5	130182634	130190634	130184860	8000	130186634	-4000	4000	-1774
chr5	58493090	58501090	58494591	8000	58497090	-4000	4000	-2499
chr5	141208571	141216571	141209403	8000	141212571	-4000	4000	-3168
chr5	141208571	141216571	141209404	8000	141212571	-4000	4000	-3167
chr5	178233476	178241476	178239151	8000	178237476	-4000	4000	1675
chr5	62577446	62585446	62580045	8000	62581446	-4000	4000	-1401
chr5	140658480	140666480	140659101	8000	140662480	-4000	4000	-3379
chr5	141172383	141180383	141173516	8000	141176383	-4000	4000	-2867
chr5	135440226	135448226	135446887	8000	135444226	-4000	4000	2661
chr5	133192455	133200455	133199500	8000	133196455	-4000	4000	3045
chr5	32106932	32114932	32108163	8000	32110932	-4000	4000	-2769
chr5	33464091	33472091	33466949	8000	33468091	-4000	4000	-1142
chr5	33519535	33527535	33527305	8000	33523535	-4000	4000	3770
chr5	36192849	36200849	36200242	8000	36196849	-4000	4000	3393
chr5	36684334	36692334	36686325	8000	36688334	-4000	4000	-2009
chr5	40689735	40697735	40692393	8000	40693735	-4000	4000	-1342
chr5	41138116	41146116	41142751	8000	41142116	-4000	4000	635
chr5	41937743	41945743	41941249	8000	41941743	-4000	4000	-494
chr5	42717878	42725878	42718774	8000	42721878	-4000	4000	-3104
chr5	42717878	42725878	42719345	8000	42721878	-4000	4000	-2533
chr5	42798439	42806439	42800737	8000	42802439	-4000	4000	-1702
chr5	43440252	43448252	43446386	8000	43444252	-4000	4000	2134
chr5	43440252	43448252	43446533	8000	43444252	-4000	4000	2281
chr5	54542586	54550586	54543319	8000	54546586	-4000	4000	-3267
chr5	55030570	55038570	55031532	8000	55034570	-4000	4000	-3038
chr5	58449982	58457982	58457067	8000	58453982	-4000	4000	3085
chr5	58493090	58501090	58494807	8000	58497090	-4000	4000	-2283
chr5	60747791	60755791	60754601	8000	60751791	-4000	4000	2810
chr5	65585690	65593690	65591848	8000	65589690	-4000	4000	2158
chr5	71717048	71725048	71720767	8000	71721048	-4000	4000	-281
chr5	73086522	73094522	73087699	8000	73090522	-4000	4000	-2823
chr5	75352345	75360345	75360064	8000	75356345	-4000	4000	3719
chr5	76831315	76839315	76832915	8000	76835315	-4000	4000	-2400
chr5	78481215	78489215	78488839	8000	78485215	-4000	4000	3624
chr5	87387931	87395931	87394407	8000	87391931	-4000	4000	2476
chr5	95601102	95609102	95603419	8000	95605102	-4000	4000	-1683
chr5	95680773	95688773	95682614	8000	95684773	-4000	4000	-2159
chr5	95680773	95688773	95682810	8000	95684773	-4000	4000	-1963
chr5	111658621	111666621	111664685	8000	111662621	-4000	4000	2064
chr5	112842239	112850239	112842262	8000	112846239	-4000	4000	-3977
chr5	112842239	112850239	112842889	8000	112846239	-4000	4000	-3350
chr5	115263190	115271190	115267886	8000	115267190	-4000	4000	696
chr5	123613045	123621045	123614554	8000	123617045	-4000	4000	-2491
chr5	126863714	126871714	126870624	8000	126867714	-4000	4000	2910
chr5	130182634	130190634	130185868	8000	130186634	-4000	4000	-766
chr5	132857181	132865181	132864191	8000	132861181	-4000	4000	3010
chr5	138442969	138450969	138444505	8000	138446969	-4000	4000	-2464
chr5	138549756	138557756	138555959	8000	138553756	-4000	4000	2203
chr5	141199779	141207779	141200516	8000	141203779	-4000	4000	-3263
chr5	141214979	141222979	141215446	8000	141218979	-4000	4000	-3533
chr5	141214979	141222979	141216234	8000	141218979	-4000	4000	-2745
chr5	141635302	141643302	141641394	8000	141639302	-4000	4000	2092
chr5	147876726	147884726	147881524	8000	147880726	-4000	4000	798
chr5	148438836	148446836	148440462	8000	148442836	-4000	4000	-2374
chr5	148824623	148832623	148827143	8000	148828623	-4000	4000	-1480
chr5	150890392	150898392	150896686	8000	150894392	-4000	4000	2294
chr5	155014141	155022141	155016245	8000	155018141	-4000	4000	-1896
chr5	157781743	157789743	157789614	8000	157785743	-4000	4000	3871
chr5	163515354	163523354	163518293	8000	163519354	-4000	4000	-1061
chr5	178929212	178937212	178932508	8000	178933212	-4000	4000	-704
chr5	31396494	31404494	31401487	8000	31400494	-4000	4000	993
chr5	40980643	40988643	40981394	8000	40984643	-4000	4000	-3249
chr5	74717206	74725206	74721217	8000	74721206	-4000	4000	11
chr5	74717206	74725206	74721541	8000	74721206	-4000	4000	335
chr5	83349787	83357787	83353180	8000	83353787	-4000	4000	-607
chr5	120683332	120691332	120686455	8000	120687332	-4000	4000	-877
chr5	122071570	122079570	122077118	8000	122075570	-4000	4000	1548
chr5	127041235	127049235	127047898	8000	127045235	-4000	4000	2663
chr5	138135770	138143770	138138770	8000	138139770	-4000	4000	-1000
chr5	141008347	141016347	141010880	8000	141012347	-4000	4000	-1467
chr5	141094703	141102703	141100488	8000	141098703	-4000	4000	1785
chr5	150292343	150300343	150297390	8000	150296343	-4000	4000	1047
chr5	180229143	180237143	180236311	8000	180233143	-4000	4000	3168
chr5	36188589	36196589	36195191	8000	36192589	-4000	4000	2602
chr5	36684334	36692334	36686454	8000	36688334	-4000	4000	-1880
chr5	43035233	43043233	43042657	8000	43039233	-4000	4000	3424
chr5	141172383	141180383	141174985	8000	141176383	-4000	4000	-1398
chr5	78481215	78489215	78488506	8000	78485215	-4000	4000	3291
chr5	10221507	10229507	10227466	8000	10225507	-4000	4000	1959
chr5	141208571	141216571	141210598	8000	141212571	-4000	4000	-1973
chr5	170242233	170250233	170248425	8000	170246233	-4000	4000	2192
chr5	132992985	133000985	132998428	8000	132996985	-4000	4000	1443
chr5	170370671	170378671	170378489	8000	170374671	-4000	4000	3818
chr5	180229143	180237143	180236439	8000	180233143	-4000	4000	3296
chr5	141134615	141142615	141136457	8000	141138615	-4000	4000	-2158
chr5	58449982	58457982	58455588	8000	58453982	-4000	4000	1606
chr5	141099827	141107827	141103124	8000	141103827	-4000	4000	-703
chr5	141134615	141142615	141137766	8000	141138615	-4000	4000	-849
chr5	141191647	141199647	141193141	8000	141195647	-4000	4000	-2506
chr5	148438836	148446836	148440512	8000	148442836	-4000	4000	-2324
chr5	179858066	179866066	179865838	8000	179862066	-4000	4000	3772
chr5	67165593	67173593	67166432	8000	67169593	-4000	4000	-3161
chr5	141008347	141016347	141012206	8000	141012347	-4000	4000	-141
chr5	172038079	172046079	172044953	8000	172042079	-4000	4000	2874
chr5	149488982	149496982	149495777	8000	149492982	-4000	4000	2795
chr5	172764096	172772096	172768855	8000	172768096	-4000	4000	759
chr5	141134615	141142615	141137260	8000	141138615	-4000	4000	-1355
chr5	135885770	135893770	135888284	8000	135889770	-4000	4000	-1486
chr5	141199779	141207779	141201835	8000	141203779	-4000	4000	-1944
chr5	130182634	130190634	130184334	8000	130186634	-4000	4000	-2300
chr5	33983174	33991174	33984422	8000	33987174	-4000	4000	-2752
chr5	115800733	115808733	115805216	8000	115804733	-4000	4000	483
chr5	37102228	37110228	37108448	8000	37106228	-4000	4000	2220
chr5	181057521	181065521	181059582	8000	181061521	-4000	4000	-1939
chr5	81262398	81270398	81266270	8000	81266398	-4000	4000	-128
chr5	97156867	97164867	97162790	8000	97160867	-4000	4000	1923
chr5	141121623	141129623	141122128	8000	141125623	-4000	4000	-3495
chr5	76611482	76619482	76618559	8000	76615482	-4000	4000	3077
chr5	141182226	141190226	141183589	8000	141186226	-4000	4000	-2637
chr5	141208571	141216571	141209699	8000	141212571	-4000	4000	-2872
chr5	155014141	155022141	155016178	8000	155018141	-4000	4000	-1963
chr5	73579380	73587380	73580122	8000	73583380	-4000	4000	-3258
chr5	129029642	129037642	129029675	8000	129033642	-4000	4000	-3967
chr5	5316304	5324304	5318199	8000	5320304	-4000	4000	-2105
chr5	83633805	83641805	83641389	8000	83637805	-4000	4000	3584
chr5	34921996	34929996	34925266	8000	34925996	-4000	4000	-730
chr5	112842239	112850239	112843589	8000	112846239	-4000	4000	-2650
chr5	163515354	163523354	163516526	8000	163519354	-4000	4000	-2828
chr5	141172383	141180383	141173265	8000	141176383	-4000	4000	-3118
chr5	141094703	141102703	141094733	8000	141098703	-4000	4000	-3970
chr5	141199779	141207779	141200691	8000	141203779	-4000	4000	-3088
chr5	58493090	58501090	58494885	8000	58497090	-4000	4000	-2205
chr5	141199779	141207779	141201374	8000	141203779	-4000	4000	-2405
chr5	146335251	146343251	146339119	8000	146339251	-4000	4000	-132
chr5	74717206	74725206	74722497	8000	74721206	-4000	4000	1291
chr5	141094703	141102703	141096095	8000	141098703	-4000	4000	-2608
chr5	141094703	141102703	141100839	8000	141098703	-4000	4000	2136
chr5	141094703	141102703	141102193	8000	141098703	-4000	4000	3490
chr5	141172383	141180383	141173137	8000	141176383	-4000	4000	-3246
chr5	149365653	149373653	149368730	8000	149369653	-4000	4000	-923
chr5	160389148	160397148	160394749	8000	160393148	-4000	4000	1601
chr5	163487941	163495941	163491358	8000	163491941	-4000	4000	-583
chr5	172764096	172772096	172769713	8000	172768096	-4000	4000	1617
chr5	176341991	176349991	176347493	8000	176345991	-4000	4000	1502
chr5	177368596	177376596	177371484	8000	177372596	-4000	4000	-1112
chr5	138135770	138143770	138140028	8000	138139770	-4000	4000	258
chr5	141182226	141190226	141188925	8000	141186226	-4000	4000	2699
chr5	141182226	141190226	141184693	8000	141186226	-4000	4000	-1533
chr5	65513766	65521766	65518633	8000	65517766	-4000	4000	867
chr5	43035233	43043233	43040064	8000	43039233	-4000	4000	831
chr5	132746819	132754819	132750894	8000	132750819	-4000	4000	75
chr5	141094703	141102703	141097176	8000	141098703	-4000	4000	-1527
chr5	128253909	128261909	128261874	8000	128257909	-4000	4000	3965
chr5	141182226	141190226	141187336	8000	141186226	-4000	4000	1110
chr5	141208571	141216571	141209014	8000	141212571	-4000	4000	-3557
chr5	176876898	176884898	176881509	8000	176880898	-4000	4000	611
chr5	33983174	33991174	33989158	8000	33987174	-4000	4000	1984
chr5	141172383	141180383	141178489	8000	141176383	-4000	4000	2106
chr5	15935795	15943795	15936938	8000	15939795	-4000	4000	-2857
chr5	168260157	168268157	168262550	8000	168264157	-4000	4000	-1607
chr5	177094144	177102144	177096631	8000	177098144	-4000	4000	-1513
chr5	170105734	170113734	170108080	8000	170109734	-4000	4000	-1654
chr5	150890392	150898392	150896118	8000	150894392	-4000	4000	1726
chr5	179031064	179039064	179033709	8000	179035064	-4000	4000	-1355
chr5	141121623	141129623	141123841	8000	141125623	-4000	4000	-1782
chr5	135440226	135448226	135446689	8000	135444226	-4000	4000	2463
chr5	157737449	157745449	157739407	8000	157741449	-4000	4000	-2042
chr5	53483134	53491134	53485215	8000	53487134	-4000	4000	-1919
chr5	180586105	180594105	180590716	8000	180590105	-4000	4000	611
chr5	90511611	90519611	90519455	8000	90515611	-4000	4000	3844
chr5	148824623	148832623	148826919	8000	148828623	-4000	4000	-1704
chr5	136971298	136979298	136978709	8000	136975298	-4000	4000	3411
chr5	141149287	141157287	141157074	8000	141153287	-4000	4000	3787
chr5	76611482	76619482	76617494	8000	76615482	-4000	4000	2012
chr5	132746819	132754819	132748356	8000	132750819	-4000	4000	-2463
chr5	138433028	138441028	138435671	8000	138437028	-4000	4000	-1357
chr5	7826081	7834081	7831895	8000	7830081	-4000	4000	1814
chr5	35810611	35818611	35814481	8000	35814611	-4000	4000	-130
chr5	141008347	141016347	141010914	8000	141012347	-4000	4000	-1433
chr5	141172383	141180383	141173045	8000	141176383	-4000	4000	-3338
chr5	179773283	179781283	179773976	8000	179777283	-4000	4000	-3307
chr5	56921532	56929532	56924004	8000	56925532	-4000	4000	-1528
chr5	58449982	58457982	58457542	8000	58453982	-4000	4000	3560
chr5	33983174	33991174	33984215	8000	33987174	-4000	4000	-2959
chr5	141208571	141216571	141210753	8000	141212571	-4000	4000	-1818
chr5	15935795	15943795	15936858	8000	15939795	-4000	4000	-2937
chr5	65585690	65593690	65591565	8000	65589690	-4000	4000	1875
chr5	146507961	146515961	146509174	8000	146511961	-4000	4000	-2787
chr5	153809869	153817869	153811165	8000	153813869	-4000	4000	-2704
chr5	163515354	163523354	163517869	8000	163519354	-4000	4000	-1485
chr5	178180505	178188505	178186007	8000	178184505	-4000	4000	1502
chr5	41917636	41925636	41921209	8000	41921636	-4000	4000	-427
chr5	123613045	123621045	123615125	8000	123617045	-4000	4000	-1920
chr5	176876898	176884898	176877242	8000	176880898	-4000	4000	-3656
chr5	171453626	171461626	171456557	8000	171457626	-4000	4000	-1069
chr5	141094703	141102703	141102026	8000	141098703	-4000	4000	3323
chr5	141172383	141180383	141173485	8000	141176383	-4000	4000	-2898
chr5	141208571	141216571	141211267	8000	141212571	-4000	4000	-1304
chr5	123340890	123348890	123346615	8000	123344890	-4000	4000	1725
chr5	141214979	141222979	141215337	8000	141218979	-4000	4000	-3642
chr5	93590611	93598611	93593897	8000	93594611	-4000	4000	-714
chr5	69440330	69448330	69441707	8000	69444330	-4000	4000	-2623
chr5	146335251	146343251	146339613	8000	146339251	-4000	4000	362
chr5	80872815	80880815	80875978	8000	80876815	-4000	4000	-837
chr5	34921996	34929996	34925475	8000	34925996	-4000	4000	-521
chr5	150890392	150898392	150895447	8000	150894392	-4000	4000	1055
chr5	34921996	34929996	34924856	8000	34925996	-4000	4000	-1140
chr5	40689735	40697735	40692254	8000	40693735	-4000	4000	-1481
chr5	79368636	79376636	79376107	8000	79372636	-4000	4000	3471
chr5	141172383	141180383	141172701	8000	141176383	-4000	4000	-3682
chr5	141172383	141180383	141175240	8000	141176383	-4000	4000	-1143
chr5	55621845	55629845	55627965	8000	55625845	-4000	4000	2120
chr5	140627728	140635728	140633193	8000	140631728	-4000	4000	1465
chr5	141199779	141207779	141200737	8000	141203779	-4000	4000	-3042
chr5	134579230	134587230	134579240	8000	134583230	-4000	4000	-3990
chr5	141121623	141129623	141123638	8000	141125623	-4000	4000	-1985
chr5	141208571	141216571	141209152	8000	141212571	-4000	4000	-3419
chr5	96386333	96394333	96393342	8000	96390333	-4000	4000	3009
chr5	141208571	141216571	141214785	8000	141212571	-4000	4000	2214
chr5	32350350	32358350	32355895	8000	32354350	-4000	4000	1545
chr5	95601102	95609102	95603512	8000	95605102	-4000	4000	-1590
chr5	141182226	141190226	141183818	8000	141186226	-4000	4000	-2408
chr5	141172383	141180383	141174393	8000	141176383	-4000	4000	-1990
chr5	133192455	133200455	133199481	8000	133196455	-4000	4000	3026
chr5	140565100	140573100	140567835	8000	140569100	-4000	4000	-1265
chr5	168515301	168523301	168517840	8000	168519301	-4000	4000	-1461
chr5	178929212	178937212	178932682	8000	178933212	-4000	4000	-530
chr5	134388108	134396108	134390937	8000	134392108	-4000	4000	-1171
chr5	135003959	135011959	135011567	8000	135007959	-4000	4000	3608
chr5	192868	200868	195038	8000	196868	-4000	4000	-1830
chr5	37102228	37110228	37108458	8000	37106228	-4000	4000	2230
chr5	43035233	43043233	43039519	8000	43039233	-4000	4000	286
chr5	69127069	69135069	69129522	8000	69131069	-4000	4000	-1547
chr5	76831315	76839315	76833354	8000	76835315	-4000	4000	-1961
chr5	139471533	139479533	139478401	8000	139475533	-4000	4000	2868
chr5	170810047	170818047	170812277	8000	170814047	-4000	4000	-1770
chr5	141182226	141190226	141185154	8000	141186226	-4000	4000	-1072
chr5	116439555	116447555	116445883	8000	116443555	-4000	4000	2328
chr5	110761161	110769161	110761479	8000	110765161	-4000	4000	-3682
chr5	132857181	132865181	132861939	8000	132861181	-4000	4000	758
chr5	151177052	151185052	151183457	8000	151181052	-4000	4000	2405
chr5	73579380	73587380	73580019	8000	73583380	-4000	4000	-3361
chr5	103025730	103033730	103029313	8000	103029730	-4000	4000	-417
chr5	141182226	141190226	141184459	8000	141186226	-4000	4000	-1767
chr5	150890392	150898392	150895582	8000	150894392	-4000	4000	1190
chr5	33983174	33991174	33989452	8000	33987174	-4000	4000	2278
chr5	115263190	115271190	115267903	8000	115267190	-4000	4000	713
chr5	141172383	141180383	141177995	8000	141176383	-4000	4000	1612
chr6	24533207	24541207	24533991	8000	24537207	-4000	4000	-3216
chr6	78942440	78950440	78946102	8000	78946440	-4000	4000	-338
chr6	32841209	32849209	32841627	8000	32845209	-4000	4000	-3582
chr6	116114909	116122909	116120858	8000	116118909	-4000	4000	1949
chr6	149500495	149508495	149505422	8000	149504495	-4000	4000	927
chr6	31826254	31834254	31829965	8000	31830254	-4000	4000	-289
chr6	125928034	125936034	125929192	8000	125932034	-4000	4000	-2842
chr6	127284567	127292567	127287295	8000	127288567	-4000	4000	-1272
chr6	138084505	138092505	138092049	8000	138088505	-4000	4000	3544
chr6	35463102	35471102	35468959	8000	35467102	-4000	4000	1857
chr6	26411208	26419208	26413696	8000	26415208	-4000	4000	-1512
chr6	35469597	35477597	35470282	8000	35473597	-4000	4000	-3315
chr6	70852679	70860679	70857992	8000	70856679	-4000	4000	1313
chr6	170278206	170286206	170285296	8000	170282206	-4000	4000	3090
chr6	3264962	3272962	3267562	8000	3268962	-4000	4000	-1400
chr6	26213483	26221483	26216415	8000	26217483	-4000	4000	-1068
chr6	31136092	31144092	31142453	8000	31140092	-4000	4000	2361
chr6	36736775	36744775	36742420	8000	36740775	-4000	4000	1645
chr6	151617193	151625193	151617949	8000	151621193	-4000	4000	-3244
chr6	7414037	7422037	7414285	8000	7418037	-4000	4000	-3752
chr6	31526219	31534219	31531101	8000	31530219	-4000	4000	882
chr6	32037153	32045153	32042301	8000	32041153	-4000	4000	1148
chr6	32124707	32132707	32129539	8000	32128707	-4000	4000	832
chr6	35775552	35783552	35777482	8000	35779552	-4000	4000	-2070
chr6	42959865	42967865	42966816	8000	42963865	-4000	4000	2951
chr6	118955763	118963763	118961767	8000	118959763	-4000	4000	2004
chr6	149590873	149598873	149597166	8000	149594873	-4000	4000	2293
chr6	167968023	167976023	167969137	8000	167972023	-4000	4000	-2886
chr6	12293194	12301194	12295985	8000	12297194	-4000	4000	-1209
chr6	131569966	131577966	131574210	8000	131573966	-4000	4000	244
chr6	87081498	87089498	87086384	8000	87085498	-4000	4000	886
chr6	127284567	127292567	127287962	8000	127288567	-4000	4000	-605
chr6	130137449	130145449	130144415	8000	130141449	-4000	4000	2966
chr6	33200439	33208439	33201548	8000	33204439	-4000	4000	-2891
chr6	109488855	109496855	109493357	8000	109492855	-4000	4000	502
chr6	159794436	159802436	159797292	8000	159798436	-4000	4000	-1144
chr6	159816704	159824704	159819050	8000	159820704	-4000	4000	-1654
chr6	44230142	44238142	44232049	8000	44234142	-4000	4000	-2093
chr6	28229487	28237487	28233378	8000	28233487	-4000	4000	-109
chr6	35424191	35432191	35425876	8000	35428191	-4000	4000	-2315
chr6	42864558	42872558	42865545	8000	42868558	-4000	4000	-3013
chr6	152720569	152728569	152721981	8000	152724569	-4000	4000	-2588
chr6	149945235	149953235	149946470	8000	149949235	-4000	4000	-2765
chr6	72399145	72407145	72402348	8000	72403145	-4000	4000	-797
chr6	107657306	107665306	107658455	8000	107661306	-4000	4000	-2851
chr6	33158681	33166681	33165784	8000	33162681	-4000	4000	3103
chr6	43518334	43526334	43519423	8000	43522334	-4000	4000	-2911
chr6	26195988	26203988	26197171	8000	26199988	-4000	4000	-2817
chr6	126344875	126352875	126348465	8000	126348875	-4000	4000	-410
chr6	89360616	89368616	89368017	8000	89364616	-4000	4000	3401
chr6	127704072	127712072	127709873	8000	127708072	-4000	4000	1801
chr6	157285025	157293025	157292902	8000	157289025	-4000	4000	3877
chr6	2883270	2891270	2890006	8000	2887270	-4000	4000	2736
chr6	33405896	33413896	33406871	8000	33409896	-4000	4000	-3025
chr6	26195988	26203988	26196935	8000	26199988	-4000	4000	-3053
chr6	134165248	134173248	134170403	8000	134169248	-4000	4000	1155
chr6	89091959	89099959	89098735	8000	89095959	-4000	4000	2776
chr6	42959865	42967865	42964847	8000	42963865	-4000	4000	982
chr6	84120241	84128241	84125211	8000	84124241	-4000	4000	970
chr6	30559723	30567723	30562095	8000	30563723	-4000	4000	-1628
chr6	31941672	31949672	31946637	8000	31945672	-4000	4000	965
chr6	7414037	7422037	7414253	8000	7418037	-4000	4000	-3784
chr6	26630383	26638383	26637444	8000	26634383	-4000	4000	3061
chr6	116459771	116467771	116461887	8000	116463771	-4000	4000	-1884
chr6	4060983	4068983	4068384	8000	4064983	-4000	4000	3401
chr6	89564144	89572144	89567014	8000	89568144	-4000	4000	-1130
chr6	13976310	13984310	13978145	8000	13980310	-4000	4000	-2165
chr6	79197245	79205245	79201871	8000	79201245	-4000	4000	626
chr6	89564144	89572144	89566996	8000	89568144	-4000	4000	-1148
chr6	83157150	83165150	83162887	8000	83161150	-4000	4000	1737
chr6	2944159	2952159	2948971	8000	2948159	-4000	4000	812
chr6	347355	355355	350800	8000	351355	-4000	4000	-555
chr6	27807300	27815300	27814470	8000	27811300	-4000	4000	3170
chr6	29827125	29835125	29829437	8000	29831125	-4000	4000	-1688
chr6	41679978	41687978	41684576	8000	41683978	-4000	4000	598
chr6	28298549	28306549	28300844	8000	28302549	-4000	4000	-1705
chr6	159774498	159782498	159779076	8000	159778498	-4000	4000	578
chr6	42740498	42748498	42745132	8000	42744498	-4000	4000	634
chr6	99393629	99401629	99400703	8000	99397629	-4000	4000	3074
chr6	26213483	26221483	26217357	8000	26217483	-4000	4000	-126
chr6	31682962	31690962	31687711	8000	31686962	-4000	4000	749
chr6	47623263	47631263	47627036	8000	47627263	-4000	4000	-227
chr6	24533207	24541207	24533543	8000	24537207	-4000	4000	-3664
chr6	57051239	57059239	57053428	8000	57055239	-4000	4000	-1811
chr6	26195988	26203988	26199084	8000	26199988	-4000	4000	-904
chr6	26195988	26203988	26199771	8000	26199988	-4000	4000	-217
chr6	31805619	31813619	31809876	8000	31809619	-4000	4000	257
chr6	31107223	31115223	31111943	8000	31111223	-4000	4000	720
chr6	347355	355355	348111	8000	351355	-4000	4000	-3244
chr6	7247980	7255980	7248593	8000	7251980	-4000	4000	-3387
chr6	28320693	28328693	28326697	8000	28324693	-4000	4000	2004
chr6	35291985	35299985	35292729	8000	35295985	-4000	4000	-3256
chr6	36107236	36115236	36108746	8000	36111236	-4000	4000	-2490
chr6	26248075	26256075	26251719	8000	26252075	-4000	4000	-356
chr6	27807300	27815300	27814720	8000	27811300	-4000	4000	3420
chr6	29668483	29676483	29672587	8000	29672483	-4000	4000	104
chr6	157285025	157293025	157292724	8000	157289025	-4000	4000	3699
chr6	26248075	26256075	26250391	8000	26252075	-4000	4000	-1684
chr6	26266918	26274918	26273044	8000	26270918	-4000	4000	2126
chr6	42740498	42748498	42745915	8000	42744498	-4000	4000	1417
chr6	33412442	33420442	33418261	8000	33416442	-4000	4000	1819
chr6	26223473	26231473	26225303	8000	26227473	-4000	4000	-2170
chr6	18219854	18227854	18222076	8000	18223854	-4000	4000	-1778
chr6	27807300	27815300	27814571	8000	27811300	-4000	4000	3271
chr6	33412442	33420442	33416680	8000	33416442	-4000	4000	238
chr6	110095819	110103819	110101607	8000	110099819	-4000	4000	1788
chr6	110095819	110103819	110103505	8000	110099819	-4000	4000	3686
chr6	112103931	112111931	112109469	8000	112107931	-4000	4000	1538
chr6	127284567	127292567	127287064	8000	127288567	-4000	4000	-1503
chr6	170278206	170286206	170282865	8000	170282206	-4000	4000	659
chr6	106105939	106113939	106107306	8000	106109939	-4000	4000	-2633
chr6	54941099	54949099	54941110	8000	54945099	-4000	4000	-3989
chr6	10625368	10633368	10626701	8000	10629368	-4000	4000	-2667
chr6	28320693	28328693	28326194	8000	28324693	-4000	4000	1501
chr6	37328970	37336970	37331053	8000	37332970	-4000	4000	-1917
chr6	44151519	44159519	44153674	8000	44155519	-4000	4000	-1845
chr6	57166305	57174305	57172679	8000	57170305	-4000	4000	2374
chr6	116114909	116122909	116121755	8000	116118909	-4000	4000	2846
chr6	127284567	127292567	127287253	8000	127288567	-4000	4000	-1314
chr6	127284567	127292567	127287599	8000	127288567	-4000	4000	-968
chr6	150839665	150847665	150839979	8000	150843665	-4000	4000	-3686
chr6	121445727	121453727	121447227	8000	121449727	-4000	4000	-2500
chr6	26201021	26209021	26204723	8000	26205021	-4000	4000	-298
chr6	27142361	27150361	27147488	8000	27146361	-4000	4000	1127
chr6	52260014	52268014	52264556	8000	52264014	-4000	4000	542
chr6	118557716	118565716	118559032	8000	118561716	-4000	4000	-2684
chr6	99393629	99401629	99400265	8000	99397629	-4000	4000	2636
chr6	26248075	26256075	26251998	8000	26252075	-4000	4000	-77
chr6	136191574	136199574	136191716	8000	136195574	-4000	4000	-3858
chr6	11179298	11187298	11185498	8000	11183298	-4000	4000	2200
chr6	117565858	117573858	117573599	8000	117569858	-4000	4000	3741
chr6	27862792	27870792	27865582	8000	27866792	-4000	4000	-1210
chr6	24645979	24653979	24650911	8000	24649979	-4000	4000	932
chr6	107148562	107156562	107153667	8000	107152562	-4000	4000	1105
chr6	149072990	149080990	149073973	8000	149076990	-4000	4000	-3017
chr6	26213483	26221483	26217357	8000	26217483	-4000	4000	-126
chr6	32164212	32172212	32166202	8000	32168212	-4000	4000	-2010
chr6	41732711	41740711	41736858	8000	41736711	-4000	4000	147
chr6	26201021	26209021	26204865	8000	26205021	-4000	4000	-156
chr6	30066333	30074333	30069371	8000	30070333	-4000	4000	-962
chr6	46216736	46224736	46222161	8000	46220736	-4000	4000	1425
chr6	26266918	26274918	26272225	8000	26270918	-4000	4000	1307
chr6	73237314	73245314	73242161	8000	73241314	-4000	4000	847
chr6	159774498	159782498	159778572	8000	159778498	-4000	4000	74
chr6	159794436	159802436	159797436	8000	159798436	-4000	4000	-1000
chr6	157206779	157214779	157207761	8000	157210779	-4000	4000	-3018
chr6	73589379	73597379	73594929	8000	73593379	-4000	4000	1550
chr6	26180655	26188655	26183834	8000	26184655	-4000	4000	-821
chr6	26195988	26203988	26198861	8000	26199988	-4000	4000	-1127
chr6	34769857	34777857	34770357	8000	34773857	-4000	4000	-3500
chr6	127284567	127292567	127290202	8000	127288567	-4000	4000	1635
chr6	28990785	28998785	28998762	8000	28994785	-4000	4000	3977
chr6	29827125	29835125	29829531	8000	29831125	-4000	4000	-1594
chr6	7877522	7885522	7883253	8000	7881522	-4000	4000	1731
chr6	12160999	12168999	12161465	8000	12164999	-4000	4000	-3534
chr6	14132918	14140918	14133691	8000	14136918	-4000	4000	-3227
chr6	27446743	27454743	27451514	8000	27450743	-4000	4000	771
chr6	28085563	28093563	28088809	8000	28089563	-4000	4000	-754
chr6	39900877	39908877	39906380	8000	39904877	-4000	4000	1503
chr6	41679978	41687978	41685031	8000	41683978	-4000	4000	1053
chr6	109488855	109496855	109493439	8000	109492855	-4000	4000	584
chr6	125757269	125765269	125759189	8000	125761269	-4000	4000	-2080
chr6	131704441	131712441	131710064	8000	131708441	-4000	4000	1623
chr6	132739870	132747870	132744298	8000	132743870	-4000	4000	428
chr6	159752319	159760319	159755421	8000	159756319	-4000	4000	-898
chr6	3219324	3227324	3224832	8000	3223324	-4000	4000	1508
chr6	49723376	49731376	49728726	8000	49727376	-4000	4000	1350
chr6	125757269	125765269	125759192	8000	125761269	-4000	4000	-2077
chr6	7247980	7255980	7248772	8000	7251980	-4000	4000	-3208
chr6	34583288	34591288	34587455	8000	34587288	-4000	4000	167
chr6	36736775	36744775	36742354	8000	36740775	-4000	4000	1579
chr6	63715980	63723980	63721659	8000	63719980	-4000	4000	1679
chr6	31805619	31813619	31810241	8000	31809619	-4000	4000	622
chr6	151360115	151368115	151366827	8000	151364115	-4000	4000	2712
chr6	131704441	131712441	131710693	8000	131708441	-4000	4000	2252
chr6	166360919	166368919	166366026	8000	166364919	-4000	4000	1107
chr6	170278206	170286206	170283487	8000	170282206	-4000	4000	1281
chr6	18116440	18124440	18122069	8000	18120440	-4000	4000	1629
chr6	36964141	36972141	36970067	8000	36968141	-4000	4000	1926
chr6	42740498	42748498	42744985	8000	42744498	-4000	4000	487
chr6	109439919	109447919	109443043	8000	109443919	-4000	4000	-876
chr6	31714648	31722648	31719001	8000	31718648	-4000	4000	353
chr6	155252134	155260134	155254274	8000	155256134	-4000	4000	-1860
chr6	26506425	26514425	26509035	8000	26510425	-4000	4000	-1390
chr6	32124707	32132707	32129450	8000	32128707	-4000	4000	743
chr6	119173205	119181205	119179868	8000	119177205	-4000	4000	2663
chr6	132292055	132300055	132297284	8000	132296055	-4000	4000	1229
chr6	31163159	31171159	31170674	8000	31167159	-4000	4000	3515
chr6	31682962	31690962	31687137	8000	31686962	-4000	4000	175
chr6	170278206	170286206	170283795	8000	170282206	-4000	4000	1589
chr6	26449415	26457415	26452060	8000	26453415	-4000	4000	-1355
chr6	27886315	27894315	27892868	8000	27890315	-4000	4000	2553
chr6	30896156	30904156	30896811	8000	30900156	-4000	4000	-3345
chr6	17127378	17135378	17130705	8000	17131378	-4000	4000	-673
chr6	20489714	20497714	20491612	8000	20493714	-4000	4000	-2102
chr6	26213483	26221483	26217034	8000	26217483	-4000	4000	-449
chr6	26248075	26256075	26251879	8000	26252075	-4000	4000	-196
chr6	27142361	27150361	27147405	8000	27146361	-4000	4000	1044
chr6	33158681	33166681	33163156	8000	33162681	-4000	4000	475
chr6	33200439	33208439	33201420	8000	33204439	-4000	4000	-3019
chr6	43303134	43311134	43307715	8000	43307134	-4000	4000	581
chr6	31136092	31144092	31138675	8000	31140092	-4000	4000	-1417
chr6	43017298	43025298	43017850	8000	43021298	-4000	4000	-3448
chr6	170278206	170286206	170285012	8000	170282206	-4000	4000	2806
chr6	159268108	159276108	159271495	8000	159272108	-4000	4000	-613
chr6	31163159	31171159	31165666	8000	31167159	-4000	4000	-1493
chr6	43558419	43566419	43565657	8000	43562419	-4000	4000	3238
chr6	30672389	30680389	30679389	8000	30676389	-4000	4000	3000
chr6	53263398	53271398	53269128	8000	53267398	-4000	4000	1730
chr6	27807300	27815300	27814467	8000	27811300	-4000	4000	3167
chr6	30896156	30904156	30896848	8000	30900156	-4000	4000	-3308
chr6	32944613	32952613	32949632	8000	32948613	-4000	4000	1019
chr6	35424191	35432191	35424642	8000	35428191	-4000	4000	-3549
chr6	37025069	37033069	37027467	8000	37029069	-4000	4000	-1602
chr6	37025069	37033069	37027468	8000	37029069	-4000	4000	-1601
chr6	159816704	159824704	159820537	8000	159820704	-4000	4000	-167
chr6	132292055	132300055	132297191	8000	132296055	-4000	4000	1136
chr6	159752319	159760319	159753492	8000	159756319	-4000	4000	-2827
chr6	117565858	117573858	117570919	8000	117569858	-4000	4000	1061
chr6	4060983	4068983	4068384	8000	4064983	-4000	4000	3401
chr6	31760851	31768851	31766034	8000	31764851	-4000	4000	1183
chr6	117706727	117714727	117707055	8000	117710727	-4000	4000	-3672
chr6	136338281	136346281	136344239	8000	136342281	-4000	4000	1958
chr6	18124311	18132311	18132140	8000	18128311	-4000	4000	3829
chr6	2782952	2790952	2785096	8000	2786952	-4000	4000	-1856
chr6	24540104	24548104	24547153	8000	24544104	-4000	4000	3049
chr6	26248075	26256075	26250277	8000	26252075	-4000	4000	-1798
chr6	89638498	89646498	89644171	8000	89642498	-4000	4000	1673
chr6	151360115	151368115	151366660	8000	151364115	-4000	4000	2545
chr6	152966519	152974519	152972301	8000	152970519	-4000	4000	1782
chr6	33405896	33413896	33406862	8000	33409896	-4000	4000	-3034
chr6	46700201	46708201	46704649	8000	46704201	-4000	4000	448
chr6	16144248	16152248	16145147	8000	16148248	-4000	4000	-3101
chr6	11134733	11142733	11135230	8000	11138733	-4000	4000	-3503
chr6	57051239	57059239	57053901	8000	57055239	-4000	4000	-1338
chr6	33200439	33208439	33201583	8000	33204439	-4000	4000	-2856
chr6	139236061	139244061	139240610	8000	139240061	-4000	4000	549
chr6	75080326	75088326	75084715	8000	75084326	-4000	4000	389
chr6	25697783	25705783	25701480	8000	25701783	-4000	4000	-303
chr6	31726581	31734581	31732297	8000	31730581	-4000	4000	1716
chr6	73409515	73417515	73413684	8000	73413515	-4000	4000	169
chr6	83194935	83202935	83195752	8000	83198935	-4000	4000	-3183
chr6	18116440	18124440	18121468	8000	18120440	-4000	4000	1028
chr6	26248075	26256075	26251855	8000	26252075	-4000	4000	-220
chr6	30596413	30604413	30604033	8000	30600413	-4000	4000	3620
chr6	37025069	37033069	37025811	8000	37029069	-4000	4000	-3258
chr6	47623263	47631263	47626538	8000	47627263	-4000	4000	-725
chr6	52997279	53005279	53001844	8000	53001279	-4000	4000	565
chr6	93236020	93244020	93242465	8000	93240020	-4000	4000	2445
chr6	96614626	96622626	96615760	8000	96618626	-4000	4000	-2866
chr6	112098790	112106790	112099347	8000	112102790	-4000	4000	-3443
chr6	129572132	129580132	129580081	8000	129576132	-4000	4000	3949
chr6	136338281	136346281	136346031	8000	136342281	-4000	4000	3750
chr6	161113385	161121385	161117384	8000	161117385	-4000	4000	-1
chr6	16291549	16299549	16295073	8000	16295549	-4000	4000	-476
chr6	26248075	26256075	26250290	8000	26252075	-4000	4000	-1785
chr6	111551381	111559381	111559249	8000	111555381	-4000	4000	3868
chr6	132765370	132773370	132772157	8000	132769370	-4000	4000	2787
chr6	155252134	155260134	155254396	8000	155256134	-4000	4000	-1738
chr6	32037153	32045153	32040424	8000	32041153	-4000	4000	-729
chr6	43558419	43566419	43560293	8000	43562419	-4000	4000	-2126
chr6	47623263	47631263	47626640	8000	47627263	-4000	4000	-623
chr6	31760851	31768851	31767666	8000	31764851	-4000	4000	2815
chr6	26266918	26274918	26273332	8000	26270918	-4000	4000	2414
chr6	121445727	121453727	121448662	8000	121449727	-4000	4000	-1065
chr6	18219854	18227854	18222158	8000	18223854	-4000	4000	-1696
chr6	347355	355355	351019	8000	351355	-4000	4000	-336
chr6	24701065	24709065	24706259	8000	24705065	-4000	4000	1194
chr6	6140084	6148084	6145761	8000	6144084	-4000	4000	1677
chr6	39900877	39908877	39901861	8000	39904877	-4000	4000	-3016
chr6	116114909	116122909	116121896	8000	116118909	-4000	4000	2987
chr6	32743198	32751198	32745274	8000	32747198	-4000	4000	-1924
chr6	34531229	34539229	34534665	8000	34535229	-4000	4000	-564
chr6	44180401	44188401	44180796	8000	44184401	-4000	4000	-3605
chr6	481154	489154	486757	8000	485154	-4000	4000	1603
chr6	27129535	27137535	27133088	8000	27133535	-4000	4000	-447
chr6	36960837	36968837	36963206	8000	36964837	-4000	4000	-1631
chr6	41154506	41162506	41158725	8000	41158506	-4000	4000	219
chr6	31613021	31621021	31617008	8000	31617021	-4000	4000	-13
chr6	27827174	27835174	27831178	8000	27831174	-4000	4000	4
chr6	27886315	27894315	27890710	8000	27890315	-4000	4000	395
chr6	139236061	139244061	139242564	8000	139240061	-4000	4000	2503
chr6	149945235	149953235	149945373	8000	149949235	-4000	4000	-3862
chr6	80342270	80350270	80343698	8000	80346270	-4000	4000	-2572
chr6	152125619	152133619	152132174	8000	152129619	-4000	4000	2555
chr6	152125619	152133619	152133282	8000	152129619	-4000	4000	3663
chr6	52260014	52268014	52264446	8000	52264014	-4000	4000	432
chr6	149720315	149728315	149726762	8000	149724315	-4000	4000	2447
chr6	16291549	16299549	16295084	8000	16295549	-4000	4000	-465
chr6	28085563	28093563	28089119	8000	28089563	-4000	4000	-444
chr6	149072990	149080990	149073994	8000	149076990	-4000	4000	-2996
chr6	26201021	26209021	26204972	8000	26205021	-4000	4000	-49
chr6	4990717	4998717	4996226	8000	4994717	-4000	4000	1509
chr6	118557716	118565716	118565669	8000	118561716	-4000	4000	3953
chr6	31635028	31643028	31642891	8000	31639028	-4000	4000	3863
chr6	149500495	149508495	149505492	8000	149504495	-4000	4000	997
chr6	11179298	11187298	11185496	8000	11183298	-4000	4000	2198
chr6	161125967	161133967	161130968	8000	161129967	-4000	4000	1001
chr6	32841209	32849209	32848797	8000	32845209	-4000	4000	3588
chr6	149945235	149953235	149946579	8000	149949235	-4000	4000	-2656
chr6	4111693	4119693	4115763	8000	4115693	-4000	4000	70
chr6	8069360	8077360	8073410	8000	8073360	-4000	4000	50
chr6	13976310	13984310	13976995	8000	13980310	-4000	4000	-3315
chr6	13976310	13984310	13977471	8000	13980310	-4000	4000	-2839
chr6	26213483	26221483	26217357	8000	26217483	-4000	4000	-126
chr6	32841209	32849209	32845672	8000	32845209	-4000	4000	463
chr6	42740498	42748498	42745835	8000	42744498	-4000	4000	1337
chr6	85491791	85499791	85492039	8000	85495791	-4000	4000	-3752
chr6	33200439	33208439	33206713	8000	33204439	-4000	4000	2274
chr6	42740498	42748498	42745590	8000	42744498	-4000	4000	1092
chr6	26213483	26221483	26217357	8000	26217483	-4000	4000	-126
chr6	27820480	27828480	27824167	8000	27824480	-4000	4000	-313
chr6	2883270	2891270	2890305	8000	2887270	-4000	4000	3035
chr6	53263398	53271398	53269212	8000	53267398	-4000	4000	1814
chr6	99538387	99546387	99545189	8000	99542387	-4000	4000	2802
chr6	11179298	11187298	11185339	8000	11183298	-4000	4000	2041
chr6	13286446	13294446	13287067	8000	13290446	-4000	4000	-3379
chr6	27135678	27143678	27139680	8000	27139678	-4000	4000	2
chr6	43017298	43025298	43017696	8000	43021298	-4000	4000	-3602
chr6	63715980	63723980	63721595	8000	63719980	-4000	4000	1615
chr6	122805720	122813720	122809340	8000	122809720	-4000	4000	-380
chr6	144090884	144098884	144095248	8000	144094884	-4000	4000	364
chr6	43601316	43609316	43604003	8000	43605316	-4000	4000	-1313
chr6	37025069	37033069	37027694	8000	37029069	-4000	4000	-1375
chr6	39100063	39108063	39105221	8000	39104063	-4000	4000	1158
chr6	27827174	27835174	27831323	8000	27831174	-4000	4000	149
chr6	46700201	46708201	46701931	8000	46704201	-4000	4000	-2270
chr6	26195988	26203988	26198880	8000	26199988	-4000	4000	-1108
chr6	26411208	26419208	26413155	8000	26415208	-4000	4000	-2053
chr6	27135678	27143678	27139581	8000	27139678	-4000	4000	-97
chr6	7607967	7615967	7608847	8000	7611967	-4000	4000	-3120
chr6	27886315	27894315	27892792	8000	27890315	-4000	4000	2477
chr6	106105939	106113939	106106447	8000	106109939	-4000	4000	-3492
chr6	42959865	42967865	42966448	8000	42963865	-4000	4000	2583
chr6	87081498	87089498	87088171	8000	87085498	-4000	4000	2673
chr6	112066663	112074663	112072808	8000	112070663	-4000	4000	2145
chr6	152720569	152728569	152722122	8000	152724569	-4000	4000	-2447
chr6	152720569	152728569	152722221	8000	152724569	-4000	4000	-2348
chr6	35291985	35299985	35294483	8000	35295985	-4000	4000	-1502
chr6	31714648	31722648	31717719	8000	31718648	-4000	4000	-929
chr6	43636941	43644941	43640245	8000	43640941	-4000	4000	-696
chr6	42740498	42748498	42745200	8000	42744498	-4000	4000	702
chr6	134165248	134173248	134170063	8000	134169248	-4000	4000	815
chr6	26213483	26221483	26217357	8000	26217483	-4000	4000	-126
chr6	41786141	41794141	41787040	8000	41790141	-4000	4000	-3101
chr6	31760851	31768851	31761616	8000	31764851	-4000	4000	-3235
chr6	27820480	27828480	27824252	8000	27824480	-4000	4000	-228
chr6	151617193	151625193	151618366	8000	151621193	-4000	4000	-2827
chr6	347355	355355	349345	8000	351355	-4000	4000	-2010
chr6	13628739	13636739	13632498	8000	13632739	-4000	4000	-241
chr6	24540104	24548104	24547249	8000	24544104	-4000	4000	3145
chr6	31111087	31119087	31117289	8000	31115087	-4000	4000	2202
chr6	27446743	27454743	27451541	8000	27450743	-4000	4000	798
chr6	57182992	57190992	57184020	8000	57186992	-4000	4000	-2972
chr6	31107223	31115223	31112022	8000	31111223	-4000	4000	799
chr6	78942440	78950440	78945968	8000	78946440	-4000	4000	-472
chr6	42959865	42967865	42966105	8000	42963865	-4000	4000	2240
chr6	11708054	11716054	11714336	8000	11712054	-4000	4000	2282
chr6	46216736	46224736	46220824	8000	46220736	-4000	4000	88
chr6	52260014	52268014	52264504	8000	52264014	-4000	4000	490
chr6	52997279	53005279	53003921	8000	53001279	-4000	4000	2642
chr6	70212040	70220040	70217041	8000	70216040	-4000	4000	1001
chr6	121445727	121453727	121447206	8000	121449727	-4000	4000	-2521
chr6	130137449	130145449	130144320	8000	130141449	-4000	4000	2871
chr6	31760851	31768851	31762466	8000	31764851	-4000	4000	-2385
chr6	109488855	109496855	109493439	8000	109492855	-4000	4000	584
chr6	116628985	116636985	116629683	8000	116632985	-4000	4000	-3302
chr6	31941672	31949672	31948433	8000	31945672	-4000	4000	2761
chr6	133528128	133536128	133528745	8000	133532128	-4000	4000	-3383
chr6	26248075	26256075	26250438	8000	26252075	-4000	4000	-1637
chr6	42959865	42967865	42965114	8000	42963865	-4000	4000	1249
chr6	3015755	3023755	3019528	8000	3019755	-4000	4000	-227
chr6	130439067	130447067	130440954	8000	130443067	-4000	4000	-2113
chr6	35291985	35299985	35293912	8000	35295985	-4000	4000	-2073
chr6	96551276	96559276	96551498	8000	96555276	-4000	4000	-3778
chr6	149945235	149953235	149946567	8000	149949235	-4000	4000	-2668
chr6	1310758	1318758	1313088	8000	1314758	-4000	4000	-1670
chr6	7877522	7885522	7883239	8000	7881522	-4000	4000	1717
chr6	12293194	12301194	12296647	8000	12297194	-4000	4000	-547
chr6	42740498	42748498	42745786	8000	42744498	-4000	4000	1288
chr6	42959865	42967865	42963643	8000	42963865	-4000	4000	-222
chr6	32513353	32521353	32517425	8000	32517353	-4000	4000	72
chr6	7582714	7590714	7585865	8000	7586714	-4000	4000	-849
chr6	36960837	36968837	36963192	8000	36964837	-4000	4000	-1645
chr6	97138161	97146161	97139454	8000	97142161	-4000	4000	-2707
chr6	27252624	27260624	27252942	8000	27256624	-4000	4000	-3682
chr6	100504194	100512194	100509308	8000	100508194	-4000	4000	1114
chr6	159816704	159824704	159818634	8000	159820704	-4000	4000	-2070
chr6	170568870	170576870	170571504	8000	170572870	-4000	4000	-1366
chr6	34014643	34022643	34022180	8000	34018643	-4000	4000	3537
chr6	109362514	109370514	109366940	8000	109366514	-4000	4000	426
chr6	35828966	35836966	35835188	8000	35832966	-4000	4000	2222
chr6	26374320	26382320	26376739	8000	26378320	-4000	4000	-1581
chr6	149407613	149415613	149409870	8000	149411613	-4000	4000	-1743
chr6	27807300	27815300	27807515	8000	27811300	-4000	4000	-3785
chr6	6650983	6658983	6654725	8000	6654983	-4000	4000	-258
chr6	347355	355355	348862	8000	351355	-4000	4000	-2493
chr6	26374320	26382320	26377193	8000	26378320	-4000	4000	-1127
chr6	26213483	26221483	26216488	8000	26217483	-4000	4000	-995
chr6	28085563	28093563	28089071	8000	28089563	-4000	4000	-492
chr6	31136092	31144092	31143081	8000	31140092	-4000	4000	2989
chr6	31654298	31662298	31659841	8000	31658298	-4000	4000	1543
chr6	31805619	31813619	31811637	8000	31809619	-4000	4000	2018
chr6	33200439	33208439	33200447	8000	33204439	-4000	4000	-3992
chr6	33200439	33208439	33201342	8000	33204439	-4000	4000	-3097
chr6	33767202	33775202	33772518	8000	33771202	-4000	4000	1316
chr6	35828966	35836966	35835057	8000	35832966	-4000	4000	2091
chr6	75915537	75923537	75921679	8000	75919537	-4000	4000	2142
chr6	80342270	80350270	80343828	8000	80346270	-4000	4000	-2442
chr6	143418832	143426832	143425895	8000	143422832	-4000	4000	3063
chr6	33294401	33302401	33301634	8000	33298401	-4000	4000	3233
chr6	46700201	46708201	46702134	8000	46704201	-4000	4000	-2067
chr6	84086881	84094881	84089220	8000	84090881	-4000	4000	-1661
chr6	142747469	142755469	142753122	8000	142751469	-4000	4000	1653
chr6	157206779	157214779	157206821	8000	157210779	-4000	4000	-3958
chr6	12160999	12168999	12164721	8000	12164999	-4000	4000	-278
chr6	33158681	33166681	33162756	8000	33162681	-4000	4000	75
chr6	84086881	84094881	84089361	8000	84090881	-4000	4000	-1520
chr6	170278206	170286206	170283486	8000	170282206	-4000	4000	1280
chr6	13976310	13984310	13977692	8000	13980310	-4000	4000	-2618
chr6	28298549	28306549	28301349	8000	28302549	-4000	4000	-1200
chr6	130439067	130447067	130441218	8000	130443067	-4000	4000	-1849
chr6	37328970	37336970	37331248	8000	37332970	-4000	4000	-1722
chr6	27807300	27815300	27815152	8000	27811300	-4000	4000	3852
chr6	89638498	89646498	89644180	8000	89642498	-4000	4000	1682
chr6	63715980	63723980	63721651	8000	63719980	-4000	4000	1671
chr6	12160999	12168999	12163832	8000	12164999	-4000	4000	-1167
chr6	20489714	20497714	20490423	8000	20493714	-4000	4000	-3291
chr6	26180655	26188655	26183833	8000	26184655	-4000	4000	-822
chr6	26201021	26209021	26204677	8000	26205021	-4000	4000	-344
chr6	28237697	28245697	28245218	8000	28241697	-4000	4000	3521
chr6	31760851	31768851	31761942	8000	31764851	-4000	4000	-2909
chr6	35317771	35325771	35319893	8000	35321771	-4000	4000	-1878
chr6	36107236	36115236	36108451	8000	36111236	-4000	4000	-2785
chr6	39100063	39108063	39105163	8000	39104063	-4000	4000	1100
chr6	46993708	47001708	47000271	8000	46997708	-4000	4000	2563
chr6	89081160	89089160	89084178	8000	89085160	-4000	4000	-982
chr6	106568017	106576017	106571884	8000	106572017	-4000	4000	-133
chr6	106568017	106576017	106572024	8000	106572017	-4000	4000	7
chr6	116114909	116122909	116115690	8000	116118909	-4000	4000	-3219
chr6	122805720	122813720	122809557	8000	122809720	-4000	4000	-163
chr6	149945235	149953235	149946482	8000	149949235	-4000	4000	-2753
chr6	166360919	166368919	166366857	8000	166364919	-4000	4000	1938
chr6	27142361	27150361	27146681	8000	27146361	-4000	4000	320
chr6	83167350	83175350	83167936	8000	83171350	-4000	4000	-3414
chr6	131279535	131287535	131281631	8000	131283535	-4000	4000	-1904
chr6	13286446	13294446	13287071	8000	13290446	-4000	4000	-3375
chr6	2883270	2891270	2890556	8000	2887270	-4000	4000	3286
chr6	3264962	3272962	3269459	8000	3268962	-4000	4000	497
chr6	4990717	4998717	4996064	8000	4994717	-4000	4000	1347
chr6	13353830	13361830	13360730	8000	13357830	-4000	4000	2900
chr6	27142361	27150361	27146802	8000	27146361	-4000	4000	441
chr6	28566535	28574535	28571856	8000	28570535	-4000	4000	1321
chr6	31264749	31272749	31269973	8000	31268749	-4000	4000	1224
chr6	31654298	31662298	31660015	8000	31658298	-4000	4000	1717
chr6	35424191	35432191	35424786	8000	35428191	-4000	4000	-3405
chr6	36107236	36115236	36109604	8000	36111236	-4000	4000	-1632
chr6	79910814	79918814	79916502	8000	79914814	-4000	4000	1688
chr6	100504194	100512194	100509415	8000	100508194	-4000	4000	1221
chr6	107061182	107069182	107066271	8000	107065182	-4000	4000	1089
chr6	149407613	149415613	149411330	8000	149411613	-4000	4000	-283
chr6	157206779	157214779	157207581	8000	157210779	-4000	4000	-3198
chr6	27807300	27815300	27807867	8000	27811300	-4000	4000	-3433
chr6	87081498	87089498	87086313	8000	87085498	-4000	4000	815
chr6	52787371	52795371	52794256	8000	52791371	-4000	4000	2885
chr6	42959865	42967865	42966852	8000	42963865	-4000	4000	2987
chr6	12293194	12301194	12294327	8000	12297194	-4000	4000	-2867
chr6	96211612	96219612	96212654	8000	96215612	-4000	4000	-2958
chr6	118809442	118817442	118815006	8000	118813442	-4000	4000	1564
chr6	26411208	26419208	26412520	8000	26415208	-4000	4000	-2688
chr6	107148562	107156562	107154735	8000	107152562	-4000	4000	2173
chr6	43502969	43510969	43503393	8000	43506969	-4000	4000	-3576
chr6	43502969	43510969	43503753	8000	43506969	-4000	4000	-3216
chr6	24782099	24790099	24784164	8000	24786099	-4000	4000	-1935
chr6	26630383	26638383	26637389	8000	26634383	-4000	4000	3006
chr6	31349872	31357872	31356694	8000	31353872	-4000	4000	2822
chr6	31760851	31768851	31767718	8000	31764851	-4000	4000	2867
chr6	33000182	33008182	33007130	8000	33004182	-4000	4000	2948
chr6	55749653	55757653	55755500	8000	55753653	-4000	4000	1847
chr6	57166305	57174305	57168422	8000	57170305	-4000	4000	-1883
chr6	89564144	89572144	89567008	8000	89568144	-4000	4000	-1136
chr6	122780074	122788074	122780350	8000	122784074	-4000	4000	-3724
chr6	131704441	131712441	131708640	8000	131708441	-4000	4000	199
chr6	158105519	158113519	158111503	8000	158109519	-4000	4000	1984
chr6	26213483	26221483	26217357	8000	26217483	-4000	4000	-126
chr6	6650983	6658983	6654547	8000	6654983	-4000	4000	-436
chr6	17289871	17297871	17291779	8000	17293871	-4000	4000	-2092
chr6	31859192	31867192	31865328	8000	31863192	-4000	4000	2136
chr6	37025069	37033069	37027439	8000	37029069	-4000	4000	-1630
chr6	42740498	42748498	42745125	8000	42744498	-4000	4000	627
chr6	49426360	49434360	49431796	8000	49430360	-4000	4000	1436
chr6	110095819	110103819	110103474	8000	110099819	-4000	4000	3655
chr6	3219324	3227324	3225660	8000	3223324	-4000	4000	2336
chr6	26195988	26203988	26198880	8000	26199988	-4000	4000	-1108
chr6	27862792	27870792	27865787	8000	27866792	-4000	4000	-1005
chr6	32190843	32198843	32192832	8000	32194843	-4000	4000	-2011
chr6	33000182	33008182	33007148	8000	33004182	-4000	4000	2966
chr6	34531229	34539229	34532468	8000	34535229	-4000	4000	-2761
chr6	37171428	37179428	37175028	8000	37175428	-4000	4000	-400
chr6	79480991	79488991	79486761	8000	79484991	-4000	4000	1770
chr6	84120241	84128241	84126432	8000	84124241	-4000	4000	2191
chr6	106664417	106672417	106666103	8000	106668417	-4000	4000	-2314
chr6	107657306	107665306	107658910	8000	107661306	-4000	4000	-2396
chr6	132292055	132300055	132297100	8000	132296055	-4000	4000	1045
chr6	132765370	132773370	132770315	8000	132769370	-4000	4000	945
chr6	158507828	158515828	158510269	8000	158511828	-4000	4000	-1559
chr6	159030468	159038468	159035736	8000	159034468	-4000	4000	1268
chr6	161125967	161133967	161131062	8000	161129967	-4000	4000	1095
chr6	157206779	157214779	157207532	8000	157210779	-4000	4000	-3247
chr6	12160999	12168999	12163865	8000	12164999	-4000	4000	-1134
chr6	27862792	27870792	27865358	8000	27866792	-4000	4000	-1434
chr6	31264749	31272749	31269526	8000	31268749	-4000	4000	777
chr6	35291985	35299985	35293766	8000	35295985	-4000	4000	-2219
chr6	39895578	39903578	39898917	8000	39899578	-4000	4000	-661
chr6	43502969	43510969	43503631	8000	43506969	-4000	4000	-3338
chr6	7247980	7255980	7248538	8000	7251980	-4000	4000	-3442
chr6	32809767	32817767	32813090	8000	32813767	-4000	4000	-677
chr6	36960837	36968837	36963356	8000	36964837	-4000	4000	-1481
chr6	26266918	26274918	26271160	8000	26270918	-4000	4000	242
chr6	35424191	35432191	35426067	8000	35428191	-4000	4000	-2124
chr6	151360115	151368115	151366833	8000	151364115	-4000	4000	2718
chr6	89638498	89646498	89644101	8000	89642498	-4000	4000	1603
chr6	33568547	33576547	33573690	8000	33572547	-4000	4000	1143
chr6	13976310	13984310	13977794	8000	13980310	-4000	4000	-2516
chr6	125976244	125984244	125977865	8000	125980244	-4000	4000	-2379
chr6	158631429	158639429	158631893	8000	158635429	-4000	4000	-3536
chr6	170278206	170286206	170283401	8000	170282206	-4000	4000	1195
chr6	26266918	26274918	26271347	8000	26270918	-4000	4000	429
chr6	32037153	32045153	32043798	8000	32041153	-4000	4000	2645
chr6	41786141	41794141	41786146	8000	41790141	-4000	4000	-3995
chr6	27129535	27137535	27132415	8000	27133535	-4000	4000	-1120
chr6	26213483	26221483	26217077	8000	26217483	-4000	4000	-406
chr6	27807300	27815300	27807811	8000	27811300	-4000	4000	-3489
chr6	27820480	27828480	27824421	8000	27824480	-4000	4000	-59
chr6	13976310	13984310	13977267	8000	13980310	-4000	4000	-3043
chr6	28566535	28574535	28573026	8000	28570535	-4000	4000	2491
chr6	63715980	63723980	63721164	8000	63719980	-4000	4000	1184
chr6	63715980	63723980	63721166	8000	63719980	-4000	4000	1186
chr6	27142361	27150361	27147262	8000	27146361	-4000	4000	901
chr6	3015755	3023755	3016945	8000	3019755	-4000	4000	-2810
chr6	33412442	33420442	33418027	8000	33416442	-4000	4000	1585
chr6	26195988	26203988	26197017	8000	26199988	-4000	4000	-2971
chr6	26542933	26550933	26546117	8000	26546933	-4000	4000	-816
chr6	26213483	26221483	26217357	8000	26217483	-4000	4000	-126
chr6	111551381	111559381	111559272	8000	111555381	-4000	4000	3891
chr6	131704441	131712441	131709898	8000	131708441	-4000	4000	1457
chr6	28566535	28574535	28573644	8000	28570535	-4000	4000	3109
chr6	88605897	88613897	88612576	8000	88609897	-4000	4000	2679
chr6	159030468	159038468	159036323	8000	159034468	-4000	4000	1855
chr6	44180401	44188401	44182999	8000	44184401	-4000	4000	-1402
chr6	2782952	2790952	2785155	8000	2786952	-4000	4000	-1797
chr6	129512566	129520566	129514501	8000	129516566	-4000	4000	-2065
chr6	27142361	27150361	27147138	8000	27146361	-4000	4000	777
chr6	31826254	31834254	31827955	8000	31830254	-4000	4000	-2299
chr6	26223473	26231473	26225569	8000	26227473	-4000	4000	-1904
chr6	27142361	27150361	27147341	8000	27146361	-4000	4000	980
chr6	32124707	32132707	32127118	8000	32128707	-4000	4000	-1589
chr6	157941077	157949077	157944285	8000	157945077	-4000	4000	-792
chr6	31264749	31272749	31271669	8000	31268749	-4000	4000	2920
chr6	31349872	31357872	31356672	8000	31353872	-4000	4000	2800
chr6	26506425	26514425	26508980	8000	26510425	-4000	4000	-1445
chr6	33000182	33008182	33007233	8000	33004182	-4000	4000	3051
chr6	89629834	89637834	89630660	8000	89633834	-4000	4000	-3174
chr6	33310406	33318406	33313353	8000	33314406	-4000	4000	-1053
chr6	121445727	121453727	121447673	8000	121449727	-4000	4000	-2054
chr6	347355	355355	350772	8000	351355	-4000	4000	-583
chr6	34280887	34288887	34288807	8000	34284887	-4000	4000	3920
chr6	87507634	87515634	87508452	8000	87511634	-4000	4000	-3182
chr6	116114909	116122909	116121487	8000	116118909	-4000	4000	2578
chr6	27129535	27137535	27133203	8000	27133535	-4000	4000	-332
chr6	30910106	30918106	30917214	8000	30914106	-4000	4000	3108
chr6	32037153	32045153	32039429	8000	32041153	-4000	4000	-1724
chr6	116628985	116636985	116630522	8000	116632985	-4000	4000	-2463
chr6	32180733	32188733	32186371	8000	32184733	-4000	4000	1638
chr6	26195988	26203988	26199090	8000	26199988	-4000	4000	-898
chr6	116628985	116636985	116629620	8000	116632985	-4000	4000	-3365
chr6	13976310	13984310	13977345	8000	13980310	-4000	4000	-2965
chr6	63775336	63783336	63778037	8000	63779336	-4000	4000	-1299
chr6	27886315	27894315	27893026	8000	27890315	-4000	4000	2711
chr6	28237697	28245697	28245152	8000	28241697	-4000	4000	3455
chr6	44374957	44382957	44377101	8000	44378957	-4000	4000	-1856
chr6	139236061	139244061	139243057	8000	139240061	-4000	4000	2996
chr6	347355	355355	348208	8000	351355	-4000	4000	-3147
chr6	16144248	16152248	16145084	8000	16148248	-4000	4000	-3164
chr6	28298549	28306549	28301225	8000	28302549	-4000	4000	-1324
chr6	96551276	96559276	96553493	8000	96555276	-4000	4000	-1783
chr6	26506425	26514425	26508925	8000	26510425	-4000	4000	-1500
chr6	27399908	27407908	27401327	8000	27403908	-4000	4000	-2581
chr6	43050029	43058029	43056339	8000	43054029	-4000	4000	2310
chr6	28298549	28306549	28300988	8000	28302549	-4000	4000	-1561
chr6	118905171	118913171	118905671	8000	118909171	-4000	4000	-3500
chr6	29941884	29949884	29943100	8000	29945884	-4000	4000	-2784
chr6	43017298	43025298	43019126	8000	43021298	-4000	4000	-2172
chr6	127284567	127292567	127290006	8000	127288567	-4000	4000	1439
chr6	142747469	142755469	142753873	8000	142751469	-4000	4000	2404
chr6	36683337	36691337	36685864	8000	36687337	-4000	4000	-1473
chr6	99538387	99546387	99543261	8000	99542387	-4000	4000	874
chr6	57182992	57190992	57190496	8000	57186992	-4000	4000	3504
chr6	27129535	27137535	27132573	8000	27133535	-4000	4000	-962
chr6	32031418	32039418	32039174	8000	32035418	-4000	4000	3756
chr6	26266918	26274918	26271254	8000	26270918	-4000	4000	336
chr6	36960837	36968837	36963852	8000	36964837	-4000	4000	-985
chr6	43017298	43025298	43018892	8000	43021298	-4000	4000	-2406
chr6	72399145	72407145	72400812	8000	72403145	-4000	4000	-2333
chr6	144090884	144098884	144095588	8000	144094884	-4000	4000	704
chr6	136553046	136561046	136557812	8000	136557046	-4000	4000	766
chr6	7877522	7885522	7882986	8000	7881522	-4000	4000	1464
chr6	26230212	26238212	26234743	8000	26234212	-4000	4000	531
chr6	33294401	33302401	33301651	8000	33298401	-4000	4000	3250
chr6	27807300	27815300	27807897	8000	27811300	-4000	4000	-3403
chr6	169736109	169744109	169740225	8000	169740109	-4000	4000	116
chr6	26213483	26221483	26216304	8000	26217483	-4000	4000	-1179
chr6	30066333	30074333	30069309	8000	30070333	-4000	4000	-1024
chr6	27446743	27454743	27452987	8000	27450743	-4000	4000	2244
chr6	27807300	27815300	27808591	8000	27811300	-4000	4000	-2709
chr6	29827125	29835125	29829446	8000	29831125	-4000	4000	-1679
chr6	29551629	29559629	29555985	8000	29555629	-4000	4000	356
chr6	52997279	53005279	53004754	8000	53001279	-4000	4000	3475
chr6	36736775	36744775	36742299	8000	36740775	-4000	4000	1524
chr6	27399908	27407908	27400620	8000	27403908	-4000	4000	-3288
chr6	26213483	26221483	26217167	8000	26217483	-4000	4000	-316
chr6	31264749	31272749	31271117	8000	31268749	-4000	4000	2368
chr6	33280832	33288832	33287501	8000	33284832	-4000	4000	2669
chr6	4111693	4119693	4115753	8000	4115693	-4000	4000	60
chr6	12160999	12168999	12161574	8000	12164999	-4000	4000	-3425
chr6	26195988	26203988	26196916	8000	26199988	-4000	4000	-3072
chr6	26201021	26209021	26204842	8000	26205021	-4000	4000	-179
chr6	26248075	26256075	26250287	8000	26252075	-4000	4000	-1788
chr6	26248075	26256075	26251879	8000	26252075	-4000	4000	-196
chr6	27142361	27150361	27147225	8000	27146361	-4000	4000	864
chr6	27807300	27815300	27810226	8000	27811300	-4000	4000	-1074
chr6	27807300	27815300	27814343	8000	27811300	-4000	4000	3043
chr6	27820480	27828480	27824468	8000	27824480	-4000	4000	-12
chr6	27827174	27835174	27831217	8000	27831174	-4000	4000	43
chr6	27886315	27894315	27893616	8000	27890315	-4000	4000	3301
chr6	28085563	28093563	28092740	8000	28089563	-4000	4000	3177
chr6	33280832	33288832	33286842	8000	33284832	-4000	4000	2010
chr6	36960837	36968837	36961448	8000	36964837	-4000	4000	-3389
chr6	36960837	36968837	36961945	8000	36964837	-4000	4000	-2892
chr6	36960837	36968837	36962992	8000	36964837	-4000	4000	-1845
chr6	37025069	37033069	37028017	8000	37029069	-4000	4000	-1052
chr6	41786141	41794141	41787735	8000	41790141	-4000	4000	-2406
chr6	42202807	42210807	42208075	8000	42206807	-4000	4000	1268
chr6	42864558	42872558	42865000	8000	42868558	-4000	4000	-3558
chr6	44230142	44238142	44232914	8000	44234142	-4000	4000	-1228
chr6	57182992	57190992	57183985	8000	57186992	-4000	4000	-3007
chr6	73485308	73493308	73492271	8000	73489308	-4000	4000	2963
chr6	106568017	106576017	106571836	8000	106572017	-4000	4000	-181
chr6	111295028	111303028	111299873	8000	111299028	-4000	4000	845
chr6	112066663	112074663	112068342	8000	112070663	-4000	4000	-2321
chr6	118557716	118565716	118559212	8000	118561716	-4000	4000	-2504
chr6	118955763	118963763	118960074	8000	118959763	-4000	4000	311
chr6	122805720	122813720	122809345	8000	122809720	-4000	4000	-375
chr6	136338281	136346281	136345913	8000	136342281	-4000	4000	3632
chr6	155252134	155260134	155256786	8000	155256134	-4000	4000	652
chr6	158095176	158103176	158096148	8000	158099176	-4000	4000	-3028
chr6	158761741	158769741	158763310	8000	158765741	-4000	4000	-2431
chr6	159030468	159038468	159035928	8000	159034468	-4000	4000	1460
chr6	159030468	159038468	159036768	8000	159034468	-4000	4000	2300
chr6	159816704	159824704	159819002	8000	159820704	-4000	4000	-1702
chr6	159816704	159824704	159819269	8000	159820704	-4000	4000	-1435
chr6	160448577	160456577	160453652	8000	160452577	-4000	4000	1075
chr6	170278206	170286206	170282762	8000	170282206	-4000	4000	556
chr6	18116440	18124440	18122023	8000	18120440	-4000	4000	1583
chr6	39900877	39908877	39901349	8000	39904877	-4000	4000	-3528
chr6	26094343	26102343	26096707	8000	26098343	-4000	4000	-1636
chr6	32841209	32849209	32842225	8000	32845209	-4000	4000	-2984
chr6	36601600	36609600	36603515	8000	36605600	-4000	4000	-2085
chr6	159752319	159760319	159755352	8000	159756319	-4000	4000	-967
chr6	160448577	160456577	160453618	8000	160452577	-4000	4000	1041
chr6	347355	355355	350668	8000	351355	-4000	4000	-687
chr6	28566535	28574535	28573403	8000	28570535	-4000	4000	2868
chr6	33200439	33208439	33201399	8000	33204439	-4000	4000	-3040
chr6	152125619	152133619	152130741	8000	152129619	-4000	4000	1122
chr6	151360115	151368115	151366302	8000	151364115	-4000	4000	2187
chr6	149407613	149415613	149410440	8000	149411613	-4000	4000	-1173
chr6	158507828	158515828	158511605	8000	158511828	-4000	4000	-223
chr6	17607719	17615719	17608217	8000	17611719	-4000	4000	-3502
chr6	33000182	33008182	33007331	8000	33004182	-4000	4000	3149
chr6	57182992	57190992	57190144	8000	57186992	-4000	4000	3152
chr6	25697783	25705783	25701256	8000	25701783	-4000	4000	-527
chr6	152720569	152728569	152722166	8000	152724569	-4000	4000	-2403
chr6	157206779	157214779	157206803	8000	157210779	-4000	4000	-3976
chr6	4060983	4068983	4068702	8000	4064983	-4000	4000	3719
chr6	6650983	6658983	6654849	8000	6654983	-4000	4000	-134
chr6	10705782	10713782	10707456	8000	10709782	-4000	4000	-2326
chr6	10926423	10934423	10927251	8000	10930423	-4000	4000	-3172
chr6	11708054	11716054	11714424	8000	11712054	-4000	4000	2370
chr6	13286446	13294446	13287071	8000	13290446	-4000	4000	-3375
chr6	13617498	13625498	13620328	8000	13621498	-4000	4000	-1170
chr6	13976310	13984310	13976979	8000	13980310	-4000	4000	-3331
chr6	20095684	20103684	20102167	8000	20099684	-4000	4000	2483
chr6	20489714	20497714	20490210	8000	20493714	-4000	4000	-3504
chr6	21228404	21236404	21231162	8000	21232404	-4000	4000	-1242
chr6	24540104	24548104	24547160	8000	24544104	-4000	4000	3056
chr6	26094343	26102343	26094425	8000	26098343	-4000	4000	-3918
chr6	26213483	26221483	26216280	8000	26217483	-4000	4000	-1203
chr6	26213483	26221483	26216430	8000	26217483	-4000	4000	-1053
chr6	27252624	27260624	27255034	8000	27256624	-4000	4000	-1590
chr6	33280832	33288832	33287145	8000	33284832	-4000	4000	2313
chr6	33449689	33457689	33456654	8000	33453689	-4000	4000	2965
chr6	33568547	33576547	33575912	8000	33572547	-4000	4000	3365
chr6	34280887	34288887	34288887	8000	34284887	-4000	4000	4000
chr6	35317771	35325771	35319889	8000	35321771	-4000	4000	-1882
chr6	39900877	39908877	39901304	8000	39904877	-4000	4000	-3573
chr6	41154506	41162506	41161456	8000	41158506	-4000	4000	2950
chr6	43050029	43058029	43056149	8000	43054029	-4000	4000	2120
chr6	46216736	46224736	46223123	8000	46220736	-4000	4000	2387
chr6	54941099	54949099	54941336	8000	54945099	-4000	4000	-3763
chr6	55749653	55757653	55755554	8000	55753653	-4000	4000	1901
chr6	57166305	57174305	57168526	8000	57170305	-4000	4000	-1779
chr6	75714281	75722281	75715394	8000	75718281	-4000	4000	-2887
chr6	78942440	78950440	78946118	8000	78946440	-4000	4000	-322
chr6	83167350	83175350	83168072	8000	83171350	-4000	4000	-3278
chr6	87081498	87089498	87085568	8000	87085498	-4000	4000	70
chr6	89564144	89572144	89566859	8000	89568144	-4000	4000	-1285
chr6	96614626	96622626	96615668	8000	96618626	-4000	4000	-2958
chr6	100504194	100512194	100509317	8000	100508194	-4000	4000	1123
chr6	107047586	107055586	107051268	8000	107051586	-4000	4000	-318
chr6	109488855	109496855	109495380	8000	109492855	-4000	4000	2525
chr6	116628985	116636985	116630528	8000	116632985	-4000	4000	-2457
chr6	116628985	116636985	116632596	8000	116632985	-4000	4000	-389
chr6	121445727	121453727	121447395	8000	121449727	-4000	4000	-2332
chr6	121445727	121453727	121447803	8000	121449727	-4000	4000	-1924
chr6	127284567	127292567	127286821	8000	127288567	-4000	4000	-1746
chr6	127964785	127972785	127970242	8000	127968785	-4000	4000	1457
chr6	130439067	130447067	130441083	8000	130443067	-4000	4000	-1984
chr6	131704441	131712441	131709792	8000	131708441	-4000	4000	1351
chr6	132739870	132747870	132744342	8000	132743870	-4000	4000	472
chr6	132813564	132821564	132816984	8000	132817564	-4000	4000	-580
chr6	138789319	138797319	138792879	8000	138793319	-4000	4000	-440
chr6	139236061	139244061	139243224	8000	139240061	-4000	4000	3163
chr6	143490812	143498812	143495840	8000	143494812	-4000	4000	1028
chr6	149654153	149662153	149662127	8000	149658153	-4000	4000	3974
chr6	150839665	150847665	150840530	8000	150843665	-4000	4000	-3135
chr6	152720569	152728569	152722125	8000	152724569	-4000	4000	-2444
chr6	157206779	157214779	157207157	8000	157210779	-4000	4000	-3622
chr6	157285025	157293025	157292987	8000	157289025	-4000	4000	3962
chr6	158195344	158203344	158197376	8000	158199344	-4000	4000	-1968
chr6	169736109	169744109	169740152	8000	169740109	-4000	4000	43
chr6	17611035	17619035	17616685	8000	17615035	-4000	4000	1650
chr6	31163159	31171159	31166025	8000	31167159	-4000	4000	-1134
chr6	151360115	151368115	151366437	8000	151364115	-4000	4000	2322
chr6	155252134	155260134	155257069	8000	155256134	-4000	4000	935
chr6	27142361	27150361	27146837	8000	27146361	-4000	4000	476
chr6	75080326	75088326	75086404	8000	75084326	-4000	4000	2078
chr6	149654153	149662153	149661691	8000	149658153	-4000	4000	3538
chr6	26213483	26221483	26217357	8000	26217483	-4000	4000	-126
chr6	26201021	26209021	26204984	8000	26205021	-4000	4000	-37
chr6	31349872	31357872	31355208	8000	31353872	-4000	4000	1336
chr6	34531229	34539229	34531728	8000	34535229	-4000	4000	-3501
chr6	170278206	170286206	170282747	8000	170282206	-4000	4000	541
chr6	170568870	170576870	170569647	8000	170572870	-4000	4000	-3223
chr6	26195988	26203988	26199787	8000	26199988	-4000	4000	-201
chr6	27886315	27894315	27893732	8000	27890315	-4000	4000	3417
chr6	169699902	169707902	169704024	8000	169703902	-4000	4000	122
chr6	152117687	152125687	152122622	8000	152121687	-4000	4000	935
chr6	26542933	26550933	26545519	8000	26546933	-4000	4000	-1414
chr6	28298549	28306549	28301422	8000	28302549	-4000	4000	-1127
chr6	37328970	37336970	37331686	8000	37332970	-4000	4000	-1284
chr6	107657306	107665306	107659035	8000	107661306	-4000	4000	-2271
chr6	109362514	109370514	109366990	8000	109366514	-4000	4000	476
chr6	33158681	33166681	33166512	8000	33162681	-4000	4000	3831
chr6	130439067	130447067	130441477	8000	130443067	-4000	4000	-1590
chr6	78942440	78950440	78945900	8000	78946440	-4000	4000	-540
chr6	149969715	149977715	149970111	8000	149973715	-4000	4000	-3604
chr6	158095176	158103176	158095806	8000	158099176	-4000	4000	-3370
chr6	11179298	11187298	11185274	8000	11183298	-4000	4000	1976
chr6	30649210	30657210	30652678	8000	30653210	-4000	4000	-532
chr6	79910814	79918814	79916186	8000	79914814	-4000	4000	1372
chr6	18116440	18124440	18121630	8000	18120440	-4000	4000	1190
chr6	160448577	160456577	160454180	8000	160452577	-4000	4000	1603
chr6	347355	355355	350830	8000	351355	-4000	4000	-525
chr6	138899493	138907493	138900945	8000	138903493	-4000	4000	-2548
chr6	85491791	85499791	85493913	8000	85495791	-4000	4000	-1878
chr6	166405364	166413364	166411686	8000	166409364	-4000	4000	2322
chr6	89081160	89089160	89084378	8000	89085160	-4000	4000	-782
chr6	26248075	26256075	26250433	8000	26252075	-4000	4000	-1642
chr6	96885315	96893315	96891070	8000	96889315	-4000	4000	1755
chr6	161343417	161351417	161350003	8000	161347417	-4000	4000	2586
chr6	10625368	10633368	10626841	8000	10629368	-4000	4000	-2527
chr6	26094343	26102343	26094395	8000	26098343	-4000	4000	-3948
chr6	57051239	57059239	57054491	8000	57055239	-4000	4000	-748
chr6	99538387	99546387	99543432	8000	99542387	-4000	4000	1045
chr6	106568017	106576017	106568750	8000	106572017	-4000	4000	-3267
chr6	106568017	106576017	106568751	8000	106572017	-4000	4000	-3266
chr6	152720569	152728569	152721880	8000	152724569	-4000	4000	-2689
chr6	56453987	56461987	56459142	8000	56457987	-4000	4000	1155
chr6	56453987	56461987	56459229	8000	56457987	-4000	4000	1242
chr6	84120241	84128241	84126387	8000	84124241	-4000	4000	2146
chr6	96551276	96559276	96553350	8000	96555276	-4000	4000	-1926
chr6	27142361	27150361	27147470	8000	27146361	-4000	4000	1109
chr6	43177506	43185506	43184511	8000	43181506	-4000	4000	3005
chr6	95605470	95613470	95605798	8000	95609470	-4000	4000	-3672
chr6	32190843	32198843	32191498	8000	32194843	-4000	4000	-3345
chr6	7877522	7885522	7880310	8000	7881522	-4000	4000	-1212
chr6	35789675	35797675	35797238	8000	35793675	-4000	4000	3563
chr6	96885315	96893315	96891324	8000	96889315	-4000	4000	2009
chr6	3219324	3227324	3225460	8000	3223324	-4000	4000	2136
chr6	27129535	27137535	27133383	8000	27133535	-4000	4000	-152
chr6	27862792	27870792	27865668	8000	27866792	-4000	4000	-1124
chr6	31584909	31592909	31587308	8000	31588909	-4000	4000	-1601
chr6	31714648	31722648	31720182	8000	31718648	-4000	4000	1534
chr6	36850827	36858827	36855923	8000	36854827	-4000	4000	1096
chr6	53920125	53928125	53922649	8000	53924125	-4000	4000	-1476
chr6	85500776	85508776	85507258	8000	85504776	-4000	4000	2482
chr6	97138161	97146161	97139481	8000	97142161	-4000	4000	-2680
chr6	159752319	159760319	159755662	8000	159756319	-4000	4000	-657
chr6	5993999	6001999	5998799	8000	5997999	-4000	4000	800
chr6	26213483	26221483	26217357	8000	26217483	-4000	4000	-126
chr6	27446743	27454743	27451562	8000	27450743	-4000	4000	819
chr6	136191574	136199574	136191845	8000	136195574	-4000	4000	-3729
chr6	15518042	15526042	15524402	8000	15522042	-4000	4000	2360
chr6	28237697	28245697	28245602	8000	28241697	-4000	4000	3905
chr6	42959865	42967865	42966378	8000	42963865	-4000	4000	2513
chr6	158105519	158113519	158111311	8000	158109519	-4000	4000	1792
chr6	16144248	16152248	16146808	8000	16148248	-4000	4000	-1440
chr6	35463102	35471102	35468429	8000	35467102	-4000	4000	1327
chr6	125757269	125765269	125759426	8000	125761269	-4000	4000	-1843
chr6	136995971	137003971	137001801	8000	136999971	-4000	4000	1830
chr6	28298549	28306549	28302095	8000	28302549	-4000	4000	-454
chr6	32180733	32188733	32186460	8000	32184733	-4000	4000	1727
chr6	26213483	26221483	26217139	8000	26217483	-4000	4000	-344
chr6	26449415	26457415	26451867	8000	26453415	-4000	4000	-1548
chr6	31853659	31861659	31860136	8000	31857659	-4000	4000	2477
chr6	33405896	33413896	33406393	8000	33409896	-4000	4000	-3503
chr6	106568017	106576017	106568716	8000	106572017	-4000	4000	-3301
chr6	33200439	33208439	33201635	8000	33204439	-4000	4000	-2804
chr6	118557716	118565716	118558978	8000	118561716	-4000	4000	-2738
chr6	127284567	127292567	127287319	8000	127288567	-4000	4000	-1248
chr6	13976310	13984310	13977852	8000	13980310	-4000	4000	-2458
chr6	26201021	26209021	26204794	8000	26205021	-4000	4000	-227
chr6	28566535	28574535	28573146	8000	28570535	-4000	4000	2611
chr6	72399145	72407145	72400676	8000	72403145	-4000	4000	-2469
chr6	116459771	116467771	116463607	8000	116463771	-4000	4000	-164
chr6	136995971	137003971	137002056	8000	136999971	-4000	4000	2085
chr6	26195988	26203988	26199067	8000	26199988	-4000	4000	-921
chr6	85491791	85499791	85492170	8000	85495791	-4000	4000	-3621
chr6	134165248	134173248	134171661	8000	134169248	-4000	4000	2413
chr6	87663453	87671453	87665811	8000	87667453	-4000	4000	-1642
chr6	32574769	32582769	32579049	8000	32578769	-4000	4000	280
chr6	33158681	33166681	33164464	8000	33162681	-4000	4000	1783
chr6	28237697	28245697	28245250	8000	28241697	-4000	4000	3553
chr6	138084505	138092505	138092164	8000	138088505	-4000	4000	3659
chr6	107148562	107156562	107154441	8000	107152562	-4000	4000	1879
chr6	149654153	149662153	149661749	8000	149658153	-4000	4000	3596
chr6	57182992	57190992	57190454	8000	57186992	-4000	4000	3462
chr6	27886315	27894315	27893024	8000	27890315	-4000	4000	2709
chr6	12160999	12168999	12163649	8000	12164999	-4000	4000	-1350
chr6	3264962	3272962	3267652	8000	3268962	-4000	4000	-1310
chr6	26223473	26231473	26225580	8000	26227473	-4000	4000	-1893
chr6	83157150	83165150	83159801	8000	83161150	-4000	4000	-1349
chr6	118557716	118565716	118565555	8000	118561716	-4000	4000	3839
chr6	158761741	158769741	158763509	8000	158765741	-4000	4000	-2232
chr6	29553721	29561721	29559780	8000	29557721	-4000	4000	2059
chr6	144187939	144195939	144188119	8000	144191939	-4000	4000	-3820
chr6	37390734	37398734	37391262	8000	37394734	-4000	4000	-3472
chr6	27446743	27454743	27452211	8000	27450743	-4000	4000	1468
chr6	27807300	27815300	27814609	8000	27811300	-4000	4000	3309
chr6	13976310	13984310	13979065	8000	13980310	-4000	4000	-1245
chr6	118557716	118565716	118559245	8000	118561716	-4000	4000	-2471
chr6	155252134	155260134	155254713	8000	155256134	-4000	4000	-1421
chr6	36228790	36236790	36230483	8000	36232790	-4000	4000	-2307
chr6	89161565	89169565	89161872	8000	89165565	-4000	4000	-3693
chr6	130137449	130145449	130145403	8000	130141449	-4000	4000	3954
chr6	14132918	14140918	14135320	8000	14136918	-4000	4000	-1598
chr6	30066333	30074333	30068342	8000	30070333	-4000	4000	-1991
chr6	34280887	34288887	34288843	8000	34284887	-4000	4000	3956
chr6	26180655	26188655	26183836	8000	26184655	-4000	4000	-819
chr6	170531120	170539120	170535316	8000	170535120	-4000	4000	196
chr6	31264749	31272749	31271424	8000	31268749	-4000	4000	2675
chr6	17289871	17297871	17292063	8000	17293871	-4000	4000	-1808
chr6	15518042	15526042	15524442	8000	15522042	-4000	4000	2400
chr6	31726581	31734581	31734180	8000	31730581	-4000	4000	3599
chr6	33568547	33576547	33573822	8000	33572547	-4000	4000	1275
chr6	10758723	10766723	10764409	8000	10762723	-4000	4000	1686
chr6	36960837	36968837	36963357	8000	36964837	-4000	4000	-1480
chr6	41650244	41658244	41653793	8000	41654244	-4000	4000	-451
chr6	29668483	29676483	29673306	8000	29672483	-4000	4000	823
chr6	117314211	117322211	117321308	8000	117318211	-4000	4000	3097
chr6	36601600	36609600	36602859	8000	36605600	-4000	4000	-2741
chr6	70212040	70220040	70216925	8000	70216040	-4000	4000	885
chr6	30649210	30657210	30655259	8000	30653210	-4000	4000	2049
chr6	160448577	160456577	160453513	8000	160452577	-4000	4000	936
chr6	26411208	26419208	26412742	8000	26415208	-4000	4000	-2466
chr6	3015755	3023755	3019529	8000	3019755	-4000	4000	-226
chr6	84120241	84128241	84124935	8000	84124241	-4000	4000	694
chr6	150246392	150254392	150249150	8000	150250392	-4000	4000	-1242
chr6	72399145	72407145	72400511	8000	72403145	-4000	4000	-2634
chr6	95605470	95613470	95606181	8000	95609470	-4000	4000	-3289
chr6	52260014	52268014	52264723	8000	52264014	-4000	4000	709
chr6	57051239	57059239	57054339	8000	57055239	-4000	4000	-900
chr6	108207222	108215222	108211833	8000	108211222	-4000	4000	611
chr6	26374320	26382320	26376639	8000	26378320	-4000	4000	-1681
chr6	13976310	13984310	13979972	8000	13980310	-4000	4000	-338
chr6	111656332	111664332	111661350	8000	111660332	-4000	4000	1018
chr6	33449689	33457689	33456347	8000	33453689	-4000	4000	2658
chr6	46993708	47001708	47000174	8000	46997708	-4000	4000	2466
chr6	26180655	26188655	26183817	8000	26184655	-4000	4000	-838
chr6	44180401	44188401	44184027	8000	44184401	-4000	4000	-374
chr6	157206779	157214779	157206929	8000	157210779	-4000	4000	-3850
chr6	73194853	73202853	73195089	8000	73198853	-4000	4000	-3764
chr6	26180655	26188655	26184169	8000	26184655	-4000	4000	-486
chr6	27807300	27815300	27808542	8000	27811300	-4000	4000	-2758
chr6	18219854	18227854	18225437	8000	18223854	-4000	4000	1583
chr6	12160999	12168999	12164252	8000	12164999	-4000	4000	-747
chr6	39295001	39303001	39300459	8000	39299001	-4000	4000	1458
chr6	110095819	110103819	110101726	8000	110099819	-4000	4000	1907
chr6	32944613	32952613	32950463	8000	32948613	-4000	4000	1850
chr6	24701065	24709065	24706137	8000	24705065	-4000	4000	1072
chr6	54941099	54949099	54941625	8000	54945099	-4000	4000	-3474
chr6	99365401	99373401	99369712	8000	99369401	-4000	4000	311
chr6	122805720	122813720	122809482	8000	122809720	-4000	4000	-238
chr6	10625368	10633368	10626660	8000	10629368	-4000	4000	-2708
chr6	144849034	144857034	144851067	8000	144853034	-4000	4000	-1967
chr6	39900877	39908877	39901455	8000	39904877	-4000	4000	-3422
chr6	30642823	30650823	30644482	8000	30646823	-4000	4000	-2341
chr6	26266918	26274918	26270991	8000	26270918	-4000	4000	73
chr6	99393629	99401629	99394146	8000	99397629	-4000	4000	-3483
chr6	131704441	131712441	131709367	8000	131708441	-4000	4000	926
chr6	160448577	160456577	160453656	8000	160452577	-4000	4000	1079
chr6	26266918	26274918	26273059	8000	26270918	-4000	4000	2141
chr6	89161565	89169565	89161859	8000	89165565	-4000	4000	-3706
chr6	137879312	137887312	137880141	8000	137883312	-4000	4000	-3171
chr6	43071095	43079095	43074681	8000	43075095	-4000	4000	-414
chr6	53263398	53271398	53269028	8000	53267398	-4000	4000	1630
chr6	35463102	35471102	35468429	8000	35467102	-4000	4000	1327
chr6	109439919	109447919	109443834	8000	109443919	-4000	4000	-85
chr6	4111693	4119693	4115929	8000	4115693	-4000	4000	236
chr6	30896156	30904156	30896822	8000	30900156	-4000	4000	-3334
chr6	47227532	47235532	47234808	8000	47231532	-4000	4000	3276
chr6	53493341	53501341	53498638	8000	53497341	-4000	4000	1297
chr6	130137449	130145449	130145385	8000	130141449	-4000	4000	3936
chr6	33200439	33208439	33201078	8000	33204439	-4000	4000	-3361
chr6	118905171	118913171	118911531	8000	118909171	-4000	4000	2360
chr6	27820480	27828480	27824322	8000	27824480	-4000	4000	-158
chr6	38150624	38158624	38152464	8000	38154624	-4000	4000	-2160
chr6	3219324	3227324	3225646	8000	3223324	-4000	4000	2322
chr6	15518042	15526042	15522922	8000	15522042	-4000	4000	880
chr6	26195988	26203988	26199867	8000	26199988	-4000	4000	-121
chr6	26213483	26221483	26217081	8000	26217483	-4000	4000	-402
chr6	27807300	27815300	27808438	8000	27811300	-4000	4000	-2862
chr6	28566535	28574535	28572915	8000	28570535	-4000	4000	2380
chr6	30922459	30930459	30924491	8000	30926459	-4000	4000	-1968
chr6	31760851	31768851	31762484	8000	31764851	-4000	4000	-2367
chr6	31941672	31949672	31946545	8000	31945672	-4000	4000	873
chr6	32190843	32198843	32198486	8000	32194843	-4000	4000	3643
chr6	35317771	35325771	35319655	8000	35321771	-4000	4000	-2116
chr6	42864558	42872558	42864815	8000	42868558	-4000	4000	-3743
chr6	57166305	57174305	57168586	8000	57170305	-4000	4000	-1719
chr6	116628985	116636985	116632340	8000	116632985	-4000	4000	-645
chr6	150839665	150847665	150840782	8000	150843665	-4000	4000	-2883
chr6	26195988	26203988	26196945	8000	26199988	-4000	4000	-3043
chr6	89922528	89930528	89928879	8000	89926528	-4000	4000	2351
chr6	122429119	122437119	122432426	8000	122433119	-4000	4000	-693
chr6	46142688	46150688	46143588	8000	46146688	-4000	4000	-3100
chr6	87670860	87678860	87675476	8000	87674860	-4000	4000	616
chr6	27142361	27150361	27146792	8000	27146361	-4000	4000	431
chr6	41786141	41794141	41789309	8000	41790141	-4000	4000	-832
chr6	4111693	4119693	4115904	8000	4115693	-4000	4000	211
chr6	26213483	26221483	26216362	8000	26217483	-4000	4000	-1121
chr6	26390874	26398874	26392742	8000	26394874	-4000	4000	-2132
chr6	31793396	31801396	31795206	8000	31797396	-4000	4000	-2190
chr6	31853659	31861659	31860604	8000	31857659	-4000	4000	2945
chr6	32841209	32849209	32845717	8000	32845209	-4000	4000	508
chr6	35789675	35797675	35795147	8000	35793675	-4000	4000	1472
chr6	106568017	106576017	106568489	8000	106572017	-4000	4000	-3528
chr6	131704441	131712441	131710108	8000	131708441	-4000	4000	1667
chr6	133528128	133536128	133529204	8000	133532128	-4000	4000	-2924
chr6	121445727	121453727	121447797	8000	121449727	-4000	4000	-1930
chr6	132765370	132773370	132770183	8000	132769370	-4000	4000	813
chr6	42885925	42893925	42886069	8000	42889925	-4000	4000	-3856
chr6	170531120	170539120	170537235	8000	170535120	-4000	4000	2115
chr7	135644757	135652757	135648416	8000	135648757	-4000	4000	-341
chr7	73432120	73440120	73434841	8000	73436120	-4000	4000	-1279
chr7	103308289	103316289	103312480	8000	103312289	-4000	4000	191
chr7	87829568	87837568	87836191	8000	87833568	-4000	4000	2623
chr7	106244298	106252298	106251003	8000	106248298	-4000	4000	2705
chr7	98210624	98218624	98218028	8000	98214624	-4000	4000	3404
chr7	28821894	28829894	28825552	8000	28825894	-4000	4000	-342
chr7	150475393	150483393	150477700	8000	150479393	-4000	4000	-1693
chr7	25130692	25138692	25136543	8000	25134692	-4000	4000	1851
chr7	142867208	142875208	142871653	8000	142871208	-4000	4000	445
chr7	77306751	77314751	77312123	8000	77310751	-4000	4000	1372
chr7	93095513	93103513	93101990	8000	93099513	-4000	4000	2477
chr7	93095513	93103513	93102685	8000	93099513	-4000	4000	3172
chr7	99644194	99652194	99650190	8000	99648194	-4000	4000	1996
chr7	100396096	100404096	100401160	8000	100400096	-4000	4000	1064
chr7	130502465	130510465	130506540	8000	130506465	-4000	4000	75
chr7	151049815	151057815	151051844	8000	151053815	-4000	4000	-1971
chr7	103308289	103316289	103311697	8000	103312289	-4000	4000	-592
chr7	22728002	22736002	22729672	8000	22732002	-4000	4000	-2330
chr7	26209607	26217607	26211751	8000	26213607	-4000	4000	-1856
chr7	93095513	93103513	93103145	8000	93099513	-4000	4000	3632
chr7	100155244	100163244	100160663	8000	100159244	-4000	4000	1419
chr7	150689641	150697641	150692524	8000	150693641	-4000	4000	-1117
chr7	4265000	4273000	4268818	8000	4269000	-4000	4000	-182
chr7	26370383	26378383	26371957	8000	26374383	-4000	4000	-2426
chr7	39606320	39614320	39610131	8000	39610320	-4000	4000	-189
chr7	27521442	27529442	27526125	8000	27525442	-4000	4000	683
chr7	152118340	152126340	152118642	8000	152122340	-4000	4000	-3698
chr7	23197011	23205011	23200183	8000	23201011	-4000	4000	-828
chr7	92106673	92114673	92108522	8000	92110673	-4000	4000	-2151
chr7	38379704	38387704	38384829	8000	38383704	-4000	4000	1125
chr7	100611384	100619384	100615194	8000	100615384	-4000	4000	-190
chr7	7632518	7640518	7640412	8000	7636518	-4000	4000	3894
chr7	8748961	8756961	8751027	8000	8752961	-4000	4000	-1934
chr7	150940961	150948961	150948458	8000	150944961	-4000	4000	3497
chr7	140019749	140027749	140024615	8000	140023749	-4000	4000	866
chr7	95355872	95363872	95360109	8000	95359872	-4000	4000	237
chr7	31747179	31755179	31753086	8000	31751179	-4000	4000	1907
chr7	6018247	6026247	6024578	8000	6022247	-4000	4000	2331
chr7	84991553	84999553	84999496	8000	84995553	-4000	4000	3943
chr7	1743946	1751946	1746986	8000	1747946	-4000	4000	-960
chr7	1743946	1751946	1746987	8000	1747946	-4000	4000	-959
chr7	84991553	84999553	84999439	8000	84995553	-4000	4000	3886
chr7	100459359	100467359	100463966	8000	100463359	-4000	4000	607
chr7	122060583	122068583	122061234	8000	122064583	-4000	4000	-3349
chr7	74401935	74409935	74403932	8000	74405935	-4000	4000	-2003
chr7	23197011	23205011	23200344	8000	23201011	-4000	4000	-667
chr7	112815147	112823147	112819313	8000	112819147	-4000	4000	166
chr7	37947936	37955936	37950414	8000	37951936	-4000	4000	-1522
chr7	71709600	71717600	71710836	8000	71713600	-4000	4000	-2764
chr7	106244298	106252298	106251003	8000	106248298	-4000	4000	2705
chr7	149179042	149187042	149181143	8000	149183042	-4000	4000	-1899
chr7	26183137	26191137	26185839	8000	26187137	-4000	4000	-1298
chr7	99542300	99550300	99547649	8000	99546300	-4000	4000	1349
chr7	142102747	142110747	142103414	8000	142106747	-4000	4000	-3333
chr7	142867208	142875208	142873534	8000	142871208	-4000	4000	2326
chr7	44822791	44830791	44829919	8000	44826791	-4000	4000	3128
chr7	32864172	32872172	32868565	8000	32868172	-4000	4000	393
chr7	108570850	108578850	108571890	8000	108574850	-4000	4000	-2960
chr7	150475393	150483393	150477309	8000	150479393	-4000	4000	-2084
chr7	6157564	6165564	6164814	8000	6161564	-4000	4000	3250
chr7	1055261	1063261	1059067	8000	1059261	-4000	4000	-194
chr7	100155244	100163244	100160115	8000	100159244	-4000	4000	871
chr7	76385334	76393334	76390261	8000	76389334	-4000	4000	927
chr7	130014287	130022287	130018598	8000	130018287	-4000	4000	311
chr7	150689641	150697641	150693081	8000	150693641	-4000	4000	-560
chr7	132780870	132788870	132785520	8000	132784870	-4000	4000	650
chr7	97016396	97024396	97021016	8000	97020396	-4000	4000	620
chr7	97016396	97024396	97022271	8000	97020396	-4000	4000	1875
chr7	24792540	24800540	24800014	8000	24796540	-4000	4000	3474
chr7	142867208	142875208	142870311	8000	142871208	-4000	4000	-897
chr7	93126056	93134056	93133751	8000	93130056	-4000	4000	3695
chr7	1743946	1751946	1746101	8000	1747946	-4000	4000	-1845
chr7	30630033	30638033	30632383	8000	30634033	-4000	4000	-1650
chr7	64829681	64837681	64831628	8000	64833681	-4000	4000	-2053
chr7	93881396	93889396	93889113	8000	93885396	-4000	4000	3717
chr7	98306441	98314441	98310578	8000	98310441	-4000	4000	137
chr7	100155244	100163244	100160031	8000	100159244	-4000	4000	787
chr7	100061040	100069040	100064799	8000	100065040	-4000	4000	-241
chr7	44213150	44221150	44220181	8000	44217150	-4000	4000	3031
chr7	38718974	38726974	38726906	8000	38722974	-4000	4000	3932
chr7	87829568	87837568	87836188	8000	87833568	-4000	4000	2620
chr7	55429737	55437737	55431341	8000	55433737	-4000	4000	-2396
chr7	1055261	1063261	1057663	8000	1059261	-4000	4000	-1598
chr7	1743946	1751946	1745863	8000	1747946	-4000	4000	-2083
chr7	6157564	6165564	6164843	8000	6161564	-4000	4000	3279
chr7	15607212	15615212	15612466	8000	15611212	-4000	4000	1254
chr7	76512522	76520522	76515155	8000	76516522	-4000	4000	-1367
chr7	95355872	95363872	95363801	8000	95359872	-4000	4000	3929
chr7	99499650	99507650	99499888	8000	99503650	-4000	4000	-3762
chr7	107198522	107206522	107200197	8000	107202522	-4000	4000	-2325
chr7	141923357	141931357	141930001	8000	141927357	-4000	4000	2644
chr7	121293442	121301442	121295702	8000	121297442	-4000	4000	-1740
chr7	149760182	149768182	149764795	8000	149764182	-4000	4000	613
chr7	112477017	112485017	112484924	8000	112481017	-4000	4000	3907
chr7	5302912	5310912	5308941	8000	5306912	-4000	4000	2029
chr7	142867208	142875208	142870970	8000	142871208	-4000	4000	-238
chr7	48104736	48112736	48107488	8000	48108736	-4000	4000	-1248
chr7	143751089	143759089	143757077	8000	143755089	-4000	4000	1988
chr7	142218324	142226324	142220970	8000	142222324	-4000	4000	-1354
chr7	150940961	150948961	150945462	8000	150944961	-4000	4000	501
chr7	151374449	151382449	151377097	8000	151378449	-4000	4000	-1352
chr7	23271108	23279108	23273530	8000	23275108	-4000	4000	-1578
chr7	37947936	37955936	37950221	8000	37951936	-4000	4000	-1715
chr7	74401935	74409935	74403853	8000	74405935	-4000	4000	-2082
chr7	90160829	90168829	90160993	8000	90164829	-4000	4000	-3836
chr7	150801118	150809118	150801589	8000	150805118	-4000	4000	-3529
chr7	77189369	77197369	77196926	8000	77193369	-4000	4000	3557
chr7	150621375	150629375	150627753	8000	150625375	-4000	4000	2378
chr7	143387111	143395111	143394310	8000	143391111	-4000	4000	3199
chr7	99962720	99970720	99968235	8000	99966720	-4000	4000	1515
chr7	112815147	112823147	112822256	8000	112819147	-4000	4000	3109
chr7	102809230	102817230	102813466	8000	102813230	-4000	4000	236
chr7	64829681	64837681	64832362	8000	64833681	-4000	4000	-1319
chr7	98306441	98314441	98307775	8000	98310441	-4000	4000	-2666
chr7	99023440	99031440	99030731	8000	99027440	-4000	4000	3291
chr7	93357123	93365123	93358751	8000	93361123	-4000	4000	-2372
chr7	64926981	64934981	64927809	8000	64930981	-4000	4000	-3172
chr7	6684433	6692433	6691094	8000	6688433	-4000	4000	2661
chr7	80738538	80746538	80744994	8000	80742538	-4000	4000	2456
chr7	100396096	100404096	100401892	8000	100400096	-4000	4000	1796
chr7	150787285	150795285	150793188	8000	150791285	-4000	4000	1903
chr7	36320152	36328152	36326836	8000	36324152	-4000	4000	2684
chr7	103467381	103475381	103472618	8000	103471381	-4000	4000	1237
chr7	84991553	84999553	84999496	8000	84995553	-4000	4000	3943
chr7	37901932	37909932	37907569	8000	37905932	-4000	4000	1637
chr7	135689418	135697418	135692382	8000	135693418	-4000	4000	-1036
chr7	95355872	95363872	95362386	8000	95359872	-4000	4000	2514
chr7	143751089	143759089	143756485	8000	143755089	-4000	4000	1396
chr7	107761467	107769467	107767595	8000	107765467	-4000	4000	2128
chr7	95292415	95300415	95298807	8000	95296415	-4000	4000	2392
chr7	1089815	1097815	1092789	8000	1093815	-4000	4000	-1026
chr7	150621375	150629375	150628198	8000	150625375	-4000	4000	2823
chr7	151008209	151016209	151014230	8000	151012209	-4000	4000	2021
chr7	134062589	134070589	134064404	8000	134066589	-4000	4000	-2185
chr7	54567080	54575080	54569149	8000	54571080	-4000	4000	-1931
chr7	25130692	25138692	25136109	8000	25134692	-4000	4000	1417
chr7	27149716	27157716	27155127	8000	27153716	-4000	4000	1411
chr7	104122341	104130341	104126739	8000	104126341	-4000	4000	398
chr7	782475	790475	785635	8000	786475	-4000	4000	-840
chr7	150689641	150697641	150692409	8000	150693641	-4000	4000	-1232
chr7	6620290	6628290	6621798	8000	6624290	-4000	4000	-2492
chr7	16702523	16710523	16704632	8000	16706523	-4000	4000	-1891
chr7	151371909	151379909	151374219	8000	151375909	-4000	4000	-1690
chr7	75145817	75153817	75148436	8000	75149817	-4000	4000	-1381
chr7	140016325	140024325	140020245	8000	140020325	-4000	4000	-80
chr7	4265000	4273000	4268578	8000	4269000	-4000	4000	-422
chr7	77189369	77197369	77196819	8000	77193369	-4000	4000	3450
chr7	84991553	84999553	84999533	8000	84995553	-4000	4000	3980
chr7	56059989	56067989	56063092	8000	56063989	-4000	4000	-897
chr7	151552124	151560124	151556419	8000	151556124	-4000	4000	295
chr7	114689772	114697772	114690852	8000	114693772	-4000	4000	-2920
chr7	120746337	120754337	120749529	8000	120750337	-4000	4000	-808
chr7	149098784	149106784	149104740	8000	149102784	-4000	4000	1956
chr7	149098784	149106784	149105188	8000	149102784	-4000	4000	2404
chr7	6620290	6628290	6621604	8000	6624290	-4000	4000	-2686
chr7	99872958	99880958	99876296	8000	99876958	-4000	4000	-662
chr7	158627169	158635169	158631497	8000	158631169	-4000	4000	328
chr7	142867208	142875208	142867766	8000	142871208	-4000	4000	-3442
chr7	139039515	139047515	139047350	8000	139043515	-4000	4000	3835
chr7	150334156	150342156	150337313	8000	150338156	-4000	4000	-843
chr7	105106704	105114704	105113458	8000	105110704	-4000	4000	2754
chr7	99872958	99880958	99876574	8000	99876958	-4000	4000	-384
chr7	33010130	33018130	33014674	8000	33014130	-4000	4000	544
chr7	98625869	98633869	98628497	8000	98629869	-4000	4000	-1372
chr7	43803342	43811342	43807236	8000	43807342	-4000	4000	-106
chr7	23640708	23648708	23643622	8000	23644708	-4000	4000	-1086
chr7	108143623	108151623	108148573	8000	108147623	-4000	4000	950
chr7	103308289	103316289	103312411	8000	103312289	-4000	4000	122
chr7	106032432	106040432	106032806	8000	106036432	-4000	4000	-3626
chr7	545197	553197	550475	8000	549197	-4000	4000	1278
chr7	1148071	1156071	1152947	8000	1152071	-4000	4000	876
chr7	64707577	64715577	64708623	8000	64711577	-4000	4000	-2954
chr7	77779022	77787022	77779550	8000	77783022	-4000	4000	-3472
chr7	95579499	95587499	95583856	8000	95583499	-4000	4000	357
chr7	105106704	105114704	105107503	8000	105110704	-4000	4000	-3201
chr7	128855274	128863274	128856609	8000	128859274	-4000	4000	-2665
chr7	72947440	72955440	72949912	8000	72951440	-4000	4000	-1528
chr7	107757667	107765667	107759436	8000	107761667	-4000	4000	-2231
chr7	120783320	120791320	120787979	8000	120787320	-4000	4000	659
chr7	151043782	151051782	151049344	8000	151047782	-4000	4000	1562
chr7	38379704	38387704	38384591	8000	38383704	-4000	4000	887
chr7	150569953	150577953	150572617	8000	150573953	-4000	4000	-1336
chr7	6684433	6692433	6691191	8000	6688433	-4000	4000	2758
chr7	27102184	27110184	27108450	8000	27106184	-4000	4000	2266
chr7	149760182	149768182	149766229	8000	149764182	-4000	4000	2047
chr7	102809230	102817230	102813261	8000	102813230	-4000	4000	31
chr7	102809230	102817230	102813343	8000	102813230	-4000	4000	113
chr7	23173914	23181914	23174270	8000	23177914	-4000	4000	-3644
chr7	50586063	50594063	50593073	8000	50590063	-4000	4000	3010
chr7	48104736	48112736	48108314	8000	48108736	-4000	4000	-422
chr7	138834101	138842101	138837847	8000	138838101	-4000	4000	-254
chr7	95579499	95587499	95587494	8000	95583499	-4000	4000	3995
chr7	100088187	100096187	100089641	8000	100092187	-4000	4000	-2546
chr7	150334156	150342156	150336861	8000	150338156	-4000	4000	-1295
chr7	150689641	150697641	150692852	8000	150693641	-4000	4000	-789
chr7	150689641	150697641	150692853	8000	150693641	-4000	4000	-788
chr7	128855274	128863274	128855311	8000	128859274	-4000	4000	-3963
chr7	100396096	100404096	100401212	8000	100400096	-4000	4000	1116
chr7	129209545	129217545	129211014	8000	129213545	-4000	4000	-2531
chr7	102469168	102477168	102476241	8000	102473168	-4000	4000	3073
chr7	107761467	107769467	107767581	8000	107765467	-4000	4000	2114
chr7	151008209	151016209	151009041	8000	151012209	-4000	4000	-3168
chr7	87499017	87507017	87505924	8000	87503017	-4000	4000	2907
chr7	139039515	139047515	139047253	8000	139043515	-4000	4000	3738
chr7	100061040	100069040	100064813	8000	100065040	-4000	4000	-227
chr7	36848906	36856906	36855336	8000	36852906	-4000	4000	2430
chr7	6157564	6165564	6164713	8000	6161564	-4000	4000	3149
chr7	6157564	6165564	6165002	8000	6161564	-4000	4000	3438
chr7	22808628	22816628	22813156	8000	22812628	-4000	4000	528
chr7	99499650	99507650	99499904	8000	99503650	-4000	4000	-3746
chr7	129209545	129217545	129211004	8000	129213545	-4000	4000	-2541
chr7	130502465	130510465	130506586	8000	130506465	-4000	4000	121
chr7	43646713	43654713	43648628	8000	43650713	-4000	4000	-2085
chr7	70789506	70797506	70792837	8000	70793506	-4000	4000	-669
chr7	72947440	72955440	72949654	8000	72951440	-4000	4000	-1786
chr7	44210294	44218294	44211054	8000	44214294	-4000	4000	-3240
chr7	6684433	6692433	6691156	8000	6688433	-4000	4000	2723
chr7	144182083	144190083	144187713	8000	144186083	-4000	4000	1630
chr7	93095513	93103513	93103429	8000	93099513	-4000	4000	3916
chr7	128950180	128958180	128955070	8000	128954180	-4000	4000	890
chr7	23173914	23181914	23174382	8000	23177914	-4000	4000	-3532
chr7	143135739	143143739	143139597	8000	143139739	-4000	4000	-142
chr7	143751089	143759089	143756494	8000	143755089	-4000	4000	1405
chr7	150517073	150525073	150520818	8000	150521073	-4000	4000	-255
chr7	12326885	12334885	12333505	8000	12330885	-4000	4000	2620
chr7	124739885	124747885	124746970	8000	124743885	-4000	4000	3085
chr7	90234137	90242137	90236969	8000	90238137	-4000	4000	-1168
chr7	129484399	129492399	129485734	8000	129488399	-4000	4000	-2665
chr7	4265000	4273000	4268677	8000	4269000	-4000	4000	-323
chr7	71709600	71717600	71710862	8000	71713600	-4000	4000	-2738
chr7	26183137	26191137	26184664	8000	26187137	-4000	4000	-2473
chr7	90160829	90168829	90164786	8000	90164829	-4000	4000	-43
chr7	105106704	105114704	105109172	8000	105110704	-4000	4000	-1532
chr7	111121454	111129454	111122845	8000	111125454	-4000	4000	-2609
chr7	21510822	21518822	21511254	8000	21514822	-4000	4000	-3568
chr7	44508535	44516535	44515822	8000	44512535	-4000	4000	3287
chr7	99499650	99507650	99500056	8000	99503650	-4000	4000	-3594
chr7	124739885	124747885	124747267	8000	124743885	-4000	4000	3382
chr7	30420527	30428527	30425384	8000	30424527	-4000	4000	857
chr7	90160829	90168829	90161262	8000	90164829	-4000	4000	-3567
chr7	100611384	100619384	100613267	8000	100615384	-4000	4000	-2117
chr7	135689418	135697418	135695454	8000	135693418	-4000	4000	2036
chr7	75145817	75153817	75148707	8000	75149817	-4000	4000	-1110
chr7	99530700	99538700	99531595	8000	99534700	-4000	4000	-3105
chr7	149468696	149476696	149473957	8000	149472696	-4000	4000	1261
chr7	8748961	8756961	8752445	8000	8752961	-4000	4000	-516
chr7	27149716	27157716	27152722	8000	27153716	-4000	4000	-994
chr7	151043782	151051782	151048985	8000	151047782	-4000	4000	1203
chr7	120783320	120791320	120788855	8000	120787320	-4000	4000	1535
chr7	8109184	8117184	8113995	8000	8113184	-4000	4000	811
chr7	26183137	26191137	26184647	8000	26187137	-4000	4000	-2490
chr7	137870979	137878979	137876060	8000	137874979	-4000	4000	1081
chr7	100863010	100871010	100870636	8000	100867010	-4000	4000	3626
chr7	70789506	70797506	70790705	8000	70793506	-4000	4000	-2801
chr7	142867208	142875208	142873464	8000	142871208	-4000	4000	2256
chr7	150689641	150697641	150692746	8000	150693641	-4000	4000	-895
chr7	7604932	7612932	7606042	8000	7608932	-4000	4000	-2890
chr7	93126056	93134056	93132140	8000	93130056	-4000	4000	2084
chr7	103308289	103316289	103311692	8000	103312289	-4000	4000	-597
chr7	28949358	28957358	28953881	8000	28953358	-4000	4000	523
chr7	103467381	103475381	103472864	8000	103471381	-4000	4000	1483
chr7	141652728	141660728	141652972	8000	141656728	-4000	4000	-3756
chr7	42905273	42913273	42910716	8000	42909273	-4000	4000	1443
chr7	152118340	152126340	152118881	8000	152122340	-4000	4000	-3459
chr7	114689772	114697772	114689825	8000	114693772	-4000	4000	-3947
chr7	150857504	150865504	150857506	8000	150861504	-4000	4000	-3998
chr7	142867208	142875208	142875147	8000	142871208	-4000	4000	3939
chr7	93095513	93103513	93101249	8000	93099513	-4000	4000	1736
chr7	24792540	24800540	24800154	8000	24796540	-4000	4000	3614
chr7	150334156	150342156	150337987	8000	150338156	-4000	4000	-169
chr7	116557179	116565179	116559136	8000	116561179	-4000	4000	-2043
chr7	64829681	64837681	64831680	8000	64833681	-4000	4000	-2001
chr7	138702294	138710294	138709754	8000	138706294	-4000	4000	3460
chr7	129209545	129217545	129210977	8000	129213545	-4000	4000	-2568
chr7	23173914	23181914	23174107	8000	23177914	-4000	4000	-3807
chr7	23173914	23181914	23174108	8000	23177914	-4000	4000	-3806
chr7	8748961	8756961	8751597	8000	8752961	-4000	4000	-1364
chr7	93095513	93103513	93102521	8000	93099513	-4000	4000	3008
chr7	8748961	8756961	8751520	8000	8752961	-4000	4000	-1441
chr7	27149716	27157716	27155060	8000	27153716	-4000	4000	1344
chr7	27102184	27110184	27107868	8000	27106184	-4000	4000	1684
chr7	256772	264772	259819	8000	260772	-4000	4000	-953
chr7	102475976	102483976	102478861	8000	102479976	-4000	4000	-1115
chr7	102578523	102586523	102581345	8000	102582523	-4000	4000	-1178
chr7	151043782	151051782	151048946	8000	151047782	-4000	4000	1164
chr7	22728002	22736002	22731517	8000	22732002	-4000	4000	-485
chr7	27177157	27185157	27182904	8000	27181157	-4000	4000	1747
chr7	86872906	86880906	86880389	8000	86876906	-4000	4000	3483
chr7	93126056	93134056	93133885	8000	93130056	-4000	4000	3829
chr7	98842488	98850488	98847891	8000	98846488	-4000	4000	1403
chr7	122314411	122322411	122320176	8000	122318411	-4000	4000	1765
chr7	129209545	129217545	129212448	8000	129213545	-4000	4000	-1097
chr7	140998610	141006610	141006293	8000	141002610	-4000	4000	3683
chr7	144182083	144190083	144188143	8000	144186083	-4000	4000	2060
chr7	148416998	148424998	148420873	8000	148420998	-4000	4000	-125
chr7	26183137	26191137	26184851	8000	26187137	-4000	4000	-2286
chr7	100088187	100096187	100089315	8000	100092187	-4000	4000	-2872
chr7	140019749	140027749	140024519	8000	140023749	-4000	4000	770
chr7	150517073	150525073	150519997	8000	150521073	-4000	4000	-1076
chr7	32481338	32489338	32489301	8000	32485338	-4000	4000	3963
chr7	36508941	36516941	36513189	8000	36512941	-4000	4000	248
chr7	77636069	77644069	77639506	8000	77640069	-4000	4000	-563
chr7	97847677	97855677	97854642	8000	97851677	-4000	4000	2965
chr7	95579499	95587499	95587071	8000	95583499	-4000	4000	3572
chr7	117271451	117279451	117278164	8000	117275451	-4000	4000	2713
chr7	112477017	112485017	112484851	8000	112481017	-4000	4000	3834
chr7	112815147	112823147	112822083	8000	112819147	-4000	4000	2936
chr7	135689418	135697418	135691635	8000	135693418	-4000	4000	-1783
chr7	29563293	29571293	29566457	8000	29567293	-4000	4000	-836
chr7	75412786	75420786	75414942	8000	75416786	-4000	4000	-1844
chr7	129126793	129134793	129127226	8000	129130793	-4000	4000	-3567
chr7	27177157	27185157	27182664	8000	27181157	-4000	4000	1507
chr7	64515878	64523878	64520875	8000	64519878	-4000	4000	997
chr7	70789506	70797506	70790407	8000	70793506	-4000	4000	-3099
chr7	93095513	93103513	93102890	8000	93099513	-4000	4000	3377
chr7	122314411	122322411	122320078	8000	122318411	-4000	4000	1667
chr7	149251606	149259606	149253740	8000	149255606	-4000	4000	-1866
chr7	101135247	101143247	101137068	8000	101139247	-4000	4000	-2179
chr7	48104736	48112736	48108247	8000	48108736	-4000	4000	-489
chr7	4793055	4801055	4799237	8000	4797055	-4000	4000	2182
chr7	6684433	6692433	6691718	8000	6688433	-4000	4000	3285
chr7	74785315	74793315	74788610	8000	74789315	-4000	4000	-705
chr7	77325533	77333533	77326329	8000	77329533	-4000	4000	-3204
chr7	78013055	78021055	78017677	8000	78017055	-4000	4000	622
chr7	99499650	99507650	99506281	8000	99503650	-4000	4000	2631
chr7	100121508	100129508	100128120	8000	100125508	-4000	4000	2612
chr7	100570011	100578011	100575608	8000	100574011	-4000	4000	1597
chr7	101135247	101143247	101138060	8000	101139247	-4000	4000	-1187
chr7	103308289	103316289	103315767	8000	103312289	-4000	4000	3478
chr7	105106704	105114704	105107778	8000	105110704	-4000	4000	-2926
chr7	113074331	113082331	113082098	8000	113078331	-4000	4000	3767
chr7	115015917	115023917	115016071	8000	115019917	-4000	4000	-3846
chr7	129426211	129434211	129427519	8000	129430211	-4000	4000	-2692
chr7	129753082	129761082	129755940	8000	129757082	-4000	4000	-1142
chr7	130389771	130397771	130397705	8000	130393771	-4000	4000	3934
chr7	132780870	132788870	132785651	8000	132784870	-4000	4000	781
chr7	157413439	157421439	157416114	8000	157417439	-4000	4000	-1325
chr7	151043782	151051782	151049069	8000	151047782	-4000	4000	1287
chr7	111121454	111129454	111123810	8000	111125454	-4000	4000	-1644
chr7	1743946	1751946	1745284	8000	1747946	-4000	4000	-2662
chr7	44872299	44880299	44879451	8000	44876299	-4000	4000	3152
chr7	150940961	150948961	150947677	8000	150944961	-4000	4000	2716
chr7	76385334	76393334	76390282	8000	76389334	-4000	4000	948
chr7	97016396	97024396	97020715	8000	97020396	-4000	4000	319
chr7	100396096	100404096	100400030	8000	100400096	-4000	4000	-66
chr7	101135247	101143247	101138220	8000	101139247	-4000	4000	-1027
chr7	73432120	73440120	73435976	8000	73436120	-4000	4000	-144
chr7	30888081	30896081	30892076	8000	30892081	-4000	4000	-5
chr7	142867208	142875208	142868716	8000	142871208	-4000	4000	-2492
chr7	142867208	142875208	142868718	8000	142871208	-4000	4000	-2490
chr7	102805225	102813225	102808449	8000	102809225	-4000	4000	-776
chr7	108143623	108151623	108150733	8000	108147623	-4000	4000	3110
chr7	121293442	121301442	121295613	8000	121297442	-4000	4000	-1829
chr7	135689418	135697418	135692311	8000	135693418	-4000	4000	-1107
chr7	111121454	111129454	111123748	8000	111125454	-4000	4000	-1706
chr7	128023071	128031071	128030221	8000	128027071	-4000	4000	3150
chr7	150517073	150525073	150520232	8000	150521073	-4000	4000	-841
chr7	16780536	16788536	16783976	8000	16784536	-4000	4000	-560
chr7	25130692	25138692	25136248	8000	25134692	-4000	4000	1556
chr7	26209607	26217607	26212333	8000	26213607	-4000	4000	-1274
chr7	54748250	54756250	54752412	8000	54752250	-4000	4000	162
chr7	80738538	80746538	80744925	8000	80742538	-4000	4000	2387
chr7	102809230	102817230	102813392	8000	102813230	-4000	4000	162
chr7	108570850	108578850	108573526	8000	108574850	-4000	4000	-1324
chr7	135689418	135697418	135692265	8000	135693418	-4000	4000	-1153
chr7	137870979	137878979	137876025	8000	137874979	-4000	4000	1046
chr7	150394630	150402630	150396680	8000	150398630	-4000	4000	-1950
chr7	150689641	150697641	150692990	8000	150693641	-4000	4000	-651
chr7	151043782	151051782	151048959	8000	151047782	-4000	4000	1177
chr7	152118340	152126340	152121589	8000	152122340	-4000	4000	-751
chr7	155777485	155785485	155777613	8000	155781485	-4000	4000	-3872
chr7	158726995	158734995	158734111	8000	158730995	-4000	4000	3116
chr7	93881396	93889396	93886829	8000	93885396	-4000	4000	1433
chr7	142867208	142875208	142869820	8000	142871208	-4000	4000	-1388
chr7	56059989	56067989	56064361	8000	56063989	-4000	4000	372
chr7	76283288	76291288	76283594	8000	76287288	-4000	4000	-3694
chr7	99023440	99031440	99027722	8000	99027440	-4000	4000	282
chr7	135922760	135930760	135926875	8000	135926760	-4000	4000	115
chr7	23306209	23314209	23312370	8000	23310209	-4000	4000	2161
chr7	150857504	150865504	150858005	8000	150861504	-4000	4000	-3499
chr7	44508535	44516535	44513338	8000	44512535	-4000	4000	803
chr7	44508535	44516535	44516176	8000	44512535	-4000	4000	3641
chr7	70789506	70797506	70790895	8000	70793506	-4000	4000	-2611
chr7	127598144	127606144	127598543	8000	127602144	-4000	4000	-3601
chr7	135689418	135697418	135695476	8000	135693418	-4000	4000	2058
chr7	128088609	128096609	128091875	8000	128092609	-4000	4000	-734
chr7	143751089	143759089	143756561	8000	143755089	-4000	4000	1472
chr7	6684433	6692433	6692257	8000	6688433	-4000	4000	3824
chr7	149098784	149106784	149104841	8000	149102784	-4000	4000	2057
chr7	92483020	92491020	92489769	8000	92487020	-4000	4000	2749
chr7	120746337	120754337	120747709	8000	120750337	-4000	4000	-2628
chr7	75145817	75153817	75148984	8000	75149817	-4000	4000	-833
chr7	44958662	44966662	44965004	8000	44962662	-4000	4000	2342
chr7	111121454	111129454	111124819	8000	111125454	-4000	4000	-635
chr7	2902142	2910142	2906721	8000	2906142	-4000	4000	579
chr7	25130692	25138692	25136587	8000	25134692	-4000	4000	1895
chr7	992986	1000986	997747	8000	996986	-4000	4000	761
chr7	121293442	121301442	121295465	8000	121297442	-4000	4000	-1977
chr7	144182083	144190083	144186993	8000	144186083	-4000	4000	910
chr7	43803342	43811342	43807081	8000	43807342	-4000	4000	-261
chr7	99046831	99054831	99047710	8000	99050831	-4000	4000	-3121
chr7	91206590	91214590	91209626	8000	91210590	-4000	4000	-964
chr7	28949358	28957358	28957281	8000	28953358	-4000	4000	3923
chr7	143303696	143311696	143305173	8000	143307696	-4000	4000	-2523
chr7	156969176	156977176	156969567	8000	156973176	-4000	4000	-3609
chr7	128088609	128096609	128091876	8000	128092609	-4000	4000	-733
chr7	26370383	26378383	26372553	8000	26374383	-4000	4000	-1830
chr7	15607212	15615212	15611561	8000	15611212	-4000	4000	349
chr7	137870979	137878979	137875348	8000	137874979	-4000	4000	369
chr7	149098784	149106784	149105007	8000	149102784	-4000	4000	2223
chr7	150569953	150577953	150569962	8000	150573953	-4000	4000	-3991
chr7	65397136	65405136	65399915	8000	65401136	-4000	4000	-1221
chr7	122058036	122066036	122058882	8000	122062036	-4000	4000	-3154
chr7	23173914	23181914	23174040	8000	23177914	-4000	4000	-3874
chr7	105561120	105569120	105565450	8000	105565120	-4000	4000	330
chr7	135179839	135187839	135186104	8000	135183839	-4000	4000	2265
chr7	30493077	30501077	30496918	8000	30497077	-4000	4000	-159
chr7	30493077	30501077	30497139	8000	30497077	-4000	4000	62
chr7	103308289	103316289	103311867	8000	103312289	-4000	4000	-422
chr7	95355872	95363872	95363814	8000	95359872	-4000	4000	3942
chr7	6684433	6692433	6691277	8000	6688433	-4000	4000	2844
chr7	21896899	21904899	21904238	8000	21900899	-4000	4000	3339
chr7	26183137	26191137	26185468	8000	26187137	-4000	4000	-1669
chr7	32481338	32489338	32487152	8000	32485338	-4000	4000	1814
chr7	106086505	106094505	106093021	8000	106090505	-4000	4000	2516
chr7	149468696	149476696	149475235	8000	149472696	-4000	4000	2539
chr7	92106673	92114673	92113448	8000	92110673	-4000	4000	2775
chr7	30630033	30638033	30633739	8000	30634033	-4000	4000	-294
chr7	159024175	159032175	159030740	8000	159028175	-4000	4000	2565
chr7	6790134	6798134	6796753	8000	6794134	-4000	4000	2619
chr7	73298516	73306516	73300570	8000	73302516	-4000	4000	-1946
chr7	93095513	93103513	93103264	8000	93099513	-4000	4000	3751
chr7	112815147	112823147	112821833	8000	112819147	-4000	4000	2686
chr7	151043782	151051782	151049073	8000	151047782	-4000	4000	1291
chr7	44508535	44516535	44513539	8000	44512535	-4000	4000	1004
chr7	99046831	99054831	99050946	8000	99050831	-4000	4000	115
chr7	97847677	97855677	97852458	8000	97851677	-4000	4000	781
chr7	77325533	77333533	77329477	8000	77329533	-4000	4000	-56
chr7	8748961	8756961	8751312	8000	8752961	-4000	4000	-1649
chr7	97016396	97024396	97022226	8000	97020396	-4000	4000	1830
chr7	27102184	27110184	27108388	8000	27106184	-4000	4000	2204
chr7	64707577	64715577	64707848	8000	64711577	-4000	4000	-3729
chr7	140019749	140027749	140026215	8000	140023749	-4000	4000	2466
chr7	31747179	31755179	31753086	8000	31751179	-4000	4000	1907
chr7	70789506	70797506	70790880	8000	70793506	-4000	4000	-2626
chr7	77789728	77797728	77794300	8000	77793728	-4000	4000	572
chr7	103308289	103316289	103312053	8000	103312289	-4000	4000	-236
chr7	135162215	135170215	135168936	8000	135166215	-4000	4000	2721
chr7	100061040	100069040	100064622	8000	100065040	-4000	4000	-418
chr7	143386289	143394289	143394236	8000	143390289	-4000	4000	3947
chr7	15607212	15615212	15611469	8000	15611212	-4000	4000	257
chr7	143386289	143394289	143388800	8000	143390289	-4000	4000	-1489
chr7	128855274	128863274	128856846	8000	128859274	-4000	4000	-2428
chr7	23173914	23181914	23174528	8000	23177914	-4000	4000	-3386
chr7	95292415	95300415	95298939	8000	95296415	-4000	4000	2524
chr7	5302912	5310912	5308189	8000	5306912	-4000	4000	1277
chr7	43803342	43811342	43803727	8000	43807342	-4000	4000	-3615
chr7	55951239	55959239	55955016	8000	55955239	-4000	4000	-223
chr7	121344878	121352878	121350432	8000	121348878	-4000	4000	1554
chr7	93126056	93134056	93131521	8000	93130056	-4000	4000	1465
chr7	142867208	142875208	142870877	8000	142871208	-4000	4000	-331
chr7	150569953	150577953	150572458	8000	150573953	-4000	4000	-1495
chr7	15607212	15615212	15612508	8000	15611212	-4000	4000	1296
chr7	37947936	37955936	37949012	8000	37951936	-4000	4000	-2924
chr7	73432120	73440120	73435545	8000	73436120	-4000	4000	-575
chr7	892435	900435	893813	8000	896435	-4000	4000	-2622
chr7	1089815	1097815	1092432	8000	1093815	-4000	4000	-1383
chr7	5921550	5929550	5925806	8000	5925550	-4000	4000	256
chr7	5966925	5974925	5973537	8000	5970925	-4000	4000	2612
chr7	6620290	6628290	6621274	8000	6624290	-4000	4000	-3016
chr7	7632518	7640518	7640464	8000	7636518	-4000	4000	3946
chr7	27149716	27157716	27156601	8000	27153716	-4000	4000	2885
chr7	27177157	27185157	27182696	8000	27181157	-4000	4000	1539
chr7	33010130	33018130	33015819	8000	33014130	-4000	4000	1689
chr7	33090797	33098797	33097275	8000	33094797	-4000	4000	2478
chr7	36297538	36305538	36299191	8000	36301538	-4000	4000	-2347
chr7	64707577	64715577	64707883	8000	64711577	-4000	4000	-3694
chr7	64829681	64837681	64832697	8000	64833681	-4000	4000	-984
chr7	65397136	65405136	65399280	8000	65401136	-4000	4000	-1856
chr7	73298516	73306516	73304970	8000	73302516	-4000	4000	2454
chr7	75145817	75153817	75147936	8000	75149817	-4000	4000	-1881
chr7	75145817	75153817	75148219	8000	75149817	-4000	4000	-1598
chr7	77189369	77197369	77196564	8000	77193369	-4000	4000	3195
chr7	81695010	81703010	81702512	8000	81699010	-4000	4000	3502
chr7	90160829	90168829	90164671	8000	90164829	-4000	4000	-158
chr7	92106673	92114673	92108564	8000	92110673	-4000	4000	-2109
chr7	93126056	93134056	93133100	8000	93130056	-4000	4000	3044
chr7	93126056	93134056	93134024	8000	93130056	-4000	4000	3968
chr7	97847677	97855677	97853062	8000	97851677	-4000	4000	1385
chr7	99412739	99420739	99416258	8000	99416739	-4000	4000	-481
chr7	99499650	99507650	99506053	8000	99503650	-4000	4000	2403
chr7	99530700	99538700	99531593	8000	99534700	-4000	4000	-3107
chr7	100318196	100326196	100320816	8000	100322196	-4000	4000	-1380
chr7	100604175	100612175	100607803	8000	100608175	-4000	4000	-372
chr7	101220190	101228190	101223719	8000	101224190	-4000	4000	-471
chr7	106904980	106912980	106905400	8000	106908980	-4000	4000	-3580
chr7	107198522	107206522	107201226	8000	107202522	-4000	4000	-1296
chr7	111121454	111129454	111124684	8000	111125454	-4000	4000	-770
chr7	135644757	135652757	135648628	8000	135648757	-4000	4000	-129
chr7	143135739	143143739	143139715	8000	143139739	-4000	4000	-24
chr7	143386289	143394289	143393849	8000	143390289	-4000	4000	3560
chr7	149251606	149259606	149253569	8000	149255606	-4000	4000	-2037
chr7	150475393	150483393	150477893	8000	150479393	-4000	4000	-1500
chr7	150569953	150577953	150572458	8000	150573953	-4000	4000	-1495
chr7	150857504	150865504	150861108	8000	150861504	-4000	4000	-396
chr7	151043782	151051782	151049095	8000	151047782	-4000	4000	1313
chr7	151043782	151051782	151050226	8000	151047782	-4000	4000	2444
chr7	152118340	152126340	152118655	8000	152122340	-4000	4000	-3685
chr7	152118340	152126340	152121587	8000	152122340	-4000	4000	-753
chr7	90307063	90315063	90310078	8000	90311063	-4000	4000	-985
chr7	26183137	26191137	26184623	8000	26187137	-4000	4000	-2514
chr7	135644757	135652757	135648712	8000	135648757	-4000	4000	-45
chr7	112758377	112766377	112766014	8000	112762377	-4000	4000	3637
chr7	156673130	156681130	156680944	8000	156677130	-4000	4000	3814
chr7	28821894	28829894	28824769	8000	28825894	-4000	4000	-1125
chr7	128023071	128031071	128028823	8000	128027071	-4000	4000	1752
chr7	158726995	158734995	158731897	8000	158730995	-4000	4000	902
chr7	142867208	142875208	142873465	8000	142871208	-4000	4000	2257
chr7	106244298	106252298	106251003	8000	106248298	-4000	4000	2705
chr7	105561120	105569120	105565356	8000	105565120	-4000	4000	236
chr7	143751089	143759089	143756831	8000	143755089	-4000	4000	1742
chr7	150746033	150754033	150749840	8000	150750033	-4000	4000	-193
chr7	42905273	42913273	42910813	8000	42909273	-4000	4000	1540
chr7	93184534	93192534	93188853	8000	93188534	-4000	4000	319
chr7	5229840	5237840	5231953	8000	5233840	-4000	4000	-1887
chr7	39704120	39712120	39708003	8000	39708120	-4000	4000	-117
chr7	1089815	1097815	1093718	8000	1093815	-4000	4000	-97
chr7	135162215	135170215	135167894	8000	135166215	-4000	4000	1679
chr7	1089815	1097815	1092709	8000	1093815	-4000	4000	-1106
chr7	1743946	1751946	1744884	8000	1747946	-4000	4000	-3062
chr7	11165623	11173623	11169498	8000	11169623	-4000	4000	-125
chr7	27177157	27185157	27182885	8000	27181157	-4000	4000	1728
chr7	28991235	28999235	28995666	8000	28995235	-4000	4000	431
chr7	36297538	36305538	36299141	8000	36301538	-4000	4000	-2397
chr7	50586063	50594063	50592936	8000	50590063	-4000	4000	2873
chr7	55429737	55437737	55431307	8000	55433737	-4000	4000	-2430
chr7	64515878	64523878	64521786	8000	64519878	-4000	4000	1908
chr7	64707577	64715577	64708859	8000	64711577	-4000	4000	-2718
chr7	64926981	64934981	64928719	8000	64930981	-4000	4000	-2262
chr7	65397136	65405136	65398467	8000	65401136	-4000	4000	-2669
chr7	75023122	75031122	75024690	8000	75027122	-4000	4000	-2432
chr7	87397696	87405696	87398553	8000	87401696	-4000	4000	-3143
chr7	87397696	87405696	87402054	8000	87401696	-4000	4000	358
chr7	88201115	88209115	88208556	8000	88205115	-4000	4000	3441
chr7	92483020	92491020	92487271	8000	92487020	-4000	4000	251
chr7	93095513	93103513	93101852	8000	93099513	-4000	4000	2339
chr7	93126056	93134056	93132479	8000	93130056	-4000	4000	2423
chr7	100061040	100069040	100064369	8000	100065040	-4000	4000	-671
chr7	100165606	100173606	100167070	8000	100169606	-4000	4000	-2536
chr7	100396096	100404096	100401957	8000	100400096	-4000	4000	1861
chr7	101135247	101143247	101137534	8000	101139247	-4000	4000	-1713
chr7	103308289	103316289	103312679	8000	103312289	-4000	4000	390
chr7	105561120	105569120	105565246	8000	105565120	-4000	4000	126
chr7	105600772	105608772	105607609	8000	105604772	-4000	4000	2837
chr7	108143623	108151623	108150069	8000	108147623	-4000	4000	2446
chr7	108570850	108578850	108573042	8000	108574850	-4000	4000	-1808
chr7	111121454	111129454	111123837	8000	111125454	-4000	4000	-1617
chr7	121293442	121301442	121295563	8000	121297442	-4000	4000	-1879
chr7	134260591	134268591	134264027	8000	134264591	-4000	4000	-564
chr7	143387111	143395111	143394325	8000	143391111	-4000	4000	3214
chr7	143751089	143759089	143756341	8000	143755089	-4000	4000	1252
chr7	143751089	143759089	143756638	8000	143755089	-4000	4000	1549
chr7	144447941	144455941	144453499	8000	144451941	-4000	4000	1558
chr7	151010588	151018588	151016706	8000	151014588	-4000	4000	2118
chr7	23699249	23707249	23702338	8000	23703249	-4000	4000	-911
chr7	25130692	25138692	25136024	8000	25134692	-4000	4000	1332
chr7	99542300	99550300	99547184	8000	99546300	-4000	4000	884
chr7	103467381	103475381	103472843	8000	103471381	-4000	4000	1462
chr7	107198522	107206522	107200162	8000	107202522	-4000	4000	-2360
chr7	150475393	150483393	150477734	8000	150479393	-4000	4000	-1659
chr7	151374449	151382449	151377154	8000	151378449	-4000	4000	-1295
chr7	77189369	77197369	77196613	8000	77193369	-4000	4000	3244
chr7	26183137	26191137	26184905	8000	26187137	-4000	4000	-2232
chr7	97177763	97185763	97181017	8000	97181763	-4000	4000	-746
chr7	24694355	24702355	24699165	8000	24698355	-4000	4000	810
chr7	27149716	27157716	27156661	8000	27153716	-4000	4000	2945
chr7	120746337	120754337	120747795	8000	120750337	-4000	4000	-2542
chr7	22728002	22736002	22729674	8000	22732002	-4000	4000	-2328
chr7	149760182	149768182	149764803	8000	149764182	-4000	4000	621
chr7	111121454	111129454	111123218	8000	111125454	-4000	4000	-2236
chr7	116794377	116802377	116795989	8000	116798377	-4000	4000	-2388
chr7	111121454	111129454	111122788	8000	111125454	-4000	4000	-2666
chr7	77306751	77314751	77314387	8000	77310751	-4000	4000	3636
chr7	27177157	27185157	27184815	8000	27181157	-4000	4000	3658
chr7	7632518	7640518	7637021	8000	7636518	-4000	4000	503
chr7	15607212	15615212	15611581	8000	15611212	-4000	4000	369
chr7	143386289	143394289	143388844	8000	143390289	-4000	4000	-1445
chr7	107713809	107721809	107715430	8000	107717809	-4000	4000	-2379
chr7	135179839	135187839	135187074	8000	135183839	-4000	4000	3235
chr7	100604175	100612175	100605759	8000	100608175	-4000	4000	-2416
chr7	143303696	143311696	143303878	8000	143307696	-4000	4000	-3818
chr7	150857504	150865504	150857957	8000	150861504	-4000	4000	-3547
chr7	94427227	94435227	94427632	8000	94431227	-4000	4000	-3595
chr7	149098784	149106784	149104123	8000	149102784	-4000	4000	1339
chr7	149098784	149106784	149105219	8000	149102784	-4000	4000	2435
chr7	99023440	99031440	99030689	8000	99027440	-4000	4000	3249
chr7	93126056	93134056	93132742	8000	93130056	-4000	4000	2686
chr7	141783922	141791922	141790497	8000	141787922	-4000	4000	2575
chr7	77953503	77961503	77955073	8000	77957503	-4000	4000	-2430
chr7	21896899	21904899	21899994	8000	21900899	-4000	4000	-905
chr7	97847677	97855677	97853183	8000	97851677	-4000	4000	1506
chr7	101555024	101563024	101557488	8000	101559024	-4000	4000	-1536
chr7	149098784	149106784	149103777	8000	149102784	-4000	4000	993
chr7	77189369	77197369	77196549	8000	77193369	-4000	4000	3180
chr7	151043782	151051782	151049277	8000	151047782	-4000	4000	1495
chr7	33002930	33010930	33005343	8000	33006930	-4000	4000	-1587
chr7	84991553	84999553	84999500	8000	84995553	-4000	4000	3947
chr7	134260591	134268591	134263881	8000	134264591	-4000	4000	-710
chr7	93095513	93103513	93102630	8000	93099513	-4000	4000	3117
chr7	98306441	98314441	98307801	8000	98310441	-4000	4000	-2640
chr7	99644194	99652194	99648312	8000	99648194	-4000	4000	118
chr7	112815147	112823147	112820321	8000	112819147	-4000	4000	1174
chr7	23306209	23314209	23309516	8000	23310209	-4000	4000	-693
chr7	149760182	149768182	149764858	8000	149764182	-4000	4000	676
chr7	64829681	64837681	64832139	8000	64833681	-4000	4000	-1542
chr7	77189369	77197369	77196923	8000	77193369	-4000	4000	3554
chr7	93126056	93134056	93131435	8000	93130056	-4000	4000	1379
chr7	107198522	107206522	107201439	8000	107202522	-4000	4000	-1083
chr7	1743946	1751946	1747100	8000	1747946	-4000	4000	-846
chr7	116557179	116565179	116559279	8000	116561179	-4000	4000	-1900
chr7	132780870	132788870	132785651	8000	132784870	-4000	4000	781
chr7	106244298	106252298	106250901	8000	106248298	-4000	4000	2603
chr7	112339934	112347934	112342594	8000	112343934	-4000	4000	-1340
chr7	56059989	56067989	56062757	8000	56063989	-4000	4000	-1232
chr7	129209545	129217545	129212389	8000	129213545	-4000	4000	-1156
chr7	21896899	21904899	21901191	8000	21900899	-4000	4000	292
chr7	64515878	64523878	64522264	8000	64519878	-4000	4000	2386
chr7	150517073	150525073	150520942	8000	150521073	-4000	4000	-131
chr7	256772	264772	258679	8000	260772	-4000	4000	-2093
chr7	140998610	141006610	141006449	8000	141002610	-4000	4000	3839
chr7	33002930	33010930	33005279	8000	33006930	-4000	4000	-1651
chr7	73432120	73440120	73434746	8000	73436120	-4000	4000	-1374
chr7	140423974	140431974	140425917	8000	140427974	-4000	4000	-2057
chr7	149098784	149106784	149103540	8000	149102784	-4000	4000	756
chr7	73668112	73676112	73670054	8000	73672112	-4000	4000	-2058
chr7	149098784	149106784	149104137	8000	149102784	-4000	4000	1353
chr7	34152427	34160427	34153191	8000	34156427	-4000	4000	-3236
chr7	36508941	36516941	36513251	8000	36512941	-4000	4000	310
chr7	26183137	26191137	26184926	8000	26187137	-4000	4000	-2211
chr7	26183137	26191137	26185013	8000	26187137	-4000	4000	-2124
chr7	124818386	124826386	124823889	8000	124822386	-4000	4000	1503
chr7	45072469	45080469	45074274	8000	45076469	-4000	4000	-2195
chr7	117706651	117714651	117711252	8000	117710651	-4000	4000	601
chr7	100151944	100159944	100159786	8000	100155944	-4000	4000	3842
chr7	105106704	105114704	105111970	8000	105110704	-4000	4000	1266
chr7	73298516	73306516	73305081	8000	73302516	-4000	4000	2565
chr7	26183137	26191137	26186021	8000	26187137	-4000	4000	-1116
chr7	26183137	26191137	26186023	8000	26187137	-4000	4000	-1114
chr7	149098784	149106784	149104498	8000	149102784	-4000	4000	1714
chr7	84991553	84999553	84999416	8000	84995553	-4000	4000	3863
chr7	149468696	149476696	149474190	8000	149472696	-4000	4000	1494
chr7	98625869	98633869	98629491	8000	98629869	-4000	4000	-378
chr7	99872958	99880958	99876483	8000	99876958	-4000	4000	-475
chr7	27102184	27110184	27108443	8000	27106184	-4000	4000	2259
chr7	99628408	99636408	99629897	8000	99632408	-4000	4000	-2511
chr7	51012212	51020212	51017503	8000	51016212	-4000	4000	1291
chr7	26370383	26378383	26372523	8000	26374383	-4000	4000	-1860
chr7	151374449	151382449	151377268	8000	151378449	-4000	4000	-1181
chr7	25130692	25138692	25135854	8000	25134692	-4000	4000	1162
chr7	100102876	100110876	100105258	8000	100106876	-4000	4000	-1618
chr7	149098784	149106784	149104724	8000	149102784	-4000	4000	1940
chr7	150621375	150629375	150628294	8000	150625375	-4000	4000	2919
chr7	44110562	44118562	44110738	8000	44114562	-4000	4000	-3824
chr7	21896899	21904899	21903096	8000	21900899	-4000	4000	2197
chr7	101555024	101563024	101557458	8000	101559024	-4000	4000	-1566
chr7	76605986	76613986	76610207	8000	76609986	-4000	4000	221
chr7	107198522	107206522	107201206	8000	107202522	-4000	4000	-1316
chr7	135689418	135697418	135692581	8000	135693418	-4000	4000	-837
chr7	23197011	23205011	23200764	8000	23201011	-4000	4000	-247
chr7	102941111	102949111	102944847	8000	102945111	-4000	4000	-264
chr7	56059989	56067989	56060917	8000	56063989	-4000	4000	-3072
chr7	143349400	143357400	143357006	8000	143353400	-4000	4000	3606
chr7	100604175	100612175	100607647	8000	100608175	-4000	4000	-528
chr7	99542300	99550300	99547753	8000	99546300	-4000	4000	1453
chr7	87397696	87405696	87402063	8000	87401696	-4000	4000	367
chr7	94427227	94435227	94428441	8000	94431227	-4000	4000	-2786
chr7	149098784	149106784	149103663	8000	149102784	-4000	4000	879
chr7	93126056	93134056	93133539	8000	93130056	-4000	4000	3483
chr7	93095513	93103513	93102102	8000	93099513	-4000	4000	2589
chr7	111121454	111129454	111124902	8000	111125454	-4000	4000	-552
chr7	106244298	106252298	106251003	8000	106248298	-4000	4000	2705
chr7	100616416	100624416	100620832	8000	100620416	-4000	4000	416
chr7	6684433	6692433	6692205	8000	6688433	-4000	4000	3772
chr7	43803342	43811342	43807048	8000	43807342	-4000	4000	-294
chr7	97016396	97024396	97020626	8000	97020396	-4000	4000	230
chr7	28949358	28957358	28957356	8000	28953358	-4000	4000	3998
chr7	150475393	150483393	150477840	8000	150479393	-4000	4000	-1553
chr7	6325411	6333411	6330324	8000	6329411	-4000	4000	913
chr7	56059989	56067989	56060318	8000	56063989	-4000	4000	-3671
chr7	66954551	66962551	66955577	8000	66958551	-4000	4000	-2974
chr7	129753082	129761082	129755346	8000	129757082	-4000	4000	-1736
chr7	142867208	142875208	142868619	8000	142871208	-4000	4000	-2589
chr7	150689641	150697641	150693012	8000	150693641	-4000	4000	-629
chr7	155306235	155314235	155308475	8000	155310235	-4000	4000	-1760
chr7	129126793	129134793	129127663	8000	129130793	-4000	4000	-3130
chr7	151008209	151016209	151009041	8000	151012209	-4000	4000	-3168
chr7	16787811	16795811	16794967	8000	16791811	-4000	4000	3156
chr7	74193122	74201122	74196396	8000	74197122	-4000	4000	-726
chr7	97016396	97024396	97024269	8000	97020396	-4000	4000	3873
chr7	102475976	102483976	102478840	8000	102479976	-4000	4000	-1136
chr7	128855274	128863274	128856634	8000	128859274	-4000	4000	-2640
chr7	152118340	152126340	152121815	8000	152122340	-4000	4000	-525
chr8	85477493	85485493	85480750	8000	85481493	-4000	4000	-743
chr8	66624487	66632487	66630477	8000	66628487	-4000	4000	1990
chr8	30674066	30682066	30679512	8000	30678066	-4000	4000	1446
chr8	100129351	100137351	100133759	8000	100133351	-4000	4000	408
chr8	144136851	144144851	144139267	8000	144140851	-4000	4000	-1584
chr8	144389229	144397229	144393893	8000	144393229	-4000	4000	664
chr8	144445582	144453582	144452384	8000	144449582	-4000	4000	2802
chr8	11756002	11764002	11759948	8000	11760002	-4000	4000	-54
chr8	129744196	129752196	129748586	8000	129748196	-4000	4000	390
chr8	144136851	144144851	144139228	8000	144140851	-4000	4000	-1623
chr8	22600150	22608150	22607244	8000	22604150	-4000	4000	3094
chr8	42832674	42840674	42838059	8000	42836674	-4000	4000	1385
chr8	63208786	63216786	63209731	8000	63212786	-4000	4000	-3055
chr8	73044123	73052123	73046315	8000	73048123	-4000	4000	-1808
chr8	94875770	94883770	94876249	8000	94879770	-4000	4000	-3521
chr8	102822111	102830111	102829857	8000	102826111	-4000	4000	3746
chr8	142780882	142788882	142785278	8000	142784882	-4000	4000	396
chr8	144389229	144397229	144393315	8000	144393229	-4000	4000	86
chr8	144768224	144776224	144774578	8000	144772224	-4000	4000	2354
chr8	76976258	76984258	76983275	8000	76980258	-4000	4000	3017
chr8	79758371	79766371	79765319	8000	79762371	-4000	4000	2948
chr8	38271558	38279558	38275767	8000	38275558	-4000	4000	209
chr8	109561996	109569996	109564895	8000	109565996	-4000	4000	-1101
chr8	48913598	48921598	48921404	8000	48917598	-4000	4000	3806
chr8	92879532	92887532	92886670	8000	92883532	-4000	4000	3138
chr8	94245253	94253253	94250268	8000	94249253	-4000	4000	1015
chr8	100255278	100263278	100259909	8000	100259278	-4000	4000	631
chr8	144768224	144776224	144773837	8000	144772224	-4000	4000	1613
chr8	144768224	144776224	144774094	8000	144772224	-4000	4000	1870
chr8	109569978	109577978	109575206	8000	109573978	-4000	4000	1228
chr8	133130903	133138903	133133498	8000	133134903	-4000	4000	-1405
chr8	26654178	26662178	26658129	8000	26658178	-4000	4000	-49
chr8	133233175	133241175	133238568	8000	133237175	-4000	4000	1393
chr8	73044123	73052123	73046309	8000	73048123	-4000	4000	-1814
chr8	119553086	119561086	119557528	8000	119557086	-4000	4000	442
chr8	58579508	58587508	58580542	8000	58583508	-4000	4000	-2966
chr8	76863281	76871281	76864481	8000	76867281	-4000	4000	-2800
chr8	2931353	2939353	2938686	8000	2935353	-4000	4000	3333
chr8	143973153	143981153	143975285	8000	143977153	-4000	4000	-1868
chr8	120046918	120054918	120049601	8000	120050918	-4000	4000	-1317
chr8	121608116	121616116	121614604	8000	121612116	-4000	4000	2488
chr8	144837042	144845042	144842350	8000	144841042	-4000	4000	1308
chr8	42551195	42559195	42552649	8000	42555195	-4000	4000	-2546
chr8	71193433	71201433	71199174	8000	71197433	-4000	4000	1741
chr8	78671743	78679743	78678605	8000	78675743	-4000	4000	2862
chr8	105800539	105808539	105804339	8000	105804539	-4000	4000	-200
chr8	95152685	95160685	95154403	8000	95156685	-4000	4000	-2282
chr8	105800539	105808539	105802782	8000	105804539	-4000	4000	-1757
chr8	121608116	121616116	121614151	8000	121612116	-4000	4000	2035
chr8	133233175	133241175	133238908	8000	133237175	-4000	4000	1733
chr8	71837560	71845560	71843765	8000	71841560	-4000	4000	2205
chr8	144716907	144724907	144722586	8000	144720907	-4000	4000	1679
chr8	22002585	22010585	22005032	8000	22006585	-4000	4000	-1553
chr8	76976258	76984258	76983673	8000	76980258	-4000	4000	3415
chr8	23571463	23579463	23572303	8000	23575463	-4000	4000	-3160
chr8	80963810	80971810	80970324	8000	80967810	-4000	4000	2514
chr8	141428454	141436454	141433913	8000	141432454	-4000	4000	1459
chr8	118919557	118927557	118924112	8000	118923557	-4000	4000	555
chr8	104485231	104493231	104490884	8000	104489231	-4000	4000	1653
chr8	12178096	12186096	12182523	8000	12182096	-4000	4000	427
chr8	78715765	78723765	78717436	8000	78719765	-4000	4000	-2329
chr8	144257927	144265927	144258845	8000	144261927	-4000	4000	-3082
chr8	67169511	67177511	67175346	8000	67173511	-4000	4000	1835
chr8	23571463	23579463	23573918	8000	23575463	-4000	4000	-1545
chr8	103439453	103447453	103441462	8000	103443453	-4000	4000	-1991
chr8	144047266	144055266	144055173	8000	144051266	-4000	4000	3907
chr8	123206079	123214079	123209685	8000	123210079	-4000	4000	-394
chr8	70105782	70113782	70113621	8000	70109782	-4000	4000	3839
chr8	79758371	79766371	79765215	8000	79762371	-4000	4000	2844
chr8	94875770	94883770	94881713	8000	94879770	-4000	4000	1943
chr8	100150003	100158003	100153475	8000	100154003	-4000	4000	-528
chr8	133233175	133241175	133239036	8000	133237175	-4000	4000	1861
chr8	142701127	142709127	142703007	8000	142705127	-4000	4000	-2120
chr8	144445582	144453582	144452528	8000	144449582	-4000	4000	2946
chr8	47974160	47982160	47975822	8000	47978160	-4000	4000	-2338
chr8	24402013	24410013	24405403	8000	24406013	-4000	4000	-610
chr8	38271558	38279558	38275602	8000	38275558	-4000	4000	44
chr8	66558175	66566175	66564641	8000	66562175	-4000	4000	2466
chr8	93727527	93735527	93728301	8000	93731527	-4000	4000	-3226
chr8	144768224	144776224	144773975	8000	144772224	-4000	4000	1751
chr8	144926358	144934358	144931336	8000	144930358	-4000	4000	978
chr8	27455391	27463391	27463312	8000	27459391	-4000	4000	3921
chr8	96607790	96615790	96610706	8000	96611790	-4000	4000	-1084
chr8	144047266	144055266	144052219	8000	144051266	-4000	4000	953
chr8	129744196	129752196	129750569	8000	129748196	-4000	4000	2373
chr8	144768224	144776224	144774442	8000	144772224	-4000	4000	2218
chr8	74851029	74859029	74852999	8000	74855029	-4000	4000	-2030
chr8	127416066	127424066	127416235	8000	127420066	-4000	4000	-3831
chr8	38265704	38273704	38267219	8000	38269704	-4000	4000	-2485
chr8	42170718	42178718	42176012	8000	42174718	-4000	4000	1294
chr8	105800539	105808539	105801495	8000	105804539	-4000	4000	-3044
chr8	18025948	18033948	18027710	8000	18029948	-4000	4000	-2238
chr8	54144514	54152514	54147587	8000	54148514	-4000	4000	-927
chr8	93922068	93930068	93922684	8000	93926068	-4000	4000	-3384
chr8	67192778	67200778	67200279	8000	67196778	-4000	4000	3501
chr8	85445040	85453040	85446267	8000	85449040	-4000	4000	-2773
chr8	95152685	95160685	95154548	8000	95156685	-4000	4000	-2137
chr8	91394155	91402155	91397507	8000	91398155	-4000	4000	-648
chr8	38209301	38217301	38210028	8000	38213301	-4000	4000	-3273
chr8	129744196	129752196	129750542	8000	129748196	-4000	4000	2346
chr8	121608116	121616116	121614483	8000	121612116	-4000	4000	2367
chr8	109569978	109577978	109575471	8000	109573978	-4000	4000	1493
chr8	89923888	89931888	89924867	8000	89927888	-4000	4000	-3021
chr8	94367960	94375960	94372381	8000	94371960	-4000	4000	421
chr8	105800539	105808539	105803625	8000	105804539	-4000	4000	-914
chr8	24402013	24410013	24402044	8000	24406013	-4000	4000	-3969
chr8	27729316	27737316	27736123	8000	27733316	-4000	4000	2807
chr8	58579508	58587508	58586001	8000	58583508	-4000	4000	2493
chr8	67169511	67177511	67175367	8000	67173511	-4000	4000	1856
chr8	127416066	127424066	127416870	8000	127420066	-4000	4000	-3196
chr8	105800539	105808539	105802180	8000	105804539	-4000	4000	-2359
chr8	27455391	27463391	27458350	8000	27459391	-4000	4000	-1041
chr8	138126023	138134023	138132512	8000	138130023	-4000	4000	2489
chr8	26368680	26376680	26370139	8000	26372680	-4000	4000	-2541
chr8	133032728	133040728	133038686	8000	133036728	-4000	4000	1958
chr8	89923888	89931888	89926397	8000	89927888	-4000	4000	-1491
chr8	96607790	96615790	96608401	8000	96611790	-4000	4000	-3389
chr8	56214809	56222809	56217469	8000	56218809	-4000	4000	-1340
chr8	10424891	10432891	10428264	8000	10428891	-4000	4000	-627
chr8	41507095	41515095	41509741	8000	41511095	-4000	4000	-1354
chr8	76863281	76871281	76865936	8000	76867281	-4000	4000	-1345
chr8	90049633	90057633	90051836	8000	90053633	-4000	4000	-1797
chr8	40526590	40534590	40532174	8000	40530590	-4000	4000	1584
chr8	58801412	58809412	58805547	8000	58805412	-4000	4000	135
chr8	117172714	117180714	117176405	8000	117176714	-4000	4000	-309
chr8	19400161	19408161	19405982	8000	19404161	-4000	4000	1821
chr8	96235398	96243398	96235510	8000	96239398	-4000	4000	-3888
chr8	138126023	138134023	138132710	8000	138130023	-4000	4000	2687
chr8	60619644	60627644	60620675	8000	60623644	-4000	4000	-2969
chr8	39924790	39932790	39927959	8000	39928790	-4000	4000	-831
chr8	85142080	85150080	85145451	8000	85146080	-4000	4000	-629
chr8	85142080	85150080	85145766	8000	85146080	-4000	4000	-314
chr8	12178096	12186096	12185352	8000	12182096	-4000	4000	3256
chr8	123222189	123230189	123226485	8000	123226189	-4000	4000	296
chr8	78601267	78609267	78601827	8000	78605267	-4000	4000	-3440
chr8	98098344	98106344	98102548	8000	98102344	-4000	4000	204
chr8	54144514	54152514	54147618	8000	54148514	-4000	4000	-896
chr8	13564288	13572288	13567019	8000	13568288	-4000	4000	-1269
chr8	41649220	41657220	41654171	8000	41653220	-4000	4000	951
chr8	69656915	69664915	69659203	8000	69660915	-4000	4000	-1712
chr8	144445582	144453582	144450421	8000	144449582	-4000	4000	839
chr8	17118642	17126642	17120730	8000	17122642	-4000	4000	-1912
chr8	13564288	13572288	13567534	8000	13568288	-4000	4000	-754
chr8	26500701	26508701	26507702	8000	26504701	-4000	4000	3001
chr8	26654178	26662178	26658005	8000	26658178	-4000	4000	-173
chr8	27592917	27600917	27598601	8000	27596917	-4000	4000	1684
chr8	67192778	67200778	67199026	8000	67196778	-4000	4000	2248
chr8	81280777	81288777	81284623	8000	81284777	-4000	4000	-154
chr8	95152685	95160685	95155692	8000	95156685	-4000	4000	-993
chr8	116940487	116948487	116942659	8000	116944487	-4000	4000	-1828
chr8	124975389	124983389	124977681	8000	124979389	-4000	4000	-1708
chr8	144264481	144272481	144268130	8000	144268481	-4000	4000	-351
chr8	144716907	144724907	144722318	8000	144720907	-4000	4000	1411
chr8	144837042	144845042	144842468	8000	144841042	-4000	4000	1426
chr8	76863281	76871281	76864333	8000	76867281	-4000	4000	-2948
chr8	97849013	97857013	97851484	8000	97853013	-4000	4000	-1529
chr8	141203166	141211166	141207249	8000	141207166	-4000	4000	83
chr8	72015917	72023917	72022932	8000	72019917	-4000	4000	3015
chr8	144257927	144265927	144264520	8000	144261927	-4000	4000	2593
chr8	105800539	105808539	105803286	8000	105804539	-4000	4000	-1253
chr8	144716907	144724907	144722031	8000	144720907	-4000	4000	1124
chr8	81474419	81482419	81478829	8000	81478419	-4000	4000	410
chr8	144257927	144265927	144260791	8000	144261927	-4000	4000	-1136
chr8	17298427	17306427	17301855	8000	17302427	-4000	4000	-572
chr8	47974160	47982160	47974904	8000	47978160	-4000	4000	-3256
chr8	124484485	124492485	124486355	8000	124488485	-4000	4000	-2130
chr8	17298427	17306427	17302008	8000	17302427	-4000	4000	-419
chr8	96235398	96243398	96235604	8000	96239398	-4000	4000	-3794
chr8	109569978	109577978	109574837	8000	109573978	-4000	4000	859
chr8	109569978	109577978	109574970	8000	109573978	-4000	4000	992
chr8	71193433	71201433	71199321	8000	71197433	-4000	4000	1888
chr8	76976258	76984258	76983104	8000	76980258	-4000	4000	2846
chr8	58579508	58587508	58579653	8000	58583508	-4000	4000	-3855
chr8	144926358	144934358	144930717	8000	144930358	-4000	4000	359
chr8	39924790	39932790	39928071	8000	39928790	-4000	4000	-719
chr8	144837042	144845042	144842653	8000	144841042	-4000	4000	1611
chr8	74025079	74033079	74026796	8000	74029079	-4000	4000	-2283
chr8	109569978	109577978	109575823	8000	109573978	-4000	4000	1845
chr8	69656915	69664915	69658543	8000	69660915	-4000	4000	-2372
chr8	119829976	119837976	119832707	8000	119833976	-4000	4000	-1269
chr8	38140076	38148076	38144357	8000	38144076	-4000	4000	281
chr8	90989802	90997802	90995526	8000	90993802	-4000	4000	1724
chr8	11417476	11425476	11424462	8000	11421476	-4000	4000	2986
chr8	104485231	104493231	104491357	8000	104489231	-4000	4000	2126
chr8	22078527	22086527	22081168	8000	22082527	-4000	4000	-1359
chr8	102200502	102208502	102207912	8000	102204502	-4000	4000	3410
chr8	73978783	73986783	73981434	8000	73982783	-4000	4000	-1349
chr8	485803	493803	492323	8000	489803	-4000	4000	2520
chr8	124484485	124492485	124487906	8000	124488485	-4000	4000	-579
chr8	20242165	20250165	20249958	8000	20246165	-4000	4000	3793
chr8	28344287	28352287	28350068	8000	28348287	-4000	4000	1781
chr8	69656915	69664915	69658548	8000	69660915	-4000	4000	-2367
chr8	89787064	89795064	89790129	8000	89791064	-4000	4000	-935
chr8	123148153	123156153	123151809	8000	123152153	-4000	4000	-344
chr8	85477493	85485493	85480827	8000	85481493	-4000	4000	-666
chr8	119420434	119428434	119423404	8000	119424434	-4000	4000	-1030
chr8	119420434	119428434	119423405	8000	119424434	-4000	4000	-1029
chr8	98155835	98163835	98156063	8000	98159835	-4000	4000	-3772
chr8	42832674	42840674	42838229	8000	42836674	-4000	4000	1555
chr8	8779354	8787354	8786011	8000	8783354	-4000	4000	2657
chr8	94483689	94491689	94490070	8000	94487689	-4000	4000	2381
chr8	93727527	93735527	93728355	8000	93731527	-4000	4000	-3172
chr8	21904873	21912873	21912303	8000	21908873	-4000	4000	3430
chr8	118919557	118927557	118924627	8000	118923557	-4000	4000	1070
chr8	105800539	105808539	105802148	8000	105804539	-4000	4000	-2391
chr8	109569978	109577978	109577881	8000	109573978	-4000	4000	3903
chr8	81474419	81482419	81480446	8000	81478419	-4000	4000	2027
chr8	118919557	118927557	118926608	8000	118923557	-4000	4000	3051
chr8	42170718	42178718	42175890	8000	42174718	-4000	4000	1172
chr8	100129351	100137351	100133911	8000	100133351	-4000	4000	560
chr8	30059003	30067003	30066838	8000	30063003	-4000	4000	3835
chr8	6757503	6765503	6758386	8000	6761503	-4000	4000	-3117
chr8	56156909	56164909	56162763	8000	56160909	-4000	4000	1854
chr8	11560599	11568599	11561441	8000	11564599	-4000	4000	-3158
chr8	102822111	102830111	102829318	8000	102826111	-4000	4000	3207
chr8	38396215	38404215	38400946	8000	38400215	-4000	4000	731
chr8	78715765	78723765	78717348	8000	78719765	-4000	4000	-2417
chr8	95152685	95160685	95154314	8000	95156685	-4000	4000	-2371
chr8	124975389	124983389	124976418	8000	124979389	-4000	4000	-2971
chr8	142701127	142709127	142703262	8000	142705127	-4000	4000	-1865
chr8	73044123	73052123	73045990	8000	73048123	-4000	4000	-2133
chr8	106748694	106756694	106750824	8000	106752694	-4000	4000	-1870
chr8	21904873	21912873	21909248	8000	21908873	-4000	4000	375
chr8	105800539	105808539	105801664	8000	105804539	-4000	4000	-2875
chr8	117536262	117544262	117539931	8000	117540262	-4000	4000	-331
chr8	25503911	25511911	25507535	8000	25507911	-4000	4000	-376
chr8	100255278	100263278	100259924	8000	100259278	-4000	4000	646
chr8	30173208	30181208	30180530	8000	30177208	-4000	4000	3322
chr8	39101445	39109445	39103652	8000	39105445	-4000	4000	-1793
chr8	93922068	93930068	93922862	8000	93926068	-4000	4000	-3206
chr8	93922068	93930068	93922864	8000	93926068	-4000	4000	-3204
chr8	73978783	73986783	73978873	8000	73982783	-4000	4000	-3910
chr8	23571463	23579463	23574797	8000	23575463	-4000	4000	-666
chr8	100150003	100158003	100153461	8000	100154003	-4000	4000	-542
chr8	116638130	116646130	116644876	8000	116642130	-4000	4000	2746
chr8	100255278	100263278	100258497	8000	100259278	-4000	4000	-781
chr8	78671743	78679743	78675857	8000	78675743	-4000	4000	114
chr8	52618458	52626458	52623704	8000	52622458	-4000	4000	1246
chr8	98020851	98028851	98027433	8000	98024851	-4000	4000	2582
chr8	109236919	109244919	109242978	8000	109240919	-4000	4000	2059
chr8	98155835	98163835	98156158	8000	98159835	-4000	4000	-3677
chr8	8700096	8708096	8703633	8000	8704096	-4000	4000	-463
chr8	67169511	67177511	67175470	8000	67173511	-4000	4000	1959
chr8	71193433	71201433	71198770	8000	71197433	-4000	4000	1337
chr8	73044123	73052123	73045992	8000	73048123	-4000	4000	-2131
chr8	130048104	130056104	130054442	8000	130052104	-4000	4000	2338
chr8	22002585	22010585	22005024	8000	22006585	-4000	4000	-1561
chr8	23674697	23682697	23681335	8000	23678697	-4000	4000	2638
chr8	109236919	109244919	109243118	8000	109240919	-4000	4000	2199
chr8	40151310	40159310	40154596	8000	40155310	-4000	4000	-714
chr8	40151310	40159310	40154837	8000	40155310	-4000	4000	-473
chr8	21904873	21912873	21909727	8000	21908873	-4000	4000	854
chr8	67418038	67426038	67422356	8000	67422038	-4000	4000	318
chr8	65598458	65606458	65604326	8000	65602458	-4000	4000	1868
chr8	73321281	73329281	73323075	8000	73325281	-4000	4000	-2206
chr8	13564288	13572288	13567161	8000	13568288	-4000	4000	-1127
chr8	19963259	19971259	19967231	8000	19967259	-4000	4000	-28
chr8	141191808	141199808	141192649	8000	141195808	-4000	4000	-3159
chr8	58579508	58587508	58585714	8000	58583508	-4000	4000	2206
chr8	144047266	144055266	144052866	8000	144051266	-4000	4000	1600
chr8	6866592	6874592	6870682	8000	6870592	-4000	4000	90
chr8	18219689	18227689	18222516	8000	18223689	-4000	4000	-1173
chr8	22537142	22545142	22540906	8000	22541142	-4000	4000	-236
chr8	25503911	25511911	25507120	8000	25507911	-4000	4000	-791
chr8	25503911	25511911	25507495	8000	25507911	-4000	4000	-416
chr8	27808640	27816640	27810287	8000	27812640	-4000	4000	-2353
chr8	38209301	38217301	38210058	8000	38213301	-4000	4000	-3243
chr8	93922068	93930068	93922900	8000	93926068	-4000	4000	-3168
chr8	94245253	94253253	94253071	8000	94249253	-4000	4000	3818
chr8	94483689	94491689	94488605	8000	94487689	-4000	4000	916
chr8	118919557	118927557	118924356	8000	118923557	-4000	4000	799
chr8	67192778	67200778	67200324	8000	67196778	-4000	4000	3546
chr8	70105782	70113782	70113211	8000	70109782	-4000	4000	3429
chr8	101665726	101673726	101669500	8000	101669726	-4000	4000	-226
chr8	27541564	27549564	27544541	8000	27545564	-4000	4000	-1023
chr8	11417476	11425476	11424030	8000	11421476	-4000	4000	2554
chr8	142678725	142686725	142680621	8000	142682725	-4000	4000	-2104
chr8	92879532	92887532	92884951	8000	92883532	-4000	4000	1419
chr8	105800539	105808539	105802948	8000	105804539	-4000	4000	-1591
chr8	94875770	94883770	94881626	8000	94879770	-4000	4000	1856
chr8	121608116	121616116	121614549	8000	121612116	-4000	4000	2433
chr8	144926358	144934358	144931011	8000	144930358	-4000	4000	653
chr8	109561996	109569996	109564436	8000	109565996	-4000	4000	-1560
chr8	121608116	121616116	121614969	8000	121612116	-4000	4000	2853
chr8	66558175	66566175	66564621	8000	66562175	-4000	4000	2446
chr8	27592917	27600917	27599986	8000	27596917	-4000	4000	3069
chr8	144768224	144776224	144773873	8000	144772224	-4000	4000	1649
chr8	11838524	11846524	11845166	8000	11842524	-4000	4000	2642
chr8	12420411	12428411	12424881	8000	12424411	-4000	4000	470
chr8	13079361	13087361	13083682	8000	13083361	-4000	4000	321
chr8	13079361	13087361	13084129	8000	13083361	-4000	4000	768
chr8	17220799	17228799	17221542	8000	17224799	-4000	4000	-3257
chr8	28344287	28352287	28349165	8000	28348287	-4000	4000	878
chr8	41649220	41657220	41654263	8000	41653220	-4000	4000	1043
chr8	67169511	67177511	67172553	8000	67173511	-4000	4000	-958
chr8	67192778	67200778	67195518	8000	67196778	-4000	4000	-1260
chr8	80030745	80038745	80037235	8000	80034745	-4000	4000	2490
chr8	90954471	90962471	90958964	8000	90958471	-4000	4000	493
chr8	94703466	94711466	94706187	8000	94707466	-4000	4000	-1279
chr8	121608116	121616116	121614753	8000	121612116	-4000	4000	2637
chr8	132844807	132852807	132847108	8000	132848807	-4000	4000	-1699
chr8	144257927	144265927	144260693	8000	144261927	-4000	4000	-1234
chr8	144257927	144265927	144260694	8000	144261927	-4000	4000	-1233
chr8	109341954	109349954	109343662	8000	109345954	-4000	4000	-2292
chr8	123206079	123214079	123209524	8000	123210079	-4000	4000	-555
chr8	21904873	21912873	21910786	8000	21908873	-4000	4000	1913
chr8	38969912	38977912	38975077	8000	38973912	-4000	4000	1165
chr8	81652914	81660914	81659444	8000	81656914	-4000	4000	2530
chr8	124975389	124983389	124977237	8000	124979389	-4000	4000	-2152
chr8	124975389	124983389	124977450	8000	124979389	-4000	4000	-1939
chr8	142780882	142788882	142786468	8000	142784882	-4000	4000	1586
chr8	144768224	144776224	144773636	8000	144772224	-4000	4000	1412
chr8	144843509	144851509	144850737	8000	144847509	-4000	4000	3228
chr8	52618458	52626458	52622897	8000	52622458	-4000	4000	439
chr8	98948104	98956104	98950861	8000	98952104	-4000	4000	-1243
chr8	11838524	11846524	11845748	8000	11842524	-4000	4000	3224
chr8	81755515	81763515	81758208	8000	81759515	-4000	4000	-1307
chr8	97849013	97857013	97851462	8000	97853013	-4000	4000	-1551
chr8	96332995	96340995	96334400	8000	96336995	-4000	4000	-2595
chr8	56296005	56304005	56301554	8000	56300005	-4000	4000	1549
chr8	118919557	118927557	118926552	8000	118923557	-4000	4000	2995
chr8	130048104	130056104	130054625	8000	130052104	-4000	4000	2521
chr8	47974160	47982160	47974748	8000	47978160	-4000	4000	-3412
chr8	71193433	71201433	71198577	8000	71197433	-4000	4000	1144
chr8	144807169	144815169	144809986	8000	144811169	-4000	4000	-1183
chr8	93922068	93930068	93922186	8000	93926068	-4000	4000	-3882
chr8	102644784	102652784	102650093	8000	102648784	-4000	4000	1309
chr8	90617995	90625995	90625047	8000	90621995	-4000	4000	3052
chr8	22002585	22010585	22004026	8000	22006585	-4000	4000	-2559
chr8	94483689	94491689	94488757	8000	94487689	-4000	4000	1068
chr8	73978783	73986783	73981202	8000	73982783	-4000	4000	-1581
chr8	16103878	16111878	16110112	8000	16107878	-4000	4000	2234
chr8	144837042	144845042	144842751	8000	144841042	-4000	4000	1709
chr8	37840896	37848896	37843681	8000	37844896	-4000	4000	-1215
chr8	41925479	41933479	41931953	8000	41929479	-4000	4000	2474
chr8	41257962	41265962	41265178	8000	41261962	-4000	4000	3216
chr8	144843509	144851509	144850658	8000	144847509	-4000	4000	3149
chr8	103439453	103447453	103440155	8000	103443453	-4000	4000	-3298
chr8	105800539	105808539	105802580	8000	105804539	-4000	4000	-1959
chr8	37775768	37783768	37775935	8000	37779768	-4000	4000	-3833
chr8	144445582	144453582	144450541	8000	144449582	-4000	4000	959
chr8	42401937	42409937	42402126	8000	42405937	-4000	4000	-3811
chr8	26500701	26508701	26508440	8000	26504701	-4000	4000	3739
chr8	108485196	108493196	108486548	8000	108489196	-4000	4000	-2648
chr8	127416066	127424066	127416804	8000	127420066	-4000	4000	-3262
chr8	56156909	56164909	56162843	8000	56160909	-4000	4000	1934
chr8	90989802	90997802	90995502	8000	90993802	-4000	4000	1700
chr8	98185826	98193826	98193411	8000	98189826	-4000	4000	3585
chr8	75562834	75570834	75564007	8000	75566834	-4000	4000	-2827
chr8	21904873	21912873	21909248	8000	21908873	-4000	4000	375
chr8	23837929	23845929	23844631	8000	23841929	-4000	4000	2702
chr8	13079361	13087361	13085754	8000	13083361	-4000	4000	2393
chr8	73978783	73986783	73981187	8000	73982783	-4000	4000	-1596
chr8	144257927	144265927	144264255	8000	144261927	-4000	4000	2328
chr8	124975389	124983389	124977253	8000	124979389	-4000	4000	-2136
chr8	132009642	132017642	132010863	8000	132013642	-4000	4000	-2779
chr8	22600150	22608150	22607312	8000	22604150	-4000	4000	3162
chr8	144926358	144934358	144931449	8000	144930358	-4000	4000	1091
chr8	96332995	96340995	96333565	8000	96336995	-4000	4000	-3430
chr8	112218928	112226928	112224898	8000	112222928	-4000	4000	1970
chr8	2931353	2939353	2938553	8000	2935353	-4000	4000	3200
chr8	38259130	38267130	38264326	8000	38263130	-4000	4000	1196
chr8	42367808	42375808	42371601	8000	42371808	-4000	4000	-207
chr8	40151310	40159310	40154987	8000	40155310	-4000	4000	-323
chr8	56214809	56222809	56217405	8000	56218809	-4000	4000	-1404
chr8	42367808	42375808	42374762	8000	42371808	-4000	4000	2954
chr8	144716907	144724907	144722867	8000	144720907	-4000	4000	1960
chr8	23292279	23300279	23297944	8000	23296279	-4000	4000	1665
chr8	22002585	22010585	22005181	8000	22006585	-4000	4000	-1404
chr8	70569218	70577218	70574005	8000	70573218	-4000	4000	787
chr8	42551195	42559195	42552582	8000	42555195	-4000	4000	-2613
chr8	104485231	104493231	104491307	8000	104489231	-4000	4000	2076
chr8	109569978	109577978	109575817	8000	109573978	-4000	4000	1839
chr8	144837042	144845042	144843112	8000	144841042	-4000	4000	2070
chr8	38159335	38167335	38163552	8000	38163335	-4000	4000	217
chr8	43198855	43206855	43199492	8000	43202855	-4000	4000	-3363
chr8	124975389	124983389	124977021	8000	124979389	-4000	4000	-2368
chr8	93922068	93930068	93925022	8000	93926068	-4000	4000	-1046
chr8	22100911	22108911	22107958	8000	22104911	-4000	4000	3047
chr8	27729316	27737316	27736180	8000	27733316	-4000	4000	2864
chr8	29329064	29337064	29337030	8000	29333064	-4000	4000	3966
chr8	41257962	41265962	41265320	8000	41261962	-4000	4000	3358
chr8	42367808	42375808	42369937	8000	42371808	-4000	4000	-1871
chr8	42367808	42375808	42374197	8000	42371808	-4000	4000	2389
chr8	51813575	51821575	51820259	8000	51817575	-4000	4000	2684
chr8	63208786	63216786	63209884	8000	63212786	-4000	4000	-2902
chr8	64579627	64587627	64581594	8000	64583627	-4000	4000	-2033
chr8	73060543	73068543	73067454	8000	73064543	-4000	4000	2911
chr8	79758371	79766371	79765266	8000	79762371	-4000	4000	2895
chr8	85280073	85288073	85281422	8000	85284073	-4000	4000	-2651
chr8	89923888	89931888	89924773	8000	89927888	-4000	4000	-3115
chr8	93727527	93735527	93728405	8000	93731527	-4000	4000	-3122
chr8	94483689	94491689	94488600	8000	94487689	-4000	4000	911
chr8	100129351	100137351	100133805	8000	100133351	-4000	4000	454
chr8	102644784	102652784	102651801	8000	102648784	-4000	4000	3017
chr8	109236919	109244919	109243207	8000	109240919	-4000	4000	2288
chr8	124484485	124492485	124485862	8000	124488485	-4000	4000	-2623
chr8	124484485	124492485	124486099	8000	124488485	-4000	4000	-2386
chr8	141191808	141199808	141194099	8000	141195808	-4000	4000	-1709
chr8	98948104	98956104	98949091	8000	98952104	-4000	4000	-3013
chr8	129835593	129843593	129842157	8000	129839593	-4000	4000	2564
chr8	38209301	38217301	38210283	8000	38213301	-4000	4000	-3018
chr8	104485231	104493231	104490618	8000	104489231	-4000	4000	1387
chr8	93724155	93732155	93726494	8000	93728155	-4000	4000	-1661
chr8	38140076	38148076	38145262	8000	38144076	-4000	4000	1186
chr8	76863281	76871281	76864172	8000	76867281	-4000	4000	-3109
chr8	127416066	127424066	127416805	8000	127420066	-4000	4000	-3261
chr8	42832674	42840674	42837700	8000	42836674	-4000	4000	1026
chr8	121608116	121616116	121614103	8000	121612116	-4000	4000	1987
chr8	102644784	102652784	102651798	8000	102648784	-4000	4000	3014
chr8	138126023	138134023	138132515	8000	138130023	-4000	4000	2492
chr8	118919557	118927557	118924358	8000	118923557	-4000	4000	801
chr8	95240913	95248913	95247470	8000	95244913	-4000	4000	2557
chr8	42167673	42175673	42169521	8000	42171673	-4000	4000	-2152
chr8	112218928	112226928	112224924	8000	112222928	-4000	4000	1996
chr8	144837042	144845042	144842801	8000	144841042	-4000	4000	1759
chr8	25423847	25431847	25428524	8000	25427847	-4000	4000	677
chr8	13564288	13572288	13567515	8000	13568288	-4000	4000	-773
chr8	22215703	22223703	22221712	8000	22219703	-4000	4000	2009
chr8	23016133	23024133	23022710	8000	23020133	-4000	4000	2577
chr8	23292279	23300279	23293306	8000	23296279	-4000	4000	-2973
chr8	24402013	24410013	24405506	8000	24406013	-4000	4000	-507
chr8	26500701	26508701	26507614	8000	26504701	-4000	4000	2913
chr8	26501636	26509636	26508751	8000	26505636	-4000	4000	3115
chr8	27455391	27463391	27458452	8000	27459391	-4000	4000	-939
chr8	27808640	27816640	27810391	8000	27812640	-4000	4000	-2249
chr8	28344287	28352287	28349175	8000	28348287	-4000	4000	888
chr8	30173208	30181208	30175118	8000	30177208	-4000	4000	-2090
chr8	30574318	30582318	30578995	8000	30578318	-4000	4000	677
chr8	40526590	40534590	40531987	8000	40530590	-4000	4000	1397
chr8	42367808	42375808	42375770	8000	42371808	-4000	4000	3962
chr8	58447501	58455501	58447655	8000	58451501	-4000	4000	-3846
chr8	63208786	63216786	63209777	8000	63212786	-4000	4000	-3009
chr8	73321281	73329281	73322993	8000	73325281	-4000	4000	-2288
chr8	81795581	81803581	81801416	8000	81799581	-4000	4000	1835
chr8	89923888	89931888	89925111	8000	89927888	-4000	4000	-2777
chr8	90617995	90625995	90625822	8000	90621995	-4000	4000	3827
chr8	93922068	93930068	93923639	8000	93926068	-4000	4000	-2429
chr8	95152685	95160685	95154790	8000	95156685	-4000	4000	-1895
chr8	98098344	98106344	98106000	8000	98102344	-4000	4000	3656
chr8	102200502	102208502	102208220	8000	102204502	-4000	4000	3718
chr8	102644784	102652784	102651781	8000	102648784	-4000	4000	2997
chr8	116638130	116646130	116644945	8000	116642130	-4000	4000	2815
chr8	116841934	116849934	116847632	8000	116845934	-4000	4000	1698
chr8	119420434	119428434	119423148	8000	119424434	-4000	4000	-1286
chr8	121608116	121616116	121614433	8000	121612116	-4000	4000	2317
chr8	124484485	124492485	124487423	8000	124488485	-4000	4000	-1062
chr8	124546784	124554784	124547026	8000	124550784	-4000	4000	-3758
chr8	127416066	127424066	127417090	8000	127420066	-4000	4000	-2976
chr8	129835593	129843593	129842031	8000	129839593	-4000	4000	2438
chr8	133032728	133040728	133038609	8000	133036728	-4000	4000	1881
chr8	142780882	142788882	142785596	8000	142784882	-4000	4000	714
chr8	143829583	143837583	143837481	8000	143833583	-4000	4000	3898
chr8	144716907	144724907	144723184	8000	144720907	-4000	4000	2277
chr8	144768224	144776224	144773596	8000	144772224	-4000	4000	1372
chr8	38209301	38217301	38210234	8000	38213301	-4000	4000	-3067
chr8	47974160	47982160	47974912	8000	47978160	-4000	4000	-3248
chr8	48913598	48921598	48918905	8000	48917598	-4000	4000	1307
chr8	85210048	85218048	85215068	8000	85214048	-4000	4000	1020
chr8	94875770	94883770	94881451	8000	94879770	-4000	4000	1681
chr8	133032728	133040728	133038667	8000	133036728	-4000	4000	1939
chr8	30059003	30067003	30063871	8000	30063003	-4000	4000	868
chr8	79758371	79766371	79765290	8000	79762371	-4000	4000	2919
chr8	56156909	56164909	56164750	8000	56160909	-4000	4000	3841
chr8	105800539	105808539	105802911	8000	105804539	-4000	4000	-1628
chr8	42167673	42175673	42168988	8000	42171673	-4000	4000	-2685
chr8	100912523	100920523	100918747	8000	100916523	-4000	4000	2224
chr8	133130903	133138903	133133489	8000	133134903	-4000	4000	-1414
chr8	144716907	144724907	144723086	8000	144720907	-4000	4000	2179
chr8	40526590	40534590	40532213	8000	40530590	-4000	4000	1623
chr8	123640442	123648442	123646011	8000	123644442	-4000	4000	1569
chr8	89923888	89931888	89924548	8000	89927888	-4000	4000	-3340
chr8	19392218	19400218	19394854	8000	19396218	-4000	4000	-1364
chr8	109569978	109577978	109575648	8000	109573978	-4000	4000	1670
chr8	41649220	41657220	41654179	8000	41653220	-4000	4000	959
chr8	144047266	144055266	144053329	8000	144051266	-4000	4000	2063
chr8	105800539	105808539	105803158	8000	105804539	-4000	4000	-1381
chr8	21904873	21912873	21910692	8000	21908873	-4000	4000	1819
chr8	144716907	144724907	144723196	8000	144720907	-4000	4000	2289
chr8	116940487	116948487	116942748	8000	116944487	-4000	4000	-1739
chr8	103378989	103386989	103382802	8000	103382989	-4000	4000	-187
chr8	23016133	23024133	23018786	8000	23020133	-4000	4000	-1347
chr8	98948104	98956104	98951523	8000	98952104	-4000	4000	-581
chr8	85445040	85453040	85445174	8000	85449040	-4000	4000	-3866
chr8	24402013	24410013	24405385	8000	24406013	-4000	4000	-628
chr8	42832674	42840674	42838316	8000	42836674	-4000	4000	1642
chr8	23016133	23024133	23022964	8000	23020133	-4000	4000	2831
chr8	23674697	23682697	23681388	8000	23678697	-4000	4000	2691
chr8	27541564	27549564	27544622	8000	27545564	-4000	4000	-942
chr8	67192778	67200778	67193508	8000	67196778	-4000	4000	-3270
chr8	76863281	76871281	76863424	8000	76867281	-4000	4000	-3857
chr8	129744196	129752196	129748328	8000	129748196	-4000	4000	132
chr8	144716907	144724907	144721978	8000	144720907	-4000	4000	1071
chr8	94875770	94883770	94876463	8000	94879770	-4000	4000	-3307
chr8	40151310	40159310	40153637	8000	40155310	-4000	4000	-1673
chr8	91394155	91402155	91394251	8000	91398155	-4000	4000	-3904
chr8	27541564	27549564	27544504	8000	27545564	-4000	4000	-1060
chr8	485803	493803	492559	8000	489803	-4000	4000	2756
chr8	86150225	86158225	86152824	8000	86154225	-4000	4000	-1401
chr8	76863281	76871281	76863662	8000	76867281	-4000	4000	-3619
chr8	10424891	10432891	10428153	8000	10428891	-4000	4000	-738
chr8	115404496	115412496	115411275	8000	115408496	-4000	4000	2779
chr8	27808640	27816640	27811123	8000	27812640	-4000	4000	-1517
chr8	73416369	73424369	73421393	8000	73420369	-4000	4000	1024
chr8	105800539	105808539	105802309	8000	105804539	-4000	4000	-2230
chr8	94703466	94711466	94705947	8000	94707466	-4000	4000	-1519
chr8	104485231	104493231	104490077	8000	104489231	-4000	4000	846
chr8	126548443	126556443	126553384	8000	126552443	-4000	4000	941
chr8	26500701	26508701	26507945	8000	26504701	-4000	4000	3244
chr8	27865883	27873883	27871950	8000	27869883	-4000	4000	2067
chr8	61496556	61504556	61503366	8000	61500556	-4000	4000	2810
chr8	76863281	76871281	76865993	8000	76867281	-4000	4000	-1288
chr8	73286242	73294242	73292244	8000	73290242	-4000	4000	2002
chr8	109569978	109577978	109575568	8000	109573978	-4000	4000	1590
chr8	86474420	86482420	86477307	8000	86478420	-4000	4000	-1113
chr8	144047266	144055266	144052873	8000	144051266	-4000	4000	1607
chr8	76976258	76984258	76983855	8000	76980258	-4000	4000	3597
chr8	26500701	26508701	26508150	8000	26504701	-4000	4000	3449
chr8	98020851	98028851	98027672	8000	98024851	-4000	4000	2821
chr8	30574318	30582318	30578623	8000	30578318	-4000	4000	305
chr8	23258000	23266000	23258819	8000	23262000	-4000	4000	-3181
chr8	69656915	69664915	69659510	8000	69660915	-4000	4000	-1405
chr8	102644784	102652784	102651395	8000	102648784	-4000	4000	2611
chr8	102644784	102652784	102651890	8000	102648784	-4000	4000	3106
chr8	85280073	85288073	85281300	8000	85284073	-4000	4000	-2773
chr8	107245482	107253482	107251775	8000	107249482	-4000	4000	2293
chr8	55822445	55830445	55824695	8000	55826445	-4000	4000	-1750
chr8	74230700	74238700	74234885	8000	74234700	-4000	4000	185
chr8	94483689	94491689	94488731	8000	94487689	-4000	4000	1042
chr8	144716907	144724907	144722429	8000	144720907	-4000	4000	1522
chr8	104485231	104493231	104491205	8000	104489231	-4000	4000	1974
chr8	144926358	144934358	144932237	8000	144930358	-4000	4000	1879
chr8	25837725	25845725	25844570	8000	25841725	-4000	4000	2845
chr8	73416369	73424369	73420106	8000	73420369	-4000	4000	-263
chr8	94703466	94711466	94706067	8000	94707466	-4000	4000	-1399
chr8	120369573	120377573	120370501	8000	120373573	-4000	4000	-3072
chr8	33497262	33505262	33503534	8000	33501262	-4000	4000	2272
chr8	73321281	73329281	73323037	8000	73325281	-4000	4000	-2244
chr8	85280073	85288073	85281422	8000	85284073	-4000	4000	-2651
chr8	109569978	109577978	109577918	8000	109573978	-4000	4000	3940
chr8	124975389	124983389	124977465	8000	124979389	-4000	4000	-1924
chr8	12717906	12725906	12722224	8000	12721906	-4000	4000	318
chr8	10721399	10729399	10726080	8000	10725399	-4000	4000	681
chr8	19963259	19971259	19965395	8000	19967259	-4000	4000	-1864
chr8	90617995	90625995	90625805	8000	90621995	-4000	4000	3810
chr8	118919557	118927557	118924538	8000	118923557	-4000	4000	981
chr8	105800539	105808539	105801340	8000	105804539	-4000	4000	-3199
chr8	20242165	20250165	20246245	8000	20246165	-4000	4000	80
chr8	53962552	53970552	53967128	8000	53966552	-4000	4000	576
chr8	71837560	71845560	71842695	8000	71841560	-4000	4000	1135
chr8	98948104	98956104	98949288	8000	98952104	-4000	4000	-2816
chr8	10721399	10729399	10725965	8000	10725399	-4000	4000	566
chr8	17292794	17300794	17300109	8000	17296794	-4000	4000	3315
chr8	18219689	18227689	18223057	8000	18223689	-4000	4000	-632
chr8	28344287	28352287	28348536	8000	28348287	-4000	4000	249
chr8	28344287	28352287	28348682	8000	28348287	-4000	4000	395
chr8	31172138	31180138	31173103	8000	31176138	-4000	4000	-3035
chr8	105800539	105808539	105803478	8000	105804539	-4000	4000	-1061
chr8	124484485	124492485	124486072	8000	124488485	-4000	4000	-2413
chr8	70569218	70577218	70574618	8000	70573218	-4000	4000	1400
chr8	25503911	25511911	25507397	8000	25507911	-4000	4000	-514
chr8	120369573	120377573	120371320	8000	120373573	-4000	4000	-2253
chr8	96332995	96340995	96334101	8000	96336995	-4000	4000	-2894
chr8	144926358	144934358	144931611	8000	144930358	-4000	4000	1253
chr8	42832674	42840674	42837943	8000	42836674	-4000	4000	1269
chr9	2716469	2724469	2717849	8000	2720469	-4000	4000	-2620
chr9	127219166	127227166	127219775	8000	127223166	-4000	4000	-3391
chr9	127219166	127227166	127220085	8000	127223166	-4000	4000	-3081
chr9	127219166	127227166	127220998	8000	127223166	-4000	4000	-2168
chr9	70222972	70230972	70226457	8000	70226972	-4000	4000	-515
chr9	27226174	27234174	27228231	8000	27230174	-4000	4000	-1943
chr9	93316572	93324572	93320374	8000	93320572	-4000	4000	-198
chr9	130898438	130906438	130904258	8000	130902438	-4000	4000	1820
chr9	34657886	34665886	34660533	8000	34661886	-4000	4000	-1353
chr9	34657886	34665886	34660534	8000	34661886	-4000	4000	-1352
chr9	461259	469259	464280	8000	465259	-4000	4000	-979
chr9	4583469	4591469	4585454	8000	4587469	-4000	4000	-2015
chr9	20995509	21003509	20995577	8000	20999509	-4000	4000	-3932
chr9	65730041	65738041	65737154	8000	65734041	-4000	4000	3113
chr9	74976790	74984790	74983581	8000	74980790	-4000	4000	2791
chr9	104756120	104764120	104759345	8000	104760120	-4000	4000	-775
chr9	122391703	122399703	122392248	8000	122395703	-4000	4000	-3455
chr9	124938608	124946608	124938767	8000	124942608	-4000	4000	-3841
chr9	129086438	129094438	129086711	8000	129090438	-4000	4000	-3727
chr9	133067861	133075861	133071051	8000	133071861	-4000	4000	-810
chr9	35100112	35108112	35105205	8000	35104112	-4000	4000	1093
chr9	37434102	37442102	37441981	8000	37438102	-4000	4000	3879
chr9	65730041	65738041	65733028	8000	65734041	-4000	4000	-1013
chr9	14733152	14741152	14737585	8000	14737152	-4000	4000	433
chr9	127389660	127397660	127390732	8000	127393660	-4000	4000	-2928
chr9	136202333	136210333	136208494	8000	136206333	-4000	4000	2161
chr9	35069835	35077835	35077302	8000	35073835	-4000	4000	3467
chr9	92609183	92617183	92615776	8000	92613183	-4000	4000	2593
chr9	110869263	110877263	110875610	8000	110873263	-4000	4000	2347
chr9	12819060	12827060	12821545	8000	12823060	-4000	4000	-1515
chr9	34630722	34638722	34635780	8000	34634722	-4000	4000	1058
chr9	34362666	34370666	34369978	8000	34366666	-4000	4000	3312
chr9	120596811	120604811	120602528	8000	120600811	-4000	4000	1717
chr9	122911566	122919566	122919296	8000	122915566	-4000	4000	3730
chr9	116697300	116705300	116697976	8000	116701300	-4000	4000	-3324
chr9	34547432	34555432	34552059	8000	34551432	-4000	4000	627
chr9	94105856	94113856	94107878	8000	94109856	-4000	4000	-1978
chr9	10475	18475	12799	8000	14475	-4000	4000	-1676
chr9	14077843	14085843	14085080	8000	14081843	-4000	4000	3237
chr9	100573636	100581636	100577044	8000	100577636	-4000	4000	-592
chr9	6528467	6536467	6534748	8000	6532467	-4000	4000	2281
chr9	95095054	95103054	95101654	8000	95099054	-4000	4000	2600
chr9	133067861	133075861	133071806	8000	133071861	-4000	4000	-55
chr9	84000074	84008074	84002708	8000	84004074	-4000	4000	-1366
chr9	83655968	83663968	83661938	8000	83659968	-4000	4000	1970
chr9	132257356	132265356	132264017	8000	132261356	-4000	4000	2661
chr9	84000074	84008074	84001686	8000	84004074	-4000	4000	-2388
chr9	113290009	113298009	113297796	8000	113294009	-4000	4000	3787
chr9	12819060	12827060	12821545	8000	12823060	-4000	4000	-1515
chr9	6528467	6536467	6532874	8000	6532467	-4000	4000	407
chr9	114056127	114064127	114061491	8000	114060127	-4000	4000	1364
chr9	5466566	5474566	5466805	8000	5470566	-4000	4000	-3761
chr9	35748990	35756990	35749935	8000	35752990	-4000	4000	-3055
chr9	88474694	88482694	88475166	8000	88478694	-4000	4000	-3528
chr9	89001155	89009155	89001470	8000	89005155	-4000	4000	-3685
chr9	128497292	128505292	128500226	8000	128501292	-4000	4000	-1066
chr9	96487336	96495336	96490014	8000	96491336	-4000	4000	-1322
chr9	2716469	2724469	2717879	8000	2720469	-4000	4000	-2590
chr9	32625454	32633454	32633085	8000	32629454	-4000	4000	3631
chr9	35677159	35685159	35679333	8000	35681159	-4000	4000	-1826
chr9	35748990	35756990	35749341	8000	35752990	-4000	4000	-3649
chr9	87727469	87735469	87729675	8000	87731469	-4000	4000	-1794
chr9	96812269	96820269	96819075	8000	96816269	-4000	4000	2806
chr9	113160140	113168140	113166129	8000	113164140	-4000	4000	1989
chr9	129090142	129098142	129095561	8000	129094142	-4000	4000	1419
chr9	133067861	133075861	133071202	8000	133071861	-4000	4000	-659
chr9	97900489	97908489	97904764	8000	97904489	-4000	4000	275
chr9	21325665	21333665	21333117	8000	21329665	-4000	4000	3452
chr9	65730041	65738041	65737556	8000	65734041	-4000	4000	3515
chr9	72896671	72904671	72901212	8000	72900671	-4000	4000	541
chr9	35657511	35665511	35664111	8000	35661511	-4000	4000	2600
chr9	88474694	88482694	88475099	8000	88478694	-4000	4000	-3595
chr9	742105	750105	742357	8000	746105	-4000	4000	-3748
chr9	6007025	6015025	6013135	8000	6011025	-4000	4000	2110
chr9	18906950	18914950	18908547	8000	18910950	-4000	4000	-2403
chr9	35069835	35077835	35076500	8000	35073835	-4000	4000	2665
chr9	33437156	33445156	33442640	8000	33441156	-4000	4000	1484
chr9	126881878	126889878	126885008	8000	126885878	-4000	4000	-870
chr9	6253983	6261983	6256323	8000	6257983	-4000	4000	-1660
chr9	84000074	84008074	84001749	8000	84004074	-4000	4000	-2325
chr9	5295864	5303864	5300362	8000	5299864	-4000	4000	498
chr9	32625454	32633454	32631140	8000	32629454	-4000	4000	1686
chr9	32625454	32633454	32632015	8000	32629454	-4000	4000	2561
chr9	35100112	35108112	35105709	8000	35104112	-4000	4000	1597
chr9	35677159	35685159	35679915	8000	35681159	-4000	4000	-1244
chr9	89001771	89009771	89002226	8000	89005771	-4000	4000	-3545
chr9	93675587	93683587	93677643	8000	93679587	-4000	4000	-1944
chr9	95438980	95446980	95446962	8000	95442980	-4000	4000	3982
chr9	101469170	101477170	101476060	8000	101473170	-4000	4000	2890
chr9	108862898	108870898	108863299	8000	108866898	-4000	4000	-3599
chr9	112468405	112476405	112470537	8000	112472405	-4000	4000	-1868
chr9	127931099	127939099	127935693	8000	127935099	-4000	4000	594
chr9	123100866	123108866	123101589	8000	123104866	-4000	4000	-3277
chr9	37584413	37592413	37588670	8000	37588413	-4000	4000	257
chr9	92452205	92460205	92456538	8000	92456205	-4000	4000	333
chr9	34994900	35002900	34996384	8000	34998900	-4000	4000	-2516
chr9	8310246	8318246	8317504	8000	8314246	-4000	4000	3258
chr9	99862891	99870891	99863724	8000	99866891	-4000	4000	-3167
chr9	100573636	100581636	100576750	8000	100577636	-4000	4000	-886
chr9	37354149	37362149	37354801	8000	37358149	-4000	4000	-3348
chr9	742105	750105	742314	8000	746105	-4000	4000	-3791
chr9	127734317	127742317	127738459	8000	127738317	-4000	4000	142
chr9	32625454	32633454	32631494	8000	32629454	-4000	4000	2040
chr9	35654875	35662875	35662259	8000	35658875	-4000	4000	3384
chr9	35657511	35665511	35664059	8000	35661511	-4000	4000	2548
chr9	137080539	137088539	137088284	8000	137084539	-4000	4000	3745
chr9	99212425	99220425	99218138	8000	99216425	-4000	4000	1713
chr9	126503041	126511041	126503210	8000	126507041	-4000	4000	-3831
chr9	32625454	32633454	32633085	8000	32629454	-4000	4000	3631
chr9	10475	18475	16035	8000	14475	-4000	4000	1560
chr9	35748990	35756990	35749741	8000	35752990	-4000	4000	-3249
chr9	35748990	35756990	35751664	8000	35752990	-4000	4000	-1326
chr9	23686104	23694104	23692329	8000	23690104	-4000	4000	2225
chr9	91405045	91413045	91409995	8000	91409045	-4000	4000	950
chr9	74976790	74984790	74983708	8000	74980790	-4000	4000	2918
chr9	22451740	22459740	22451852	8000	22455740	-4000	4000	-3888
chr9	19047025	19055025	19050616	8000	19051025	-4000	4000	-409
chr9	32625454	32633454	32633235	8000	32629454	-4000	4000	3781
chr9	92408380	92416380	92414912	8000	92412380	-4000	4000	2532
chr9	92408380	92416380	92414913	8000	92412380	-4000	4000	2533
chr9	92609183	92617183	92615895	8000	92613183	-4000	4000	2712
chr9	32564621	32572621	32571051	8000	32568621	-4000	4000	2430
chr9	35692948	35700948	35700201	8000	35696948	-4000	4000	3253
chr9	135491181	135499181	135495432	8000	135495181	-4000	4000	251
chr9	135491181	135499181	135495315	8000	135495181	-4000	4000	134
chr9	127810327	127818327	127813458	8000	127814327	-4000	4000	-869
chr9	77419079	77427079	77425716	8000	77423079	-4000	4000	2637
chr9	10475	18475	14653	8000	14475	-4000	4000	178
chr9	12819060	12827060	12821876	8000	12823060	-4000	4000	-1184
chr9	16405503	16413503	16412159	8000	16409503	-4000	4000	2656
chr9	32625454	32633454	32631328	8000	32629454	-4000	4000	1874
chr9	93675587	93683587	93678060	8000	93679587	-4000	4000	-1527
chr9	126834210	126842210	126838011	8000	126838210	-4000	4000	-199
chr9	121781530	121789530	121782399	8000	121785530	-4000	4000	-3131
chr9	131254076	131262076	131261076	8000	131258076	-4000	4000	3000
chr9	122391703	122399703	122392366	8000	122395703	-4000	4000	-3337
chr9	36332396	36340396	36339344	8000	36336396	-4000	4000	2948
chr9	93675587	93683587	93677625	8000	93679587	-4000	4000	-1962
chr9	32625454	32633454	32630249	8000	32629454	-4000	4000	795
chr9	35677159	35685159	35682117	8000	35681159	-4000	4000	958
chr9	41127306	41135306	41127360	8000	41131306	-4000	4000	-3946
chr9	116419112	116427112	116426003	8000	116423112	-4000	4000	2891
chr9	83735425	83743425	83742532	8000	83739425	-4000	4000	3107
chr9	94599133	94607133	94605535	8000	94603133	-4000	4000	2402
chr9	98284109	98292109	98290606	8000	98288109	-4000	4000	2497
chr9	35657511	35665511	35663074	8000	35661511	-4000	4000	1563
chr9	68296035	68304035	68302973	8000	68300035	-4000	4000	2938
chr9	113251835	113259835	113256237	8000	113255835	-4000	4000	402
chr9	81579683	81587683	81584168	8000	81583683	-4000	4000	485
chr9	93675587	93683587	93677704	8000	93679587	-4000	4000	-1883
chr9	77419079	77427079	77425630	8000	77423079	-4000	4000	2551
chr9	113290009	113298009	113291643	8000	113294009	-4000	4000	-2366
chr9	132240526	132248526	132241019	8000	132244526	-4000	4000	-3507
chr9	136202333	136210333	136209165	8000	136206333	-4000	4000	2832
chr9	8310246	8318246	8317484	8000	8314246	-4000	4000	3238
chr9	6007025	6015025	6013905	8000	6011025	-4000	4000	2880
chr9	114329251	114337251	114330542	8000	114333251	-4000	4000	-2709
chr9	34994900	35002900	34996747	8000	34998900	-4000	4000	-2153
chr9	35748990	35756990	35749398	8000	35752990	-4000	4000	-3592
chr9	135545969	135553969	135547945	8000	135549969	-4000	4000	-2024
chr9	87704634	87712634	87707245	8000	87708634	-4000	4000	-1389
chr9	120811496	120819496	120818066	8000	120815496	-4000	4000	2570
chr9	6007025	6015025	6012355	8000	6011025	-4000	4000	1330
chr9	76647203	76655203	76652578	8000	76651203	-4000	4000	1375
chr9	101406660	101414660	101408381	8000	101410660	-4000	4000	-2279
chr9	6007025	6015025	6012280	8000	6011025	-4000	4000	1255
chr9	83934311	83942311	83939406	8000	83938311	-4000	4000	1095
chr9	18906950	18914950	18908593	8000	18910950	-4000	4000	-2357
chr9	114329251	114337251	114331826	8000	114333251	-4000	4000	-1425
chr9	32625454	32633454	32631331	8000	32629454	-4000	4000	1877
chr9	99862891	99870891	99864431	8000	99866891	-4000	4000	-2460
chr9	98195011	98203011	98200350	8000	98199011	-4000	4000	1339
chr9	117038	125038	121439	8000	121038	-4000	4000	401
chr9	22451740	22459740	22451753	8000	22455740	-4000	4000	-3987
chr9	92379268	92387268	92385678	8000	92383268	-4000	4000	2410
chr9	35606041	35614041	35612975	8000	35610041	-4000	4000	2934
chr9	35645295	35653295	35649947	8000	35649295	-4000	4000	652
chr9	128057233	128065233	128063590	8000	128061233	-4000	4000	2357
chr9	128725786	128733786	128731389	8000	128729786	-4000	4000	1603
chr9	128149453	128157453	128149514	8000	128153453	-4000	4000	-3939
chr9	133571519	133579519	133573984	8000	133575519	-4000	4000	-1535
chr9	35645295	35653295	35650932	8000	35649295	-4000	4000	1637
chr9	95438980	95446980	95443649	8000	95442980	-4000	4000	669
chr9	101406660	101414660	101409527	8000	101410660	-4000	4000	-1133
chr9	94599133	94607133	94603475	8000	94603133	-4000	4000	342
chr9	68527061	68535061	68529666	8000	68531061	-4000	4000	-1395
chr9	107009634	107017634	107010957	8000	107013634	-4000	4000	-2677
chr9	8310246	8318246	8317921	8000	8314246	-4000	4000	3675
chr9	35748990	35756990	35751640	8000	35752990	-4000	4000	-1350
chr9	35677159	35685159	35685145	8000	35681159	-4000	4000	3986
chr9	131254076	131262076	131261120	8000	131258076	-4000	4000	3044
chr9	37434102	37442102	37441775	8000	37438102	-4000	4000	3673
chr9	92707363	92715363	92713485	8000	92711363	-4000	4000	2122
chr9	96635577	96643577	96641758	8000	96639577	-4000	4000	2181
chr9	89001155	89009155	89001720	8000	89005155	-4000	4000	-3435
chr9	107009634	107017634	107011013	8000	107013634	-4000	4000	-2621
chr9	131119152	131127152	131125632	8000	131123152	-4000	4000	2480
chr9	130497274	130505274	130501169	8000	130501274	-4000	4000	-105
chr9	122198577	122206577	122199961	8000	122202577	-4000	4000	-2616
chr9	6007025	6015025	6013396	8000	6011025	-4000	4000	2371
chr9	34657886	34665886	34661487	8000	34661886	-4000	4000	-399
chr9	113403235	113411235	113407993	8000	113407235	-4000	4000	758
chr9	89001771	89009771	89001845	8000	89005771	-4000	4000	-3926
chr9	91405045	91413045	91410270	8000	91409045	-4000	4000	1225
chr9	107480852	107488852	107487067	8000	107484852	-4000	4000	2215
chr9	111666229	111674229	111666856	8000	111670229	-4000	4000	-3373
chr9	127712002	127720002	127716197	8000	127716002	-4000	4000	195
chr9	98284109	98292109	98290707	8000	98288109	-4000	4000	2598
chr9	19371715	19379715	19371865	8000	19375715	-4000	4000	-3850
chr9	98284109	98292109	98290506	8000	98288109	-4000	4000	2397
chr9	5295864	5303864	5300414	8000	5299864	-4000	4000	550
chr9	36210441	36218441	36211702	8000	36214441	-4000	4000	-2739
chr9	108862898	108870898	108863093	8000	108866898	-4000	4000	-3805
chr9	114056127	114064127	114061506	8000	114060127	-4000	4000	1379
chr9	128057233	128065233	128063784	8000	128061233	-4000	4000	2551
chr9	135804487	135812487	135811131	8000	135808487	-4000	4000	2644
chr9	121334987	121342987	121341206	8000	121338987	-4000	4000	2219
chr9	35100112	35108112	35105150	8000	35104112	-4000	4000	1038
chr9	35645295	35653295	35650371	8000	35649295	-4000	4000	1076
chr9	101469170	101477170	101476023	8000	101473170	-4000	4000	2853
chr9	116697300	116705300	116697868	8000	116701300	-4000	4000	-3432
chr9	127712002	127720002	127717012	8000	127716002	-4000	4000	1010
chr9	33437156	33445156	33443284	8000	33441156	-4000	4000	2128
chr9	113251835	113259835	113258851	8000	113255835	-4000	4000	3016
chr9	6007025	6015025	6014816	8000	6011025	-4000	4000	3791
chr9	131090473	131098473	131091886	8000	131094473	-4000	4000	-2587
chr9	132257356	132265356	132264705	8000	132261356	-4000	4000	3349
chr9	128357470	128365470	128360378	8000	128361470	-4000	4000	-1092
chr9	23686104	23694104	23690828	8000	23690104	-4000	4000	724
chr9	35805732	35813732	35813389	8000	35809732	-4000	4000	3657
chr9	35677992	35685992	35685482	8000	35681992	-4000	4000	3490
chr9	99862891	99870891	99863904	8000	99866891	-4000	4000	-2987
chr9	34705005	34713005	34710099	8000	34709005	-4000	4000	1094
chr9	92609183	92617183	92613277	8000	92613183	-4000	4000	94
chr9	96487336	96495336	96490075	8000	96491336	-4000	4000	-1261
chr9	96812269	96820269	96818112	8000	96816269	-4000	4000	1843
chr9	114642422	114650422	114643193	8000	114646422	-4000	4000	-3229
chr9	116419112	116427112	116425502	8000	116423112	-4000	4000	2390
chr9	127810327	127818327	127813369	8000	127814327	-4000	4000	-958
chr9	133347426	133355426	133354944	8000	133351426	-4000	4000	3518
chr9	125142573	125150573	125149521	8000	125146573	-4000	4000	2948
chr9	101469170	101477170	101476059	8000	101473170	-4000	4000	2889
chr9	742105	750105	742283	8000	746105	-4000	4000	-3822
chr9	2189624	2197624	2193411	8000	2193624	-4000	4000	-213
chr9	2716469	2724469	2718729	8000	2720469	-4000	4000	-1740
chr9	23686104	23694104	23691624	8000	23690104	-4000	4000	1520
chr9	32625454	32633454	32631260	8000	32629454	-4000	4000	1806
chr9	72347413	72355413	72354465	8000	72351413	-4000	4000	3052
chr9	86940362	86948362	86946075	8000	86944362	-4000	4000	1713
chr9	86940362	86948362	86946924	8000	86944362	-4000	4000	2562
chr9	98079077	98087077	98082894	8000	98083077	-4000	4000	-183
chr9	101469170	101477170	101476398	8000	101473170	-4000	4000	3228
chr9	114056127	114064127	114061176	8000	114060127	-4000	4000	1049
chr9	122904056	122912056	122911535	8000	122908056	-4000	4000	3479
chr9	126834210	126842210	126836326	8000	126838210	-4000	4000	-1884
chr9	128692400	128700400	128695697	8000	128696400	-4000	4000	-703
chr9	128692400	128700400	128696339	8000	128696400	-4000	4000	-61
chr9	132887348	132895348	132888494	8000	132891348	-4000	4000	-2854
chr9	125230161	125238161	125234078	8000	125234161	-4000	4000	-83
chr9	104756120	104764120	104759347	8000	104760120	-4000	4000	-773
chr9	12706285	12714285	12708043	8000	12710285	-4000	4000	-2242
chr9	35748990	35756990	35752860	8000	35752990	-4000	4000	-130
chr9	92452205	92460205	92457330	8000	92456205	-4000	4000	1125
chr9	19371715	19379715	19372167	8000	19375715	-4000	4000	-3548
chr9	19448505	19456505	19450627	8000	19452505	-4000	4000	-1878
chr9	33437156	33445156	33443641	8000	33441156	-4000	4000	2485
chr9	35100112	35108112	35108038	8000	35104112	-4000	4000	3926
chr9	83655968	83663968	83663877	8000	83659968	-4000	4000	3909
chr9	93675587	93683587	93677790	8000	93679587	-4000	4000	-1797
chr9	97025677	97033677	97032979	8000	97029677	-4000	4000	3302
chr9	100298175	100306175	100300593	8000	100302175	-4000	4000	-1582
chr9	125230161	125238161	125237017	8000	125234161	-4000	4000	2856
chr9	133201277	133209277	133208543	8000	133205277	-4000	4000	3266
chr9	129090142	129098142	129097263	8000	129094142	-4000	4000	3121
chr9	33379179	33387179	33385520	8000	33383179	-4000	4000	2341
chr9	35084688	35092688	35089541	8000	35088688	-4000	4000	853
chr9	91405045	91413045	91410459	8000	91409045	-4000	4000	1414
chr9	92609183	92617183	92615803	8000	92613183	-4000	4000	2620
chr9	4661258	4669258	4665060	8000	4665258	-4000	4000	-198
chr9	16405503	16413503	16412233	8000	16409503	-4000	4000	2730
chr9	26899372	26907372	26904824	8000	26903372	-4000	4000	1452
chr9	34082387	34090387	34088357	8000	34086387	-4000	4000	1970
chr9	35401338	35409338	35403907	8000	35405338	-4000	4000	-1431
chr9	35654875	35662875	35661844	8000	35658875	-4000	4000	2969
chr9	92379268	92387268	92385429	8000	92383268	-4000	4000	2161
chr9	97492125	97500125	97495857	8000	97496125	-4000	4000	-268
chr9	99862891	99870891	99866694	8000	99866891	-4000	4000	-197
chr9	122904056	122912056	122905272	8000	122908056	-4000	4000	-2784
chr9	35903136	35911136	35906379	8000	35907136	-4000	4000	-757
chr9	128105245	128113245	128107034	8000	128109245	-4000	4000	-2211
chr9	35692948	35700948	35697746	8000	35696948	-4000	4000	798
chr9	65730041	65738041	65737408	8000	65734041	-4000	4000	3367
chr9	83964083	83972083	83969363	8000	83968083	-4000	4000	1280
chr9	107480852	107488852	107485690	8000	107484852	-4000	4000	838
chr9	123100866	123108866	123103147	8000	123104866	-4000	4000	-1719
chr9	100573636	100581636	100578141	8000	100577636	-4000	4000	505
chr9	70380604	70388604	70386611	8000	70384604	-4000	4000	2007
chr9	113290009	113298009	113297917	8000	113294009	-4000	4000	3908
chr9	99862891	99870891	99864242	8000	99866891	-4000	4000	-2649
chr9	35401338	35409338	35403595	8000	35405338	-4000	4000	-1743
chr9	114056127	114064127	114062733	8000	114060127	-4000	4000	2606
chr9	122904056	122912056	122910682	8000	122908056	-4000	4000	2626
chr9	122198577	122206577	122199952	8000	122202577	-4000	4000	-2625
chr9	86260546	86268546	86265776	8000	86264546	-4000	4000	1230
chr9	92408380	92416380	92415265	8000	92412380	-4000	4000	2885
chr9	32625454	32633454	32632817	8000	32629454	-4000	4000	3363
chr9	34517043	34525043	34520904	8000	34521043	-4000	4000	-139
chr9	125230161	125238161	125232606	8000	125234161	-4000	4000	-1555
chr9	32625454	32633454	32632678	8000	32629454	-4000	4000	3224
chr9	83964083	83972083	83969396	8000	83968083	-4000	4000	1313
chr9	127083348	127091348	127088987	8000	127087348	-4000	4000	1639
chr9	98846081	98854081	98848980	8000	98850081	-4000	4000	-1101
chr9	130634352	130642352	130638098	8000	130638352	-4000	4000	-254
chr9	93032236	93040236	93032808	8000	93036236	-4000	4000	-3428
chr9	92379268	92387268	92384978	8000	92383268	-4000	4000	1710
chr9	121328843	121336843	121332632	8000	121332843	-4000	4000	-211
chr9	131254076	131262076	131261177	8000	131258076	-4000	4000	3101
chr9	5772557	5780557	5772602	8000	5776557	-4000	4000	-3955
chr9	35645295	35653295	35650903	8000	35649295	-4000	4000	1608
chr9	68527061	68535061	68529592	8000	68531061	-4000	4000	-1469
chr9	128388016	128396016	128389440	8000	128392016	-4000	4000	-2576
chr9	128388016	128396016	128389441	8000	128392016	-4000	4000	-2575
chr9	32450769	32458769	32457351	8000	32454769	-4000	4000	2582
chr9	81579683	81587683	81584294	8000	81583683	-4000	4000	611
chr9	127810327	127818327	127813528	8000	127814327	-4000	4000	-799
chr9	114308511	114316511	114309450	8000	114312511	-4000	4000	-3061
chr9	35677992	35685992	35685271	8000	35681992	-4000	4000	3279
chr9	89001771	89009771	89001994	8000	89005771	-4000	4000	-3777
chr9	128057233	128065233	128063445	8000	128061233	-4000	4000	2212
chr9	128938041	128946041	128946020	8000	128942041	-4000	4000	3979
chr9	113425690	113433690	113428954	8000	113429690	-4000	4000	-736
chr9	68296035	68304035	68303913	8000	68300035	-4000	4000	3878
chr9	128941530	128949530	128946577	8000	128945530	-4000	4000	1047
chr9	35748990	35756990	35750661	8000	35752990	-4000	4000	-2329
chr9	3820127	3828127	3824142	8000	3824127	-4000	4000	15
chr9	32625454	32633454	32630538	8000	32629454	-4000	4000	1084
chr9	68296035	68304035	68303897	8000	68300035	-4000	4000	3862
chr9	120948335	120956335	120952772	8000	120952335	-4000	4000	437
chr9	129068082	129076082	129069083	8000	129072082	-4000	4000	-2999
chr9	98116975	98124975	98124836	8000	98120975	-4000	4000	3861
chr9	84000074	84008074	84003000	8000	84004074	-4000	4000	-1074
chr9	128149453	128157453	128151692	8000	128153453	-4000	4000	-1761
chr9	127712002	127720002	127716022	8000	127716002	-4000	4000	20
chr9	99150192	99158192	99150518	8000	99154192	-4000	4000	-3674
chr9	15460066	15468066	15465640	8000	15464066	-4000	4000	1574
chr9	38567358	38575358	38571742	8000	38571358	-4000	4000	384
chr9	26899372	26907372	26905476	8000	26903372	-4000	4000	2104
chr9	125230161	125238161	125236526	8000	125234161	-4000	4000	2365
chr9	26899372	26907372	26905605	8000	26903372	-4000	4000	2233
chr9	27226174	27234174	27228266	8000	27230174	-4000	4000	-1908
chr9	32564621	32572621	32570986	8000	32568621	-4000	4000	2365
chr9	32625454	32633454	32632777	8000	32629454	-4000	4000	3323
chr9	33035907	33043907	33037107	8000	33039907	-4000	4000	-2800
chr9	34994900	35002900	34996651	8000	34998900	-4000	4000	-2249
chr9	35069835	35077835	35074435	8000	35073835	-4000	4000	600
chr9	35654875	35662875	35662540	8000	35658875	-4000	4000	3665
chr9	35748990	35756990	35752773	8000	35752990	-4000	4000	-217
chr9	37434102	37442102	37441307	8000	37438102	-4000	4000	3205
chr9	37774972	37782972	37777827	8000	37778972	-4000	4000	-1145
chr9	81579683	81587683	81584047	8000	81583683	-4000	4000	364
chr9	84000074	84008074	84002664	8000	84004074	-4000	4000	-1410
chr9	89001155	89009155	89001383	8000	89005155	-4000	4000	-3772
chr9	92293358	92301358	92299970	8000	92297358	-4000	4000	2612
chr9	94105856	94113856	94107959	8000	94109856	-4000	4000	-1897
chr9	96812269	96820269	96817963	8000	96816269	-4000	4000	1694
chr9	99066792	99074792	99069811	8000	99070792	-4000	4000	-981
chr9	113425690	113433690	113429263	8000	113429690	-4000	4000	-427
chr9	116697300	116705300	116699793	8000	116701300	-4000	4000	-1507
chr9	127441372	127449372	127444036	8000	127445372	-4000	4000	-1336
chr9	127441372	127449372	127444142	8000	127445372	-4000	4000	-1230
chr9	127712002	127720002	127715567	8000	127716002	-4000	4000	-435
chr9	127712002	127720002	127716217	8000	127716002	-4000	4000	215
chr9	127734317	127742317	127738817	8000	127738317	-4000	4000	500
chr9	129090142	129098142	129095456	8000	129094142	-4000	4000	1314
chr9	131119152	131127152	131125642	8000	131123152	-4000	4000	2490
chr9	132257356	132265356	132264611	8000	132261356	-4000	4000	3255
chr9	133201277	133209277	133206381	8000	133205277	-4000	4000	1104
chr9	135545969	135553969	135546777	8000	135549969	-4000	4000	-3192
chr9	137027241	137035241	137028876	8000	137031241	-4000	4000	-2365
chr9	113290009	113298009	113291633	8000	113294009	-4000	4000	-2376
chr9	34517043	34525043	34521804	8000	34521043	-4000	4000	761
chr9	35606041	35614041	35608982	8000	35610041	-4000	4000	-1059
chr9	135491181	135499181	135498582	8000	135495181	-4000	4000	3401
chr9	84000074	84008074	84002356	8000	84004074	-4000	4000	-1718
chr9	5295864	5303864	5300346	8000	5299864	-4000	4000	482
chr9	99212425	99220425	99218333	8000	99216425	-4000	4000	1908
chr9	122911566	122919566	122918712	8000	122915566	-4000	4000	3146
chr9	4705556	4713556	4713072	8000	4709556	-4000	4000	3516
chr9	32625454	32633454	32632177	8000	32629454	-4000	4000	2723
chr9	34547432	34555432	34552696	8000	34551432	-4000	4000	1264
chr9	35804045	35812045	35811638	8000	35808045	-4000	4000	3593
chr9	92609183	92617183	92613116	8000	92613183	-4000	4000	-67
chr9	101469170	101477170	101475788	8000	101473170	-4000	4000	2618
chr9	121173729	121181729	121181489	8000	121177729	-4000	4000	3760
chr9	6007025	6015025	6013269	8000	6011025	-4000	4000	2244
chr9	6007025	6015025	6013702	8000	6011025	-4000	4000	2677
chr9	6253983	6261983	6254512	8000	6257983	-4000	4000	-3471
chr9	13101706	13109706	13109042	8000	13105706	-4000	4000	3336
chr9	32625454	32633454	32632168	8000	32629454	-4000	4000	2714
chr9	34657886	34665886	34662040	8000	34661886	-4000	4000	154
chr9	34685570	34693570	34689965	8000	34689570	-4000	4000	395
chr9	34705005	34713005	34709126	8000	34709005	-4000	4000	121
chr9	35645295	35653295	35650834	8000	35649295	-4000	4000	1539
chr9	35677992	35685992	35685749	8000	35681992	-4000	4000	3757
chr9	35748990	35756990	35753264	8000	35752990	-4000	4000	274
chr9	36159913	36167913	36162560	8000	36163913	-4000	4000	-1353
chr9	37434102	37442102	37441805	8000	37438102	-4000	4000	3703
chr9	65730041	65738041	65737227	8000	65734041	-4000	4000	3186
chr9	69005176	69013176	69008649	8000	69009176	-4000	4000	-527
chr9	78326093	78334093	78328098	8000	78330093	-4000	4000	-1995
chr9	83735425	83743425	83739514	8000	83739425	-4000	4000	89
chr9	86260546	86268546	86265901	8000	86264546	-4000	4000	1355
chr9	91405045	91413045	91409448	8000	91409045	-4000	4000	403
chr9	92408380	92416380	92414959	8000	92412380	-4000	4000	2579
chr9	95095054	95103054	95101720	8000	95099054	-4000	4000	2666
chr9	100573636	100581636	100576612	8000	100577636	-4000	4000	-1024
chr9	101406660	101414660	101408911	8000	101410660	-4000	4000	-1749
chr9	101406660	101414660	101409354	8000	101410660	-4000	4000	-1306
chr9	101469170	101477170	101476141	8000	101473170	-4000	4000	2971
chr9	113251835	113259835	113256117	8000	113255835	-4000	4000	282
chr9	114329251	114337251	114331652	8000	114333251	-4000	4000	-1599
chr9	115015575	115023575	115020972	8000	115019575	-4000	4000	1397
chr9	127441372	127449372	127444046	8000	127445372	-4000	4000	-1326
chr9	132257356	132265356	132264880	8000	132261356	-4000	4000	3524
chr9	132371548	132379548	132375903	8000	132375548	-4000	4000	355
chr9	33278070	33286070	33280964	8000	33282070	-4000	4000	-1106
chr9	75143265	75151265	75146962	8000	75147265	-4000	4000	-303
chr9	92840182	92848182	92847226	8000	92844182	-4000	4000	3044
chr9	33437156	33445156	33442728	8000	33441156	-4000	4000	1572
chr9	37774972	37782972	37777824	8000	37778972	-4000	4000	-1148
chr9	4705556	4713556	4712874	8000	4709556	-4000	4000	3318
chr9	132588997	132596997	132589984	8000	132592997	-4000	4000	-3013
chr9	110869263	110877263	110875489	8000	110873263	-4000	4000	2226
chr9	108862898	108870898	108863049	8000	108866898	-4000	4000	-3849
chr9	127712002	127720002	127712205	8000	127716002	-4000	4000	-3797
chr9	133659560	133667560	133666922	8000	133663560	-4000	4000	3362
chr9	35677159	35685159	35683162	8000	35681159	-4000	4000	2003
chr9	91405045	91413045	91409358	8000	91409045	-4000	4000	313
chr9	133659560	133667560	133666828	8000	133663560	-4000	4000	3268
chr9	35606041	35614041	35607512	8000	35610041	-4000	4000	-2529
chr9	127686348	127694348	127692374	8000	127690348	-4000	4000	2026
chr9	84000074	84008074	84002049	8000	84004074	-4000	4000	-2025
chr9	113290009	113298009	113290911	8000	113294009	-4000	4000	-3098
chr9	125142573	125150573	125149689	8000	125146573	-4000	4000	3116
chr9	89001771	89009771	89002838	8000	89005771	-4000	4000	-2933
chr9	99226615	99234615	99230421	8000	99230615	-4000	4000	-194
chr9	33437156	33445156	33442379	8000	33441156	-4000	4000	1223
chr9	114322479	114330479	114323691	8000	114326479	-4000	4000	-2788
chr9	6007025	6015025	6012961	8000	6011025	-4000	4000	1936
chr9	32625454	32633454	32631173	8000	32629454	-4000	4000	1719
chr9	128057233	128065233	128063523	8000	128061233	-4000	4000	2290
chr9	101559344	101567344	101561144	8000	101563344	-4000	4000	-2200
chr9	33916399	33924399	33917123	8000	33920399	-4000	4000	-3276
chr9	137578081	137586081	137583161	8000	137582081	-4000	4000	1080
chr9	5295864	5303864	5300144	8000	5299864	-4000	4000	280
chr9	32564621	32572621	32571009	8000	32568621	-4000	4000	2388
chr9	35677159	35685159	35684278	8000	35681159	-4000	4000	3119
chr9	35732999	35740999	35740055	8000	35736999	-4000	4000	3056
chr9	87727469	87735469	87729702	8000	87731469	-4000	4000	-1767
chr9	93081133	93089133	93084839	8000	93085133	-4000	4000	-294
chr9	101383633	101391633	101390578	8000	101387633	-4000	4000	2945
chr9	113425690	113433690	113429176	8000	113429690	-4000	4000	-514
chr9	128105245	128113245	128107174	8000	128109245	-4000	4000	-2071
chr9	128938041	128946041	128945662	8000	128942041	-4000	4000	3621
chr9	132721578	132729578	132725738	8000	132725578	-4000	4000	160
chr9	98195011	98203011	98199513	8000	98199011	-4000	4000	502
chr9	87962441	87970441	87969809	8000	87966441	-4000	4000	3368
chr9	35748990	35756990	35753717	8000	35752990	-4000	4000	727
chr9	4705556	4713556	4713067	8000	4709556	-4000	4000	3511
chr9	35748990	35756990	35749245	8000	35752990	-4000	4000	-3745
chr9	93675587	93683587	93677712	8000	93679587	-4000	4000	-1875
chr9	128938041	128946041	128945673	8000	128942041	-4000	4000	3632
chr9	127734317	127742317	127739776	8000	127738317	-4000	4000	1459
chr9	32625454	32633454	32631816	8000	32629454	-4000	4000	2362
chr9	70380604	70388604	70385586	8000	70384604	-4000	4000	982
chr9	101383633	101391633	101390846	8000	101387633	-4000	4000	3213
chr9	89312703	89320703	89319707	8000	89316703	-4000	4000	3004
chr9	33437156	33445156	33442429	8000	33441156	-4000	4000	1273
chr9	128149453	128157453	128150443	8000	128153453	-4000	4000	-3010
chr9	137080539	137088539	137088328	8000	137084539	-4000	4000	3789
chr9	34339711	34347711	34343330	8000	34343711	-4000	4000	-381
chr9	133757894	133765894	133763976	8000	133761894	-4000	4000	2082
chr9	19448505	19456505	19450515	8000	19452505	-4000	4000	-1990
chr9	65730041	65738041	65737143	8000	65734041	-4000	4000	3102
chr9	125963377	125971377	125966858	8000	125967377	-4000	4000	-519
chr9	35084688	35092688	35088748	8000	35088688	-4000	4000	60
chr9	89001771	89009771	89002275	8000	89005771	-4000	4000	-3496
chr9	132887348	132895348	132889733	8000	132891348	-4000	4000	-1615
chr9	36159913	36167913	36162466	8000	36163913	-4000	4000	-1447
chr9	17499923	17507923	17502603	8000	17503923	-4000	4000	-1320
chr9	33379179	33387179	33386977	8000	33383179	-4000	4000	3798
chr9	34657886	34665886	34662020	8000	34661886	-4000	4000	134
chr9	110239810	110247810	110244183	8000	110243810	-4000	4000	373
chr9	114329251	114337251	114329980	8000	114333251	-4000	4000	-3271
chr9	87704634	87712634	87706999	8000	87708634	-4000	4000	-1635
chr9	137455952	137463952	137462308	8000	137459952	-4000	4000	2356
chr9	107480852	107488852	107485316	8000	107484852	-4000	4000	464
chr9	128149453	128157453	128150579	8000	128153453	-4000	4000	-2874
chr9	5295864	5303864	5300176	8000	5299864	-4000	4000	312
chr9	34394184	34402184	34401100	8000	34398184	-4000	4000	2916
chr9	35677159	35685159	35685032	8000	35681159	-4000	4000	3873
chr9	35645295	35653295	35650903	8000	35649295	-4000	4000	1608
chr9	35084688	35092688	35089514	8000	35088688	-4000	4000	826
chr9	35657511	35665511	35664120	8000	35661511	-4000	4000	2609
chr9	99212425	99220425	99218047	8000	99216425	-4000	4000	1622
chr9	108862898	108870898	108863517	8000	108866898	-4000	4000	-3381
chr9	107480852	107488852	107485355	8000	107484852	-4000	4000	503
chr9	122794389	122802389	122800271	8000	122798389	-4000	4000	1882
chr9	133455402	133463402	133456640	8000	133459402	-4000	4000	-2762
chr9	34705005	34713005	34709560	8000	34709005	-4000	4000	555
chr9	68527061	68535061	68529748	8000	68531061	-4000	4000	-1313
chr9	112877671	112885671	112879717	8000	112881671	-4000	4000	-1954
chr9	100573636	100581636	100576957	8000	100577636	-4000	4000	-679
chr9	122904056	122912056	122911010	8000	122908056	-4000	4000	2954
chr9	122911566	122919566	122911694	8000	122915566	-4000	4000	-3872
chr9	128941530	128949530	128946342	8000	128945530	-4000	4000	812
chr9	132887348	132895348	132889817	8000	132891348	-4000	4000	-1531
chr9	35657511	35665511	35664026	8000	35661511	-4000	4000	2515
chr9	101469170	101477170	101476593	8000	101473170	-4000	4000	3423
chr9	121328843	121336843	121332611	8000	121332843	-4000	4000	-232
chr9	96812269	96820269	96817955	8000	96816269	-4000	4000	1686
chr9	19371715	19379715	19371905	8000	19375715	-4000	4000	-3810
chr9	114308511	114316511	114309262	8000	114312511	-4000	4000	-3249
chr9	6503054	6511054	6506202	8000	6507054	-4000	4000	-852
chr9	108862898	108870898	108863339	8000	108866898	-4000	4000	-3559
chr9	128941530	128949530	128949234	8000	128945530	-4000	4000	3704
chr9	133571519	133579519	133573879	8000	133575519	-4000	4000	-1640
chr9	76647203	76655203	76652612	8000	76651203	-4000	4000	1409
chr9	107480852	107488852	107487067	8000	107484852	-4000	4000	2215
chr9	5772557	5780557	5772697	8000	5776557	-4000	4000	-3860
chr9	12706285	12714285	12709118	8000	12710285	-4000	4000	-1167
chr9	23686104	23694104	23692711	8000	23690104	-4000	4000	2607
chr9	35606041	35614041	35607474	8000	35610041	-4000	4000	-2567
chr9	35804045	35812045	35809220	8000	35808045	-4000	4000	1175
chr9	89001155	89009155	89001528	8000	89005155	-4000	4000	-3627
chr9	89001771	89009771	89001797	8000	89005771	-4000	4000	-3974
chr9	93316572	93324572	93318575	8000	93320572	-4000	4000	-1997
chr9	98195011	98203011	98200305	8000	98199011	-4000	4000	1294
chr9	116419112	116427112	116425995	8000	116423112	-4000	4000	2883
chr9	121781530	121789530	121783685	8000	121785530	-4000	4000	-1845
chr9	122198577	122206577	122200028	8000	122202577	-4000	4000	-2549
chr9	122904056	122912056	122911099	8000	122908056	-4000	4000	3043
chr9	125230161	125238161	125236962	8000	125234161	-4000	4000	2801
chr9	127441372	127449372	127444109	8000	127445372	-4000	4000	-1263
chr9	110168512	110176512	110169099	8000	110172512	-4000	4000	-3413
chr9	35100112	35108112	35107631	8000	35104112	-4000	4000	3519
chr9	84000074	84008074	84003344	8000	84004074	-4000	4000	-730
chr9	122911566	122919566	122918610	8000	122915566	-4000	4000	3044
chr9	122911566	122919566	122918776	8000	122915566	-4000	4000	3210
chr9	130883675	130891675	130886882	8000	130887675	-4000	4000	-793
chr9	101469170	101477170	101476352	8000	101473170	-4000	4000	3182
chr9	135928969	135936969	135933377	8000	135932969	-4000	4000	408
chr10	93952062	93960062	93959221	8000	93956062	-4000	4000	3159
chr10	100482646	100490646	100487655	8000	100486646	-4000	4000	1009
chr10	80267820	80275820	80274530	8000	80271820	-4000	4000	2710
chr10	17907164	17915164	17910989	8000	17911164	-4000	4000	-175
chr10	51691486	51699486	51698082	8000	51695486	-4000	4000	2596
chr10	113585602	113593602	113588837	8000	113589602	-4000	4000	-765
chr10	103244016	103252016	103245958	8000	103248016	-4000	4000	-2058
chr10	63163221	63171221	63168533	8000	63167221	-4000	4000	1312
chr10	68690487	68698487	68691241	8000	68694487	-4000	4000	-3246
chr10	104027286	104035286	104033245	8000	104031286	-4000	4000	1959
chr10	110602048	110610048	110604260	8000	110606048	-4000	4000	-1788
chr10	43190535	43198535	43195783	8000	43194535	-4000	4000	1248
chr10	91280337	91288337	91281578	8000	91284337	-4000	4000	-2759
chr10	270190	278190	277445	8000	274190	-4000	4000	3255
chr10	5103686	5111686	5107565	8000	5107686	-4000	4000	-121
chr10	7555270	7563270	7563258	8000	7559270	-4000	4000	3988
chr10	11456510	11464510	11463091	8000	11460510	-4000	4000	2581
chr10	17585032	17593032	17590265	8000	17589032	-4000	4000	1233
chr10	68891432	68899432	68892872	8000	68895432	-4000	4000	-2560
chr10	70758441	70766441	70760855	8000	70762441	-4000	4000	-1586
chr10	73670287	73678287	73674821	8000	73674287	-4000	4000	534
chr10	122993513	123001513	122994040	8000	122997513	-4000	4000	-3473
chr10	68891432	68899432	68892865	8000	68895432	-4000	4000	-2567
chr10	49730641	49738641	49738237	8000	49734641	-4000	4000	3596
chr10	113585602	113593602	113589695	8000	113589602	-4000	4000	93
chr10	7555270	7563270	7562799	8000	7559270	-4000	4000	3529
chr10	69100805	69108805	69104326	8000	69104805	-4000	4000	-479
chr10	28619112	28627112	28619549	8000	28623112	-4000	4000	-3563
chr10	122510907	122518907	122514213	8000	122514907	-4000	4000	-694
chr10	15207643	15215643	15213346	8000	15211643	-4000	4000	1703
chr10	25022664	25030664	25023443	8000	25026664	-4000	4000	-3221
chr10	1128384	1136384	1130289	8000	1132384	-4000	4000	-2095
chr10	85595552	85603552	85602482	8000	85599552	-4000	4000	2930
chr10	122428354	122436354	122429885	8000	122432354	-4000	4000	-2469
chr10	68690487	68698487	68693269	8000	68694487	-4000	4000	-1218
chr10	125849695	125857695	125853274	8000	125853695	-4000	4000	-421
chr10	129831233	129839233	129837883	8000	129835233	-4000	4000	2650
chr10	21509475	21517475	21514661	8000	21513475	-4000	4000	1186
chr10	15071475	15079475	15078423	8000	15075475	-4000	4000	2948
chr10	62092944	62100944	62093034	8000	62096944	-4000	4000	-3910
chr10	31801398	31809398	31808654	8000	31805398	-4000	4000	3256
chr10	100825944	100833944	100829007	8000	100829944	-4000	4000	-937
chr10	91624442	91632442	91630103	8000	91628442	-4000	4000	1661
chr10	59646764	59654764	59652931	8000	59650764	-4000	4000	2167
chr10	32263751	32271751	32269079	8000	32267751	-4000	4000	1328
chr10	70593348	70601348	70598113	8000	70597348	-4000	4000	765
chr10	93952062	93960062	93959969	8000	93956062	-4000	4000	3907
chr10	8012631	8020631	8013793	8000	8016631	-4000	4000	-2838
chr10	24844614	24852614	24849794	8000	24848614	-4000	4000	1180
chr10	43479181	43487181	43482442	8000	43483181	-4000	4000	-739
chr10	79512440	79520440	79513976	8000	79516440	-4000	4000	-2464
chr10	6006689	6014689	6012779	8000	6010689	-4000	4000	2090
chr10	51691486	51699486	51698603	8000	51695486	-4000	4000	3117
chr10	15071475	15079475	15078465	8000	15075475	-4000	4000	2990
chr10	119567802	119575802	119575751	8000	119571802	-4000	4000	3949
chr10	101821974	101829974	101829188	8000	101825974	-4000	4000	3214
chr10	110286730	110294730	110294184	8000	110290730	-4000	4000	3454
chr10	47309577	47317577	47312700	8000	47313577	-4000	4000	-877
chr10	99606522	99614522	99611046	8000	99610522	-4000	4000	524
chr10	122639736	122647736	122643214	8000	122643736	-4000	4000	-522
chr10	100519740	100527740	100526520	8000	100523740	-4000	4000	2780
chr10	60790852	60798852	60793927	8000	60794852	-4000	4000	-925
chr10	111076907	111084907	111079139	8000	111080907	-4000	4000	-1768
chr10	116659696	116667696	116664104	8000	116663696	-4000	4000	408
chr10	87747512	87755512	87754508	8000	87751512	-4000	4000	2996
chr10	68690487	68698487	68692198	8000	68694487	-4000	4000	-2289
chr10	46001088	46009088	46003431	8000	46005088	-4000	4000	-1657
chr10	47497854	47505854	47503229	8000	47501854	-4000	4000	1375
chr10	73670287	73678287	73675366	8000	73674287	-4000	4000	1079
chr10	13207110	13215110	13209286	8000	13211110	-4000	4000	-1824
chr10	73640881	73648881	73648469	8000	73644881	-4000	4000	3588
chr10	15071475	15079475	15073161	8000	15075475	-4000	4000	-2314
chr10	5389101	5397101	5395458	8000	5393101	-4000	4000	2357
chr10	5522771	5530771	5525160	8000	5526771	-4000	4000	-1611
chr10	5759740	5767740	5766069	8000	5763740	-4000	4000	2329
chr10	7555270	7563270	7563064	8000	7559270	-4000	4000	3794
chr10	43613904	43621904	43617243	8000	43617904	-4000	4000	-661
chr10	73640881	73648881	73648778	8000	73644881	-4000	4000	3897
chr10	71743556	71751556	71751228	8000	71747556	-4000	4000	3672
chr10	1035152	1043152	1041207	8000	1039152	-4000	4000	2055
chr10	102102489	102110489	102108153	8000	102106489	-4000	4000	1664
chr10	17907164	17915164	17907605	8000	17911164	-4000	4000	-3559
chr10	21509475	21517475	21515170	8000	21513475	-4000	4000	1695
chr10	31525814	31533814	31527059	8000	31529814	-4000	4000	-2755
chr10	45788964	45796964	45792264	8000	45792964	-4000	4000	-700
chr10	50129509	50137509	50130930	8000	50133509	-4000	4000	-2579
chr10	73126155	73134155	73126697	8000	73130155	-4000	4000	-3458
chr10	85595552	85603552	85602429	8000	85599552	-4000	4000	2877
chr10	89402487	89410487	89403073	8000	89406487	-4000	4000	-3414
chr10	102830516	102838516	102837211	8000	102834516	-4000	4000	2695
chr10	49730641	49738641	49738012	8000	49734641	-4000	4000	3371
chr10	79551852	79559852	79558952	8000	79555852	-4000	4000	3100
chr10	25598229	25606229	25598866	8000	25602229	-4000	4000	-3363
chr10	5370692	5378692	5373766	8000	5374692	-4000	4000	-926
chr10	124984189	124992189	124987271	8000	124988189	-4000	4000	-918
chr10	73640881	73648881	73647854	8000	73644881	-4000	4000	2973
chr10	100146094	100154094	100152290	8000	100150094	-4000	4000	2196
chr10	71743556	71751556	71751181	8000	71747556	-4000	4000	3625
chr10	116877477	116885477	116885399	8000	116881477	-4000	4000	3922
chr10	5522771	5530771	5525176	8000	5526771	-4000	4000	-1595
chr10	103385041	103393041	103385469	8000	103389041	-4000	4000	-3572
chr10	133549901	133557901	133556759	8000	133553901	-4000	4000	2858
chr10	5389101	5397101	5394423	8000	5393101	-4000	4000	1322
chr10	100269280	100277280	100275109	8000	100273280	-4000	4000	1829
chr10	23034523	23042523	23037329	8000	23038523	-4000	4000	-1194
chr10	68337107	68345107	68337459	8000	68341107	-4000	4000	-3648
chr10	59243774	59251774	59251467	8000	59247774	-4000	4000	3693
chr10	132804392	132812392	132810967	8000	132808392	-4000	4000	2575
chr10	15071475	15079475	15073243	8000	15075475	-4000	4000	-2232
chr10	45001326	45009326	45003746	8000	45005326	-4000	4000	-1580
chr10	24579609	24587609	24585027	8000	24583609	-4000	4000	1418
chr10	17907164	17915164	17910664	8000	17911164	-4000	4000	-500
chr10	22325542	22333542	22329407	8000	22329542	-4000	4000	-135
chr10	60865438	60873438	60869519	8000	60869438	-4000	4000	81
chr10	15207643	15215643	15212825	8000	15211643	-4000	4000	1182
chr10	101553321	101561321	101553655	8000	101557321	-4000	4000	-3666
chr10	89402487	89410487	89403507	8000	89406487	-4000	4000	-2980
chr10	11456510	11464510	11462370	8000	11460510	-4000	4000	1860
chr10	97861000	97869000	97865491	8000	97865000	-4000	4000	491
chr10	133549901	133557901	133555506	8000	133553901	-4000	4000	1605
chr10	11456510	11464510	11462875	8000	11460510	-4000	4000	2365
chr10	113585602	113593602	113589020	8000	113589602	-4000	4000	-582
chr10	116667192	116675192	116674935	8000	116671192	-4000	4000	3743
chr10	133519558	133527558	133527489	8000	133523558	-4000	4000	3931
chr10	5634867	5642867	5639121	8000	5638867	-4000	4000	254
chr10	47309577	47317577	47309932	8000	47313577	-4000	4000	-3645
chr10	25598229	25606229	25598248	8000	25602229	-4000	4000	-3981
chr10	91510829	91518829	91514176	8000	91514829	-4000	4000	-653
chr10	59784747	59792747	59792500	8000	59788747	-4000	4000	3753
chr10	79512440	79520440	79513127	8000	79516440	-4000	4000	-3313
chr10	102102489	102110489	102110022	8000	102106489	-4000	4000	3533
chr10	5522771	5530771	5525487	8000	5526771	-4000	4000	-1284
chr10	102146333	102154333	102148642	8000	102150333	-4000	4000	-1691
chr10	63151031	63159031	63153649	8000	63155031	-4000	4000	-1382
chr10	17907164	17915164	17910518	8000	17911164	-4000	4000	-646
chr10	116667192	116675192	116672844	8000	116671192	-4000	4000	1652
chr10	67917899	67925899	67925086	8000	67921899	-4000	4000	3187
chr10	68690487	68698487	68691535	8000	68694487	-4000	4000	-2952
chr10	35208958	35216958	35211372	8000	35212958	-4000	4000	-1586
chr10	96589315	96597315	96595419	8000	96593315	-4000	4000	2104
chr10	126008381	126016381	126009409	8000	126012381	-4000	4000	-2972
chr10	270190	278190	277415	8000	274190	-4000	4000	3225
chr10	37945573	37953573	37952518	8000	37949573	-4000	4000	2945
chr10	102473045	102481045	102479246	8000	102477045	-4000	4000	2201
chr10	102830516	102838516	102830766	8000	102834516	-4000	4000	-3750
chr10	121474332	121482332	121479872	8000	121478332	-4000	4000	1540
chr10	124832667	124840667	124834726	8000	124836667	-4000	4000	-1941
chr10	1128384	1136384	1130048	8000	1132384	-4000	4000	-2336
chr10	43613904	43621904	43616980	8000	43617904	-4000	4000	-924
chr10	45001326	45009326	45003951	8000	45005326	-4000	4000	-1375
chr10	91510829	91518829	91512725	8000	91514829	-4000	4000	-2104
chr10	102102489	102110489	102107748	8000	102106489	-4000	4000	1259
chr10	125849695	125857695	125854169	8000	125853695	-4000	4000	474
chr10	44991891	44999891	44991911	8000	44995891	-4000	4000	-3980
chr10	119825404	119833404	119827368	8000	119829404	-4000	4000	-2036
chr10	125760143	125768143	125767633	8000	125764143	-4000	4000	3490
chr10	89402487	89410487	89402772	8000	89406487	-4000	4000	-3715
chr10	47309577	47317577	47310597	8000	47313577	-4000	4000	-2980
chr10	104027286	104035286	104034157	8000	104031286	-4000	4000	2871
chr10	1035152	1043152	1041377	8000	1039152	-4000	4000	2225
chr10	6423143	6431143	6430899	8000	6427143	-4000	4000	3756
chr10	15207643	15215643	15213982	8000	15211643	-4000	4000	2339
chr10	21739630	21747630	21742182	8000	21743630	-4000	4000	-1448
chr10	24579609	24587609	24585731	8000	24583609	-4000	4000	2122
chr10	93073885	93081885	93075211	8000	93077885	-4000	4000	-2674
chr10	73913496	73921496	73915291	8000	73917496	-4000	4000	-2205
chr10	85595552	85603552	85602586	8000	85599552	-4000	4000	3034
chr10	73419579	73427579	73425116	8000	73423579	-4000	4000	1537
chr10	100965458	100973458	100973236	8000	100969458	-4000	4000	3778
chr10	13273796	13281796	13278306	8000	13277796	-4000	4000	510
chr10	73127828	73135828	73134721	8000	73131828	-4000	4000	2893
chr10	24579609	24587609	24585902	8000	24583609	-4000	4000	2293
chr10	93073885	93081885	93076558	8000	93077885	-4000	4000	-1327
chr10	22325542	22333542	22327614	8000	22329542	-4000	4000	-1928
chr10	73913496	73921496	73916451	8000	73917496	-4000	4000	-1045
chr10	103385041	103393041	103387677	8000	103389041	-4000	4000	-1364
chr10	117545546	117553546	117548439	8000	117549546	-4000	4000	-1107
chr10	100990403	100998403	100990899	8000	100994403	-4000	4000	-3504
chr10	14514557	14522557	14521986	8000	14518557	-4000	4000	3429
chr10	14815245	14823245	14820103	8000	14819245	-4000	4000	858
chr10	56353227	56361227	56360373	8000	56357227	-4000	4000	3146
chr10	67914390	67922390	67916519	8000	67918390	-4000	4000	-1871
chr10	72883694	72891694	72885901	8000	72887694	-4000	4000	-1793
chr10	62807996	62815996	62813365	8000	62811996	-4000	4000	1369
chr10	124832667	124840667	124834855	8000	124836667	-4000	4000	-1812
chr10	12165961	12173961	12173796	8000	12169961	-4000	4000	3835
chr10	92027437	92035437	92028940	8000	92031437	-4000	4000	-2497
chr10	116659696	116667696	116664817	8000	116663696	-4000	4000	1121
chr10	47497854	47505854	47502517	8000	47501854	-4000	4000	663
chr10	87549461	87557461	87552470	8000	87553461	-4000	4000	-991
chr10	5522771	5530771	5525262	8000	5526771	-4000	4000	-1509
chr10	15207643	15215643	15212194	8000	15211643	-4000	4000	551
chr10	95307771	95315771	95312142	8000	95311771	-4000	4000	371
chr10	73371101	73379101	73376157	8000	73375101	-4000	4000	1056
chr10	5389101	5397101	5394327	8000	5393101	-4000	4000	1226
chr10	99390330	99398330	99390342	8000	99394330	-4000	4000	-3988
chr10	125760143	125768143	125763526	8000	125764143	-4000	4000	-617
chr10	100961134	100969134	100963122	8000	100965134	-4000	4000	-2012
chr10	15774170	15782170	15778828	8000	15778170	-4000	4000	658
chr10	87743705	87751705	87745919	8000	87747705	-4000	4000	-1786
chr10	109860766	109868766	109865077	8000	109864766	-4000	4000	311
chr10	113830725	113838725	113837085	8000	113834725	-4000	4000	2360
chr10	89417605	89425605	89418624	8000	89421605	-4000	4000	-2981
chr10	73627612	73635612	73632024	8000	73631612	-4000	4000	412
chr10	92691647	92699647	92692724	8000	92695647	-4000	4000	-2923
chr10	62807996	62815996	62814271	8000	62811996	-4000	4000	2275
chr10	17907164	17915164	17910664	8000	17911164	-4000	4000	-500
chr10	45001326	45009326	45003781	8000	45005326	-4000	4000	-1545
chr10	68690487	68698487	68690832	8000	68694487	-4000	4000	-3655
chr10	72009558	72017558	72009796	8000	72013558	-4000	4000	-3762
chr10	117545546	117553546	117548384	8000	117549546	-4000	4000	-1162
chr10	15071475	15079475	15073238	8000	15075475	-4000	4000	-2237
chr10	45821594	45829594	45827193	8000	45825594	-4000	4000	1599
chr10	71743556	71751556	71751028	8000	71747556	-4000	4000	3472
chr10	102146333	102154333	102148693	8000	102150333	-4000	4000	-1640
chr10	62807996	62815996	62813739	8000	62811996	-4000	4000	1743
chr10	25022664	25030664	25024482	8000	25026664	-4000	4000	-2182
chr10	35634247	35642247	35641169	8000	35638247	-4000	4000	2922
chr10	69503666	69511666	69506139	8000	69507666	-4000	4000	-1527
chr10	91624442	91632442	91629914	8000	91628442	-4000	4000	1472
chr10	42830937	42838937	42830939	8000	42834937	-4000	4000	-3998
chr10	13313428	13321428	13318858	8000	13317428	-4000	4000	1430
chr10	62807996	62815996	62813424	8000	62811996	-4000	4000	1428
chr10	68942847	68950847	68946494	8000	68946847	-4000	4000	-353
chr10	70108282	70116282	70109092	8000	70112282	-4000	4000	-3190
chr10	73003217	73011217	73007980	8000	73007217	-4000	4000	763
chr10	11868277	11876277	11869457	8000	11872277	-4000	4000	-2820
chr10	27164135	27172135	27171061	8000	27168135	-4000	4000	2926
chr10	45001326	45009326	45004447	8000	45005326	-4000	4000	-879
chr10	70094223	70102223	70100264	8000	70098223	-4000	4000	2041
chr10	73808501	73816501	73812774	8000	73812501	-4000	4000	273
chr10	103385041	103393041	103388204	8000	103389041	-4000	4000	-837
chr10	103385041	103393041	103388436	8000	103389041	-4000	4000	-605
chr10	127131426	127139426	127137461	8000	127135426	-4000	4000	2035
chr10	73240504	73248504	73243503	8000	73244504	-4000	4000	-1001
chr10	73913496	73921496	73914787	8000	73917496	-4000	4000	-2709
chr10	35208958	35216958	35211735	8000	35212958	-4000	4000	-1223
chr10	84215621	84223621	84222257	8000	84219621	-4000	4000	2636
chr10	70593348	70601348	70600771	8000	70597348	-4000	4000	3423
chr10	31525814	31533814	31526891	8000	31529814	-4000	4000	-2923
chr10	59646764	59654764	59652733	8000	59650764	-4000	4000	1969
chr10	45611500	45619500	45616059	8000	45615500	-4000	4000	559
chr10	102669731	102677731	102676776	8000	102673731	-4000	4000	3045
chr10	4844062	4852062	4847210	8000	4848062	-4000	4000	-852
chr10	27668874	27676874	27675068	8000	27672874	-4000	4000	2194
chr10	27668874	27676874	27675070	8000	27672874	-4000	4000	2196
chr10	51691486	51699486	51698674	8000	51695486	-4000	4000	3188
chr10	62092944	62100944	62093255	8000	62096944	-4000	4000	-3689
chr10	70593348	70601348	70598935	8000	70597348	-4000	4000	1587
chr10	101821974	101829974	101827365	8000	101825974	-4000	4000	1391
chr10	103385041	103393041	103388348	8000	103389041	-4000	4000	-693
chr10	104263459	104271459	104267320	8000	104267459	-4000	4000	-139
chr10	110507533	110515533	110510069	8000	110511533	-4000	4000	-1464
chr10	113585602	113593602	113592211	8000	113589602	-4000	4000	2609
chr10	113585602	113593602	113592212	8000	113589602	-4000	4000	2610
chr10	3133718	3141718	3134508	8000	3137718	-4000	4000	-3210
chr10	17907164	17915164	17910352	8000	17911164	-4000	4000	-812
chr10	27164135	27172135	27170634	8000	27168135	-4000	4000	2499
chr10	47497854	47505854	47502746	8000	47501854	-4000	4000	892
chr10	92042692	92050692	92049803	8000	92046692	-4000	4000	3111
chr10	101780443	101788443	101786074	8000	101784443	-4000	4000	1631
chr10	104122385	104130385	104125681	8000	104126385	-4000	4000	-704
chr10	31525814	31533814	31526818	8000	31529814	-4000	4000	-2996
chr10	45001326	45009326	45003758	8000	45005326	-4000	4000	-1568
chr10	72883694	72891694	72886125	8000	72887694	-4000	4000	-1569
chr10	80267820	80275820	80275183	8000	80271820	-4000	4000	3363
chr10	11456510	11464510	11463032	8000	11460510	-4000	4000	2522
chr10	49730641	49738641	49738049	8000	49734641	-4000	4000	3408
chr10	79512440	79520440	79514130	8000	79516440	-4000	4000	-2310
chr10	69629596	69637596	69633058	8000	69633596	-4000	4000	-538
chr10	125849695	125857695	125854317	8000	125853695	-4000	4000	622
chr10	1035152	1043152	1042634	8000	1039152	-4000	4000	3482
chr10	21752548	21760548	21756708	8000	21756548	-4000	4000	160
chr10	45001326	45009326	45003486	8000	45005326	-4000	4000	-1840
chr10	69397884	69405884	69398646	8000	69401884	-4000	4000	-3238
chr10	88931074	88939074	88935449	8000	88935074	-4000	4000	375
chr10	89417605	89425605	89418633	8000	89421605	-4000	4000	-2972
chr10	97429444	97437444	97430500	8000	97433444	-4000	4000	-2944
chr10	113726907	113734907	113729480	8000	113730907	-4000	4000	-1427
chr10	270190	278190	277452	8000	274190	-4000	4000	3262
chr10	270190	278190	276920	8000	274190	-4000	4000	2730
chr10	4844062	4852062	4847529	8000	4848062	-4000	4000	-533
chr10	7555270	7563270	7559781	8000	7559270	-4000	4000	511
chr10	11868277	11876277	11870841	8000	11872277	-4000	4000	-1436
chr10	13313428	13321428	13318879	8000	13317428	-4000	4000	1451
chr10	15207643	15215643	15211818	8000	15211643	-4000	4000	175
chr10	15207643	15215643	15212223	8000	15211643	-4000	4000	580
chr10	16509745	16517745	16512809	8000	16513745	-4000	4000	-936
chr10	20775973	20783973	20783574	8000	20779973	-4000	4000	3601
chr10	25598229	25606229	25598688	8000	25602229	-4000	4000	-3541
chr10	37228567	37236567	37231530	8000	37232567	-4000	4000	-1037
chr10	47309577	47317577	47310650	8000	47313577	-4000	4000	-2927
chr10	100961134	100969134	100965126	8000	100965134	-4000	4000	-8
chr10	102629535	102637535	102630275	8000	102633535	-4000	4000	-3260
chr10	111076907	111084907	111079475	8000	111080907	-4000	4000	-1432
chr10	119029670	119037670	119034038	8000	119033670	-4000	4000	368
chr10	11916022	11924022	11921303	8000	11920022	-4000	4000	1281
chr10	44966981	44974981	44970399	8000	44970981	-4000	4000	-582
chr10	70294970	70302970	70301460	8000	70298970	-4000	4000	2490
chr10	73640881	73648881	73645037	8000	73644881	-4000	4000	156
chr10	13651929	13659929	13657219	8000	13655929	-4000	4000	1290
chr10	68690487	68698487	68691891	8000	68694487	-4000	4000	-2596
chr10	29453338	29461338	29457813	8000	29457338	-4000	4000	475
chr10	46998488	47006488	47001044	8000	47002488	-4000	4000	-1444
chr10	13434484	13442484	13439240	8000	13438484	-4000	4000	756
chr10	37945573	37953573	37952516	8000	37949573	-4000	4000	2943
chr10	58366751	58374751	58368825	8000	58370751	-4000	4000	-1926
chr10	98379565	98387565	98383625	8000	98383565	-4000	4000	60
chr10	46001088	46009088	46005722	8000	46005088	-4000	4000	634
chr10	70593348	70601348	70598568	8000	70597348	-4000	4000	1220
chr10	73627612	73635612	73634482	8000	73631612	-4000	4000	2870
chr10	73244843	73252843	73251800	8000	73248843	-4000	4000	2957
chr10	33173492	33181492	33180260	8000	33177492	-4000	4000	2768
chr10	126008381	126016381	126008450	8000	126012381	-4000	4000	-3931
chr10	12246589	12254589	12249675	8000	12250589	-4000	4000	-914
chr10	17233593	17241593	17236369	8000	17237593	-4000	4000	-1224
chr10	91510829	91518829	91512426	8000	91514829	-4000	4000	-2403
chr10	15207643	15215643	15213283	8000	15211643	-4000	4000	1640
chr10	122926901	122934901	122932588	8000	122930901	-4000	4000	1687
chr10	50812495	50820495	50813932	8000	50816495	-4000	4000	-2563
chr10	24579609	24587609	24584832	8000	24583609	-4000	4000	1223
chr10	27668874	27676874	27675306	8000	27672874	-4000	4000	2432
chr10	113779429	113787429	113780617	8000	113783429	-4000	4000	-2812
chr10	31801398	31809398	31807127	8000	31805398	-4000	4000	1729
chr10	60790852	60798852	60792178	8000	60794852	-4000	4000	-2674
chr10	93587687	93595687	93593924	8000	93591687	-4000	4000	2237
chr10	112145865	112153865	112150304	8000	112149865	-4000	4000	439
chr10	125849695	125857695	125853188	8000	125853695	-4000	4000	-507
chr10	117545546	117553546	117548117	8000	117549546	-4000	4000	-1429
chr10	5389101	5397101	5393826	8000	5393101	-4000	4000	725
chr10	68410064	68418064	68415015	8000	68414064	-4000	4000	951
chr10	75028624	75036624	75028952	8000	75032624	-4000	4000	-3672
chr10	3133718	3141718	3140695	8000	3137718	-4000	4000	2977
chr10	31525814	31533814	31526744	8000	31529814	-4000	4000	-3070
chr10	73640881	73648881	73646787	8000	73644881	-4000	4000	1906
chr10	47309577	47317577	47312800	8000	47313577	-4000	4000	-777
chr10	119163720	119171720	119168444	8000	119167720	-4000	4000	724
chr10	106569663	106577663	106577452	8000	106573663	-4000	4000	3789
chr10	5522771	5530771	5525379	8000	5526771	-4000	4000	-1392
chr10	112420428	112428428	112425417	8000	112424428	-4000	4000	989
chr10	49730641	49738641	49736367	8000	49734641	-4000	4000	1726
chr10	30305801	30313801	30313683	8000	30309801	-4000	4000	3882
chr10	50301586	50309586	50307205	8000	50305586	-4000	4000	1619
chr10	93073885	93081885	93077203	8000	93077885	-4000	4000	-682
chr10	99871577	99879577	99877281	8000	99875577	-4000	4000	1704
chr10	5634867	5642867	5641802	8000	5638867	-4000	4000	2935
chr10	89305271	89313271	89306550	8000	89309271	-4000	4000	-2721
chr10	89417605	89425605	89418410	8000	89421605	-4000	4000	-3195
chr10	30457833	30465833	30460703	8000	30461833	-4000	4000	-1130
chr10	5494697	5502697	5499320	8000	5498697	-4000	4000	623
chr10	5494697	5502697	5499336	8000	5498697	-4000	4000	639
chr10	24579609	24587609	24585577	8000	24583609	-4000	4000	1968
chr10	87232908	87240908	87234941	8000	87236908	-4000	4000	-1967
chr10	37228567	37236567	37231669	8000	37232567	-4000	4000	-898
chr10	93055493	93063493	93058494	8000	93059493	-4000	4000	-999
chr10	15207643	15215643	15214167	8000	15211643	-4000	4000	2524
chr10	102159871	102167871	102160322	8000	102163871	-4000	4000	-3549
chr10	69100805	69108805	69103897	8000	69104805	-4000	4000	-908
chr10	70877184	70885184	70883735	8000	70881184	-4000	4000	2551
chr10	71743556	71751556	71751113	8000	71747556	-4000	4000	3557
chr10	103244016	103252016	103246361	8000	103248016	-4000	4000	-1655
chr10	70564450	70572450	70566605	8000	70568450	-4000	4000	-1845
chr10	11456510	11464510	11463404	8000	11460510	-4000	4000	2894
chr10	110602048	110610048	110602559	8000	110606048	-4000	4000	-3489
chr10	11332675	11340675	11333448	8000	11336675	-4000	4000	-3227
chr10	87046202	87054202	87051603	8000	87050202	-4000	4000	1401
chr10	96589315	96597315	96595493	8000	96593315	-4000	4000	2178
chr10	7555270	7563270	7563229	8000	7559270	-4000	4000	3959
chr10	97431909	97439909	97432599	8000	97435909	-4000	4000	-3310
chr10	11456510	11464510	11463543	8000	11460510	-4000	4000	3033
chr10	23034523	23042523	23037311	8000	23038523	-4000	4000	-1212
chr10	101037244	101045244	101039538	8000	101041244	-4000	4000	-1706
chr10	92691647	92699647	92694746	8000	92695647	-4000	4000	-901
chr10	11456510	11464510	11463282	8000	11460510	-4000	4000	2772
chr10	15509954	15517954	15517178	8000	15513954	-4000	4000	3224
chr10	17233593	17241593	17233623	8000	17237593	-4000	4000	-3970
chr10	17907164	17915164	17910321	8000	17911164	-4000	4000	-843
chr10	24543848	24551848	24546197	8000	24547848	-4000	4000	-1651
chr10	29453338	29461338	29458553	8000	29457338	-4000	4000	1215
chr10	43613904	43621904	43616727	8000	43617904	-4000	4000	-1177
chr10	68410064	68418064	68416753	8000	68414064	-4000	4000	2689
chr10	70593348	70601348	70597980	8000	70597348	-4000	4000	632
chr10	73244843	73252843	73246008	8000	73248843	-4000	4000	-2835
chr10	85595552	85603552	85602369	8000	85599552	-4000	4000	2817
chr10	87747512	87755512	87754560	8000	87751512	-4000	4000	3048
chr10	89402487	89410487	89403688	8000	89406487	-4000	4000	-2799
chr10	91624442	91632442	91630479	8000	91628442	-4000	4000	2037
chr10	102830516	102838516	102832618	8000	102834516	-4000	4000	-1898
chr10	104122385	104130385	104125545	8000	104126385	-4000	4000	-840
chr10	104122385	104130385	104125804	8000	104126385	-4000	4000	-581
chr10	122926901	122934901	122932297	8000	122930901	-4000	4000	1396
chr10	126008381	126016381	126008486	8000	126012381	-4000	4000	-3895
chr10	133549901	133557901	133555978	8000	133553901	-4000	4000	2077
chr10	79512440	79520440	79513976	8000	79516440	-4000	4000	-2464
chr10	99871577	99879577	99877281	8000	99875577	-4000	4000	1704
chr10	104122385	104130385	104130180	8000	104126385	-4000	4000	3795
chr10	119825404	119833404	119827846	8000	119829404	-4000	4000	-1558
chr10	250637	258637	252912	8000	254637	-4000	4000	-1725
chr10	72883694	72891694	72887575	8000	72887694	-4000	4000	-119
chr10	85595552	85603552	85602387	8000	85599552	-4000	4000	2835
chr10	91861475	91869475	91864462	8000	91865475	-4000	4000	-1013
chr10	122639736	122647736	122640348	8000	122643736	-4000	4000	-3388
chr10	133222412	133230412	133224924	8000	133226412	-4000	4000	-1488
chr10	43190535	43198535	43196097	8000	43194535	-4000	4000	1562
chr10	114973676	114981676	114975295	8000	114977676	-4000	4000	-2381
chr10	111076907	111084907	111080112	8000	111080907	-4000	4000	-795
chr10	73126155	73134155	73130819	8000	73130155	-4000	4000	664
chr10	119825404	119833404	119827560	8000	119829404	-4000	4000	-1844
chr10	15207643	15215643	15213760	8000	15211643	-4000	4000	2117
chr10	75028624	75036624	75030829	8000	75032624	-4000	4000	-1795
chr10	122993513	123001513	122994381	8000	122997513	-4000	4000	-3132
chr10	15207643	15215643	15213095	8000	15211643	-4000	4000	1452
chr10	50129509	50137509	50130954	8000	50133509	-4000	4000	-2555
chr10	70877184	70885184	70877416	8000	70881184	-4000	4000	-3768
chr10	99606522	99614522	99610658	8000	99610522	-4000	4000	136
chr10	132804392	132812392	132808415	8000	132808392	-4000	4000	23
chr10	13273796	13281796	13281039	8000	13277796	-4000	4000	3243
chr10	92042692	92050692	92049834	8000	92046692	-4000	4000	3142
chr10	112424379	112432379	112430827	8000	112428379	-4000	4000	2448
chr10	11456510	11464510	11462825	8000	11460510	-4000	4000	2315
chr10	12165961	12173961	12172823	8000	12169961	-4000	4000	2862
chr10	13207110	13215110	13209161	8000	13211110	-4000	4000	-1949
chr10	13434484	13442484	13441751	8000	13438484	-4000	4000	3267
chr10	14867741	14875741	14870624	8000	14871741	-4000	4000	-1117
chr10	14893359	14901359	14897435	8000	14897359	-4000	4000	76
chr10	21509475	21517475	21515290	8000	21513475	-4000	4000	1815
chr10	22325542	22333542	22326910	8000	22329542	-4000	4000	-2632
chr10	23034523	23042523	23037309	8000	23038523	-4000	4000	-1214
chr10	25022664	25030664	25024212	8000	25026664	-4000	4000	-2452
chr10	25598229	25606229	25598241	8000	25602229	-4000	4000	-3988
chr10	27164135	27172135	27171010	8000	27168135	-4000	4000	2875
chr10	31801398	31809398	31807608	8000	31805398	-4000	4000	2210
chr10	37945573	37953573	37953033	8000	37949573	-4000	4000	3460
chr10	43613904	43621904	43616370	8000	43617904	-4000	4000	-1534
chr10	47309577	47317577	47310667	8000	47313577	-4000	4000	-2910
chr10	51691486	51699486	51698544	8000	51695486	-4000	4000	3058
chr10	58366751	58374751	58368001	8000	58370751	-4000	4000	-2750
chr10	59243774	59251774	59251653	8000	59247774	-4000	4000	3879
chr10	59646764	59654764	59652769	8000	59650764	-4000	4000	2005
chr10	72092032	72100032	72097271	8000	72096032	-4000	4000	1239
chr10	73249762	73257762	73256398	8000	73253762	-4000	4000	2636
chr10	75028624	75036624	75029231	8000	75032624	-4000	4000	-3393
chr10	87549461	87557461	87552225	8000	87553461	-4000	4000	-1236
chr10	89402487	89410487	89403172	8000	89406487	-4000	4000	-3315
chr10	91624442	91632442	91630828	8000	91628442	-4000	4000	2386
chr10	94328823	94336823	94334204	8000	94332823	-4000	4000	1381
chr10	95233572	95241572	95238622	8000	95237572	-4000	4000	1050
chr10	97429444	97437444	97430540	8000	97433444	-4000	4000	-2904
chr10	97861000	97869000	97864182	8000	97865000	-4000	4000	-818
chr10	100990403	100998403	100990924	8000	100994403	-4000	4000	-3479
chr10	103298796	103306796	103303772	8000	103302796	-4000	4000	976
chr10	104125888	104133888	104133628	8000	104129888	-4000	4000	3740
chr10	112145865	112153865	112153588	8000	112149865	-4000	4000	3723
chr10	112420428	112428428	112427405	8000	112424428	-4000	4000	2977
chr10	116659696	116667696	116665715	8000	116663696	-4000	4000	2019
chr10	119163720	119171720	119169290	8000	119167720	-4000	4000	1570
chr10	119825404	119833404	119826650	8000	119829404	-4000	4000	-2754
chr10	122993513	123001513	122994060	8000	122997513	-4000	4000	-3453
chr10	128092659	128100659	128099179	8000	128096659	-4000	4000	2520
chr10	51691486	51699486	51698082	8000	51695486	-4000	4000	2596
chr10	110602048	110610048	110602970	8000	110606048	-4000	4000	-3078
chr10	114290824	114298824	114295943	8000	114294824	-4000	4000	1119
chr10	46387784	46395784	46390872	8000	46391784	-4000	4000	-912
chr10	62807996	62815996	62812954	8000	62811996	-4000	4000	958
chr10	6423143	6431143	6430928	8000	6427143	-4000	4000	3785
chr10	5634867	5642867	5640749	8000	5638867	-4000	4000	1882
chr10	47497854	47505854	47503504	8000	47501854	-4000	4000	1650
chr10	72055034	72063034	72062758	8000	72059034	-4000	4000	3724
chr10	76865601	76873601	76870218	8000	76869601	-4000	4000	617
chr10	120905524	120913524	120908930	8000	120909524	-4000	4000	-594
chr10	73640881	73648881	73647193	8000	73644881	-4000	4000	2312
chr10	35568669	35576669	35570025	8000	35572669	-4000	4000	-2644
chr10	67914390	67922390	67916902	8000	67918390	-4000	4000	-1488
chr10	68337107	68345107	68337309	8000	68341107	-4000	4000	-3798
chr10	87366695	87374695	87367147	8000	87370695	-4000	4000	-3548
chr10	89305271	89313271	89307310	8000	89309271	-4000	4000	-1961
chr10	7555270	7563270	7563040	8000	7559270	-4000	4000	3770
chr10	15207643	15215643	15214058	8000	15211643	-4000	4000	2415
chr10	44991891	44999891	44991995	8000	44995891	-4000	4000	-3896
chr10	27164135	27172135	27170449	8000	27168135	-4000	4000	2314
chr10	100482646	100490646	100487755	8000	100486646	-4000	4000	1109
chr10	91510829	91518829	91512571	8000	91514829	-4000	4000	-2258
chr10	91861475	91869475	91863055	8000	91865475	-4000	4000	-2420
chr10	104025233	104033233	104032686	8000	104029233	-4000	4000	3453
chr10	61402642	61410642	61410618	8000	61406642	-4000	4000	3976
chr10	72883694	72891694	72887421	8000	72887694	-4000	4000	-273
chr10	24579609	24587609	24585845	8000	24583609	-4000	4000	2236
chr10	73768161	73776161	73770322	8000	73772161	-4000	4000	-1839
chr10	73768161	73776161	73771040	8000	73772161	-4000	4000	-1121
chr10	4844062	4852062	4847807	8000	4848062	-4000	4000	-255
chr10	24543848	24551848	24545232	8000	24547848	-4000	4000	-2616
chr10	89417605	89425605	89418227	8000	89421605	-4000	4000	-3378
chr10	110835468	110843468	110836155	8000	110839468	-4000	4000	-3313
chr10	110835468	110843468	110836157	8000	110839468	-4000	4000	-3311
chr10	125849695	125857695	125853380	8000	125853695	-4000	4000	-315
chr10	100961134	100969134	100961945	8000	100965134	-4000	4000	-3189
chr10	110602048	110610048	110604272	8000	110606048	-4000	4000	-1776
chr10	3133718	3141718	3140714	8000	3137718	-4000	4000	2996
chr10	25598229	25606229	25599406	8000	25602229	-4000	4000	-2823
chr10	43613904	43621904	43616429	8000	43617904	-4000	4000	-1475
chr10	88269864	88277864	88274789	8000	88273864	-4000	4000	925
chr10	112420428	112428428	112427224	8000	112424428	-4000	4000	2796
chr10	62807996	62815996	62812549	8000	62811996	-4000	4000	553
chr10	104122385	104130385	104125740	8000	104126385	-4000	4000	-645
chr10	119825404	119833404	119831523	8000	119829404	-4000	4000	2119
chr10	25022664	25030664	25024077	8000	25026664	-4000	4000	-2587
chr10	5634867	5642867	5641826	8000	5638867	-4000	4000	2959
chr10	73003217	73011217	73008291	8000	73007217	-4000	4000	1074
chr10	75028624	75036624	75030771	8000	75032624	-4000	4000	-1853
chr10	120588065	120596065	120589597	8000	120592065	-4000	4000	-2468
chr10	120905524	120913524	120909443	8000	120909524	-4000	4000	-81
chr10	116659696	116667696	116664969	8000	116663696	-4000	4000	1273
chr10	92691647	92699647	92692378	8000	92695647	-4000	4000	-3269
chr10	70593348	70601348	70598873	8000	70597348	-4000	4000	1525
chr10	30457833	30465833	30458115	8000	30461833	-4000	4000	-3718
chr10	46998488	47006488	47000992	8000	47002488	-4000	4000	-1496
chr10	75028624	75036624	75029366	8000	75032624	-4000	4000	-3258
chr10	88931074	88939074	88938189	8000	88935074	-4000	4000	3115
chr10	129831233	129839233	129837871	8000	129835233	-4000	4000	2638
chr10	23438377	23446377	23442223	8000	23442377	-4000	4000	-154
chr10	25022664	25030664	25024469	8000	25026664	-4000	4000	-2195
chr10	15207643	15215643	15213200	8000	15211643	-4000	4000	1557
chr10	15207643	15215643	15213692	8000	15211643	-4000	4000	2049
chr10	31525814	31533814	31527071	8000	31529814	-4000	4000	-2743
chr10	72055034	72063034	72061025	8000	72059034	-4000	4000	1991
chr10	72055034	72063034	72061026	8000	72059034	-4000	4000	1992
chr10	45821594	45829594	45827250	8000	45825594	-4000	4000	1656
chr10	102064036	102072036	102066162	8000	102068036	-4000	4000	-1874
chr10	51691486	51699486	51698133	8000	51695486	-4000	4000	2647
chr10	122510907	122518907	122514283	8000	122514907	-4000	4000	-624
chr10	12892625	12900625	12898677	8000	12896625	-4000	4000	2052
chr10	45442119	45450119	45443477	8000	45446119	-4000	4000	-2642
chr10	96185171	96193171	96192069	8000	96189171	-4000	4000	2898
chr10	100269280	100277280	100275311	8000	100273280	-4000	4000	2031
chr10	20775973	20783973	20782125	8000	20779973	-4000	4000	2152
chr10	96056870	96064870	96058051	8000	96060870	-4000	4000	-2819
chr10	28678932	28686932	28681622	8000	28682932	-4000	4000	-1310
chr10	27668874	27676874	27675131	8000	27672874	-4000	4000	2257
chr10	89201629	89209629	89206854	8000	89205629	-4000	4000	1225
chr10	73670287	73678287	73676067	8000	73674287	-4000	4000	1780
chr10	99848594	99856594	99851578	8000	99852594	-4000	4000	-1016
chr10	11456510	11464510	11462394	8000	11460510	-4000	4000	1884
chr10	43613904	43621904	43616540	8000	43617904	-4000	4000	-1364
chr10	79512440	79520440	79515987	8000	79516440	-4000	4000	-453
chr10	21509475	21517475	21515641	8000	21513475	-4000	4000	2166
chr10	103590027	103598027	103597888	8000	103594027	-4000	4000	3861
chr10	69629596	69637596	69632880	8000	69633596	-4000	4000	-716
chr10	100146094	100154094	100152129	8000	100150094	-4000	4000	2035
chr10	113779429	113787429	113780628	8000	113783429	-4000	4000	-2801
chr10	102146333	102154333	102148645	8000	102150333	-4000	4000	-1688
chr10	15207643	15215643	15211912	8000	15211643	-4000	4000	269
chr10	133222412	133230412	133224830	8000	133226412	-4000	4000	-1582
chr10	87747512	87755512	87754484	8000	87751512	-4000	4000	2972
chr10	25598229	25606229	25598309	8000	25602229	-4000	4000	-3920
chr10	72363340	72371340	72368084	8000	72367340	-4000	4000	744
chr10	71811947	71819947	71817467	8000	71815947	-4000	4000	1520
chr10	46001088	46009088	46003267	8000	46005088	-4000	4000	-1821
chr10	21509475	21517475	21514975	8000	21513475	-4000	4000	1500
chr10	114973676	114981676	114975558	8000	114977676	-4000	4000	-2118
chr10	16586611	16594611	16593302	8000	16590611	-4000	4000	2691
chr10	37945573	37953573	37953423	8000	37949573	-4000	4000	3850
chr10	89305271	89313271	89306542	8000	89309271	-4000	4000	-2729
chr10	56353227	56361227	56359504	8000	56357227	-4000	4000	2277
chr10	127131426	127139426	127137185	8000	127135426	-4000	4000	1759
chr10	73003217	73011217	73009833	8000	73007217	-4000	4000	2616
chr10	70593348	70601348	70598286	8000	70597348	-4000	4000	938
chr10	30457833	30465833	30459294	8000	30461833	-4000	4000	-2539
chr10	111076907	111084907	111079229	8000	111080907	-4000	4000	-1678
chr10	28678932	28686932	28681284	8000	28682932	-4000	4000	-1648
chr10	93302429	93310429	93310079	8000	93306429	-4000	4000	3650
chr10	14867741	14875741	14870636	8000	14871741	-4000	4000	-1105
chr10	73627612	73635612	73632083	8000	73631612	-4000	4000	471
chr10	87046202	87054202	87051541	8000	87050202	-4000	4000	1339
chr10	96185171	96193171	96191967	8000	96189171	-4000	4000	2796
chr10	124980317	124988317	124983198	8000	124984317	-4000	4000	-1119
chr10	7555270	7563270	7563166	8000	7559270	-4000	4000	3896
chr10	15207643	15215643	15213677	8000	15211643	-4000	4000	2034
chr10	73419579	73427579	73422541	8000	73423579	-4000	4000	-1038
chr10	80141359	80149359	80142177	8000	80145359	-4000	4000	-3182
chr10	125849695	125857695	125853235	8000	125853695	-4000	4000	-460
chr10	73244843	73252843	73246078	8000	73248843	-4000	4000	-2765
chr11	65649599	65657599	65650704	8000	65653599	-4000	4000	-2895
chr11	65649599	65657599	65650706	8000	65653599	-4000	4000	-2893
chr11	74692429	74700429	74696455	8000	74696429	-4000	4000	26
chr11	95972598	95980598	95979551	8000	95976598	-4000	4000	2953
chr11	66642469	66650469	66644187	8000	66646469	-4000	4000	-2282
chr11	11952207	11960207	11952839	8000	11956207	-4000	4000	-3368
chr11	67487768	67495768	67495164	8000	67491768	-4000	4000	3396
chr11	125429389	125437389	125430003	8000	125433389	-4000	4000	-3386
chr11	57229577	57237577	57236361	8000	57233577	-4000	4000	2784
chr11	11952207	11960207	11956093	8000	11956207	-4000	4000	-114
chr11	5733089	5741089	5736653	8000	5737089	-4000	4000	-436
chr11	46598861	46606861	46603686	8000	46602861	-4000	4000	825
chr11	57229577	57237577	57236693	8000	57233577	-4000	4000	3116
chr11	63542462	63550462	63544682	8000	63546462	-4000	4000	-1780
chr11	65879740	65887740	65883975	8000	65883740	-4000	4000	235
chr11	93814232	93822232	93821144	8000	93818232	-4000	4000	2912
chr11	111722908	111730908	111726970	8000	111726908	-4000	4000	62
chr11	95828693	95836693	95831395	8000	95832693	-4000	4000	-1298
chr11	105021443	105029443	105026352	8000	105025443	-4000	4000	909
chr11	44928423	44936423	44934776	8000	44932423	-4000	4000	2353
chr11	40110203	40118203	40116252	8000	40114203	-4000	4000	2049
chr11	62209943	62217943	62210499	8000	62213943	-4000	4000	-3444
chr11	1833521	1841521	1837296	8000	1837521	-4000	4000	-225
chr11	6608768	6616768	6614891	8000	6612768	-4000	4000	2123
chr11	19172422	19180422	19175944	8000	19176422	-4000	4000	-478
chr11	19220063	19228063	19224820	8000	19224063	-4000	4000	757
chr11	31428401	31436401	31430415	8000	31432401	-4000	4000	-1986
chr11	33073188	33081188	33076319	8000	33077188	-4000	4000	-869
chr11	46379837	46387837	46386513	8000	46383837	-4000	4000	2676
chr11	61955718	61963718	61958341	8000	61959718	-4000	4000	-1377
chr11	65040818	65048818	65047473	8000	65044818	-4000	4000	2655
chr11	65208006	65216006	65210833	8000	65212006	-4000	4000	-1173
chr11	65208006	65216006	65211341	8000	65212006	-4000	4000	-665
chr11	77211241	77219241	77212960	8000	77215241	-4000	4000	-2281
chr11	66642469	66650469	66644420	8000	66646469	-4000	4000	-2049
chr11	6997004	7005004	7000757	8000	7001004	-4000	4000	-247
chr11	33670102	33678102	33672873	8000	33674102	-4000	4000	-1229
chr11	95817766	95825766	95818897	8000	95821766	-4000	4000	-2869
chr11	102374670	102382670	102378374	8000	102378670	-4000	4000	-296
chr11	102831801	102839801	102837397	8000	102835801	-4000	4000	1596
chr11	125429389	125437389	125431425	8000	125433389	-4000	4000	-1964
chr11	60168015	60176015	60173099	8000	60172015	-4000	4000	1084
chr11	62664496	62672496	62667762	8000	62668496	-4000	4000	-734
chr11	114387443	114395443	114391554	8000	114391443	-4000	4000	111
chr11	57480534	57488534	57485117	8000	57484534	-4000	4000	583
chr11	4594672	4602672	4600414	8000	4598672	-4000	4000	1742
chr11	117281232	117289232	117282178	8000	117285232	-4000	4000	-3054
chr11	75582918	75590918	75587791	8000	75586918	-4000	4000	873
chr11	67254082	67262082	67255145	8000	67258082	-4000	4000	-2937
chr11	108153215	108161215	108158836	8000	108157215	-4000	4000	1621
chr11	95067225	95075225	95067947	8000	95071225	-4000	4000	-3278
chr11	14500874	14508874	14505129	8000	14504874	-4000	4000	255
chr11	112189805	112197805	112193595	8000	112193805	-4000	4000	-210
chr11	22618533	22626533	22624739	8000	22622533	-4000	4000	2206
chr11	108365102	108373102	108365592	8000	108369102	-4000	4000	-3510
chr11	100989941	100997941	100992943	8000	100993941	-4000	4000	-998
chr11	62269160	62277160	62270946	8000	62273160	-4000	4000	-2214
chr11	94110208	94118208	94111558	8000	94114208	-4000	4000	-2650
chr11	125037489	125045489	125040784	8000	125041489	-4000	4000	-705
chr11	4651488	4659488	4655072	8000	4655488	-4000	4000	-416
chr11	47712494	47720494	47714318	8000	47716494	-4000	4000	-2176
chr11	66341374	66349374	66345967	8000	66345374	-4000	4000	593
chr11	117423772	117431772	117431680	8000	117427772	-4000	4000	3908
chr11	76549025	76557025	76550329	8000	76553025	-4000	4000	-2696
chr11	18013555	18021555	18021143	8000	18017555	-4000	4000	3588
chr11	124762498	124770498	124767883	8000	124766498	-4000	4000	1385
chr11	65169244	65177244	65172772	8000	65173244	-4000	4000	-472
chr11	67658160	67666160	67663321	8000	67662160	-4000	4000	1161
chr11	102229424	102237424	102232102	8000	102233424	-4000	4000	-1322
chr11	119309926	119317926	119314514	8000	119313926	-4000	4000	588
chr11	25078638	25086638	25082504	8000	25082638	-4000	4000	-134
chr11	59204510	59212510	59211613	8000	59208510	-4000	4000	3103
chr11	93726358	93734358	93729915	8000	93730358	-4000	4000	-443
chr11	74486519	74494519	74492261	8000	74490519	-4000	4000	1742
chr11	7507377	7515377	7509663	8000	7511377	-4000	4000	-1714
chr11	18363045	18371045	18366091	8000	18367045	-4000	4000	-954
chr11	18363045	18371045	18366092	8000	18367045	-4000	4000	-953
chr11	47326031	47334031	47328682	8000	47330031	-4000	4000	-1349
chr11	71998864	72006864	72006226	8000	72002864	-4000	4000	3362
chr11	1106511	1114511	1107182	8000	1110511	-4000	4000	-3329
chr11	33353023	33361023	33353432	8000	33357023	-4000	4000	-3591
chr11	68611334	68619334	68613236	8000	68615334	-4000	4000	-2098
chr11	110573042	110581042	110580804	8000	110577042	-4000	4000	3762
chr11	6602294	6610294	6603565	8000	6606294	-4000	4000	-2729
chr11	63907020	63915020	63909014	8000	63911020	-4000	4000	-2006
chr11	119351215	119359215	119358251	8000	119355215	-4000	4000	3036
chr11	86948910	86956910	86949979	8000	86952910	-4000	4000	-2931
chr11	60846933	60854933	60850393	8000	60850933	-4000	4000	-540
chr11	113405605	113413605	113410486	8000	113409605	-4000	4000	881
chr11	126198096	126206096	126203372	8000	126202096	-4000	4000	1276
chr11	66333333	66341333	66334996	8000	66337333	-4000	4000	-2337
chr11	125672255	125680255	125677978	8000	125676255	-4000	4000	1723
chr11	66326241	66334241	66334219	8000	66330241	-4000	4000	3978
chr11	57229577	57237577	57235774	8000	57233577	-4000	4000	2197
chr11	10797625	10805625	10804977	8000	10801625	-4000	4000	3352
chr11	27361961	27369961	27368755	8000	27365961	-4000	4000	2794
chr11	36589156	36597156	36593087	8000	36593156	-4000	4000	-69
chr11	65371192	65379192	65376362	8000	65375192	-4000	4000	1170
chr11	292107	300107	299462	8000	296107	-4000	4000	3355
chr11	112080800	112088800	112084886	8000	112084800	-4000	4000	86
chr11	32383775	32391775	32389111	8000	32387775	-4000	4000	1336
chr11	86341943	86349943	86345368	8000	86345943	-4000	4000	-575
chr11	63569195	63577195	63575042	8000	63573195	-4000	4000	1847
chr11	118540528	118548528	118546335	8000	118544528	-4000	4000	1807
chr11	18606255	18614255	18612247	8000	18610255	-4000	4000	1992
chr11	64930475	64938475	64931759	8000	64934475	-4000	4000	-2716
chr11	64930475	64938475	64931760	8000	64934475	-4000	4000	-2715
chr11	67421607	67429607	67423799	8000	67425607	-4000	4000	-1808
chr11	11957887	11965887	11964673	8000	11961887	-4000	4000	2786
chr11	64930475	64938475	64932887	8000	64934475	-4000	4000	-1588
chr11	6207345	6215345	6211531	8000	6211345	-4000	4000	186
chr11	26555032	26563032	26559679	8000	26559032	-4000	4000	647
chr11	125896646	125904646	125899995	8000	125900646	-4000	4000	-651
chr11	8710759	8718759	8715696	8000	8714759	-4000	4000	937
chr11	9134825	9142825	9139635	8000	9138825	-4000	4000	810
chr11	65793214	65801214	65794720	8000	65797214	-4000	4000	-2494
chr11	76653524	76661524	76661151	8000	76657524	-4000	4000	3627
chr11	124879691	124887691	124881309	8000	124883691	-4000	4000	-2382
chr11	119011793	119019793	119019290	8000	119015793	-4000	4000	3497
chr11	130472645	130480645	130473820	8000	130476645	-4000	4000	-2825
chr11	4089210	4097210	4091679	8000	4093210	-4000	4000	-1531
chr11	124879691	124887691	124885238	8000	124883691	-4000	4000	1547
chr11	8943202	8951202	8948354	8000	8947202	-4000	4000	1152
chr11	211113	219113	212685	8000	215113	-4000	4000	-2428
chr11	2996922	3004922	3001998	8000	3000922	-4000	4000	1076
chr11	5221464	5229464	5227034	8000	5225464	-4000	4000	1570
chr11	18606255	18614255	18611552	8000	18610255	-4000	4000	1297
chr11	19172422	19180422	19175970	8000	19176422	-4000	4000	-452
chr11	59204510	59212510	59212227	8000	59208510	-4000	4000	3717
chr11	61349295	61357295	61353005	8000	61353295	-4000	4000	-290
chr11	67298485	67306485	67304845	8000	67302485	-4000	4000	2360
chr11	76653524	76661524	76661509	8000	76657524	-4000	4000	3985
chr11	106047098	106055098	106053024	8000	106051098	-4000	4000	1926
chr11	108365102	108373102	108365208	8000	108369102	-4000	4000	-3894
chr11	117200337	117208337	117204349	8000	117204337	-4000	4000	12
chr11	130472645	130480645	130473047	8000	130476645	-4000	4000	-3598
chr11	119309926	119317926	119312933	8000	119313926	-4000	4000	-993
chr11	124879691	124887691	124886770	8000	124883691	-4000	4000	3079
chr11	75582918	75590918	75587364	8000	75586918	-4000	4000	446
chr11	76345898	76353898	76351754	8000	76349898	-4000	4000	1856
chr11	16754340	16762340	16754887	8000	16758340	-4000	4000	-3453
chr11	6207345	6215345	6214862	8000	6211345	-4000	4000	3517
chr11	112018653	112026653	112019171	8000	112022653	-4000	4000	-3482
chr11	112018653	112026653	112019172	8000	112022653	-4000	4000	-3481
chr11	70185530	70193530	70189346	8000	70189530	-4000	4000	-184
chr11	113729187	113737187	113733517	8000	113733187	-4000	4000	330
chr11	120107286	120115286	120112260	8000	120111286	-4000	4000	974
chr11	64760606	64768606	64767075	8000	64764606	-4000	4000	2469
chr11	64722911	64730911	64728986	8000	64726911	-4000	4000	2075
chr11	13728346	13736346	13728863	8000	13732346	-4000	4000	-3483
chr11	5640398	5648398	5642427	8000	5644398	-4000	4000	-1971
chr11	32383775	32391775	32388984	8000	32387775	-4000	4000	1209
chr11	117816163	117824163	117820615	8000	117820163	-4000	4000	452
chr11	7653127	7661127	7653240	8000	7657127	-4000	4000	-3887
chr11	57547656	57555656	57554614	8000	57551656	-4000	4000	2958
chr11	1106511	1114511	1108024	8000	1110511	-4000	4000	-2487
chr11	9134825	9142825	9139547	8000	9138825	-4000	4000	722
chr11	113274436	113282436	113275521	8000	113278436	-4000	4000	-2915
chr11	46379837	46387837	46385355	8000	46383837	-4000	4000	1518
chr11	108153215	108161215	108160890	8000	108157215	-4000	4000	3675
chr11	119011793	119019793	119015074	8000	119015793	-4000	4000	-719
chr11	4380897	4388897	4388440	8000	4384897	-4000	4000	3543
chr11	102374670	102382670	102378281	8000	102378670	-4000	4000	-389
chr11	6314946	6322946	6319727	8000	6318946	-4000	4000	781
chr11	73996277	74004277	74000512	8000	74000277	-4000	4000	235
chr11	77211241	77219241	77217230	8000	77215241	-4000	4000	1989
chr11	117281232	117289232	117282206	8000	117285232	-4000	4000	-3026
chr11	118395211	118403211	118396391	8000	118399211	-4000	4000	-2820
chr11	59151039	59159039	59152365	8000	59155039	-4000	4000	-2674
chr11	59204510	59212510	59204691	8000	59208510	-4000	4000	-3819
chr11	64799510	64807510	64800368	8000	64803510	-4000	4000	-3142
chr11	66431075	66439075	66436880	8000	66435075	-4000	4000	1805
chr11	125672255	125680255	125677926	8000	125676255	-4000	4000	1671
chr11	3822978	3830978	3824910	8000	3826978	-4000	4000	-2068
chr11	22618533	22626533	22625252	8000	22622533	-4000	4000	2719
chr11	8976576	8984576	8983007	8000	8980576	-4000	4000	2431
chr11	128809267	128817267	128810937	8000	128813267	-4000	4000	-2330
chr11	1465457	1473457	1471311	8000	1469457	-4000	4000	1854
chr11	66586176	66594176	66593037	8000	66590176	-4000	4000	2861
chr11	119089874	119097874	119097742	8000	119093874	-4000	4000	3868
chr11	6390998	6398998	6396131	8000	6394998	-4000	4000	1133
chr11	124743210	124751210	124747147	8000	124747210	-4000	4000	-63
chr11	14868044	14876044	14869697	8000	14872044	-4000	4000	-2347
chr11	57547656	57555656	57550119	8000	57551656	-4000	4000	-1537
chr11	57547656	57555656	57550120	8000	57551656	-4000	4000	-1536
chr11	57229577	57237577	57235831	8000	57233577	-4000	4000	2254
chr11	124748583	124756583	124753884	8000	124752583	-4000	4000	1301
chr11	61955718	61963718	61958185	8000	61959718	-4000	4000	-1533
chr11	32602264	32610264	32602726	8000	32606264	-4000	4000	-3538
chr11	32602264	32610264	32602778	8000	32606264	-4000	4000	-3486
chr11	14873440	14881440	14878081	8000	14877440	-4000	4000	641
chr11	14873440	14881440	14878082	8000	14877440	-4000	4000	642
chr11	62788123	62796123	62794299	8000	62792123	-4000	4000	2176
chr11	66586176	66594176	66592727	8000	66590176	-4000	4000	2551
chr11	66602019	66610019	66605534	8000	66606019	-4000	4000	-485
chr11	73996277	74004277	74000537	8000	74000277	-4000	4000	260
chr11	95764953	95772953	95770813	8000	95768953	-4000	4000	1860
chr11	128454761	128462761	128460358	8000	128458761	-4000	4000	1597
chr11	13008119	13016119	13010006	8000	13012119	-4000	4000	-2113
chr11	27650893	27658893	27657611	8000	27654893	-4000	4000	2718
chr11	34143670	34151670	34146137	8000	34147670	-4000	4000	-1533
chr11	34474791	34482791	34478964	8000	34478791	-4000	4000	173
chr11	67421607	67429607	67424245	8000	67425607	-4000	4000	-1362
chr11	47350860	47358860	47355528	8000	47354860	-4000	4000	668
chr11	128809267	128817267	128810725	8000	128813267	-4000	4000	-2542
chr11	90196429	90204429	90202290	8000	90200429	-4000	4000	1861
chr11	76345898	76353898	76351903	8000	76349898	-4000	4000	2005
chr11	1833521	1841521	1841186	8000	1837521	-4000	4000	3665
chr11	76653524	76661524	76660523	8000	76657524	-4000	4000	2999
chr11	46317409	46325409	46320381	8000	46321409	-4000	4000	-1028
chr11	62389412	62397412	62392093	8000	62393412	-4000	4000	-1319
chr11	13384008	13392008	13385722	8000	13388008	-4000	4000	-2286
chr11	119351215	119359215	119357207	8000	119355215	-4000	4000	1992
chr11	2845105	2853105	2847967	8000	2849105	-4000	4000	-1138
chr11	77211241	77219241	77217269	8000	77215241	-4000	4000	2028
chr11	100989941	100997941	100992747	8000	100993941	-4000	4000	-1194
chr11	13728346	13736346	13729002	8000	13732346	-4000	4000	-3344
chr11	211113	219113	212446	8000	215113	-4000	4000	-2667
chr11	47580562	47588562	47582353	8000	47584562	-4000	4000	-2209
chr11	61955718	61963718	61958172	8000	61959718	-4000	4000	-1546
chr11	57295638	57303638	57301894	8000	57299638	-4000	4000	2256
chr11	6617330	6625330	6624119	8000	6621330	-4000	4000	2789
chr11	69000395	69008395	69005420	8000	69004395	-4000	4000	1025
chr11	12940737	12948737	12944460	8000	12944737	-4000	4000	-277
chr11	45925096	45933096	45926787	8000	45929096	-4000	4000	-2309
chr11	65793214	65801214	65796039	8000	65797214	-4000	4000	-1175
chr11	64930475	64938475	64935355	8000	64934475	-4000	4000	880
chr11	66559464	66567464	66564108	8000	66563464	-4000	4000	644
chr11	78167249	78175249	78174170	8000	78171249	-4000	4000	2921
chr11	126198096	126206096	126203517	8000	126202096	-4000	4000	1421
chr11	1270371	1278371	1276853	8000	1274371	-4000	4000	2482
chr11	21571686	21579686	21573374	8000	21575686	-4000	4000	-2312
chr11	32989316	32997316	32993261	8000	32993316	-4000	4000	-55
chr11	45925096	45933096	45928183	8000	45929096	-4000	4000	-913
chr11	61507018	61515018	61510640	8000	61511018	-4000	4000	-378
chr11	64890546	64898546	64895158	8000	64894546	-4000	4000	612
chr11	66586176	66594176	66590658	8000	66590176	-4000	4000	482
chr11	95067225	95075225	95068881	8000	95071225	-4000	4000	-2344
chr11	125896646	125904646	125900300	8000	125900646	-4000	4000	-346
chr11	4594672	4602672	4601733	8000	4598672	-4000	4000	3061
chr11	4651488	4659488	4652706	8000	4655488	-4000	4000	-2782
chr11	35427823	35435823	35432782	8000	35431823	-4000	4000	959
chr11	44928423	44936423	44929296	8000	44932423	-4000	4000	-3127
chr11	78431968	78439968	78436756	8000	78435968	-4000	4000	788
chr11	102858736	102866736	102866397	8000	102862736	-4000	4000	3661
chr11	102858736	102866736	102866399	8000	102862736	-4000	4000	3663
chr11	9134825	9142825	9139642	8000	9138825	-4000	4000	817
chr11	66333333	66341333	66338672	8000	66337333	-4000	4000	1339
chr11	13384008	13392008	13388857	8000	13388008	-4000	4000	849
chr11	44080237	44088237	44083243	8000	44084237	-4000	4000	-994
chr11	77211241	77219241	77214738	8000	77215241	-4000	4000	-503
chr11	67658160	67666160	67664405	8000	67662160	-4000	4000	2245
chr11	66310494	66318494	66315158	8000	66314494	-4000	4000	664
chr11	118312175	118320175	118314487	8000	118316175	-4000	4000	-1688
chr11	315676	323676	319874	8000	319676	-4000	4000	198
chr11	119077972	119085972	119079136	8000	119081972	-4000	4000	-2836
chr11	7661100	7669100	7668546	8000	7665100	-4000	4000	3446
chr11	45643689	45651689	45650642	8000	45647689	-4000	4000	2953
chr11	95128645	95136645	95128997	8000	95132645	-4000	4000	-3648
chr11	40110203	40118203	40115128	8000	40114203	-4000	4000	925
chr11	46852717	46860717	46859049	8000	46856717	-4000	4000	2332
chr11	47173522	47181522	47179527	8000	47177522	-4000	4000	2005
chr11	59151039	59159039	59153410	8000	59155039	-4000	4000	-1629
chr11	61869519	61877519	61875956	8000	61873519	-4000	4000	2437
chr11	64760606	64768606	64767243	8000	64764606	-4000	4000	2637
chr11	112060404	112068404	112067966	8000	112064404	-4000	4000	3562
chr11	57383365	57391365	57389249	8000	57387365	-4000	4000	1884
chr11	62269160	62277160	62273053	8000	62273160	-4000	4000	-107
chr11	64930475	64938475	64935162	8000	64934475	-4000	4000	687
chr11	125429389	125437389	125431343	8000	125433389	-4000	4000	-2046
chr11	128895565	128903565	128902602	8000	128899565	-4000	4000	3037
chr11	86437108	86445108	86441265	8000	86441108	-4000	4000	157
chr11	47568197	47576197	47572417	8000	47572197	-4000	4000	220
chr11	83451012	83459012	83455266	8000	83455012	-4000	4000	254
chr11	95067225	95075225	95068752	8000	95071225	-4000	4000	-2473
chr11	119333309	119341309	119339585	8000	119337309	-4000	4000	2276
chr11	64722911	64730911	64730115	8000	64726911	-4000	4000	3204
chr11	47173522	47181522	47179556	8000	47177522	-4000	4000	2034
chr11	47173522	47181522	47179557	8000	47177522	-4000	4000	2035
chr11	65633439	65641439	65636227	8000	65637439	-4000	4000	-1212
chr11	107322360	107330360	107326798	8000	107326360	-4000	4000	438
chr11	1106511	1114511	1107151	8000	1110511	-4000	4000	-3360
chr11	47580562	47588562	47582420	8000	47584562	-4000	4000	-2142
chr11	4089210	4097210	4091365	8000	4093210	-4000	4000	-1845
chr11	6608768	6616768	6615466	8000	6612768	-4000	4000	2698
chr11	248984	256984	251842	8000	252984	-4000	4000	-1142
chr11	119186250	119194250	119189577	8000	119190250	-4000	4000	-673
chr11	75582918	75590918	75587737	8000	75586918	-4000	4000	819
chr11	94177968	94185968	94181032	8000	94181968	-4000	4000	-936
chr11	45902465	45910465	45903052	8000	45906465	-4000	4000	-3413
chr11	85652547	85660547	85654249	8000	85656547	-4000	4000	-2298
chr11	76345898	76353898	76351522	8000	76349898	-4000	4000	1624
chr11	6314946	6322946	6320277	8000	6318946	-4000	4000	1331
chr11	123719914	123727914	123725777	8000	123723914	-4000	4000	1863
chr11	63755891	63763891	63759613	8000	63759891	-4000	4000	-278
chr11	102229424	102237424	102229839	8000	102233424	-4000	4000	-3585
chr11	102831801	102839801	102836560	8000	102835801	-4000	4000	759
chr11	61481822	61489822	61485401	8000	61485822	-4000	4000	-421
chr11	1550051	1558051	1554976	8000	1554051	-4000	4000	925
chr11	123053489	123061489	123059897	8000	123057489	-4000	4000	2408
chr11	125896646	125904646	125900032	8000	125900646	-4000	4000	-614
chr11	60168015	60176015	60172247	8000	60172015	-4000	4000	232
chr11	119089874	119097874	119096799	8000	119093874	-4000	4000	2925
chr11	4651488	4659488	4653436	8000	4655488	-4000	4000	-2052
chr11	72192323	72200323	72196071	8000	72196323	-4000	4000	-252
chr11	102392332	102400332	102398649	8000	102396332	-4000	4000	2317
chr11	292107	300107	299396	8000	296107	-4000	4000	3289
chr11	47173522	47181522	47176831	8000	47177522	-4000	4000	-691
chr11	119180016	119188016	119185831	8000	119184016	-4000	4000	1815
chr11	66326241	66334241	66332606	8000	66330241	-4000	4000	2365
chr11	66341374	66349374	66346736	8000	66345374	-4000	4000	1362
chr11	60772733	60780733	60773433	8000	60776733	-4000	4000	-3300
chr11	66559464	66567464	66562124	8000	66563464	-4000	4000	-1340
chr11	18363045	18371045	18366038	8000	18367045	-4000	4000	-1007
chr11	18404425	18412425	18407213	8000	18408425	-4000	4000	-1212
chr11	33029582	33037582	33032667	8000	33033582	-4000	4000	-915
chr11	76653524	76661524	76660622	8000	76657524	-4000	4000	3098
chr11	102080554	102088554	102083256	8000	102084554	-4000	4000	-1298
chr11	85652547	85660547	85654127	8000	85656547	-4000	4000	-2420
chr11	102229424	102237424	102229856	8000	102233424	-4000	4000	-3568
chr11	6617330	6625330	6621571	8000	6621330	-4000	4000	241
chr11	18404425	18412425	18407635	8000	18408425	-4000	4000	-790
chr11	25078638	25086638	25082193	8000	25082638	-4000	4000	-445
chr11	57295638	57303638	57300002	8000	57299638	-4000	4000	364
chr11	57295638	57303638	57300003	8000	57299638	-4000	4000	365
chr11	73861133	73869133	73864467	8000	73865133	-4000	4000	-666
chr11	125896646	125904646	125900154	8000	125900646	-4000	4000	-492
chr11	33101943	33109943	33107913	8000	33105943	-4000	4000	1970
chr11	108365102	108373102	108365476	8000	108369102	-4000	4000	-3626
chr11	93726358	93734358	93727206	8000	93730358	-4000	4000	-3152
chr11	4089210	4097210	4095019	8000	4093210	-4000	4000	1809
chr11	31780779	31788779	31783453	8000	31784779	-4000	4000	-1326
chr11	108365102	108373102	108367706	8000	108369102	-4000	4000	-1396
chr11	119077972	119085972	119085142	8000	119081972	-4000	4000	3170
chr11	93814232	93822232	93820586	8000	93818232	-4000	4000	2354
chr11	128809267	128817267	128811109	8000	128813267	-4000	4000	-2158
chr11	60466752	60474752	60468637	8000	60470752	-4000	4000	-2115
chr11	60466752	60474752	60468639	8000	60470752	-4000	4000	-2113
chr11	47580562	47588562	47584557	8000	47584562	-4000	4000	-5
chr11	58830065	58838065	58834587	8000	58834065	-4000	4000	522
chr11	76794153	76802153	76796302	8000	76798153	-4000	4000	-1851
chr11	36589156	36597156	36593885	8000	36593156	-4000	4000	729
chr11	1730821	1738821	1735431	8000	1734821	-4000	4000	610
chr11	86948910	86956910	86951100	8000	86952910	-4000	4000	-1810
chr11	22618533	22626533	22624638	8000	22622533	-4000	4000	2105
chr11	46379837	46387837	46386131	8000	46383837	-4000	4000	2294
chr11	211113	219113	212869	8000	215113	-4000	4000	-2244
chr11	62802860	62810860	62807493	8000	62806860	-4000	4000	633
chr11	111722908	111730908	111726959	8000	111726908	-4000	4000	51
chr11	6997004	7005004	7001094	8000	7001004	-4000	4000	90
chr11	6997004	7005004	7001484	8000	7001004	-4000	4000	480
chr11	111722908	111730908	111723956	8000	111726908	-4000	4000	-2952
chr11	10503894	10511894	10505993	8000	10507894	-4000	4000	-1901
chr11	72192323	72200323	72195647	8000	72196323	-4000	4000	-676
chr11	61016377	61024377	61017989	8000	61020377	-4000	4000	-2388
chr11	119180016	119188016	119187675	8000	119184016	-4000	4000	3659
chr11	95972598	95980598	95979038	8000	95976598	-4000	4000	2440
chr11	60919443	60927443	60923169	8000	60923443	-4000	4000	-274
chr11	60919443	60927443	60923338	8000	60923443	-4000	4000	-105
chr11	75582918	75590918	75587071	8000	75586918	-4000	4000	153
chr11	112059218	112067218	112064054	8000	112063218	-4000	4000	836
chr11	4651488	4659488	4654503	8000	4655488	-4000	4000	-985
chr11	61764501	61772501	61770409	8000	61768501	-4000	4000	1908
chr11	4651488	4659488	4652927	8000	4655488	-4000	4000	-2561
chr11	61955718	61963718	61960030	8000	61959718	-4000	4000	312
chr11	1550051	1558051	1555161	8000	1554051	-4000	4000	1110
chr11	5221464	5229464	5225561	8000	5225464	-4000	4000	97
chr11	6470683	6478683	6476330	8000	6474683	-4000	4000	1647
chr11	90196429	90204429	90202545	8000	90200429	-4000	4000	2116
chr11	120329686	120337686	120330247	8000	120333686	-4000	4000	-3439
chr11	124877471	124885471	124878676	8000	124881471	-4000	4000	-2795
chr11	62762710	62770710	62762943	8000	62766710	-4000	4000	-3767
chr11	62762710	62770710	62762944	8000	62766710	-4000	4000	-3766
chr11	78167249	78175249	78174257	8000	78171249	-4000	4000	3008
chr11	123065872	123073872	123073359	8000	123069872	-4000	4000	3487
chr11	4594672	4602672	4600188	8000	4598672	-4000	4000	1516
chr11	95828693	95836693	95835129	8000	95832693	-4000	4000	2436
chr11	94995519	95003519	94999075	8000	94999519	-4000	4000	-444
chr11	4380897	4388897	4385406	8000	4384897	-4000	4000	509
chr11	10303397	10311397	10306344	8000	10307397	-4000	4000	-1053
chr11	27361961	27369961	27368906	8000	27365961	-4000	4000	2945
chr11	59151039	59159039	59152856	8000	59155039	-4000	4000	-2183
chr11	113405605	113413605	113412592	8000	113409605	-4000	4000	2987
chr11	108365102	108373102	108365208	8000	108369102	-4000	4000	-3894
chr11	6207345	6215345	6211698	8000	6211345	-4000	4000	353
chr11	105978092	105986092	105980433	8000	105982092	-4000	4000	-1659
chr11	118522832	118530832	118524997	8000	118526832	-4000	4000	-1835
chr11	7661100	7669100	7666547	8000	7665100	-4000	4000	1447
chr11	64742389	64750389	64746662	8000	64746389	-4000	4000	273
chr11	66586176	66594176	66590542	8000	66590176	-4000	4000	366
chr11	47712494	47720494	47714284	8000	47716494	-4000	4000	-2210
chr11	119186250	119194250	119188676	8000	119190250	-4000	4000	-1574
chr11	4380897	4388897	4388330	8000	4384897	-4000	4000	3433
chr11	8916084	8924084	8921461	8000	8920084	-4000	4000	1377
chr11	18227423	18235423	18231662	8000	18231423	-4000	4000	239
chr11	33101943	33109943	33106004	8000	33105943	-4000	4000	61
chr11	34468060	34476060	34471446	8000	34472060	-4000	4000	-614
chr11	57295638	57303638	57301944	8000	57299638	-4000	4000	2306
chr11	58620639	58628639	58624574	8000	58624639	-4000	4000	-65
chr11	62802860	62810860	62803835	8000	62806860	-4000	4000	-3025
chr11	75582918	75590918	75586987	8000	75586918	-4000	4000	69
chr11	76549025	76557025	76550329	8000	76553025	-4000	4000	-2696
chr11	94495578	94503578	94496679	8000	94499578	-4000	4000	-2899
chr11	117423772	117431772	117428349	8000	117427772	-4000	4000	577
chr11	119092025	119100025	119098458	8000	119096025	-4000	4000	2433
chr11	119132059	119140059	119132969	8000	119136059	-4000	4000	-3090
chr11	64983945	64991945	64989335	8000	64987945	-4000	4000	1390
chr11	119309926	119317926	119310877	8000	119313926	-4000	4000	-3049
chr11	119351215	119359215	119358794	8000	119355215	-4000	4000	3579
chr11	11957887	11965887	11964436	8000	11961887	-4000	4000	2549
chr11	13008119	13016119	13010199	8000	13012119	-4000	4000	-1920
chr11	57697182	57705182	57703923	8000	57701182	-4000	4000	2741
chr11	61481822	61489822	61482719	8000	61485822	-4000	4000	-3103
chr11	63542462	63550462	63544829	8000	63546462	-4000	4000	-1633
chr11	67254082	67262082	67255455	8000	67258082	-4000	4000	-2627
chr11	67394181	67402181	67401116	8000	67398181	-4000	4000	2935
chr11	70185530	70193530	70188114	8000	70189530	-4000	4000	-1416
chr11	70463854	70471854	70470629	8000	70467854	-4000	4000	2775
chr11	71520107	71528107	71527279	8000	71524107	-4000	4000	3172
chr11	77874720	77882720	77878824	8000	77878720	-4000	4000	104
chr11	85652547	85660547	85660409	8000	85656547	-4000	4000	3862
chr11	94495578	94503578	94496920	8000	94499578	-4000	4000	-2658
chr11	104938866	104946866	104944768	8000	104942866	-4000	4000	1902
chr11	315676	323676	320790	8000	319676	-4000	4000	1114
chr11	64760606	64768606	64767248	8000	64764606	-4000	4000	2642
chr11	62269160	62277160	62270199	8000	62273160	-4000	4000	-2961
chr11	77211241	77219241	77217252	8000	77215241	-4000	4000	2011
chr11	105037326	105045326	105044642	8000	105041326	-4000	4000	3316
chr11	57383365	57391365	57389259	8000	57387365	-4000	4000	1894
chr11	112080800	112088800	112082475	8000	112084800	-4000	4000	-2325
chr11	124877471	124885471	124878363	8000	124881471	-4000	4000	-3108
chr11	67582656	67590656	67586187	8000	67586656	-4000	4000	-469
chr11	125580684	125588684	125584454	8000	125584684	-4000	4000	-230
chr11	10569091	10577091	10576488	8000	10573091	-4000	4000	3397
chr11	20505338	20513338	20508326	8000	20509338	-4000	4000	-1012
chr11	45925096	45933096	45928271	8000	45929096	-4000	4000	-825
chr11	66586176	66594176	66590609	8000	66590176	-4000	4000	433
chr11	66586176	66594176	66592777	8000	66590176	-4000	4000	2601
chr11	248984	256984	250838	8000	252984	-4000	4000	-2146
chr11	18013555	18021555	18020935	8000	18017555	-4000	4000	3380
chr11	44080237	44088237	44081184	8000	44084237	-4000	4000	-3053
chr11	46317409	46325409	46320757	8000	46321409	-4000	4000	-652
chr11	69000395	69008395	69006247	8000	69004395	-4000	4000	1852
chr11	93726358	93734358	93727300	8000	93730358	-4000	4000	-3058
chr11	94495578	94503578	94496757	8000	94499578	-4000	4000	-2821
chr11	94995519	95003519	94997451	8000	94999519	-4000	4000	-2068
chr11	130206362	130214362	130208589	8000	130210362	-4000	4000	-1773
chr11	1106511	1114511	1107658	8000	1110511	-4000	4000	-2853
chr11	34474791	34482791	34480183	8000	34478791	-4000	4000	1392
chr11	66431075	66439075	66436082	8000	66435075	-4000	4000	1007
chr11	4594672	4602672	4594739	8000	4598672	-4000	4000	-3933
chr11	8916084	8924084	8919548	8000	8920084	-4000	4000	-536
chr11	10303397	10311397	10306012	8000	10307397	-4000	4000	-1385
chr11	21571686	21579686	21574971	8000	21575686	-4000	4000	-715
chr11	62788123	62796123	62794272	8000	62792123	-4000	4000	2149
chr11	66326241	66334241	66333626	8000	66330241	-4000	4000	3385
chr11	67298485	67306485	67304950	8000	67302485	-4000	4000	2465
chr11	67627303	67635303	67634325	8000	67631303	-4000	4000	3022
chr11	76345898	76353898	76352780	8000	76349898	-4000	4000	2882
chr11	76653524	76661524	76660983	8000	76657524	-4000	4000	3459
chr11	83451012	83459012	83458213	8000	83455012	-4000	4000	3201
chr11	86948910	86956910	86950293	8000	86952910	-4000	4000	-2617
chr11	113274436	113282436	113276871	8000	113278436	-4000	4000	-1565
chr11	113793874	113801874	113801588	8000	113797874	-4000	4000	3714
chr11	120226334	120234334	120229275	8000	120230334	-4000	4000	-1059
chr11	124879691	124887691	124886468	8000	124883691	-4000	4000	2777
chr11	1837680	1845680	1841559	8000	1841680	-4000	4000	-121
chr11	43916274	43924274	43919086	8000	43920274	-4000	4000	-1188
chr11	67582656	67590656	67584743	8000	67586656	-4000	4000	-1913
chr11	105037326	105045326	105044409	8000	105041326	-4000	4000	3083
chr11	25078638	25086638	25078671	8000	25082638	-4000	4000	-3967
chr11	47774087	47782087	47779162	8000	47778087	-4000	4000	1075
chr11	57480534	57488534	57485117	8000	57484534	-4000	4000	583
chr11	59151039	59159039	59152430	8000	59155039	-4000	4000	-2609
chr11	60094467	60102467	60095618	8000	60098467	-4000	4000	-2849
chr11	65040818	65048818	65046505	8000	65044818	-4000	4000	1687
chr11	83183451	83191451	83184765	8000	83187451	-4000	4000	-2686
chr11	86948910	86956910	86954866	8000	86952910	-4000	4000	1956
chr11	95764953	95772953	95771524	8000	95768953	-4000	4000	2571
chr11	112080800	112088800	112085330	8000	112084800	-4000	4000	530
chr11	118395211	118403211	118401632	8000	118399211	-4000	4000	2421
chr11	124877471	124885471	124878351	8000	124881471	-4000	4000	-3120
chr11	26993087	27001087	26994970	8000	26997087	-4000	4000	-2117
chr11	119040188	119048188	119045608	8000	119044188	-4000	4000	1420
chr11	118540528	118548528	118544883	8000	118544528	-4000	4000	355
chr11	126198096	126206096	126205570	8000	126202096	-4000	4000	3474
chr11	128809267	128817267	128810940	8000	128813267	-4000	4000	-2327
chr11	59204510	59212510	59211469	8000	59208510	-4000	4000	2959
chr11	112080800	112088800	112082289	8000	112084800	-4000	4000	-2511
chr11	118540528	118548528	118545844	8000	118544528	-4000	4000	1316
chr11	6617330	6625330	6623523	8000	6621330	-4000	4000	2193
chr11	5221464	5229464	5226982	8000	5225464	-4000	4000	1518
chr11	66505657	66513657	66509118	8000	66509657	-4000	4000	-539
chr11	108103761	108111761	108104492	8000	108107761	-4000	4000	-3269
chr11	6997004	7005004	7000277	8000	7001004	-4000	4000	-727
chr11	76653524	76661524	76660840	8000	76657524	-4000	4000	3316
chr11	78167249	78175249	78173924	8000	78171249	-4000	4000	2675
chr11	57229577	57237577	57235962	8000	57233577	-4000	4000	2385
chr11	69000395	69008395	69006092	8000	69004395	-4000	4000	1697
chr11	71993597	72001597	71995492	8000	71997597	-4000	4000	-2105
chr11	64890546	64898546	64892749	8000	64894546	-4000	4000	-1797
chr11	114387443	114395443	114391560	8000	114391443	-4000	4000	117
chr11	57229577	57237577	57236055	8000	57233577	-4000	4000	2478
chr11	134146113	134154113	134148650	8000	134150113	-4000	4000	-1463
chr11	6617330	6625330	6619417	8000	6621330	-4000	4000	-1913
chr11	10793050	10801050	10797223	8000	10797050	-4000	4000	173
chr11	65649599	65657599	65649763	8000	65653599	-4000	4000	-3836
chr11	61481822	61489822	61484692	8000	61485822	-4000	4000	-1130
chr11	124693518	124701518	124694370	8000	124697518	-4000	4000	-3148
chr11	112189805	112197805	112193750	8000	112193805	-4000	4000	-55
chr11	128454761	128462761	128458804	8000	128458761	-4000	4000	43
chr11	64235264	64243264	64237197	8000	64239264	-4000	4000	-2067
chr11	90196429	90204429	90202370	8000	90200429	-4000	4000	1941
chr11	111722908	111730908	111726866	8000	111726908	-4000	4000	-42
chr11	60711807	60719807	60715398	8000	60715807	-4000	4000	-409
chr11	94177968	94185968	94179924	8000	94181968	-4000	4000	-2044
chr11	77211241	77219241	77213860	8000	77215241	-4000	4000	-1381
chr11	61344754	61352754	61345527	8000	61348754	-4000	4000	-3227
chr11	49141092	49149092	49146851	8000	49145092	-4000	4000	1759
chr11	126198096	126206096	126205546	8000	126202096	-4000	4000	3450
chr11	65862441	65870441	65864730	8000	65866441	-4000	4000	-1711
chr11	35427823	35435823	35432493	8000	35431823	-4000	4000	670
chr11	108103761	108111761	108104297	8000	108107761	-4000	4000	-3464
chr11	18602403	18610403	18609789	8000	18606403	-4000	4000	3386
chr11	66310494	66318494	66315301	8000	66314494	-4000	4000	807
chr11	6207345	6215345	6214443	8000	6211345	-4000	4000	3098
chr11	59151039	59159039	59153149	8000	59155039	-4000	4000	-1890
chr11	61481822	61489822	61482398	8000	61485822	-4000	4000	-3424
chr11	61481822	61489822	61485910	8000	61485822	-4000	4000	88
chr11	57229577	57237577	57236383	8000	57233577	-4000	4000	2806
chr11	5733089	5741089	5737088	8000	5737089	-4000	4000	-1
chr11	64722911	64730911	64728893	8000	64726911	-4000	4000	1982
chr11	66310494	66318494	66316258	8000	66314494	-4000	4000	1764
chr11	6314946	6322946	6319229	8000	6318946	-4000	4000	283
chr11	65793214	65801214	65793944	8000	65797214	-4000	4000	-3270
chr11	118395211	118403211	118401658	8000	118399211	-4000	4000	2447
chr11	125429389	125437389	125431199	8000	125433389	-4000	4000	-2190
chr11	47173522	47181522	47176606	8000	47177522	-4000	4000	-916
chr11	66586176	66594176	66591393	8000	66590176	-4000	4000	1217
chr11	94177968	94185968	94180854	8000	94181968	-4000	4000	-1114
chr11	119309926	119317926	119311539	8000	119313926	-4000	4000	-2387
chr11	132332822	132340822	132335170	8000	132336822	-4000	4000	-1652
chr11	36589156	36597156	36593736	8000	36593156	-4000	4000	580
chr11	62744319	62752319	62752017	8000	62748319	-4000	4000	3698
chr11	66341374	66349374	66346601	8000	66345374	-4000	4000	1227
chr11	9015476	9023476	9021942	8000	9019476	-4000	4000	2466
chr11	76653524	76661524	76659586	8000	76657524	-4000	4000	2062
chr11	129856003	129864003	129858803	8000	129860003	-4000	4000	-1200
chr11	49141092	49149092	49148638	8000	49145092	-4000	4000	3546
chr11	125090389	125098389	125097708	8000	125094389	-4000	4000	3319
chr11	33029582	33037582	33032459	8000	33033582	-4000	4000	-1123
chr11	62904679	62912679	62910930	8000	62908679	-4000	4000	2251
chr11	73861133	73869133	73863215	8000	73865133	-4000	4000	-1918
chr11	1106511	1114511	1110141	8000	1110511	-4000	4000	-370
chr11	18363045	18371045	18365806	8000	18367045	-4000	4000	-1239
chr11	35427823	35435823	35432499	8000	35431823	-4000	4000	676
chr11	6997004	7005004	6999878	8000	7001004	-4000	4000	-1126
chr11	64930475	64938475	64931592	8000	64934475	-4000	4000	-2883
chr11	114439932	114447932	114447832	8000	114443932	-4000	4000	3900
chr11	94995519	95003519	94997742	8000	94999519	-4000	4000	-1777
chr11	66505657	66513657	66509145	8000	66509657	-4000	4000	-512
chr11	43916274	43924274	43919925	8000	43920274	-4000	4000	-349
chr11	6207345	6215345	6211768	8000	6211345	-4000	4000	423
chr11	130472645	130480645	130473440	8000	130476645	-4000	4000	-3205
chr11	134244279	134252279	134249144	8000	134248279	-4000	4000	865
chr11	119077972	119085972	119078264	8000	119081972	-4000	4000	-3708
chr11	43852617	43860617	43855728	8000	43856617	-4000	4000	-889
chr11	72839674	72847674	72842882	8000	72843674	-4000	4000	-792
chr11	76345898	76353898	76351537	8000	76349898	-4000	4000	1639
chr11	76549025	76557025	76550323	8000	76553025	-4000	4000	-2702
chr11	129859636	129867636	129864635	8000	129863636	-4000	4000	999
chr11	8689351	8697351	8694087	8000	8693351	-4000	4000	736
chr11	134244279	134252279	134248364	8000	134248279	-4000	4000	85
chr11	113274436	113282436	113277149	8000	113278436	-4000	4000	-1287
chr11	18700785	18708785	18706055	8000	18704785	-4000	4000	1270
chr11	26555032	26563032	26561188	8000	26559032	-4000	4000	2156
chr11	6602294	6610294	6604177	8000	6606294	-4000	4000	-2117
chr11	111348255	111356255	111354248	8000	111352255	-4000	4000	1993
chr11	292107	300107	294744	8000	296107	-4000	4000	-1363
chr11	6997004	7005004	6999764	8000	7001004	-4000	4000	-1240
chr11	7507377	7515377	7509830	8000	7511377	-4000	4000	-1547
chr11	7653127	7661127	7653161	8000	7657127	-4000	4000	-3966
chr11	8976576	8984576	8984116	8000	8980576	-4000	4000	3540
chr11	13008119	13016119	13010646	8000	13012119	-4000	4000	-1473
chr11	17388498	17396498	17395276	8000	17392498	-4000	4000	2778
chr11	18404425	18412425	18407427	8000	18408425	-4000	4000	-998
chr11	20379782	20387782	20383057	8000	20383782	-4000	4000	-725
chr11	21571686	21579686	21573348	8000	21575686	-4000	4000	-2338
chr11	27361961	27369961	27368737	8000	27365961	-4000	4000	2776
chr11	30334223	30342223	30336695	8000	30338223	-4000	4000	-1528
chr11	33101943	33109943	33102194	8000	33105943	-4000	4000	-3749
chr11	46852717	46860717	46859277	8000	46856717	-4000	4000	2560
chr11	47580562	47588562	47586728	8000	47584562	-4000	4000	2166
chr11	47774087	47782087	47780372	8000	47778087	-4000	4000	2285
chr11	57547656	57555656	57554470	8000	57551656	-4000	4000	2814
chr11	57657865	57665865	57661208	8000	57661865	-4000	4000	-657
chr11	59632716	59640716	59638193	8000	59636716	-4000	4000	1477
chr11	60919443	60927443	60927321	8000	60923443	-4000	4000	3878
chr11	61344754	61352754	61345901	8000	61348754	-4000	4000	-2853
chr11	61743001	61751001	61744085	8000	61747001	-4000	4000	-2916
chr11	62904679	62912679	62910021	8000	62908679	-4000	4000	1342
chr11	63907020	63915020	63908920	8000	63911020	-4000	4000	-2100
chr11	64722911	64730911	64728909	8000	64726911	-4000	4000	1998
chr11	64742389	64750389	64746700	8000	64746389	-4000	4000	311
chr11	65169244	65177244	65171355	8000	65173244	-4000	4000	-1889
chr11	66310494	66318494	66315158	8000	66314494	-4000	4000	664
chr11	66586176	66594176	66592365	8000	66590176	-4000	4000	2189
chr11	68750620	68758620	68754928	8000	68754620	-4000	4000	308
chr11	69000395	69008395	69006243	8000	69004395	-4000	4000	1848
chr11	71520107	71528107	71527626	8000	71524107	-4000	4000	3519
chr11	76653524	76661524	76661470	8000	76657524	-4000	4000	3946
chr11	86274813	86282813	86278066	8000	86278813	-4000	4000	-747
chr11	93726358	93734358	93727203	8000	93730358	-4000	4000	-3155
chr11	103903189	103911189	103909526	8000	103907189	-4000	4000	2337
chr11	110573042	110581042	110579651	8000	110577042	-4000	4000	2609
chr11	111782286	111790286	111786324	8000	111786286	-4000	4000	38
chr11	113274436	113282436	113275292	8000	113278436	-4000	4000	-3144
chr11	113405605	113413605	113410626	8000	113409605	-4000	4000	1021
chr11	114439932	114447932	114440737	8000	114443932	-4000	4000	-3195
chr11	119186250	119194250	119190724	8000	119190250	-4000	4000	474
chr11	123053489	123061489	123061254	8000	123057489	-4000	4000	3765
chr11	124629113	124637113	124631312	8000	124633113	-4000	4000	-1801
chr11	124762498	124770498	124767112	8000	124766498	-4000	4000	614
chr11	124762498	124770498	124767571	8000	124766498	-4000	4000	1073
chr11	125896646	125904646	125900351	8000	125900646	-4000	4000	-295
chr11	6617330	6625330	6622066	8000	6621330	-4000	4000	736
chr11	70185530	70193530	70185633	8000	70189530	-4000	4000	-3897
chr11	66341374	66349374	66347075	8000	66345374	-4000	4000	1701
chr11	128454761	128462761	128459614	8000	128458761	-4000	4000	853
chr11	66505657	66513657	66510647	8000	66509657	-4000	4000	990
chr11	6617330	6625330	6623920	8000	6621330	-4000	4000	2590
chr11	65862441	65870441	65864986	8000	65866441	-4000	4000	-1455
chr11	101447564	101455564	101453662	8000	101451564	-4000	4000	2098
chr11	94177968	94185968	94180805	8000	94181968	-4000	4000	-1163
chr11	61795627	61803627	61796149	8000	61799627	-4000	4000	-3478
chr11	110573042	110581042	110580135	8000	110577042	-4000	4000	3093
chr11	119334942	119342942	119342680	8000	119338942	-4000	4000	3738
chr11	66586176	66594176	66591573	8000	66590176	-4000	4000	1397
chr11	128809267	128817267	128811093	8000	128813267	-4000	4000	-2174
chr11	78012971	78020971	78017072	8000	78016971	-4000	4000	101
chr11	62664496	62672496	62667762	8000	62668496	-4000	4000	-734
chr11	59204510	59212510	59210704	8000	59208510	-4000	4000	2194
chr11	2921246	2929246	2925052	8000	2925246	-4000	4000	-194
chr11	6427049	6435049	6431254	8000	6431049	-4000	4000	205
chr11	6608768	6616768	6615315	8000	6612768	-4000	4000	2547
chr11	6617330	6625330	6623482	8000	6621330	-4000	4000	2152
chr11	6997004	7005004	7000693	8000	7001004	-4000	4000	-311
chr11	6997004	7005004	7001505	8000	7001004	-4000	4000	501
chr11	7507377	7515377	7509974	8000	7511377	-4000	4000	-1403
chr11	8976576	8984576	8983904	8000	8980576	-4000	4000	3328
chr11	9444127	9452127	9445096	8000	9448127	-4000	4000	-3031
chr11	14500874	14508874	14507722	8000	14504874	-4000	4000	2848
chr11	17388498	17396498	17395173	8000	17392498	-4000	4000	2675
chr11	18227423	18235423	18231526	8000	18231423	-4000	4000	103
chr11	18606255	18614255	18612339	8000	18610255	-4000	4000	2084
chr11	31786324	31794324	31794105	8000	31790324	-4000	4000	3781
chr11	34474791	34482791	34480143	8000	34478791	-4000	4000	1352
chr11	40110203	40118203	40115327	8000	40114203	-4000	4000	1124
chr11	47326031	47334031	47332253	8000	47330031	-4000	4000	2222
chr11	47580562	47588562	47580879	8000	47584562	-4000	4000	-3683
chr11	59123412	59131412	59124410	8000	59127412	-4000	4000	-3002
chr11	59151039	59159039	59152696	8000	59155039	-4000	4000	-2343
chr11	59204510	59212510	59211802	8000	59208510	-4000	4000	3292
chr11	59632716	59640716	59638266	8000	59636716	-4000	4000	1550
chr11	61016377	61024377	61019330	8000	61020377	-4000	4000	-1047
chr11	61295451	61303451	61302267	8000	61299451	-4000	4000	2816
chr11	61394866	61402866	61398353	8000	61398866	-4000	4000	-513
chr11	61764501	61772501	61771521	8000	61768501	-4000	4000	3020
chr11	65350262	65358262	65357182	8000	65354262	-4000	4000	2920
chr11	65793214	65801214	65795278	8000	65797214	-4000	4000	-1936
chr11	65879740	65887740	65887698	8000	65883740	-4000	4000	3958
chr11	66009505	66017505	66017087	8000	66013505	-4000	4000	3582
chr11	66559464	66567464	66560668	8000	66563464	-4000	4000	-2796
chr11	71520107	71528107	71527548	8000	71524107	-4000	4000	3441
chr11	72572141	72580141	72578909	8000	72576141	-4000	4000	2768
chr11	75582918	75590918	75587491	8000	75586918	-4000	4000	573
chr11	78012971	78020971	78016685	8000	78016971	-4000	4000	-286
chr11	78012971	78020971	78017021	8000	78016971	-4000	4000	50
chr11	85632539	85640539	85634146	8000	85636539	-4000	4000	-2393
chr11	85632539	85640539	85635786	8000	85636539	-4000	4000	-753
chr11	86274813	86282813	86277077	8000	86278813	-4000	4000	-1736
chr11	95067225	95075225	95067789	8000	95071225	-4000	4000	-3436
chr11	102831801	102839801	102838589	8000	102835801	-4000	4000	2788
chr11	106047098	106055098	106053614	8000	106051098	-4000	4000	2516
chr11	110573042	110581042	110579343	8000	110577042	-4000	4000	2301
chr11	112189805	112197805	112193481	8000	112193805	-4000	4000	-324
chr11	119309926	119317926	119310441	8000	119313926	-4000	4000	-3485
chr11	119309926	119317926	119312300	8000	119313926	-4000	4000	-1626
chr11	120329686	120337686	120330440	8000	120333686	-4000	4000	-3246
chr11	125672255	125680255	125672621	8000	125676255	-4000	4000	-3634
chr11	47350860	47358860	47352630	8000	47354860	-4000	4000	-2230
chr11	78167249	78175249	78174479	8000	78171249	-4000	4000	3230
chr11	111904564	111912564	111910408	8000	111908564	-4000	4000	1844
chr11	110573042	110581042	110579213	8000	110577042	-4000	4000	2171
chr11	95972598	95980598	95979424	8000	95976598	-4000	4000	2826
chr11	292107	300107	294169	8000	296107	-4000	4000	-1938
chr11	86274813	86282813	86277185	8000	86278813	-4000	4000	-1628
chr11	18602403	18610403	18610221	8000	18606403	-4000	4000	3818
chr11	78167249	78175249	78173877	8000	78171249	-4000	4000	2628
chr11	32383775	32391775	32388338	8000	32387775	-4000	4000	563
chr11	86274813	86282813	86278533	8000	86278813	-4000	4000	-280
chr11	46739048	46747048	46744545	8000	46743048	-4000	4000	1497
chr11	18265977	18273977	18266966	8000	18269977	-4000	4000	-3011
chr11	65208006	65216006	65211298	8000	65212006	-4000	4000	-708
chr11	123719914	123727914	123726020	8000	123723914	-4000	4000	2106
chr11	124879691	124887691	124887194	8000	124883691	-4000	4000	3503
chr11	119020114	119028114	119020162	8000	119024114	-4000	4000	-3952
chr11	68150863	68158863	68156475	8000	68154863	-4000	4000	1612
chr11	73996277	74004277	74003933	8000	74000277	-4000	4000	3656
chr11	75797535	75805535	75798288	8000	75801535	-4000	4000	-3247
chr11	61349295	61357295	61353107	8000	61353295	-4000	4000	-188
chr11	63755891	63763891	63758182	8000	63759891	-4000	4000	-1709
chr11	9134825	9142825	9138975	8000	9138825	-4000	4000	150
chr11	18274668	18282668	18279859	8000	18278668	-4000	4000	1191
chr11	119180016	119188016	119185649	8000	119184016	-4000	4000	1633
chr11	40110203	40118203	40114846	8000	40114203	-4000	4000	643
chr11	28016619	28024619	28021223	8000	28020619	-4000	4000	604
chr11	248984	256984	252640	8000	252984	-4000	4000	-344
chr11	26993087	27001087	26994794	8000	26997087	-4000	4000	-2293
chr11	119309926	119317926	119310468	8000	119313926	-4000	4000	-3458
chr11	62904679	62912679	62910115	8000	62908679	-4000	4000	1436
chr11	34468060	34476060	34471408	8000	34472060	-4000	4000	-652
chr11	76653524	76661524	76659647	8000	76657524	-4000	4000	2123
chr11	108143603	108151603	108146326	8000	108147603	-4000	4000	-1277
chr11	117816163	117824163	117820563	8000	117820163	-4000	4000	400
chr11	4651488	4659488	4653331	8000	4655488	-4000	4000	-2157
chr11	86274813	86282813	86277170	8000	86278813	-4000	4000	-1643
chr11	9015476	9023476	9021083	8000	9019476	-4000	4000	1607
chr11	102080554	102088554	102081261	8000	102084554	-4000	4000	-3293
chr11	105021443	105029443	105029145	8000	105025443	-4000	4000	3702
chr11	76345898	76353898	76351160	8000	76349898	-4000	4000	1262
chr11	27123809	27131809	27127503	8000	27127809	-4000	4000	-306
chr11	106047098	106055098	106053292	8000	106051098	-4000	4000	2194
chr11	69767022	69775022	69773345	8000	69771022	-4000	4000	2323
chr11	8710759	8718759	8710852	8000	8714759	-4000	4000	-3907
chr11	11952207	11960207	11955076	8000	11956207	-4000	4000	-1131
chr11	65862441	65870441	65864790	8000	65866441	-4000	4000	-1651
chr11	26993087	27001087	26994820	8000	26997087	-4000	4000	-2267
chr11	61955718	61963718	61962450	8000	61959718	-4000	4000	2732
chr11	64602174	64610174	64607257	8000	64606174	-4000	4000	1083
chr11	6427049	6435049	6431914	8000	6431049	-4000	4000	865
chr11	20117601	20125601	20118264	8000	20121601	-4000	4000	-3337
chr11	47350860	47358860	47355439	8000	47354860	-4000	4000	579
chr11	57229577	57237577	57236763	8000	57233577	-4000	4000	3186
chr11	67421607	67429607	67424039	8000	67425607	-4000	4000	-1568
chr11	67638555	67646555	67642756	8000	67642555	-4000	4000	201
chr11	68936602	68944602	68936659	8000	68940602	-4000	4000	-3943
chr11	125438881	125446881	125446011	8000	125442881	-4000	4000	3130
chr11	65169244	65177244	65175447	8000	65173244	-4000	4000	2203
chr11	86948910	86956910	86951424	8000	86952910	-4000	4000	-1486
chr11	119309926	119317926	119314552	8000	119313926	-4000	4000	626
chr11	6617330	6625330	6623776	8000	6621330	-4000	4000	2446
chr11	123053489	123061489	123061117	8000	123057489	-4000	4000	3628
chr11	82818936	82826936	82825006	8000	82822936	-4000	4000	2070
chr11	211113	219113	216640	8000	215113	-4000	4000	1527
chr11	62664496	62672496	62667756	8000	62668496	-4000	4000	-740
chr11	93726358	93734358	93729905	8000	93730358	-4000	4000	-453
chr11	66586176	66594176	66591330	8000	66590176	-4000	4000	1154
chr11	110573042	110581042	110580920	8000	110577042	-4000	4000	3878
chr11	3822978	3830978	3824901	8000	3826978	-4000	4000	-2077
chr11	10503894	10511894	10506556	8000	10507894	-4000	4000	-1338
chr11	65350262	65358262	65355892	8000	65354262	-4000	4000	1630
chr11	65350262	65358262	65357192	8000	65354262	-4000	4000	2930
chr11	110460884	110468884	110462526	8000	110464884	-4000	4000	-2358
chr11	58830065	58838065	58837048	8000	58834065	-4000	4000	2983
chr11	72839674	72847674	72843079	8000	72843674	-4000	4000	-595
chr11	62240812	62248812	62242349	8000	62244812	-4000	4000	-2463
chr11	64219799	64227799	64223484	8000	64223799	-4000	4000	-315
chr11	66009505	66017505	66016848	8000	66013505	-4000	4000	3343
chr11	77318017	77326017	77325335	8000	77322017	-4000	4000	3318
chr11	66310494	66318494	66314996	8000	66314494	-4000	4000	502
chr11	119089874	119097874	119097056	8000	119093874	-4000	4000	3182
chr11	292107	300107	299390	8000	296107	-4000	4000	3283
chr11	76140232	76148232	76140956	8000	76144232	-4000	4000	-3276
chr11	130206362	130214362	130208501	8000	130210362	-4000	4000	-1861
chr11	65888049	65896049	65888358	8000	65892049	-4000	4000	-3691
chr11	94495578	94503578	94498376	8000	94499578	-4000	4000	-1202
chr11	1106511	1114511	1108035	8000	1110511	-4000	4000	-2476
chr11	65169244	65177244	65171461	8000	65173244	-4000	4000	-1783
chr11	66559464	66567464	66560694	8000	66563464	-4000	4000	-2770
chr11	117200337	117208337	117204317	8000	117204337	-4000	4000	-20
chr11	106094699	106102699	106096820	8000	106098699	-4000	4000	-1879
chr11	14873440	14881440	14880139	8000	14877440	-4000	4000	2699
chr11	18602403	18610403	18609596	8000	18606403	-4000	4000	3193
chr11	45643689	45651689	45650182	8000	45647689	-4000	4000	2493
chr11	6207345	6215345	6211667	8000	6211345	-4000	4000	322
chr11	6997004	7005004	7000130	8000	7001004	-4000	4000	-874
chr11	94177968	94185968	94180110	8000	94181968	-4000	4000	-1858
chr11	119077972	119085972	119078171	8000	119081972	-4000	4000	-3801
chr11	86948910	86956910	86952420	8000	86952910	-4000	4000	-490
chr11	6997004	7005004	6999937	8000	7001004	-4000	4000	-1067
chr11	9015476	9023476	9021034	8000	9019476	-4000	4000	1558
chr11	33101943	33109943	33105853	8000	33105943	-4000	4000	-90
chr11	47580562	47588562	47586802	8000	47584562	-4000	4000	2240
chr11	33101943	33109943	33107942	8000	33105943	-4000	4000	1999
chr11	78167249	78175249	78174176	8000	78171249	-4000	4000	2927
chr11	119089874	119097874	119097285	8000	119093874	-4000	4000	3411
chr11	68936602	68944602	68939561	8000	68940602	-4000	4000	-1041
chr11	2921246	2929246	2925196	8000	2925246	-4000	4000	-50
chr11	62429542	62437542	62433746	8000	62433542	-4000	4000	204
chr11	66559464	66567464	66560665	8000	66563464	-4000	4000	-2799
chr11	68025282	68033282	68026077	8000	68029282	-4000	4000	-3205
chr11	94110208	94118208	94112404	8000	94114208	-4000	4000	-1804
chr11	112059218	112067218	112064242	8000	112063218	-4000	4000	1024
chr11	33073188	33081188	33081121	8000	33077188	-4000	4000	3933
chr11	67487154	67495154	67495131	8000	67491154	-4000	4000	3977
chr11	40110203	40118203	40115718	8000	40114203	-4000	4000	1515
chr11	126198096	126206096	126205583	8000	126202096	-4000	4000	3487
chr11	64760606	64768606	64767620	8000	64764606	-4000	4000	3014
chr11	118395211	118403211	118401583	8000	118399211	-4000	4000	2372
chr11	47350860	47358860	47351464	8000	47354860	-4000	4000	-3396
chr11	57547656	57555656	57552337	8000	57551656	-4000	4000	681
chr11	62209943	62217943	62210416	8000	62213943	-4000	4000	-3527
chr11	94110208	94118208	94110961	8000	94114208	-4000	4000	-3247
chr11	121187490	121195490	121189809	8000	121191490	-4000	4000	-1681
chr11	75582918	75590918	75587859	8000	75586918	-4000	4000	941
chr11	57697182	57705182	57704071	8000	57701182	-4000	4000	2889
chr11	27490418	27498418	27497000	8000	27494418	-4000	4000	2582
chr11	77606356	77614356	77609602	8000	77610356	-4000	4000	-754
chr11	117896641	117904641	117903737	8000	117900641	-4000	4000	3096
chr11	101447564	101455564	101455102	8000	101451564	-4000	4000	3538
chr11	94995519	95003519	94998583	8000	94999519	-4000	4000	-936
chr11	18700785	18708785	18701783	8000	18704785	-4000	4000	-3002
chr11	62788123	62796123	62794941	8000	62792123	-4000	4000	2818
chr11	59204510	59212510	59211180	8000	59208510	-4000	4000	2670
chr11	100989941	100997941	100992204	8000	100993941	-4000	4000	-1737
chr11	67658160	67666160	67664507	8000	67662160	-4000	4000	2347
chr11	110573042	110581042	110579711	8000	110577042	-4000	4000	2669
chr11	70432584	70440584	70433686	8000	70436584	-4000	4000	-2898
chr11	75582918	75590918	75587371	8000	75586918	-4000	4000	453
chr11	315676	323676	319891	8000	319676	-4000	4000	215
chr11	6427049	6435049	6431122	8000	6431049	-4000	4000	73
chr11	112080800	112088800	112082735	8000	112084800	-4000	4000	-2065
chr11	83183451	83191451	83184963	8000	83187451	-4000	4000	-2488
chr11	66326241	66334241	66332383	8000	66330241	-4000	4000	2142
chr11	75582918	75590918	75587036	8000	75586918	-4000	4000	118
chr11	20505338	20513338	20508354	8000	20509338	-4000	4000	-984
chr11	3667083	3675083	3669347	8000	3671083	-4000	4000	-1736
chr11	20117601	20125601	20118195	8000	20121601	-4000	4000	-3406
chr11	6608768	6616768	6614903	8000	6612768	-4000	4000	2135
chr11	106047098	106055098	106052130	8000	106051098	-4000	4000	1032
chr11	11957887	11965887	11964652	8000	11961887	-4000	4000	2765
chr11	57321986	57329986	57326436	8000	57325986	-4000	4000	450
chr11	7507377	7515377	7510345	8000	7511377	-4000	4000	-1032
chr11	13384008	13392008	13386660	8000	13388008	-4000	4000	-1348
chr11	18606255	18614255	18612447	8000	18610255	-4000	4000	2192
chr11	27650893	27658893	27657931	8000	27654893	-4000	4000	3038
chr11	45643689	45651689	45649825	8000	45647689	-4000	4000	2136
chr11	76549025	76557025	76550069	8000	76553025	-4000	4000	-2956
chr11	110460884	110468884	110462360	8000	110464884	-4000	4000	-2524
chr11	112059218	112067218	112059943	8000	112063218	-4000	4000	-3275
chr11	117203464	117211464	117208909	8000	117207464	-4000	4000	1445
chr11	117281232	117289232	117282156	8000	117285232	-4000	4000	-3076
chr11	118117890	118125890	118118003	8000	118121890	-4000	4000	-3887
chr11	119077972	119085972	119079182	8000	119081972	-4000	4000	-2790
chr11	126198096	126206096	126205494	8000	126202096	-4000	4000	3398
chr11	113274436	113282436	113275327	8000	113278436	-4000	4000	-3109
chr11	113793874	113801874	113801533	8000	113797874	-4000	4000	3659
chr11	72572141	72580141	72576629	8000	72576141	-4000	4000	488
chr11	57383365	57391365	57387785	8000	57387365	-4000	4000	420
chr11	61863354	61871354	61863742	8000	61867354	-4000	4000	-3612
chr11	4651488	4659488	4652523	8000	4655488	-4000	4000	-2965
chr11	59151039	59159039	59153187	8000	59155039	-4000	4000	-1852
chr11	66310494	66318494	66314759	8000	66314494	-4000	4000	265
chr11	73393474	73401474	73395274	8000	73397474	-4000	4000	-2200
chr11	73393474	73401474	73395275	8000	73397474	-4000	4000	-2199
chr11	67623938	67631938	67628258	8000	67627938	-4000	4000	320
chr11	57229577	57237577	57236636	8000	57233577	-4000	4000	3059
chr11	86948910	86956910	86951284	8000	86952910	-4000	4000	-1626
chr11	119351215	119359215	119358049	8000	119355215	-4000	4000	2834
chr11	123053489	123061489	123061153	8000	123057489	-4000	4000	3664
chr11	59123412	59131412	59126044	8000	59127412	-4000	4000	-1368
chr11	43490933	43498933	43493926	8000	43494933	-4000	4000	-1007
chr11	85953175	85961175	85958802	8000	85957175	-4000	4000	1627
chr11	102831801	102839801	102836021	8000	102835801	-4000	4000	220
chr12	21760955	21768955	21766289	8000	21764955	-4000	4000	1334
chr12	49640666	49648666	49644213	8000	49644666	-4000	4000	-453
chr12	56034435	56042435	56034996	8000	56038435	-4000	4000	-3439
chr12	8936361	8944361	8942416	8000	8940361	-4000	4000	2055
chr12	122710756	122718756	122716431	8000	122714756	-4000	4000	1675
chr12	123931720	123939720	123932107	8000	123935720	-4000	4000	-3613
chr12	22061674	22069674	22062363	8000	22065674	-4000	4000	-3311
chr12	65962291	65970291	65965275	8000	65966291	-4000	4000	-1016
chr12	95511839	95519839	95513720	8000	95515839	-4000	4000	-2119
chr12	52073495	52081495	52073851	8000	52077495	-4000	4000	-3644
chr12	105070197	105078197	105070627	8000	105074197	-4000	4000	-3570
chr12	106973277	106981277	106978030	8000	106977277	-4000	4000	753
chr12	57525633	57533633	57527661	8000	57529633	-4000	4000	-1972
chr12	132581188	132589188	132581451	8000	132585188	-4000	4000	-3737
chr12	6816799	6824799	6819381	8000	6820799	-4000	4000	-1418
chr12	6835847	6843847	6839602	8000	6839847	-4000	4000	-245
chr12	44385762	44393762	44388556	8000	44389762	-4000	4000	-1206
chr12	57525633	57533633	57530771	8000	57529633	-4000	4000	1138
chr12	71694968	71702968	71700922	8000	71698968	-4000	4000	1954
chr12	122710756	122718756	122716655	8000	122714756	-4000	4000	1899
chr12	49327731	49335731	49330241	8000	49331731	-4000	4000	-1490
chr12	53098345	53106345	53100845	8000	53102345	-4000	4000	-1500
chr12	52670736	52678736	52678549	8000	52674736	-4000	4000	3813
chr12	70634073	70642073	70635853	8000	70638073	-4000	4000	-2220
chr12	907736	915736	913131	8000	911736	-4000	4000	1395
chr12	1832753	1840753	1834597	8000	1836753	-4000	4000	-2156
chr12	6816799	6824799	6824716	8000	6820799	-4000	4000	3917
chr12	53098345	53106345	53102213	8000	53102345	-4000	4000	-132
chr12	98609405	98617405	98614033	8000	98613405	-4000	4000	628
chr12	55950027	55958027	55954206	8000	55954027	-4000	4000	179
chr12	71121085	71129085	71125193	8000	71125085	-4000	4000	108
chr12	123616406	123624406	123616530	8000	123620406	-4000	4000	-3876
chr12	113007723	113015723	113010335	8000	113011723	-4000	4000	-1388
chr12	50928510	50936510	50930059	8000	50932510	-4000	4000	-2451
chr12	109979841	109987841	109983472	8000	109983841	-4000	4000	-369
chr12	53153663	53161663	53158595	8000	53157663	-4000	4000	932
chr12	45904040	45912040	45907498	8000	45908040	-4000	4000	-542
chr12	123616406	123624406	123618748	8000	123620406	-4000	4000	-1658
chr12	10820960	10828960	10825808	8000	10824960	-4000	4000	848
chr12	89584049	89592049	89591266	8000	89588049	-4000	4000	3217
chr12	95964720	95972720	95966457	8000	95968720	-4000	4000	-2263
chr12	116572606	116580606	116575909	8000	116576606	-4000	4000	-697
chr12	48142404	48150404	48145095	8000	48146404	-4000	4000	-1309
chr12	49180686	49188686	49185745	8000	49184686	-4000	4000	1059
chr12	6840793	6848793	6843022	8000	6844793	-4000	4000	-1771
chr12	52055507	52063507	52057414	8000	52059507	-4000	4000	-2093
chr12	53187323	53195323	53193803	8000	53191323	-4000	4000	2480
chr12	89343235	89351235	89349395	8000	89347235	-4000	4000	2160
chr12	114349911	114357911	114355672	8000	114353911	-4000	4000	1761
chr12	41570745	41578745	41573540	8000	41574745	-4000	4000	-1205
chr12	50171788	50179788	50177679	8000	50175788	-4000	4000	1891
chr12	76340474	76348474	76348374	8000	76344474	-4000	4000	3900
chr12	89415718	89423718	89420795	8000	89419718	-4000	4000	1077
chr12	121304245	121312245	121308584	8000	121308245	-4000	4000	339
chr12	53098345	53106345	53105212	8000	53102345	-4000	4000	2867
chr12	113094819	113102819	113096791	8000	113098819	-4000	4000	-2028
chr12	6816799	6824799	6817239	8000	6820799	-4000	4000	-3560
chr12	52483176	52491176	52487409	8000	52487176	-4000	4000	233
chr12	50744657	50752657	50744714	8000	50748657	-4000	4000	-3943
chr12	53191142	53199142	53196944	8000	53195142	-4000	4000	1802
chr12	56994836	57002836	56996576	8000	56998836	-4000	4000	-2260
chr12	9748486	9756486	9753253	8000	9752486	-4000	4000	767
chr12	122722076	122730076	122729773	8000	122726076	-4000	4000	3697
chr12	41570745	41578745	41572574	8000	41574745	-4000	4000	-2171
chr12	56592193	56600193	56598941	8000	56596193	-4000	4000	2748
chr12	110659431	110667431	110661230	8000	110663431	-4000	4000	-2201
chr12	115953905	115961905	115958941	8000	115957905	-4000	4000	1036
chr12	133198369	133206369	133203806	8000	133202369	-4000	4000	1437
chr12	8093881	8101881	8096055	8000	8097881	-4000	4000	-1826
chr12	112022689	112030689	112029287	8000	112026689	-4000	4000	2598
chr12	84855491	84863491	84861179	8000	84859491	-4000	4000	1688
chr12	120574764	120582764	120575837	8000	120578764	-4000	4000	-2927
chr12	79769563	79777563	79774599	8000	79773563	-4000	4000	1036
chr12	123704399	123712399	123707025	8000	123708399	-4000	4000	-1374
chr12	55720703	55728703	55721305	8000	55724703	-4000	4000	-3398
chr12	75499863	75507863	75501943	8000	75503863	-4000	4000	-1920
chr12	128703911	128711911	128705777	8000	128707911	-4000	4000	-2134
chr12	47968967	47976967	47973419	8000	47972967	-4000	4000	452
chr12	53206567	53214567	53211396	8000	53210567	-4000	4000	829
chr12	52420070	52428070	52424352	8000	52424070	-4000	4000	282
chr12	54030888	54038888	54033103	8000	54034888	-4000	4000	-1785
chr12	15899478	15907478	15902921	8000	15903478	-4000	4000	-557
chr12	21467250	21475250	21471492	8000	21471250	-4000	4000	242
chr12	51056424	51064424	51064047	8000	51060424	-4000	4000	3623
chr12	54391261	54399261	54398667	8000	54395261	-4000	4000	3406
chr12	61704273	61712273	61710218	8000	61708273	-4000	4000	1945
chr12	10065554	10073554	10065688	8000	10069554	-4000	4000	-3866
chr12	6462517	6470517	6466382	8000	6466517	-4000	4000	-135
chr12	56634175	56642175	56638295	8000	56638175	-4000	4000	120
chr12	2937138	2945138	2939435	8000	2941138	-4000	4000	-1703
chr12	6458237	6466237	6463098	8000	6462237	-4000	4000	861
chr12	49640666	49648666	49643313	8000	49644666	-4000	4000	-1353
chr12	50171788	50179788	50177404	8000	50175788	-4000	4000	1616
chr12	52281913	52289913	52287145	8000	52285913	-4000	4000	1232
chr12	54288111	54296111	54292441	8000	54292111	-4000	4000	330
chr12	70634073	70642073	70635710	8000	70638073	-4000	4000	-2363
chr12	114666255	114674255	114672124	8000	114670255	-4000	4000	1869
chr12	120309249	120317249	120313059	8000	120313249	-4000	4000	-190
chr12	123616406	123624406	123618759	8000	123620406	-4000	4000	-1647
chr12	123931720	123939720	123931760	8000	123935720	-4000	4000	-3960
chr12	54575239	54583239	54583229	8000	54579239	-4000	4000	3990
chr12	49093136	49101136	49097705	8000	49097136	-4000	4000	569
chr12	57743727	57751727	57745220	8000	57747727	-4000	4000	-2507
chr12	118028687	118036687	118034212	8000	118032687	-4000	4000	1525
chr12	122697293	122705293	122702198	8000	122701293	-4000	4000	905
chr12	55950105	55958105	55958061	8000	55954105	-4000	4000	3956
chr12	122499454	122507454	122500732	8000	122503454	-4000	4000	-2722
chr12	6342843	6350843	6348051	8000	6346843	-4000	4000	1208
chr12	6662477	6670477	6667572	8000	6666477	-4000	4000	1095
chr12	7085587	7093587	7090224	8000	7089587	-4000	4000	637
chr12	26116030	26124030	26122962	8000	26120030	-4000	4000	2932
chr12	44385762	44393762	44388679	8000	44389762	-4000	4000	-1083
chr12	47964878	47972878	47968257	8000	47968878	-4000	4000	-621
chr12	51089656	51097656	51095231	8000	51093656	-4000	4000	1575
chr12	57599418	57607418	57607071	8000	57603418	-4000	4000	3653
chr12	84855491	84863491	84861576	8000	84859491	-4000	4000	2085
chr12	108518214	108526214	108519457	8000	108522214	-4000	4000	-2757
chr12	111447623	111455623	111453493	8000	111451623	-4000	4000	1870
chr12	122697293	122705293	122702527	8000	122701293	-4000	4000	1234
chr12	122710756	122718756	122716828	8000	122714756	-4000	4000	2072
chr12	123931720	123939720	123935353	8000	123935720	-4000	4000	-367
chr12	52442651	52450651	52449579	8000	52446651	-4000	4000	2928
chr12	109925804	109933804	109930035	8000	109929804	-4000	4000	231
chr12	100624288	100632288	100624533	8000	100628288	-4000	4000	-3755
chr12	108284044	108292044	108291974	8000	108288044	-4000	4000	3930
chr12	68838197	68846197	68839349	8000	68842197	-4000	4000	-2848
chr12	1561993	1569993	1566700	8000	1565993	-4000	4000	707
chr12	26967579	26975579	26974162	8000	26971579	-4000	4000	2583
chr12	57209361	57217361	57209755	8000	57213361	-4000	4000	-3606
chr12	130161740	130169740	130164145	8000	130165740	-4000	4000	-1595
chr12	56994836	57002836	56995628	8000	56998836	-4000	4000	-3208
chr12	10820960	10828960	10825588	8000	10824960	-4000	4000	628
chr12	9991694	9999694	9999038	8000	9995694	-4000	4000	3344
chr12	51993078	52001078	51995711	8000	51997078	-4000	4000	-1367
chr12	89415718	89423718	89420904	8000	89419718	-4000	4000	1186
chr12	102192459	102200459	102196391	8000	102196459	-4000	4000	-68
chr12	47071707	47079707	47077574	8000	47075707	-4000	4000	1867
chr12	57582633	57590633	57583129	8000	57586633	-4000	4000	-3504
chr12	52483176	52491176	52490065	8000	52487176	-4000	4000	2889
chr12	108565368	108573368	108567388	8000	108569368	-4000	4000	-1980
chr12	120719640	120727640	120720021	8000	120723640	-4000	4000	-3619
chr12	123658604	123666604	123659878	8000	123662604	-4000	4000	-2726
chr12	53187323	53195323	53193838	8000	53191323	-4000	4000	2515
chr12	6458237	6466237	6466080	8000	6462237	-4000	4000	3843
chr12	6634075	6642075	6638965	8000	6638075	-4000	4000	890
chr12	10112777	10120777	10118390	8000	10116777	-4000	4000	1613
chr12	10187804	10195804	10190076	8000	10191804	-4000	4000	-1728
chr12	14821569	14829569	14822933	8000	14825569	-4000	4000	-2636
chr12	21467250	21475250	21474884	8000	21471250	-4000	4000	3634
chr12	21760955	21768955	21765644	8000	21764955	-4000	4000	689
chr12	31787185	31795185	31792022	8000	31791185	-4000	4000	837
chr12	42455715	42463715	42460477	8000	42459715	-4000	4000	762
chr12	52011889	52019889	52013715	8000	52015889	-4000	4000	-2174
chr12	52483176	52491176	52487805	8000	52487176	-4000	4000	629
chr12	56109910	56117910	56117479	8000	56113910	-4000	4000	3569
chr12	57605804	57613804	57613422	8000	57609804	-4000	4000	3618
chr12	71694968	71702968	71696443	8000	71698968	-4000	4000	-2525
chr12	71694968	71702968	71697491	8000	71698968	-4000	4000	-1477
chr12	123931720	123939720	123937091	8000	123935720	-4000	4000	1371
chr12	130161740	130169740	130164212	8000	130165740	-4000	4000	-1528
chr12	109925804	109933804	109930191	8000	109929804	-4000	4000	387
chr12	120439964	120447964	120444603	8000	120443964	-4000	4000	639
chr12	9748486	9756486	9754678	8000	9752486	-4000	4000	2192
chr12	114349911	114357911	114355612	8000	114353911	-4000	4000	1701
chr12	118141584	118149584	118144679	8000	118145584	-4000	4000	-905
chr12	47232662	47240662	47235965	8000	47236662	-4000	4000	-697
chr12	56109910	56117910	56117508	8000	56113910	-4000	4000	3598
chr12	118028687	118036687	118033897	8000	118032687	-4000	4000	1210
chr12	40365285	40373285	40367140	8000	40369285	-4000	4000	-2145
chr12	103936763	103944763	103942628	8000	103940763	-4000	4000	1865
chr12	42455715	42463715	42459845	8000	42459715	-4000	4000	130
chr12	120123202	120131202	120127916	8000	120127202	-4000	4000	714
chr12	8052844	8060844	8059715	8000	8056844	-4000	4000	2871
chr12	48038897	48046897	48044357	8000	48042897	-4000	4000	1460
chr12	120494493	120502493	120496100	8000	120498493	-4000	4000	-2393
chr12	4611508	4619508	4613761	8000	4615508	-4000	4000	-1747
chr12	15103783	15111783	15109395	8000	15107783	-4000	4000	1612
chr12	122499454	122507454	122505292	8000	122503454	-4000	4000	1838
chr12	122499454	122507454	122505293	8000	122503454	-4000	4000	1839
chr12	4483735	4491735	4489844	8000	4487735	-4000	4000	2109
chr12	46354188	46362188	46361177	8000	46358188	-4000	4000	2989
chr12	55950027	55958027	55957110	8000	55954027	-4000	4000	3083
chr12	52420070	52428070	52424367	8000	52424070	-4000	4000	297
chr12	42308086	42316086	42313726	8000	42312086	-4000	4000	1640
chr12	49640666	49648666	49641534	8000	49644666	-4000	4000	-3132
chr12	51993078	52001078	51993987	8000	51997078	-4000	4000	-3091
chr12	109594125	109602125	109596553	8000	109598125	-4000	4000	-1572
chr12	120758510	120766510	120764873	8000	120762510	-4000	4000	2363
chr12	132619753	132627753	132625744	8000	132623753	-4000	4000	1991
chr12	47968967	47976967	47974171	8000	47972967	-4000	4000	1204
chr12	6458237	6466237	6458765	8000	6462237	-4000	4000	-3472
chr12	21760955	21768955	21766217	8000	21764955	-4000	4000	1262
chr12	22059773	22067773	22061300	8000	22063773	-4000	4000	-2473
chr12	52510575	52518575	52516801	8000	52514575	-4000	4000	2226
chr12	57619409	57627409	57625715	8000	57623409	-4000	4000	2306
chr12	76340474	76348474	76347118	8000	76344474	-4000	4000	2644
chr12	110023028	110031028	110028230	8000	110027028	-4000	4000	1202
chr12	12913937	12921937	12915917	8000	12917937	-4000	4000	-2020
chr12	12913937	12921937	12915918	8000	12917937	-4000	4000	-2019
chr12	52670736	52678736	52676443	8000	52674736	-4000	4000	1707
chr12	108246537	108254537	108248251	8000	108250537	-4000	4000	-2286
chr12	54288111	54296111	54292991	8000	54292111	-4000	4000	880
chr12	4556047	4564047	4559125	8000	4560047	-4000	4000	-922
chr12	88045016	88053016	88049204	8000	88049016	-4000	4000	188
chr12	113007723	113015723	113010027	8000	113011723	-4000	4000	-1696
chr12	70430292	70438292	70430715	8000	70434292	-4000	4000	-3577
chr12	10695089	10703089	10702085	8000	10699089	-4000	4000	2996
chr12	50079611	50087611	50082329	8000	50083611	-4000	4000	-1282
chr12	89584049	89592049	89590354	8000	89588049	-4000	4000	2305
chr12	8936361	8944361	8939739	8000	8940361	-4000	4000	-622
chr12	48899503	48907503	48904317	8000	48903503	-4000	4000	814
chr12	49961682	49969682	49962318	8000	49965682	-4000	4000	-3364
chr12	49327731	49335731	49330869	8000	49331731	-4000	4000	-862
chr12	52281913	52289913	52288128	8000	52285913	-4000	4000	2215
chr12	12718369	12726369	12722241	8000	12722369	-4000	4000	-128
chr12	6972185	6980185	6978685	8000	6976185	-4000	4000	2500
chr12	25104335	25112335	25107968	8000	25108335	-4000	4000	-367
chr12	83130870	83138870	83132383	8000	83134870	-4000	4000	-2487
chr12	54640589	54648589	54644697	8000	54644589	-4000	4000	108
chr12	39546033	39554033	39554019	8000	39550033	-4000	4000	3986
chr12	122499454	122507454	122500870	8000	122503454	-4000	4000	-2584
chr12	6342843	6350843	6347791	8000	6346843	-4000	4000	948
chr12	9991694	9999694	9997275	8000	9995694	-4000	4000	1581
chr12	10820960	10828960	10826109	8000	10824960	-4000	4000	1149
chr12	79769563	79777563	79775116	8000	79773563	-4000	4000	1553
chr12	120337330	120345330	120341493	8000	120341330	-4000	4000	163
chr12	120758510	120766510	120764115	8000	120762510	-4000	4000	1605
chr12	7067032	7075032	7070072	8000	7071032	-4000	4000	-960
chr12	8217260	8225260	8222464	8000	8221260	-4000	4000	1204
chr12	26331352	26339352	26339343	8000	26335352	-4000	4000	3991
chr12	47730363	47738363	47738228	8000	47734363	-4000	4000	3865
chr12	6816799	6824799	6823620	8000	6820799	-4000	4000	2821
chr12	71582310	71590310	71584818	8000	71586310	-4000	4000	-1492
chr12	110023028	110031028	110028533	8000	110027028	-4000	4000	1505
chr12	110529245	110537245	110530575	8000	110533245	-4000	4000	-2670
chr12	120090494	120098494	120097132	8000	120094494	-4000	4000	2638
chr12	54571387	54579387	54577228	8000	54575387	-4000	4000	1841
chr12	123594582	123602582	123596665	8000	123598582	-4000	4000	-1917
chr12	9144840	9152840	9152261	8000	9148840	-4000	4000	3421
chr12	23525504	23533504	23533460	8000	23529504	-4000	4000	3956
chr12	53289638	53297638	53292383	8000	53293638	-4000	4000	-1255
chr12	25201246	25209246	25204181	8000	25205246	-4000	4000	-1065
chr12	119681791	119689791	119687591	8000	119685791	-4000	4000	1800
chr12	52442651	52450651	52450616	8000	52446651	-4000	4000	3965
chr12	9144840	9152840	9148896	8000	9148840	-4000	4000	56
chr12	49123782	49131782	49128123	8000	49127782	-4000	4000	341
chr12	123704399	123712399	123706774	8000	123708399	-4000	4000	-1625
chr12	123931720	123939720	123933419	8000	123935720	-4000	4000	-2301
chr12	54358445	54366445	54362867	8000	54362445	-4000	4000	422
chr12	53206567	53214567	53213600	8000	53210567	-4000	4000	3033
chr12	57619409	57627409	57621390	8000	57623409	-4000	4000	-2019
chr12	57804071	57812071	57810383	8000	57808071	-4000	4000	2312
chr12	105169297	105177297	105176969	8000	105173297	-4000	4000	3672
chr12	76340474	76348474	76345550	8000	76344474	-4000	4000	1076
chr12	105070197	105078197	105073908	8000	105074197	-4000	4000	-289
chr12	122697293	122705293	122702594	8000	122701293	-4000	4000	1301
chr12	124942825	124950825	124950756	8000	124946825	-4000	4000	3931
chr12	54575239	54583239	54582096	8000	54579239	-4000	4000	2857
chr12	49060676	49068676	49065433	8000	49064676	-4000	4000	757
chr12	12656890	12664890	12661981	8000	12660890	-4000	4000	1091
chr12	32741650	32749650	32746999	8000	32745650	-4000	4000	1349
chr12	42455715	42463715	42459504	8000	42459715	-4000	4000	-211
chr12	50107313	50115313	50109460	8000	50111313	-4000	4000	-1853
chr12	57209361	57217361	57211784	8000	57213361	-4000	4000	-1577
chr12	57209361	57217361	57212526	8000	57213361	-4000	4000	-835
chr12	6646301	6654301	6652978	8000	6650301	-4000	4000	2677
chr12	9748486	9756486	9755201	8000	9752486	-4000	4000	2715
chr12	52305163	52313163	52306197	8000	52309163	-4000	4000	-2966
chr12	48899503	48907503	48905065	8000	48903503	-4000	4000	1562
chr12	49972923	49980923	49973304	8000	49976923	-4000	4000	-3619
chr12	57222449	57230449	57229778	8000	57226449	-4000	4000	3329
chr12	50171788	50179788	50177760	8000	50175788	-4000	4000	1972
chr12	14821569	14829569	14822999	8000	14825569	-4000	4000	-2570
chr12	103766453	103774453	103773876	8000	103770453	-4000	4000	3423
chr12	6774455	6782455	6777285	8000	6778455	-4000	4000	-1170
chr12	101382618	101390618	101383140	8000	101386618	-4000	4000	-3478
chr12	120090494	120098494	120097163	8000	120094494	-4000	4000	2669
chr12	122722076	122730076	122729617	8000	122726076	-4000	4000	3541
chr12	52420070	52428070	52424485	8000	52424070	-4000	4000	415
chr12	109444655	109452655	109451810	8000	109448655	-4000	4000	3155
chr12	52670736	52678736	52675321	8000	52674736	-4000	4000	585
chr12	55968789	55976789	55971143	8000	55972789	-4000	4000	-1646
chr12	56109910	56117910	56110578	8000	56113910	-4000	4000	-3332
chr12	14938031	14946031	14942666	8000	14942031	-4000	4000	635
chr12	52305163	52313163	52306218	8000	52309163	-4000	4000	-2945
chr12	112019449	112027449	112019811	8000	112023449	-4000	4000	-3638
chr12	10614923	10622923	10619816	8000	10618923	-4000	4000	893
chr12	57619409	57627409	57624262	8000	57623409	-4000	4000	853
chr12	10154301	10162301	10160916	8000	10158301	-4000	4000	2615
chr12	49180686	49188686	49185442	8000	49184686	-4000	4000	756
chr12	49862896	49870896	49870433	8000	49866896	-4000	4000	3537
chr12	55950027	55958027	55957419	8000	55954027	-4000	4000	3392
chr12	57209361	57217361	57210362	8000	57213361	-4000	4000	-2999
chr12	57804071	57812071	57810440	8000	57808071	-4000	4000	2369
chr12	75499863	75507863	75506857	8000	75503863	-4000	4000	2994
chr12	106973277	106981277	106977998	8000	106977277	-4000	4000	721
chr12	49972923	49980923	49974449	8000	49976923	-4000	4000	-2474
chr12	113094819	113102819	113094879	8000	113098819	-4000	4000	-3940
chr12	95298799	95306799	95299966	8000	95302799	-4000	4000	-2833
chr12	25205645	25213645	25209692	8000	25209645	-4000	4000	47
chr12	57209361	57217361	57210353	8000	57213361	-4000	4000	-3008
chr12	100337715	100345715	100339068	8000	100341715	-4000	4000	-2647
chr12	6487886	6495886	6492192	8000	6491886	-4000	4000	306
chr12	6534374	6542374	6540167	8000	6538374	-4000	4000	1793
chr12	6662477	6670477	6669036	8000	6666477	-4000	4000	2559
chr12	14910039	14918039	14915506	8000	14914039	-4000	4000	1467
chr12	49961682	49969682	49962109	8000	49965682	-4000	4000	-3573
chr12	49060676	49068676	49065027	8000	49064676	-4000	4000	351
chr12	79769563	79777563	79775829	8000	79773563	-4000	4000	2266
chr12	7067032	7075032	7069890	8000	7071032	-4000	4000	-1142
chr12	48142404	48150404	48145235	8000	48146404	-4000	4000	-1169
chr12	9991694	9999694	9998354	8000	9995694	-4000	4000	2660
chr12	51182936	51190936	51190449	8000	51186936	-4000	4000	3513
chr12	69955097	69963097	69958520	8000	69959097	-4000	4000	-577
chr12	130161740	130169740	130164274	8000	130165740	-4000	4000	-1466
chr12	89343235	89351235	89350976	8000	89347235	-4000	4000	3741
chr12	120736008	120744008	120739326	8000	120740008	-4000	4000	-682
chr12	76340474	76348474	76346370	8000	76344474	-4000	4000	1896
chr12	133198369	133206369	133203051	8000	133202369	-4000	4000	682
chr12	49327731	49335731	49330981	8000	49331731	-4000	4000	-750
chr12	55950027	55958027	55957220	8000	55954027	-4000	4000	3193
chr12	6234271	6242271	6235559	8000	6238271	-4000	4000	-2712
chr12	52802549	52810549	52807192	8000	52806549	-4000	4000	643
chr12	52670736	52678736	52677417	8000	52674736	-4000	4000	2681
chr12	8051517	8059517	8059031	8000	8055517	-4000	4000	3514
chr12	31787185	31795185	31791660	8000	31791185	-4000	4000	475
chr12	78209010	78217010	78210511	8000	78213010	-4000	4000	-2499
chr12	133198369	133206369	133203244	8000	133202369	-4000	4000	875
chr12	45904040	45912040	45904963	8000	45908040	-4000	4000	-3077
chr12	113007723	113015723	113010398	8000	113011723	-4000	4000	-1325
chr12	115953905	115961905	115959865	8000	115957905	-4000	4000	1960
chr12	130161740	130169740	130165356	8000	130165740	-4000	4000	-384
chr12	112505918	112513918	112509586	8000	112509918	-4000	4000	-332
chr12	6614835	6622835	6621127	8000	6618835	-4000	4000	2292
chr12	101389116	101397116	101396406	8000	101393116	-4000	4000	3290
chr12	21793389	21801389	21801057	8000	21797389	-4000	4000	3668
chr12	95964720	95972720	95966453	8000	95968720	-4000	4000	-2267
chr12	6816799	6824799	6819539	8000	6820799	-4000	4000	-1260
chr12	51182936	51190936	51190393	8000	51186936	-4000	4000	3457
chr12	56337597	56345597	56343418	8000	56341597	-4000	4000	1821
chr12	64498114	64506114	64501436	8000	64502114	-4000	4000	-678
chr12	49972923	49980923	49975495	8000	49976923	-4000	4000	-1428
chr12	54544243	54552243	54549883	8000	54548243	-4000	4000	1640
chr12	53289638	53297638	53293565	8000	53293638	-4000	4000	-73
chr12	57605804	57613804	57608589	8000	57609804	-4000	4000	-1215
chr12	56337597	56345597	56343835	8000	56341597	-4000	4000	2238
chr12	76340474	76348474	76346339	8000	76344474	-4000	4000	1865
chr12	108617895	108625895	108623831	8000	108621895	-4000	4000	1936
chr12	1832753	1840753	1834428	8000	1836753	-4000	4000	-2325
chr12	56783790	56791790	56787249	8000	56787790	-4000	4000	-541
chr12	53942544	53950544	53945244	8000	53946544	-4000	4000	-1300
chr12	108641109	108649109	108648746	8000	108645109	-4000	4000	3637
chr12	57513569	57521569	57516513	8000	57517569	-4000	4000	-1056
chr12	8051517	8059517	8059027	8000	8055517	-4000	4000	3510
chr12	47232662	47240662	47236345	8000	47236662	-4000	4000	-317
chr12	55831433	55839433	55838555	8000	55835433	-4000	4000	3122
chr12	55831433	55839433	55838707	8000	55835433	-4000	4000	3274
chr12	57513569	57521569	57516500	8000	57517569	-4000	4000	-1069
chr12	8217260	8225260	8224116	8000	8221260	-4000	4000	2856
chr12	132700985	132708985	132701337	8000	132704985	-4000	4000	-3648
chr12	42455715	42463715	42459896	8000	42459715	-4000	4000	181
chr12	64498114	64506114	64502036	8000	64502114	-4000	4000	-78
chr12	95511839	95519839	95517915	8000	95515839	-4000	4000	2076
chr12	26962650	26970650	26964812	8000	26966650	-4000	4000	-1838
chr12	76340474	76348474	76347240	8000	76344474	-4000	4000	2766
chr12	18076869	18084869	18081266	8000	18080869	-4000	4000	397
chr12	68741809	68749809	68741930	8000	68745809	-4000	4000	-3879
chr12	52281913	52289913	52287996	8000	52285913	-4000	4000	2083
chr12	57619409	57627409	57620198	8000	57623409	-4000	4000	-3211
chr12	130161740	130169740	130164673	8000	130165740	-4000	4000	-1067
chr12	57605804	57613804	57613630	8000	57609804	-4000	4000	3826
chr12	61704273	61712273	61710268	8000	61708273	-4000	4000	1995
chr12	95511839	95519839	95514264	8000	95515839	-4000	4000	-1575
chr12	110486385	110494385	110486553	8000	110490385	-4000	4000	-3832
chr12	120439964	120447964	120444845	8000	120443964	-4000	4000	881
chr12	7808512	7816512	7814239	8000	7812512	-4000	4000	1727
chr12	52305163	52313163	52308369	8000	52309163	-4000	4000	-794
chr12	47071707	47079707	47077844	8000	47075707	-4000	4000	2137
chr12	106973277	106981277	106977744	8000	106977277	-4000	4000	467
chr12	49270600	49278600	49272339	8000	49274600	-4000	4000	-2261
chr12	9748486	9756486	9754494	8000	9752486	-4000	4000	2008
chr12	52073495	52081495	52077106	8000	52077495	-4000	4000	-389
chr12	8529305	8537305	8537263	8000	8533305	-4000	4000	3958
chr12	16544372	16552372	16550495	8000	16548372	-4000	4000	2123
chr12	41570745	41578745	41573437	8000	41574745	-4000	4000	-1308
chr12	48649211	48657211	48653548	8000	48653211	-4000	4000	337
chr12	52305163	52313163	52306059	8000	52309163	-4000	4000	-3104
chr12	56266966	56274966	56273122	8000	56270966	-4000	4000	2156
chr12	57815927	57823927	57821457	8000	57819927	-4000	4000	1530
chr12	121835527	121843527	121839627	8000	121839527	-4000	4000	100
chr12	122499454	122507454	122505622	8000	122503454	-4000	4000	2168
chr12	123405353	123413353	123407893	8000	123409353	-4000	4000	-1460
chr12	120758510	120766510	120765060	8000	120762510	-4000	4000	2550
chr12	48649211	48657211	48654972	8000	48653211	-4000	4000	1761
chr12	6614835	6622835	6621081	8000	6618835	-4000	4000	2246
chr12	52442651	52450651	52450426	8000	52446651	-4000	4000	3775
chr12	102832889	102840889	102840489	8000	102836889	-4000	4000	3600
chr12	110715680	110723680	110722252	8000	110719680	-4000	4000	2572
chr12	56034435	56042435	56035040	8000	56038435	-4000	4000	-3395
chr12	52802549	52810549	52807731	8000	52806549	-4000	4000	1182
chr12	113007723	113015723	113009107	8000	113011723	-4000	4000	-2616
chr12	52442651	52450651	52447874	8000	52446651	-4000	4000	1223
chr12	105070197	105078197	105070734	8000	105074197	-4000	4000	-3463
chr12	121999927	122007927	122003692	8000	122003927	-4000	4000	-235
chr12	29496840	29504840	29497620	8000	29500840	-4000	4000	-3220
chr12	31667142	31675142	31668121	8000	31671142	-4000	4000	-3021
chr12	6727875	6735875	6730773	8000	6731875	-4000	4000	-1102
chr12	8217260	8225260	8222345	8000	8221260	-4000	4000	1085
chr12	6634075	6642075	6638177	8000	6638075	-4000	4000	102
chr12	48142404	48150404	48145257	8000	48146404	-4000	4000	-1147
chr12	123914660	123922660	123918730	8000	123918660	-4000	4000	70
chr12	52442651	52450651	52450460	8000	52446651	-4000	4000	3809
chr12	54640589	54648589	54645654	8000	54644589	-4000	4000	1065
chr12	52305163	52313163	52306243	8000	52309163	-4000	4000	-2920
chr12	9144840	9152840	9148952	8000	9148840	-4000	4000	112
chr12	56994836	57002836	56995860	8000	56998836	-4000	4000	-2976
chr12	6727875	6735875	6731067	8000	6731875	-4000	4000	-808
chr12	12469282	12477282	12476718	8000	12473282	-4000	4000	3436
chr12	27691564	27699564	27691778	8000	27695564	-4000	4000	-3786
chr12	48563684	48571684	48569967	8000	48567684	-4000	4000	2283
chr12	50096707	50104707	50104593	8000	50100707	-4000	4000	3886
chr12	51240558	51248558	51246160	8000	51244558	-4000	4000	1602
chr12	53187323	53195323	53193762	8000	53191323	-4000	4000	2439
chr12	53942544	53950544	53944999	8000	53946544	-4000	4000	-1545
chr12	54575239	54583239	54581003	8000	54579239	-4000	4000	1764
chr12	54575239	54583239	54582791	8000	54579239	-4000	4000	3552
chr12	57619409	57627409	57619960	8000	57623409	-4000	4000	-3449
chr12	106973277	106981277	106977351	8000	106977277	-4000	4000	74
chr12	122267432	122275432	122274038	8000	122271432	-4000	4000	2606
chr12	26967579	26975579	26973974	8000	26971579	-4000	4000	2395
chr12	51056424	51064424	51064017	8000	51060424	-4000	4000	3593
chr12	6324757	6332757	6330006	8000	6328757	-4000	4000	1249
chr12	6646301	6654301	6646968	8000	6650301	-4000	4000	-3333
chr12	8217260	8225260	8222027	8000	8221260	-4000	4000	767
chr12	10600193	10608193	10606314	8000	10604193	-4000	4000	2121
chr12	14780582	14788582	14786840	8000	14784582	-4000	4000	2258
chr12	16033381	16041381	16036320	8000	16037381	-4000	4000	-1061
chr12	48762194	48770194	48768023	8000	48766194	-4000	4000	1829
chr12	50476004	50484004	50477602	8000	50480004	-4000	4000	-2402
chr12	54030888	54038888	54033357	8000	54034888	-4000	4000	-1531
chr12	57815927	57823927	57820079	8000	57819927	-4000	4000	152
chr12	70634073	70642073	70635717	8000	70638073	-4000	4000	-2356
chr12	103984987	103992987	103985653	8000	103988987	-4000	4000	-3334
chr12	105165130	105173130	105168164	8000	105169130	-4000	4000	-966
chr12	113188368	113196368	113195739	8000	113192368	-4000	4000	3371
chr12	52802549	52810549	52807745	8000	52806549	-4000	4000	1196
chr12	21631342	21639342	21637158	8000	21635342	-4000	4000	1816
chr12	130785600	130793600	130790843	8000	130789600	-4000	4000	1243
chr12	6324757	6332757	6329221	8000	6328757	-4000	4000	464
chr12	21467250	21475250	21468710	8000	21471250	-4000	4000	-2540
chr12	109846945	109854945	109852693	8000	109850945	-4000	4000	1748
chr12	41570745	41578745	41573410	8000	41574745	-4000	4000	-1335
chr12	49640666	49648666	49641742	8000	49644666	-4000	4000	-2924
chr12	50079611	50087611	50079920	8000	50083611	-4000	4000	-3691
chr12	56947431	56955431	56952071	8000	56951431	-4000	4000	640
chr12	121013763	121021763	121020591	8000	121017763	-4000	4000	2828
chr12	122710756	122718756	122716312	8000	122714756	-4000	4000	1556
chr12	122710756	122718756	122716313	8000	122714756	-4000	4000	1557
chr12	7067032	7075032	7068464	8000	7071032	-4000	4000	-2568
chr12	6614835	6622835	6621339	8000	6618835	-4000	4000	2504
chr12	6766952	6774952	6773022	8000	6770952	-4000	4000	2070
chr12	22059773	22067773	22060876	8000	22063773	-4000	4000	-2897
chr12	56109910	56117910	56110645	8000	56113910	-4000	4000	-3265
chr12	61704273	61712273	61710304	8000	61708273	-4000	4000	2031
chr12	100624288	100632288	100624417	8000	100628288	-4000	4000	-3871
chr12	10219128	10227128	10222109	8000	10223128	-4000	4000	-1019
chr12	6342843	6350843	6347874	8000	6346843	-4000	4000	1031
chr12	7154945	7162945	7156427	8000	7158945	-4000	4000	-2518
chr12	48142404	48150404	48143768	8000	48146404	-4000	4000	-2636
chr12	51511763	51519763	51514341	8000	51515763	-4000	4000	-1422
chr12	52442651	52450651	52450455	8000	52446651	-4000	4000	3804
chr12	52464516	52472516	52471722	8000	52468516	-4000	4000	3206
chr12	56034435	56042435	56036003	8000	56038435	-4000	4000	-2432
chr12	56337597	56345597	56343454	8000	56341597	-4000	4000	1857
chr12	88488793	88496793	88493207	8000	88492793	-4000	4000	414
chr12	102008130	102016130	102013097	8000	102012130	-4000	4000	967
chr12	110023028	110031028	110028592	8000	110027028	-4000	4000	1564
chr12	112401189	112409189	112408629	8000	112405189	-4000	4000	3440
chr12	118145801	118153801	118152230	8000	118149801	-4000	4000	2429
chr12	123931720	123939720	123931995	8000	123935720	-4000	4000	-3725
chr12	130785600	130793600	130791445	8000	130789600	-4000	4000	1845
chr12	6766952	6774952	6773302	8000	6770952	-4000	4000	2350
chr12	42308086	42316086	42313743	8000	42312086	-4000	4000	1657
chr12	101382618	101390618	101383643	8000	101386618	-4000	4000	-2975
chr12	110623841	110631841	110626380	8000	110627841	-4000	4000	-1461
chr12	132619753	132627753	132624925	8000	132623753	-4000	4000	1172
chr12	22059773	22067773	22060889	8000	22063773	-4000	4000	-2884
chr12	53098345	53106345	53101151	8000	53102345	-4000	4000	-1194
chr12	53942544	53950544	53946323	8000	53946544	-4000	4000	-221
chr12	55680568	55688568	55685019	8000	55684568	-4000	4000	451
chr12	102192459	102200459	102197018	8000	102196459	-4000	4000	559
chr12	71694968	71702968	71701181	8000	71698968	-4000	4000	2213
chr12	41570745	41578745	41573317	8000	41574745	-4000	4000	-1428
chr12	41570745	41578745	41573208	8000	41574745	-4000	4000	-1537
chr12	52510575	52518575	52517704	8000	52514575	-4000	4000	3129
chr12	71582310	71590310	71584533	8000	71586310	-4000	4000	-1777
chr12	113094819	113102819	113096918	8000	113098819	-4000	4000	-1901
chr12	113188368	113196368	113195724	8000	113192368	-4000	4000	3356
chr12	131137469	131145469	131139216	8000	131141469	-4000	4000	-2253
chr12	6634075	6642075	6640412	8000	6638075	-4000	4000	2337
chr12	26116030	26124030	26123675	8000	26120030	-4000	4000	3645
chr12	55950027	55958027	55953687	8000	55954027	-4000	4000	-340
chr12	6774455	6782455	6778037	8000	6778455	-4000	4000	-418
chr12	53206567	53214567	53213241	8000	53210567	-4000	4000	2674
chr12	1643212	1651212	1646084	8000	1647212	-4000	4000	-1128
chr12	106233881	106241881	106238093	8000	106237881	-4000	4000	212
chr12	95996753	96004753	96000938	8000	96000753	-4000	4000	185
chr12	56109910	56117910	56110989	8000	56113910	-4000	4000	-2921
chr12	52670736	52678736	52677409	8000	52674736	-4000	4000	2673
chr12	54358445	54366445	54363571	8000	54362445	-4000	4000	1126
chr12	69270358	69278358	69273043	8000	69274358	-4000	4000	-1315
chr12	41068415	41076415	41070079	8000	41072415	-4000	4000	-2336
chr12	52073495	52081495	52073704	8000	52077495	-4000	4000	-3791
chr12	907736	915736	914062	8000	911736	-4000	4000	2326
chr12	30705552	30713552	30711747	8000	30709552	-4000	4000	2195
chr12	4611508	4619508	4612573	8000	4615508	-4000	4000	-2935
chr12	122622396	122630396	122622469	8000	122626396	-4000	4000	-3927
chr12	39546033	39554033	39553831	8000	39550033	-4000	4000	3798
chr12	52817408	52825408	52824306	8000	52821408	-4000	4000	2898
chr12	108246537	108254537	108248006	8000	108250537	-4000	4000	-2531
chr12	111346554	111354554	111347663	8000	111350554	-4000	4000	-2891
chr12	57619409	57627409	57624950	8000	57623409	-4000	4000	1541
chr12	6816799	6824799	6817269	8000	6820799	-4000	4000	-3530
chr12	55950027	55958027	55953843	8000	55954027	-4000	4000	-184
chr12	117027148	117035148	117028217	8000	117031148	-4000	4000	-2931
chr12	51056424	51064424	51056452	8000	51060424	-4000	4000	-3972
chr12	69270358	69278358	69273119	8000	69274358	-4000	4000	-1239
chr12	16544372	16552372	16551122	8000	16548372	-4000	4000	2750
chr12	113188368	113196368	113195793	8000	113192368	-4000	4000	3425
chr12	120439964	120447964	120446386	8000	120443964	-4000	4000	2422
chr12	6534374	6542374	6540533	8000	6538374	-4000	4000	2159
chr12	106885316	106893316	106886819	8000	106889316	-4000	4000	-2497
chr12	186077	194077	193333	8000	190077	-4000	4000	3256
chr12	100337715	100345715	100339438	8000	100341715	-4000	4000	-2277
chr12	6662477	6670477	6667636	8000	6666477	-4000	4000	1159
chr12	57619409	57627409	57625135	8000	57623409	-4000	4000	1726
chr12	117027148	117035148	117027478	8000	117031148	-4000	4000	-3670
chr12	49093136	49101136	49097694	8000	49097136	-4000	4000	558
chr12	6816799	6824799	6819442	8000	6820799	-4000	4000	-1357
chr12	6835847	6843847	6839400	8000	6839847	-4000	4000	-447
chr12	10065554	10073554	10065655	8000	10069554	-4000	4000	-3899
chr12	76849696	76857696	76850872	8000	76853696	-4000	4000	-2824
chr12	85878992	85886992	85882304	8000	85882992	-4000	4000	-688
chr12	27321959	27329959	27322367	8000	27325959	-4000	4000	-3592
chr12	34025694	34033694	34026168	8000	34029694	-4000	4000	-3526
chr12	108617895	108625895	108623022	8000	108621895	-4000	4000	1127
chr12	53060379	53068379	53068172	8000	53064379	-4000	4000	3793
chr12	57209361	57217361	57211296	8000	57213361	-4000	4000	-2065
chr12	102832889	102840889	102839154	8000	102836889	-4000	4000	2265
chr12	98609405	98617405	98614192	8000	98613405	-4000	4000	787
chr12	105169297	105177297	105174072	8000	105173297	-4000	4000	775
chr12	122467599	122475599	122473583	8000	122471599	-4000	4000	1984
chr12	14800650	14808650	14805773	8000	14804650	-4000	4000	1123
chr12	42153104	42161104	42160475	8000	42157104	-4000	4000	3371
chr12	49123782	49131782	49127969	8000	49127782	-4000	4000	187
chr12	56266966	56274966	56273499	8000	56270966	-4000	4000	2533
chr12	56266966	56274966	56274833	8000	56270966	-4000	4000	3867
chr12	57249762	57257762	57255054	8000	57253762	-4000	4000	1292
chr12	58868149	58876149	58872440	8000	58872149	-4000	4000	291
chr12	71694968	71702968	71697330	8000	71698968	-4000	4000	-1638
chr12	110214793	110222793	110218295	8000	110218793	-4000	4000	-498
chr12	8217260	8225260	8221985	8000	8221260	-4000	4000	725
chr12	122697293	122705293	122703163	8000	122701293	-4000	4000	1870
chr12	123704399	123712399	123704644	8000	123708399	-4000	4000	-3755
chr12	71582310	71590310	71584426	8000	71586310	-4000	4000	-1884
chr12	6234271	6242271	6235559	8000	6238271	-4000	4000	-2712
chr12	52802549	52810549	52808831	8000	52806549	-4000	4000	2282
chr12	8217260	8225260	8223542	8000	8221260	-4000	4000	2282
chr12	76340474	76348474	76347255	8000	76344474	-4000	4000	2781
chr12	55680568	55688568	55682251	8000	55684568	-4000	4000	-2317
chr12	70350993	70358993	70353969	8000	70354993	-4000	4000	-1024
chr12	6840793	6848793	6842997	8000	6844793	-4000	4000	-1796
chr12	54575239	54583239	54582774	8000	54579239	-4000	4000	3535
chr12	55950027	55958027	55952385	8000	55954027	-4000	4000	-1642
chr12	92766637	92774637	92772552	8000	92770637	-4000	4000	1915
chr12	76849696	76857696	76852141	8000	76853696	-4000	4000	-1555
chr12	51993078	52001078	51995043	8000	51997078	-4000	4000	-2035
chr12	55950027	55958027	55957489	8000	55954027	-4000	4000	3462
chr12	102192459	102200459	102197165	8000	102196459	-4000	4000	706
chr12	102956513	102964513	102960328	8000	102960513	-4000	4000	-185
chr12	6840793	6848793	6843481	8000	6844793	-4000	4000	-1312
chr12	121999927	122007927	122003905	8000	122003927	-4000	4000	-22
chr12	43785543	43793543	43786813	8000	43789543	-4000	4000	-2730
chr12	9748486	9756486	9755143	8000	9752486	-4000	4000	2657
chr12	48181926	48189926	48184417	8000	48185926	-4000	4000	-1509
chr12	118028687	118036687	118033897	8000	118032687	-4000	4000	1210
chr12	71121085	71129085	71125373	8000	71125085	-4000	4000	288
chr12	95511839	95519839	95511981	8000	95515839	-4000	4000	-3858
chr12	110486385	110494385	110491857	8000	110490385	-4000	4000	1472
chr12	110623841	110631841	110626422	8000	110627841	-4000	4000	-1419
chr12	51182936	51190936	51190202	8000	51186936	-4000	4000	3266
chr12	132581188	132589188	132581456	8000	132585188	-4000	4000	-3732
chr12	10065554	10073554	10073402	8000	10069554	-4000	4000	3848
chr12	53153663	53161663	53158619	8000	53157663	-4000	4000	956
chr12	2937138	2945138	2939584	8000	2941138	-4000	4000	-1554
chr12	6387571	6395571	6388421	8000	6391571	-4000	4000	-3150
chr12	9590551	9598551	9595370	8000	9594551	-4000	4000	819
chr12	25205645	25213645	25209569	8000	25209645	-4000	4000	-76
chr12	26116030	26124030	26122959	8000	26120030	-4000	4000	2929
chr12	27691564	27699564	27691784	8000	27695564	-4000	4000	-3780
chr12	40365285	40373285	40367703	8000	40369285	-4000	4000	-1582
chr12	47071707	47079707	47077991	8000	47075707	-4000	4000	2284
chr12	49060676	49068676	49065126	8000	49064676	-4000	4000	450
chr12	49180686	49188686	49186681	8000	49184686	-4000	4000	1995
chr12	49327731	49335731	49330302	8000	49331731	-4000	4000	-1429
chr12	49640666	49648666	49644159	8000	49644666	-4000	4000	-507
chr12	49760934	49768934	49761701	8000	49764934	-4000	4000	-3233
chr12	49832043	49840043	49838945	8000	49836043	-4000	4000	2902
chr12	49972923	49980923	49973522	8000	49976923	-4000	4000	-3401
chr12	50171788	50179788	50177072	8000	50175788	-4000	4000	1284
chr12	50744657	50752657	50744810	8000	50748657	-4000	4000	-3847
chr12	52464516	52472516	52469209	8000	52468516	-4000	4000	693
chr12	52510575	52518575	52517172	8000	52514575	-4000	4000	2597
chr12	53098345	53106345	53105600	8000	53102345	-4000	4000	3255
chr12	56783790	56791790	56784863	8000	56787790	-4000	4000	-2927
chr12	57468264	57476264	57472500	8000	57472264	-4000	4000	236
chr12	57468264	57476264	57475607	8000	57472264	-4000	4000	3343
chr12	57468264	57476264	57475932	8000	57472264	-4000	4000	3668
chr12	57605804	57613804	57613580	8000	57609804	-4000	4000	3776
chr12	61704273	61712273	61710256	8000	61708273	-4000	4000	1983
chr12	70350993	70358993	70353912	8000	70354993	-4000	4000	-1081
chr12	76340474	76348474	76346362	8000	76344474	-4000	4000	1888
chr12	76854709	76862709	76860409	8000	76858709	-4000	4000	1700
chr12	92766637	92774637	92770333	8000	92770637	-4000	4000	-304
chr12	95298799	95306799	95300243	8000	95302799	-4000	4000	-2556
chr12	98609405	98617405	98613591	8000	98613405	-4000	4000	186
chr12	102192459	102200459	102197668	8000	102196459	-4000	4000	1209
chr12	104113086	104121086	104119681	8000	104117086	-4000	4000	2595
chr12	106233881	106241881	106239728	8000	106237881	-4000	4000	1847
chr12	110214793	110222793	110218389	8000	110218793	-4000	4000	-404
chr12	110368900	110376900	110376179	8000	110372900	-4000	4000	3279
chr12	112972460	112980460	112978667	8000	112976460	-4000	4000	2207
chr12	120494493	120502493	120498117	8000	120498493	-4000	4000	-376
chr12	120758510	120766510	120766278	8000	120762510	-4000	4000	3768
chr12	122267432	122275432	122273021	8000	122271432	-4000	4000	1589
chr12	122697293	122705293	122702444	8000	122701293	-4000	4000	1151
chr12	123704399	123712399	123704617	8000	123708399	-4000	4000	-3782
chr12	49180686	49188686	49185138	8000	49184686	-4000	4000	452
chr12	108617895	108625895	108623886	8000	108621895	-4000	4000	1991
chr12	123931720	123939720	123933458	8000	123935720	-4000	4000	-2262
chr12	57619409	57627409	57626906	8000	57623409	-4000	4000	3497
chr12	54288111	54296111	54292790	8000	54292111	-4000	4000	679
chr12	47232662	47240662	47236180	8000	47236662	-4000	4000	-482
chr12	30705552	30713552	30711755	8000	30709552	-4000	4000	2203
chr12	71582310	71590310	71582470	8000	71586310	-4000	4000	-3840
chr12	6816799	6824799	6823698	8000	6820799	-4000	4000	2899
chr12	118414033	118422033	118414434	8000	118418033	-4000	4000	-3599
chr12	14800650	14808650	14805773	8000	14804650	-4000	4000	1123
chr12	32741650	32749650	32746989	8000	32745650	-4000	4000	1339
chr12	108284044	108292044	108291894	8000	108288044	-4000	4000	3850
chr12	6835847	6843847	6838018	8000	6839847	-4000	4000	-1829
chr12	122710756	122718756	122715451	8000	122714756	-4000	4000	695
chr12	438642	446642	440707	8000	442642	-4000	4000	-1935
chr12	6487886	6495886	6492417	8000	6491886	-4000	4000	531
chr12	7915230	7923230	7921286	8000	7919230	-4000	4000	2056
chr12	7915230	7923230	7921447	8000	7919230	-4000	4000	2217
chr12	8936361	8944361	8936956	8000	8940361	-4000	4000	-3405
chr12	10065554	10073554	10065594	8000	10069554	-4000	4000	-3960
chr12	10600193	10608193	10607878	8000	10604193	-4000	4000	3685
chr12	12641108	12649108	12642152	8000	12645108	-4000	4000	-2956
chr12	12656890	12664890	12661119	8000	12660890	-4000	4000	229
chr12	12913937	12921937	12915712	8000	12917937	-4000	4000	-2225
chr12	14800650	14808650	14800783	8000	14804650	-4000	4000	-3867
chr12	14800650	14808650	14806458	8000	14804650	-4000	4000	1808
chr12	14938031	14946031	14938425	8000	14942031	-4000	4000	-3606
chr12	21467250	21475250	21470206	8000	21471250	-4000	4000	-1044
chr12	21467250	21475250	21471158	8000	21471250	-4000	4000	-92
chr12	21467250	21475250	21471601	8000	21471250	-4000	4000	351
chr12	21760955	21768955	21765929	8000	21764955	-4000	4000	974
chr12	21793389	21801389	21800883	8000	21797389	-4000	4000	3494
chr12	26962650	26970650	26963435	8000	26966650	-4000	4000	-3215
chr12	26962650	26970650	26964829	8000	26966650	-4000	4000	-1821
chr12	41570745	41578745	41573604	8000	41574745	-4000	4000	-1141
chr12	43789723	43797723	43795525	8000	43793723	-4000	4000	1802
chr12	45915131	45923131	45922037	8000	45919131	-4000	4000	2906
chr12	47232662	47240662	47236171	8000	47236662	-4000	4000	-491
chr12	48824941	48832941	48830552	8000	48828941	-4000	4000	1611
chr12	49640666	49648666	49643703	8000	49644666	-4000	4000	-963
chr12	49972923	49980923	49975521	8000	49976923	-4000	4000	-1402
chr12	50079611	50087611	50080715	8000	50083611	-4000	4000	-2896
chr12	52011889	52019889	52013905	8000	52015889	-4000	4000	-1984
chr12	52670736	52678736	52678597	8000	52674736	-4000	4000	3861
chr12	54544243	54552243	54549962	8000	54548243	-4000	4000	1719
chr12	54626811	54634811	54631741	8000	54630811	-4000	4000	930
chr12	55680568	55688568	55684991	8000	55684568	-4000	4000	423
chr12	57468264	57476264	57471492	8000	57472264	-4000	4000	-772
chr12	57599418	57607418	57606984	8000	57603418	-4000	4000	3566
chr12	63805792	63813792	63808980	8000	63809792	-4000	4000	-812
chr12	65244355	65252355	65246291	8000	65248355	-4000	4000	-2064
chr12	65962291	65970291	65963281	8000	65966291	-4000	4000	-3010
chr12	75499863	75507863	75499994	8000	75503863	-4000	4000	-3869
chr12	76340474	76348474	76346912	8000	76344474	-4000	4000	2438
chr12	76849696	76857696	76851060	8000	76853696	-4000	4000	-2636
chr12	89584049	89592049	89591292	8000	89588049	-4000	4000	3243
chr12	90959682	90967682	90964263	8000	90963682	-4000	4000	581
chr12	91046491	91054491	91051508	8000	91050491	-4000	4000	1017
chr12	93404146	93412146	93409778	8000	93408146	-4000	4000	1632
chr12	94302449	94310449	94310025	8000	94306449	-4000	4000	3576
chr12	101389116	101397116	101395640	8000	101393116	-4000	4000	2524
chr12	102192459	102200459	102197311	8000	102196459	-4000	4000	852
chr12	102192459	102200459	102197646	8000	102196459	-4000	4000	1187
chr12	102832889	102840889	102840477	8000	102836889	-4000	4000	3588
chr12	103984987	103992987	103987127	8000	103988987	-4000	4000	-1860
chr12	106973277	106981277	106977620	8000	106977277	-4000	4000	343
chr12	112156188	112164188	112162428	8000	112160188	-4000	4000	2240
chr12	114666255	114674255	114671915	8000	114670255	-4000	4000	1660
chr12	116572606	116580606	116575950	8000	116576606	-4000	4000	-656
chr12	123594582	123602582	123596763	8000	123598582	-4000	4000	-1819
chr12	130161740	130169740	130164193	8000	130165740	-4000	4000	-1547
chr12	133100779	133108779	133106491	8000	133104779	-4000	4000	1712
chr12	133198369	133206369	133204085	8000	133202369	-4000	4000	1716
chr12	14821569	14829569	14829395	8000	14825569	-4000	4000	3826
chr12	26967579	26975579	26974013	8000	26971579	-4000	4000	2434
chr12	114349911	114357911	114355794	8000	114353911	-4000	4000	1883
chr12	114349911	114357911	114355941	8000	114353911	-4000	4000	2030
chr12	123405353	123413353	123407745	8000	123409353	-4000	4000	-1608
chr12	12656890	12664890	12662260	8000	12660890	-4000	4000	1370
chr12	52464516	52472516	52469423	8000	52468516	-4000	4000	907
chr12	7154945	7162945	7158137	8000	7158945	-4000	4000	-808
chr12	51993078	52001078	51994019	8000	51997078	-4000	4000	-3059
chr12	48038897	48046897	48045336	8000	48042897	-4000	4000	2439
chr12	52281913	52289913	52287713	8000	52285913	-4000	4000	1800
chr12	103936763	103944763	103938421	8000	103940763	-4000	4000	-2342
chr12	42455715	42463715	42459687	8000	42459715	-4000	4000	-28
chr12	49640666	49648666	49643148	8000	49644666	-4000	4000	-1518
chr12	51240558	51248558	51245383	8000	51244558	-4000	4000	825
chr12	51240558	51248558	51245385	8000	51244558	-4000	4000	827
chr12	106059345	106067345	106067089	8000	106063345	-4000	4000	3744
chr12	95511839	95519839	95517795	8000	95515839	-4000	4000	1956
chr12	55950027	55958027	55955534	8000	55954027	-4000	4000	1507
chr12	47071707	47079707	47078007	8000	47075707	-4000	4000	2300
chr12	55680568	55688568	55681999	8000	55684568	-4000	4000	-2569
chr12	56592193	56600193	56599171	8000	56596193	-4000	4000	2978
chr12	95511839	95519839	95511897	8000	95515839	-4000	4000	-3942
chr12	10219128	10227128	10221871	8000	10223128	-4000	4000	-1257
chr12	10219128	10227128	10221973	8000	10223128	-4000	4000	-1155
chr12	57249762	57257762	57254777	8000	57253762	-4000	4000	1015
chr12	57468264	57476264	57469665	8000	57472264	-4000	4000	-2599
chr12	109532705	109540705	109534547	8000	109536705	-4000	4000	-2158
chr12	12641108	12649108	12642907	8000	12645108	-4000	4000	-2201
chr12	186077	194077	192500	8000	190077	-4000	4000	2423
chr12	68741809	68749809	68741898	8000	68745809	-4000	4000	-3911
chr12	53477162	53485162	53483704	8000	53481162	-4000	4000	2542
chr12	22059773	22067773	22061312	8000	22063773	-4000	4000	-2461
chr12	52442651	52450651	52447408	8000	52446651	-4000	4000	757
chr12	56994836	57002836	57002361	8000	56998836	-4000	4000	3525
chr12	122267432	122275432	122272530	8000	122271432	-4000	4000	1098
chr12	50171788	50179788	50177199	8000	50175788	-4000	4000	1411
chr12	117137991	117145991	117145861	8000	117141991	-4000	4000	3870
chr12	41570745	41578745	41572744	8000	41574745	-4000	4000	-2001
chr12	111346554	111354554	111347871	8000	111350554	-4000	4000	-2683
chr12	43785543	43793543	43786504	8000	43789543	-4000	4000	-3039
chr12	118145801	118153801	118152339	8000	118149801	-4000	4000	2538
chr12	121304245	121312245	121309773	8000	121308245	-4000	4000	1528
chr12	10065554	10073554	10065856	8000	10069554	-4000	4000	-3698
chr12	21760955	21768955	21766321	8000	21764955	-4000	4000	1366
chr12	27954084	27962084	27958288	8000	27958084	-4000	4000	204
chr12	123704399	123712399	123707039	8000	123708399	-4000	4000	-1360
chr12	6342843	6350843	6348982	8000	6346843	-4000	4000	2139
chr12	114666255	114674255	114674242	8000	114670255	-4000	4000	3987
chr12	6816799	6824799	6819298	8000	6820799	-4000	4000	-1501
chr12	7085587	7093587	7091549	8000	7089587	-4000	4000	1962
chr12	34025694	34033694	34026421	8000	34029694	-4000	4000	-3273
chr12	47232662	47240662	47235833	8000	47236662	-4000	4000	-829
chr12	48563684	48571684	48567970	8000	48567684	-4000	4000	286
chr12	49523425	49531425	49526018	8000	49527425	-4000	4000	-1407
chr12	54358445	54366445	54362785	8000	54362445	-4000	4000	340
chr12	54571387	54579387	54577447	8000	54575387	-4000	4000	2060
chr12	69597570	69605570	69597676	8000	69601570	-4000	4000	-3894
chr12	123405353	123413353	123407624	8000	123409353	-4000	4000	-1729
chr12	6816799	6824799	6824383	8000	6820799	-4000	4000	3584
chr12	47232662	47240662	47236292	8000	47236662	-4000	4000	-370
chr12	26901181	26909181	26905412	8000	26905181	-4000	4000	231
chr12	56947431	56955431	56951866	8000	56951431	-4000	4000	435
chr12	6234271	6242271	6235559	8000	6238271	-4000	4000	-2712
chr12	6487886	6495886	6492956	8000	6491886	-4000	4000	1070
chr12	106506198	106514198	106509633	8000	106510198	-4000	4000	-565
chr12	57209361	57217361	57211303	8000	57213361	-4000	4000	-2058
chr12	49014975	49022975	49021615	8000	49018975	-4000	4000	2640
chr12	49180686	49188686	49186670	8000	49184686	-4000	4000	1984
chr12	56947431	56955431	56951984	8000	56951431	-4000	4000	553
chr12	16033381	16041381	16036817	8000	16037381	-4000	4000	-564
chr12	31667142	31675142	31667913	8000	31671142	-4000	4000	-3229
chr12	41570745	41578745	41573361	8000	41574745	-4000	4000	-1384
chr12	45915131	45923131	45922120	8000	45919131	-4000	4000	2989
chr12	76340474	76348474	76346706	8000	76344474	-4000	4000	2232
chr12	91046491	91054491	91051478	8000	91050491	-4000	4000	987
chr12	52011889	52019889	52014189	8000	52015889	-4000	4000	-1700
chr12	15103783	15111783	15109101	8000	15107783	-4000	4000	1318
chr12	57209361	57217361	57212526	8000	57213361	-4000	4000	-835
chr12	66343431	66351431	66349039	8000	66347431	-4000	4000	1608
chr12	106059345	106067345	106067273	8000	106063345	-4000	4000	3928
chr12	6727875	6735875	6731215	8000	6731875	-4000	4000	-660
chr12	128703911	128711911	128705201	8000	128707911	-4000	4000	-2710
chr12	110214793	110222793	110218252	8000	110218793	-4000	4000	-541
chr12	123658604	123666604	123659795	8000	123662604	-4000	4000	-2809
chr12	71923248	71931248	71923943	8000	71927248	-4000	4000	-3305
chr12	56994836	57002836	57002831	8000	56998836	-4000	4000	3995
chr12	98722457	98730457	98723218	8000	98726457	-4000	4000	-3239
chr12	119681791	119689791	119687494	8000	119685791	-4000	4000	1703
chr12	95511839	95519839	95518024	8000	95515839	-4000	4000	2185
chr12	81257210	81265210	81263277	8000	81261210	-4000	4000	2067
chr12	106973277	106981277	106978571	8000	106977277	-4000	4000	1294
chr12	1561993	1569993	1566629	8000	1565993	-4000	4000	636
chr12	89415718	89423718	89421217	8000	89419718	-4000	4000	1499
chr12	96265824	96273824	96267251	8000	96269824	-4000	4000	-2573
chr12	55950027	55958027	55955327	8000	55954027	-4000	4000	1300
chr12	27691564	27699564	27697199	8000	27695564	-4000	4000	1635
chr12	49123782	49131782	49128752	8000	49127782	-4000	4000	970
chr12	70350993	70358993	70353999	8000	70354993	-4000	4000	-994
chr12	71605599	71613599	71610349	8000	71609599	-4000	4000	750
chr12	108585851	108593851	108591720	8000	108589851	-4000	4000	1869
chr12	53098345	53106345	53100741	8000	53102345	-4000	4000	-1604
chr12	130161740	130169740	130163053	8000	130165740	-4000	4000	-2687
chr12	10820960	10828960	10825900	8000	10824960	-4000	4000	940
chr12	31276584	31284584	31282736	8000	31280584	-4000	4000	2152
chr12	52510575	52518575	52517651	8000	52514575	-4000	4000	3076
chr12	51182936	51190936	51190092	8000	51186936	-4000	4000	3156
chr12	102192459	102200459	102196199	8000	102196459	-4000	4000	-260
chr12	94302449	94310449	94305223	8000	94306449	-4000	4000	-1226
chr12	6342843	6350843	6349201	8000	6346843	-4000	4000	2358
chr12	26331352	26339352	26338462	8000	26335352	-4000	4000	3110
chr12	47778722	47786722	47783747	8000	47782722	-4000	4000	1025
chr12	52310301	52318301	52316560	8000	52314301	-4000	4000	2259
chr12	50171788	50179788	50177835	8000	50175788	-4000	4000	2047
chr12	102192459	102200459	102197337	8000	102196459	-4000	4000	878
chr12	25201246	25209246	25204195	8000	25205246	-4000	4000	-1051
chr12	8052844	8060844	8059945	8000	8056844	-4000	4000	3101
chr12	78209010	78217010	78211639	8000	78213010	-4000	4000	-1371
chr12	109264226	109272226	109266287	8000	109268226	-4000	4000	-1939
chr12	52670736	52678736	52675496	8000	52674736	-4000	4000	760
chr12	133198369	133206369	133203937	8000	133202369	-4000	4000	1568
chr12	89343235	89351235	89348359	8000	89347235	-4000	4000	1124
chr12	122467599	122475599	122473540	8000	122471599	-4000	4000	1941
chr12	122467599	122475599	122473906	8000	122471599	-4000	4000	2307
chr12	111753107	111761107	111755668	8000	111757107	-4000	4000	-1439
chr12	48142404	48150404	48145650	8000	48146404	-4000	4000	-754
chr12	122722076	122730076	122729700	8000	122726076	-4000	4000	3624
chr12	71694968	71702968	71699275	8000	71698968	-4000	4000	307
chr12	53412446	53420446	53415680	8000	53416446	-4000	4000	-766
chr12	53289638	53297638	53295534	8000	53293638	-4000	4000	1896
chr12	6766952	6774952	6773283	8000	6770952	-4000	4000	2331
chr12	100337715	100345715	100338852	8000	100341715	-4000	4000	-2863
chr12	120499279	120507279	120503742	8000	120503279	-4000	4000	463
chr12	116572606	116580606	116576275	8000	116576606	-4000	4000	-331
chr12	6458237	6466237	6464942	8000	6462237	-4000	4000	2705
chr12	117027148	117035148	117028045	8000	117031148	-4000	4000	-3103
chr12	6527955	6535955	6528274	8000	6531955	-4000	4000	-3681
chr12	106973277	106981277	106977751	8000	106977277	-4000	4000	474
chr12	121835527	121843527	121839987	8000	121839527	-4000	4000	460
chr12	6487886	6495886	6492449	8000	6491886	-4000	4000	563
chr12	3036676	3044676	3038048	8000	3040676	-4000	4000	-2628
chr12	48038897	48046897	48045346	8000	48042897	-4000	4000	2449
chr12	49180686	49188686	49186334	8000	49184686	-4000	4000	1648
chr12	49640666	49648666	49642822	8000	49644666	-4000	4000	-1844
chr12	123466054	123474054	123472637	8000	123470054	-4000	4000	2583
chr12	130161740	130169740	130163956	8000	130165740	-4000	4000	-1784
chr12	7085587	7093587	7088932	8000	7089587	-4000	4000	-655
chr12	12656890	12664890	12661896	8000	12660890	-4000	4000	1006
chr12	21793389	21801389	21800946	8000	21797389	-4000	4000	3557
chr12	42308086	42316086	42313948	8000	42312086	-4000	4000	1862
chr12	49180686	49188686	49184980	8000	49184686	-4000	4000	294
chr12	54288111	54296111	54293165	8000	54292111	-4000	4000	1054
chr12	54358445	54366445	54362978	8000	54362445	-4000	4000	533
chr12	57209361	57217361	57210046	8000	57213361	-4000	4000	-3315
chr12	71582310	71590310	71584131	8000	71586310	-4000	4000	-2179
chr12	71605599	71613599	71613342	8000	71609599	-4000	4000	3743
chr12	106233881	106241881	106239344	8000	106237881	-4000	4000	1463
chr12	108518214	108526214	108518831	8000	108522214	-4000	4000	-3383
chr12	109084188	109092188	109085930	8000	109088188	-4000	4000	-2258
chr12	133198369	133206369	133203782	8000	133202369	-4000	4000	1413
chr12	133198369	133206369	133204009	8000	133202369	-4000	4000	1640
chr12	6662477	6670477	6663132	8000	6666477	-4000	4000	-3345
chr12	69597570	69605570	69597984	8000	69601570	-4000	4000	-3586
chr12	1561993	1569993	1566666	8000	1565993	-4000	4000	673
chr12	47232662	47240662	47235811	8000	47236662	-4000	4000	-851
chr12	50096707	50104707	50104656	8000	50100707	-4000	4000	3949
chr12	56592193	56600193	56598403	8000	56596193	-4000	4000	2210
chr12	89584049	89592049	89590318	8000	89588049	-4000	4000	2269
chr12	109779087	109787087	109786773	8000	109783087	-4000	4000	3686
chr12	123411039	123419039	123415515	8000	123415039	-4000	4000	476
chr12	88045016	88053016	88050415	8000	88049016	-4000	4000	1399
chr13	36297638	36305638	36304363	8000	36301638	-4000	4000	2725
chr13	110519066	110527066	110523684	8000	110523066	-4000	4000	618
chr13	52472628	52480628	52473937	8000	52476628	-4000	4000	-2691
chr13	20969036	20977036	20974786	8000	20973036	-4000	4000	1750
chr13	23887099	23895099	23891400	8000	23891099	-4000	4000	301
chr13	101706804	101714804	101714489	8000	101710804	-4000	4000	3685
chr13	69696594	69704594	69701495	8000	69700594	-4000	4000	901
chr13	41123569	41131569	41130567	8000	41127569	-4000	4000	2998
chr13	41185834	41193834	41193389	8000	41189834	-4000	4000	3555
chr13	96981713	96989713	96986489	8000	96985713	-4000	4000	776
chr13	39005865	39013865	39013395	8000	39009865	-4000	4000	3530
chr13	98789429	98797429	98794721	8000	98793429	-4000	4000	1292
chr13	108203439	108211439	108210437	8000	108207439	-4000	4000	2998
chr13	26040597	26048597	26046455	8000	26044597	-4000	4000	1858
chr13	37099259	37107259	37104841	8000	37103259	-4000	4000	1582
chr13	111301737	111309737	111303184	8000	111305737	-4000	4000	-2553
chr13	61405858	61413858	61411396	8000	61409858	-4000	4000	1538
chr13	85788790	85796790	85795540	8000	85792790	-4000	4000	2750
chr13	20969036	20977036	20974977	8000	20973036	-4000	4000	1941
chr13	106537673	106545673	106543770	8000	106541673	-4000	4000	2097
chr13	30760426	30768426	30764089	8000	30764426	-4000	4000	-337
chr13	19819482	19827482	19824574	8000	19823482	-4000	4000	1092
chr13	28291335	28299335	28294809	8000	28295335	-4000	4000	-526
chr13	36438870	36446870	36442178	8000	36442870	-4000	4000	-692
chr13	41185834	41193834	41192891	8000	41189834	-4000	4000	3057
chr13	51360735	51368735	51362821	8000	51364735	-4000	4000	-1914
chr13	35469789	35477789	35475780	8000	35473789	-4000	4000	1991
chr13	24878279	24886279	24885658	8000	24882279	-4000	4000	3379
chr13	37005312	37013312	37009396	8000	37009312	-4000	4000	84
chr13	25095254	25103254	25096241	8000	25099254	-4000	4000	-3013
chr13	28296346	28304346	28303255	8000	28300346	-4000	4000	2909
chr13	39005865	39013865	39013184	8000	39009865	-4000	4000	3319
chr13	41123569	41131569	41130621	8000	41127569	-4000	4000	3052
chr13	83873205	83881205	83880123	8000	83877205	-4000	4000	2918
chr13	108203439	108211439	108210569	8000	108207439	-4000	4000	3130
chr13	113145529	113153529	113149170	8000	113149529	-4000	4000	-359
chr13	37558583	37566583	37563321	8000	37562583	-4000	4000	738
chr13	110719339	110727339	110719351	8000	110723339	-4000	4000	-3988
chr13	26684948	26692948	26685840	8000	26688948	-4000	4000	-3108
chr13	113637473	113645473	113637884	8000	113641473	-4000	4000	-3589
chr13	80331976	80339976	80337103	8000	80335976	-4000	4000	1127
chr13	83873205	83881205	83879470	8000	83877205	-4000	4000	2265
chr13	113116685	113124685	113122863	8000	113120685	-4000	4000	2178
chr13	113145529	113153529	113147491	8000	113149529	-4000	4000	-2038
chr13	45389316	45397316	45397291	8000	45393316	-4000	4000	3975
chr13	95574202	95582202	95578058	8000	95578202	-4000	4000	-144
chr13	49695320	49703320	49701895	8000	49699320	-4000	4000	2575
chr13	113973783	113981783	113979268	8000	113977783	-4000	4000	1485
chr13	27271192	27279192	27273335	8000	27275192	-4000	4000	-1857
chr13	95575759	95583759	95582258	8000	95579759	-4000	4000	2499
chr13	113637473	113645473	113637884	8000	113641473	-4000	4000	-3589
chr13	69696594	69704594	69701585	8000	69700594	-4000	4000	991
chr13	78610289	78618289	78616320	8000	78614289	-4000	4000	2031
chr13	113320163	113328163	113324466	8000	113324163	-4000	4000	303
chr13	23887099	23895099	23891257	8000	23891099	-4000	4000	158
chr13	102761888	102769888	102769388	8000	102765888	-4000	4000	3500
chr13	113320163	113328163	113324449	8000	113324163	-4000	4000	286
chr13	25095254	25103254	25098130	8000	25099254	-4000	4000	-1124
chr13	41185834	41193834	41192822	8000	41189834	-4000	4000	2988
chr13	53048057	53056057	53050015	8000	53052057	-4000	4000	-2042
chr13	37005312	37013312	37010645	8000	37009312	-4000	4000	1333
chr13	31328276	31336276	31329575	8000	31332276	-4000	4000	-2701
chr13	44428143	44436143	44436046	8000	44432143	-4000	4000	3903
chr13	40725128	40733128	40729408	8000	40729128	-4000	4000	280
chr13	98679801	98687801	98687634	8000	98683801	-4000	4000	3833
chr13	32396268	32404268	32398424	8000	32400268	-4000	4000	-1844
chr13	50016481	50024481	50016653	8000	50020481	-4000	4000	-3828
chr13	57725311	57733311	57726157	8000	57729311	-4000	4000	-3154
chr13	27062156	27070156	27069225	8000	27066156	-4000	4000	3069
chr13	108230243	108238243	108232301	8000	108234243	-4000	4000	-1942
chr13	21488691	21496691	21496161	8000	21492691	-4000	4000	3470
chr13	37099259	37107259	37104182	8000	37103259	-4000	4000	923
chr13	61405858	61413858	61412132	8000	61409858	-4000	4000	2274
chr13	32396268	32404268	32396919	8000	32400268	-4000	4000	-3349
chr13	53048057	53056057	53050243	8000	53052057	-4000	4000	-1814
chr13	85788790	85796790	85793781	8000	85792790	-4000	4000	991
chr13	113116685	113124685	113117520	8000	113120685	-4000	4000	-3165
chr13	83873205	83881205	83879762	8000	83877205	-4000	4000	2557
chr13	108203439	108211439	108210110	8000	108207439	-4000	4000	2671
chr13	85788790	85796790	85796263	8000	85792790	-4000	4000	3473
chr13	83873205	83881205	83879530	8000	83877205	-4000	4000	2325
chr13	51020120	51028120	51020585	8000	51024120	-4000	4000	-3535
chr13	35469789	35477789	35474216	8000	35473789	-4000	4000	427
chr13	49205779	49213779	49207135	8000	49209779	-4000	4000	-2644
chr13	50016481	50024481	50017007	8000	50020481	-4000	4000	-3474
chr13	102871994	102879994	102875569	8000	102875994	-4000	4000	-425
chr13	45280893	45288893	45283478	8000	45284893	-4000	4000	-1415
chr13	40927924	40935924	40933281	8000	40931924	-4000	4000	1357
chr13	108230243	108238243	108230351	8000	108234243	-4000	4000	-3892
chr13	98020296	98028296	98021850	8000	98024296	-4000	4000	-2446
chr13	30656770	30664770	30658031	8000	30660770	-4000	4000	-2739
chr13	36438870	36446870	36442716	8000	36442870	-4000	4000	-154
chr13	36438870	36446870	36442758	8000	36442870	-4000	4000	-112
chr13	41466871	41474871	41470640	8000	41470871	-4000	4000	-231
chr13	37099259	37107259	37104383	8000	37103259	-4000	4000	1124
chr13	110874540	110882540	110879842	8000	110878540	-4000	4000	1302
chr13	52373167	52381167	52378185	8000	52377167	-4000	4000	1018
chr13	98679801	98687801	98686253	8000	98683801	-4000	4000	2452
chr13	110719339	110727339	110719527	8000	110723339	-4000	4000	-3812
chr13	35669022	35677022	35671026	8000	35673022	-4000	4000	-1996
chr13	83873205	83881205	83880638	8000	83877205	-4000	4000	3433
chr13	114301817	114309817	114304830	8000	114305817	-4000	4000	-987
chr13	25095254	25103254	25097603	8000	25099254	-4000	4000	-1651
chr13	106485745	106493745	106492070	8000	106489745	-4000	4000	2325
chr13	113263108	113271108	113264783	8000	113267108	-4000	4000	-2325
chr13	32295125	32303125	32295870	8000	32299125	-4000	4000	-3255
chr13	79552077	79560077	79552694	8000	79556077	-4000	4000	-3383
chr13	28696064	28704064	28701299	8000	28700064	-4000	4000	1235
chr13	23887099	23895099	23891835	8000	23891099	-4000	4000	736
chr13	49629872	49637872	49630786	8000	49633872	-4000	4000	-3086
chr13	49656674	49664674	49661032	8000	49660674	-4000	4000	358
chr13	85788790	85796790	85794135	8000	85792790	-4000	4000	1345
chr13	52373167	52381167	52378471	8000	52377167	-4000	4000	1304
chr13	102761888	102769888	102766198	8000	102765888	-4000	4000	310
chr13	83873205	83881205	83880784	8000	83877205	-4000	4000	3579
chr13	51020120	51028120	51025347	8000	51024120	-4000	4000	1227
chr13	51280239	51288239	51280957	8000	51284239	-4000	4000	-3282
chr13	27252691	27260691	27256219	8000	27256691	-4000	4000	-472
chr13	25095254	25103254	25098334	8000	25099254	-4000	4000	-920
chr13	98679801	98687801	98686245	8000	98683801	-4000	4000	2444
chr13	51280239	51288239	51280884	8000	51284239	-4000	4000	-3355
chr13	83873205	83881205	83880361	8000	83877205	-4000	4000	3156
chr13	30656770	30664770	30658928	8000	30660770	-4000	4000	-1842
chr13	25095254	25103254	25096139	8000	25099254	-4000	4000	-3115
chr13	48707226	48715226	48708033	8000	48711226	-4000	4000	-3193
chr13	57725311	57733311	57725837	8000	57729311	-4000	4000	-3474
chr13	96981713	96989713	96986489	8000	96985713	-4000	4000	776
chr13	75855870	75863870	75856562	8000	75859870	-4000	4000	-3308
chr13	28696064	28704064	28700976	8000	28700064	-4000	4000	912
chr13	48707226	48715226	48708575	8000	48711226	-4000	4000	-2651
chr13	73073541	73081541	73075924	8000	73077541	-4000	4000	-1617
chr13	48707226	48715226	48707632	8000	48711226	-4000	4000	-3594
chr13	26751200	26759200	26758866	8000	26755200	-4000	4000	3666
chr13	52128639	52136639	52133151	8000	52132639	-4000	4000	512
chr13	78610289	78618289	78615672	8000	78614289	-4000	4000	1383
chr13	85788790	85796790	85795484	8000	85792790	-4000	4000	2694
chr13	25095254	25103254	25098102	8000	25099254	-4000	4000	-1152
chr13	27271192	27279192	27273096	8000	27275192	-4000	4000	-2096
chr13	35469789	35477789	35472507	8000	35473789	-4000	4000	-1282
chr13	77760242	77768242	77763394	8000	77764242	-4000	4000	-848
chr13	61405858	61413858	61411367	8000	61409858	-4000	4000	1509
chr13	108203439	108211439	108209605	8000	108207439	-4000	4000	2166
chr13	31328276	31336276	31329504	8000	31332276	-4000	4000	-2772
chr13	33062143	33070143	33065349	8000	33066143	-4000	4000	-794
chr13	35469789	35477789	35475377	8000	35473789	-4000	4000	1588
chr13	59661583	59669583	59666675	8000	59665583	-4000	4000	1092
chr13	77038474	77046474	77045084	8000	77042474	-4000	4000	2610
chr13	110719339	110727339	110719339	8000	110723339	-4000	4000	-4000
chr13	111301737	111309737	111303080	8000	111305737	-4000	4000	-2657
chr13	114268723	114276723	114272586	8000	114272723	-4000	4000	-137
chr13	49629872	49637872	49630515	8000	49633872	-4000	4000	-3357
chr13	113263108	113271108	113264633	8000	113267108	-4000	4000	-2475
chr13	32396268	32404268	32397012	8000	32400268	-4000	4000	-3256
chr13	35469789	35477789	35475872	8000	35473789	-4000	4000	2083
chr13	51763709	51771709	51771287	8000	51767709	-4000	4000	3578
chr13	80331976	80339976	80337350	8000	80335976	-4000	4000	1374
chr13	110719339	110727339	110719869	8000	110723339	-4000	4000	-3470
chr13	35469789	35477789	35475922	8000	35473789	-4000	4000	2133
chr13	37005312	37013312	37010632	8000	37009312	-4000	4000	1320
chr13	49527946	49535946	49534253	8000	49531946	-4000	4000	2307
chr13	20969036	20977036	20975352	8000	20973036	-4000	4000	2316
chr13	35469789	35477789	35475922	8000	35473789	-4000	4000	2133
chr13	37558583	37566583	37563217	8000	37562583	-4000	4000	634
chr13	40927924	40935924	40933267	8000	40931924	-4000	4000	1343
chr13	83873205	83881205	83877978	8000	83877205	-4000	4000	773
chr13	108203439	108211439	108211188	8000	108207439	-4000	4000	3749
chr13	113263108	113271108	113263491	8000	113267108	-4000	4000	-3617
chr13	113637473	113645473	113637709	8000	113641473	-4000	4000	-3764
chr13	40927924	40935924	40933600	8000	40931924	-4000	4000	1676
chr13	99290539	99298539	99295636	8000	99294539	-4000	4000	1097
chr13	99290539	99298539	99295637	8000	99294539	-4000	4000	1098
chr13	113451819	113459819	113453243	8000	113455819	-4000	4000	-2576
chr13	113451819	113459819	113453408	8000	113455819	-4000	4000	-2411
chr13	66298834	66306834	66302976	8000	66302834	-4000	4000	142
chr13	45389316	45397316	45395974	8000	45393316	-4000	4000	2658
chr13	76876175	76884175	76881528	8000	76880175	-4000	4000	1353
chr13	23887099	23895099	23891660	8000	23891099	-4000	4000	561
chr13	24317031	24325031	24321397	8000	24321031	-4000	4000	366
chr13	85788790	85796790	85796411	8000	85792790	-4000	4000	3621
chr13	85788790	85796790	85796412	8000	85792790	-4000	4000	3622
chr13	110719339	110727339	110719606	8000	110723339	-4000	4000	-3733
chr13	39005865	39013865	39013088	8000	39009865	-4000	4000	3223
chr13	32396268	32404268	32396925	8000	32400268	-4000	4000	-3343
chr13	41185834	41193834	41193126	8000	41189834	-4000	4000	3292
chr13	31130973	31138973	31137317	8000	31134973	-4000	4000	2344
chr13	40808460	40816460	40808533	8000	40812460	-4000	4000	-3927
chr13	78610289	78618289	78617142	8000	78614289	-4000	4000	2853
chr13	78610289	78618289	78617143	8000	78614289	-4000	4000	2854
chr13	35469789	35477789	35475746	8000	35473789	-4000	4000	1957
chr13	98020296	98028296	98022910	8000	98024296	-4000	4000	-1386
chr13	20217962	20225962	20223469	8000	20221962	-4000	4000	1507
chr13	78610289	78618289	78616147	8000	78614289	-4000	4000	1858
chr13	41185834	41193834	41193149	8000	41189834	-4000	4000	3315
chr13	20724731	20732731	20728997	8000	20728731	-4000	4000	266
chr13	85788790	85796790	85795773	8000	85792790	-4000	4000	2983
chr13	85788790	85796790	85795857	8000	85792790	-4000	4000	3067
chr13	32295125	32303125	32295216	8000	32299125	-4000	4000	-3909
chr13	99250732	99258732	99255407	8000	99254732	-4000	4000	675
chr13	33062143	33070143	33064029	8000	33066143	-4000	4000	-2114
chr13	28696064	28704064	28701357	8000	28700064	-4000	4000	1293
chr13	96981713	96989713	96987684	8000	96985713	-4000	4000	1971
chr13	111301737	111309737	111303059	8000	111305737	-4000	4000	-2678
chr13	39046109	39054109	39048123	8000	39050109	-4000	4000	-1986
chr13	49629872	49637872	49630673	8000	49633872	-4000	4000	-3199
chr13	25095254	25103254	25096991	8000	25099254	-4000	4000	-2263
chr13	106485745	106493745	106493260	8000	106489745	-4000	4000	3515
chr13	77891481	77899481	77898156	8000	77895481	-4000	4000	2675
chr13	98789429	98797429	98793768	8000	98793429	-4000	4000	339
chr13	52373167	52381167	52378394	8000	52377167	-4000	4000	1227
chr13	19819482	19827482	19824640	8000	19823482	-4000	4000	1158
chr13	44935249	44943249	44941129	8000	44939249	-4000	4000	1880
chr13	25095254	25103254	25097971	8000	25099254	-4000	4000	-1283
chr13	49656674	49664674	49661000	8000	49660674	-4000	4000	326
chr13	96981713	96989713	96987472	8000	96985713	-4000	4000	1759
chr13	28674959	28682959	28678072	8000	28678959	-4000	4000	-887
chr13	28696064	28704064	28701424	8000	28700064	-4000	4000	1360
chr13	37005312	37013312	37009798	8000	37009312	-4000	4000	486
chr13	41212369	41220369	41217173	8000	41216369	-4000	4000	804
chr13	78610289	78618289	78617089	8000	78614289	-4000	4000	2800
chr13	80331976	80339976	80337690	8000	80335976	-4000	4000	1714
chr13	85788790	85796790	85795185	8000	85792790	-4000	4000	2395
chr13	110637412	110645412	110638346	8000	110641412	-4000	4000	-3066
chr13	30656770	30664770	30658231	8000	30660770	-4000	4000	-2539
chr13	48707226	48715226	48707228	8000	48711226	-4000	4000	-3998
chr13	52472628	52480628	52475003	8000	52476628	-4000	4000	-1625
chr13	20399666	20407666	20404060	8000	20403666	-4000	4000	394
chr13	25095254	25103254	25098152	8000	25099254	-4000	4000	-1102
chr13	80331976	80339976	80336832	8000	80335976	-4000	4000	856
chr13	33962558	33970558	33966119	8000	33966558	-4000	4000	-439
chr13	21488691	21496691	21495250	8000	21492691	-4000	4000	2559
chr13	24317031	24325031	24321048	8000	24321031	-4000	4000	17
chr13	24317031	24325031	24321325	8000	24321031	-4000	4000	294
chr13	24878279	24886279	24883109	8000	24882279	-4000	4000	830
chr13	25095254	25103254	25097644	8000	25099254	-4000	4000	-1610
chr13	28674959	28682959	28678049	8000	28678959	-4000	4000	-910
chr13	30656770	30664770	30659329	8000	30660770	-4000	4000	-1441
chr13	30921572	30929572	30921674	8000	30925572	-4000	4000	-3898
chr13	32396268	32404268	32398537	8000	32400268	-4000	4000	-1731
chr13	33062143	33070143	33064043	8000	33066143	-4000	4000	-2100
chr13	39005865	39013865	39013112	8000	39009865	-4000	4000	3247
chr13	41080006	41088006	41082814	8000	41084006	-4000	4000	-1192
chr13	41123569	41131569	41131065	8000	41127569	-4000	4000	3496
chr13	41123569	41131569	41131130	8000	41127569	-4000	4000	3561
chr13	41185834	41193834	41193709	8000	41189834	-4000	4000	3875
chr13	43209130	43217130	43213931	8000	43213130	-4000	4000	801
chr13	44935249	44943249	44941271	8000	44939249	-4000	4000	2022
chr13	51360735	51368735	51362063	8000	51364735	-4000	4000	-2672
chr13	77891481	77899481	77896418	8000	77895481	-4000	4000	937
chr13	78610289	78618289	78617130	8000	78614289	-4000	4000	2841
chr13	80331976	80339976	80336742	8000	80335976	-4000	4000	766
chr13	83873205	83881205	83880972	8000	83877205	-4000	4000	3767
chr13	85788790	85796790	85795896	8000	85792790	-4000	4000	3106
chr13	94570054	94578054	94578019	8000	94574054	-4000	4000	3965
chr13	96981713	96989713	96987550	8000	96985713	-4000	4000	1837
chr13	99290539	99298539	99295297	8000	99294539	-4000	4000	758
chr13	113320163	113328163	113322370	8000	113324163	-4000	4000	-1793
chr13	114268723	114276723	114272408	8000	114272723	-4000	4000	-315
chr13	30760426	30768426	30764185	8000	30764426	-4000	4000	-241
chr13	40808460	40816460	40809585	8000	40812460	-4000	4000	-2875
chr13	39005865	39013865	39013504	8000	39009865	-4000	4000	3639
chr13	25095254	25103254	25096240	8000	25099254	-4000	4000	-3014
chr13	37558583	37566583	37563302	8000	37562583	-4000	4000	719
chr13	49527946	49535946	49533876	8000	49531946	-4000	4000	1930
chr13	85788790	85796790	85795161	8000	85792790	-4000	4000	2371
chr13	59661583	59669583	59666801	8000	59665583	-4000	4000	1218
chr13	49304650	49312650	49310783	8000	49308650	-4000	4000	2133
chr13	32295125	32303125	32295275	8000	32299125	-4000	4000	-3850
chr13	20183463	20191463	20189144	8000	20187463	-4000	4000	1681
chr13	51360735	51368735	51362210	8000	51364735	-4000	4000	-2525
chr13	94570054	94578054	94574579	8000	94574054	-4000	4000	525
chr13	32396268	32404268	32398437	8000	32400268	-4000	4000	-1831
chr13	51360735	51368735	51361733	8000	51364735	-4000	4000	-3002
chr13	27999274	28007274	28004067	8000	28003274	-4000	4000	793
chr13	49205779	49213779	49207516	8000	49209779	-4000	4000	-2263
chr13	106485745	106493745	106493110	8000	106489745	-4000	4000	3365
chr13	23887099	23895099	23891665	8000	23891099	-4000	4000	566
chr13	24317031	24325031	24321392	8000	24321031	-4000	4000	361
chr13	109204005	109212005	109206614	8000	109208005	-4000	4000	-1391
chr13	110719339	110727339	110719416	8000	110723339	-4000	4000	-3923
chr13	19819482	19827482	19824594	8000	19823482	-4000	4000	1112
chr13	112481011	112489011	112486067	8000	112485011	-4000	4000	1056
chr13	110637412	110645412	110638279	8000	110641412	-4000	4000	-3133
chr13	113116685	113124685	113118580	8000	113120685	-4000	4000	-2105
chr13	49656674	49664674	49660905	8000	49660674	-4000	4000	231
chr13	44428143	44436143	44436090	8000	44432143	-4000	4000	3947
chr13	20183463	20191463	20188983	8000	20187463	-4000	4000	1520
chr13	39005865	39013865	39013406	8000	39009865	-4000	4000	3541
chr13	75855870	75863870	75858442	8000	75859870	-4000	4000	-1428
chr13	80331976	80339976	80337030	8000	80335976	-4000	4000	1054
chr13	28696064	28704064	28701249	8000	28700064	-4000	4000	1185
chr13	51280239	51288239	51280533	8000	51284239	-4000	4000	-3706
chr13	113116685	113124685	113117571	8000	113120685	-4000	4000	-3114
chr13	37099259	37107259	37104763	8000	37103259	-4000	4000	1504
chr13	20217962	20225962	20223279	8000	20221962	-4000	4000	1317
chr13	41080006	41088006	41082749	8000	41084006	-4000	4000	-1257
chr13	98789429	98797429	98793842	8000	98793429	-4000	4000	413
chr13	39046109	39054109	39047807	8000	39050109	-4000	4000	-2302
chr13	96981713	96989713	96987419	8000	96985713	-4000	4000	1706
chr13	40927924	40935924	40932876	8000	40931924	-4000	4000	952
chr13	83873205	83881205	83878529	8000	83877205	-4000	4000	1324
chr13	77760242	77768242	77763873	8000	77764242	-4000	4000	-369
chr13	25242222	25250222	25249479	8000	25246222	-4000	4000	3257
chr13	96981713	96989713	96986832	8000	96985713	-4000	4000	1119
chr13	77760242	77768242	77760885	8000	77764242	-4000	4000	-3357
chr13	49205779	49213779	49207287	8000	49209779	-4000	4000	-2492
chr13	26128115	26136115	26132382	8000	26132115	-4000	4000	267
chr13	52373167	52381167	52377707	8000	52377167	-4000	4000	540
chr13	72704367	72712367	72710071	8000	72708367	-4000	4000	1704
chr13	51280239	51288239	51280931	8000	51284239	-4000	4000	-3308
chr13	53048057	53056057	53050131	8000	53052057	-4000	4000	-1926
chr13	83873205	83881205	83880537	8000	83877205	-4000	4000	3332
chr13	30656770	30664770	30658698	8000	30660770	-4000	4000	-2072
chr13	30656770	30664770	30659199	8000	30660770	-4000	4000	-1571
chr13	35469789	35477789	35475780	8000	35473789	-4000	4000	1991
chr13	50016481	50024481	50016790	8000	50020481	-4000	4000	-3691
chr13	77641263	77649263	77644298	8000	77645263	-4000	4000	-965
chr13	83873205	83881205	83879424	8000	83877205	-4000	4000	2219
chr13	100526164	100534164	100530137	8000	100530164	-4000	4000	-27
chr13	100599625	100607625	100604137	8000	100603625	-4000	4000	512
chr13	102675958	102683958	102679162	8000	102679958	-4000	4000	-796
chr14	102337102	102345102	102339137	8000	102341102	-4000	4000	-1965
chr14	58644321	58652321	58645551	8000	58648321	-4000	4000	-2770
chr14	104048667	104056667	104052150	8000	104052667	-4000	4000	-517
chr14	63593039	63601039	63599754	8000	63597039	-4000	4000	2715
chr14	105045395	105053395	105050503	8000	105049395	-4000	4000	1108
chr14	39393684	39401684	39401374	8000	39397684	-4000	4000	3690
chr14	75049237	75057237	75049506	8000	75053237	-4000	4000	-3731
chr14	39027919	39035919	39032682	8000	39031919	-4000	4000	763
chr14	20778467	20786467	20781943	8000	20782467	-4000	4000	-524
chr14	24332025	24340025	24337996	8000	24336025	-4000	4000	1971
chr14	68870128	68878128	68875004	8000	68874128	-4000	4000	876
chr14	75049237	75057237	75049526	8000	75053237	-4000	4000	-3711
chr14	59591976	59599976	59596686	8000	59595976	-4000	4000	710
chr14	65002174	65010174	65006193	8000	65006174	-4000	4000	19
chr14	21517080	21525080	21524259	8000	21521080	-4000	4000	3179
chr14	24261538	24269538	24269536	8000	24265538	-4000	4000	3998
chr14	58644321	58652321	58645584	8000	58648321	-4000	4000	-2737
chr14	24375604	24383604	24377834	8000	24379604	-4000	4000	-1770
chr14	69240020	69248020	69241817	8000	69244020	-4000	4000	-2203
chr14	73474484	73482484	73478548	8000	73478484	-4000	4000	64
chr14	96259929	96267929	96264371	8000	96263929	-4000	4000	442
chr14	35534352	35542352	35534439	8000	35538352	-4000	4000	-3913
chr14	69240020	69248020	69241007	8000	69244020	-4000	4000	-3013
chr14	34705113	34713113	34711258	8000	34709113	-4000	4000	2145
chr14	24375604	24383604	24377672	8000	24379604	-4000	4000	-1932
chr14	53945736	53953736	53950855	8000	53949736	-4000	4000	1119
chr14	29572479	29580479	29577178	8000	29576479	-4000	4000	699
chr14	67290371	67298371	67292690	8000	67294371	-4000	4000	-1681
chr14	73474484	73482484	73478609	8000	73478484	-4000	4000	125
chr14	24074662	24082662	24077781	8000	24078662	-4000	4000	-881
chr14	24139362	24147362	24144015	8000	24143362	-4000	4000	653
chr14	45070431	45078431	45073708	8000	45074431	-4000	4000	-723
chr14	99165287	99173287	99171369	8000	99169287	-4000	4000	2082
chr14	21517080	21525080	21524781	8000	21521080	-4000	4000	3701
chr14	31287788	31295788	31293891	8000	31291788	-4000	4000	2103
chr14	20307368	20315368	20313706	8000	20311368	-4000	4000	2338
chr14	74494183	74502183	74499328	8000	74498183	-4000	4000	1145
chr14	91576696	91584696	91580894	8000	91580696	-4000	4000	198
chr14	58268012	58276012	58270950	8000	58272012	-4000	4000	-1062
chr14	24332025	24340025	24338311	8000	24336025	-4000	4000	2286
chr14	64585381	64593381	64586862	8000	64589381	-4000	4000	-2519
chr14	64585381	64593381	64589226	8000	64589381	-4000	4000	-155
chr14	20442401	20450401	20447156	8000	20446401	-4000	4000	755
chr14	21517080	21525080	21523598	8000	21521080	-4000	4000	2518
chr14	35081467	35089467	35085730	8000	35085467	-4000	4000	263
chr14	73591766	73599766	73595322	8000	73595766	-4000	4000	-444
chr14	35081467	35089467	35087988	8000	35085467	-4000	4000	2521
chr14	58404495	58412495	58409128	8000	58408495	-4000	4000	633
chr14	88461778	88469778	88469004	8000	88465778	-4000	4000	3226
chr14	91228532	91236532	91235030	8000	91232532	-4000	4000	2498
chr14	105168938	105176938	105176748	8000	105172938	-4000	4000	3810
chr14	91961991	91969991	91969861	8000	91965991	-4000	4000	3870
chr14	20307368	20315368	20313683	8000	20311368	-4000	4000	2315
chr14	23342314	23350314	23347649	8000	23346314	-4000	4000	1335
chr14	38250000	38258000	38255065	8000	38254000	-4000	4000	1065
chr14	45070431	45078431	45073532	8000	45074431	-4000	4000	-899
chr14	69376128	69384128	69380485	8000	69380128	-4000	4000	357
chr14	88461778	88469778	88469604	8000	88465778	-4000	4000	3826
chr14	24332025	24340025	24338666	8000	24336025	-4000	4000	2641
chr14	20993035	21001035	20994860	8000	20997035	-4000	4000	-2175
chr14	23322175	23330175	23322253	8000	23326175	-4000	4000	-3922
chr14	24569518	24577518	24576246	8000	24573518	-4000	4000	2728
chr14	77931014	77939014	77933267	8000	77935014	-4000	4000	-1747
chr14	31287788	31295788	31293982	8000	31291788	-4000	4000	2194
chr14	94044287	94052287	94044585	8000	94048287	-4000	4000	-3702
chr14	23641639	23649639	23643212	8000	23645639	-4000	4000	-2427
chr14	24805454	24813454	24812457	8000	24809454	-4000	4000	3003
chr14	22942270	22950270	22946459	8000	22946270	-4000	4000	189
chr14	21347476	21355476	21348191	8000	21351476	-4000	4000	-3285
chr14	23043062	23051062	23043370	8000	23047062	-4000	4000	-3692
chr14	52324598	52332598	52327253	8000	52328598	-4000	4000	-1345
chr14	54838008	54846008	54843217	8000	54842008	-4000	4000	1209
chr14	63680216	63688216	63686394	8000	63684216	-4000	4000	2178
chr14	35397513	35405513	35404554	8000	35401513	-4000	4000	3041
chr14	23342314	23350314	23347599	8000	23346314	-4000	4000	1285
chr14	91865411	91873411	91870056	8000	91869411	-4000	4000	645
chr14	24314036	24322036	24319431	8000	24318036	-4000	4000	1395
chr14	36675362	36683362	36676195	8000	36679362	-4000	4000	-3167
chr14	45111599	45119599	45116143	8000	45115599	-4000	4000	544
chr14	73954010	73962010	73955832	8000	73958010	-4000	4000	-2178
chr14	94438464	94446464	94442712	8000	94442464	-4000	4000	248
chr14	51726727	51734727	51728175	8000	51730727	-4000	4000	-2552
chr14	64585381	64593381	64588185	8000	64589381	-4000	4000	-1196
chr14	73271107	73279107	73276470	8000	73275107	-4000	4000	1363
chr14	24314036	24322036	24319398	8000	24318036	-4000	4000	1362
chr14	58547297	58555297	58547952	8000	58551297	-4000	4000	-3345
chr14	94372747	94380747	94379463	8000	94376747	-4000	4000	2716
chr14	22845041	22853041	22845318	8000	22849041	-4000	4000	-3723
chr14	23408740	23416740	23414024	8000	23412740	-4000	4000	1284
chr14	54838008	54846008	54843773	8000	54842008	-4000	4000	1765
chr14	22942270	22950270	22947888	8000	22946270	-4000	4000	1618
chr14	21205136	21213136	21210672	8000	21209136	-4000	4000	1536
chr14	24332025	24340025	24338088	8000	24336025	-4000	4000	2063
chr14	31126996	31134996	31129218	8000	31130996	-4000	4000	-1778
chr14	29572479	29580479	29578331	8000	29576479	-4000	4000	1852
chr14	35534352	35542352	35534413	8000	35538352	-4000	4000	-3939
chr14	102726561	102734561	102729745	8000	102730561	-4000	4000	-816
chr14	21012763	21020763	21018006	8000	21016763	-4000	4000	1243
chr14	75009769	75017769	75017071	8000	75013769	-4000	4000	3302
chr14	49893054	49901054	49894421	8000	49897054	-4000	4000	-2633
chr14	73954010	73962010	73958905	8000	73958010	-4000	4000	895
chr14	96383288	96391288	96385559	8000	96387288	-4000	4000	-1729
chr14	95540724	95548724	95544010	8000	95544724	-4000	4000	-714
chr14	24332025	24340025	24338384	8000	24336025	-4000	4000	2359
chr14	88608431	88616431	88611943	8000	88612431	-4000	4000	-488
chr14	23322175	23330175	23323065	8000	23326175	-4000	4000	-3110
chr14	21494133	21502133	21496641	8000	21498133	-4000	4000	-1492
chr14	22845041	22853041	22845320	8000	22849041	-4000	4000	-3721
chr14	60705539	60713539	60709839	8000	60709539	-4000	4000	300
chr14	30616064	30624064	30622462	8000	30620064	-4000	4000	2398
chr14	60967441	60975441	60968246	8000	60971441	-4000	4000	-3195
chr14	94300248	94308248	94304420	8000	94304248	-4000	4000	172
chr14	91576696	91584696	91580985	8000	91580696	-4000	4000	289
chr14	88608431	88616431	88615659	8000	88612431	-4000	4000	3228
chr14	20473089	20481089	20474636	8000	20477089	-4000	4000	-2453
chr14	39393684	39401684	39399371	8000	39397684	-4000	4000	1687
chr14	50233563	50241563	50237582	8000	50237563	-4000	4000	19
chr14	91865411	91873411	91870168	8000	91869411	-4000	4000	757
chr14	101559452	101567452	101562472	8000	101563452	-4000	4000	-980
chr14	22981894	22989894	22989842	8000	22985894	-4000	4000	3948
chr14	60639421	60647421	60646407	8000	60643421	-4000	4000	2986
chr14	61792428	61800428	61794948	8000	61796428	-4000	4000	-1480
chr14	24065729	24073729	24068796	8000	24069729	-4000	4000	-933
chr14	22916525	22924525	22922557	8000	22920525	-4000	4000	2032
chr14	23516857	23524857	23524665	8000	23520857	-4000	4000	3808
chr14	35534352	35542352	35536334	8000	35538352	-4000	4000	-2018
chr14	75115502	75123502	75118872	8000	75119502	-4000	4000	-630
chr14	24261538	24269538	24268741	8000	24265538	-4000	4000	3203
chr14	90404268	90412268	90404973	8000	90408268	-4000	4000	-3295
chr14	61744259	61752259	61747017	8000	61748259	-4000	4000	-1242
chr14	105247093	105255093	105249877	8000	105251093	-4000	4000	-1216
chr14	54470484	54478484	54475389	8000	54474484	-4000	4000	905
chr14	24422545	24430545	24427633	8000	24426545	-4000	4000	1088
chr14	24602480	24610480	24606685	8000	24606480	-4000	4000	205
chr14	64222433	64230433	64227592	8000	64226433	-4000	4000	1159
chr14	100734224	100742224	100734314	8000	100738224	-4000	4000	-3910
chr14	20993035	21001035	20994551	8000	20997035	-4000	4000	-2484
chr14	31096117	31104117	31100754	8000	31100117	-4000	4000	637
chr14	35313474	35321474	35317393	8000	35317474	-4000	4000	-81
chr14	101559452	101567452	101561804	8000	101563452	-4000	4000	-1648
chr14	63593039	63601039	63599618	8000	63597039	-4000	4000	2579
chr14	24415283	24423283	24417001	8000	24419283	-4000	4000	-2282
chr14	57196507	57204507	57204021	8000	57200507	-4000	4000	3514
chr14	22916525	22924525	22920786	8000	22920525	-4000	4000	261
chr14	105006482	105014482	105011754	8000	105010482	-4000	4000	1272
chr14	105247093	105255093	105250213	8000	105251093	-4000	4000	-880
chr14	58644321	58652321	58646870	8000	58648321	-4000	4000	-1451
chr14	21494133	21502133	21499134	8000	21498133	-4000	4000	1001
chr14	23352403	23360403	23357295	8000	23356403	-4000	4000	892
chr14	23408740	23416740	23415117	8000	23412740	-4000	4000	2377
chr14	20993035	21001035	20996956	8000	20997035	-4000	4000	-79
chr14	49621174	49629174	49628026	8000	49625174	-4000	4000	2852
chr14	77255495	77263495	77259487	8000	77259495	-4000	4000	-8
chr14	102497767	102505767	102498210	8000	102501767	-4000	4000	-3557
chr14	88623596	88631596	88625004	8000	88627596	-4000	4000	-2592
chr14	23641639	23649639	23644454	8000	23645639	-4000	4000	-1185
chr14	68783660	68791660	68790044	8000	68787660	-4000	4000	2384
chr14	73271107	73279107	73276658	8000	73275107	-4000	4000	1551
chr14	90181853	90189853	90184592	8000	90185853	-4000	4000	-1261
chr14	92112122	92120122	92116152	8000	92116122	-4000	4000	30
chr14	24185157	24193157	24187764	8000	24189157	-4000	4000	-1393
chr14	24074662	24082662	24077011	8000	24078662	-4000	4000	-1651
chr14	38250000	38258000	38256367	8000	38254000	-4000	4000	2367
chr14	23096456	23104456	23097702	8000	23100456	-4000	4000	-2754
chr14	60639421	60647421	60646363	8000	60643421	-4000	4000	2942
chr14	23268422	23276422	23275407	8000	23272422	-4000	4000	2985
chr14	24139362	24147362	24145156	8000	24143362	-4000	4000	1794
chr14	24415283	24423283	24416593	8000	24419283	-4000	4000	-2690
chr14	73954010	73962010	73958568	8000	73958010	-4000	4000	558
chr14	24422545	24430545	24427858	8000	24426545	-4000	4000	1313
chr14	103133439	103141439	103135280	8000	103137439	-4000	4000	-2159
chr14	23516857	23524857	23522572	8000	23520857	-4000	4000	1715
chr14	50414501	50422501	50419994	8000	50418501	-4000	4000	1493
chr14	50322265	50330265	50325736	8000	50326265	-4000	4000	-529
chr14	23641639	23649639	23645242	8000	23645639	-4000	4000	-397
chr14	22981894	22989894	22982056	8000	22985894	-4000	4000	-3838
chr14	23096456	23104456	23097772	8000	23100456	-4000	4000	-2684
chr14	24805454	24813454	24812724	8000	24809454	-4000	4000	3270
chr14	94764223	94772223	94768551	8000	94768223	-4000	4000	328
chr14	105247093	105255093	105250906	8000	105251093	-4000	4000	-187
chr14	38250000	38258000	38255613	8000	38254000	-4000	4000	1613
chr14	76782009	76790009	76787499	8000	76786009	-4000	4000	1490
chr14	20778467	20786467	20782253	8000	20782467	-4000	4000	-214
chr14	67723374	67731374	67726096	8000	67727374	-4000	4000	-1278
chr14	54838008	54846008	54844029	8000	54842008	-4000	4000	2021
chr14	77422675	77430675	77422914	8000	77426675	-4000	4000	-3761
chr14	64222433	64230433	64227745	8000	64226433	-4000	4000	1312
chr14	90181853	90189853	90184146	8000	90185853	-4000	4000	-1707
chr14	53945736	53953736	53950248	8000	53949736	-4000	4000	512
chr14	50331558	50339558	50334573	8000	50335558	-4000	4000	-985
chr14	68870128	68878128	68877148	8000	68874128	-4000	4000	3020
chr14	21517080	21525080	21523724	8000	21521080	-4000	4000	2644
chr14	50971262	50979262	50977131	8000	50975262	-4000	4000	1869
chr14	60140119	60148119	60144967	8000	60144119	-4000	4000	848
chr14	73271107	73279107	73277077	8000	73275107	-4000	4000	1970
chr14	94372747	94380747	94379553	8000	94376747	-4000	4000	2806
chr14	44920324	44928324	44927422	8000	44924324	-4000	4000	3098
chr14	24065729	24073729	24073529	8000	24069729	-4000	4000	3800
chr14	74472192	74480192	74480158	8000	74476192	-4000	4000	3966
chr14	96383288	96391288	96385646	8000	96387288	-4000	4000	-1642
chr14	102929596	102937596	102933823	8000	102933596	-4000	4000	227
chr14	69046881	69054881	69054772	8000	69050881	-4000	4000	3891
chr14	75954097	75962097	75954421	8000	75958097	-4000	4000	-3676
chr14	88623596	88631596	88626897	8000	88627596	-4000	4000	-699
chr14	54934949	54942949	54941558	8000	54938949	-4000	4000	2609
chr14	93214586	93222586	93220287	8000	93218586	-4000	4000	1701
chr14	105006482	105014482	105010685	8000	105010482	-4000	4000	203
chr14	22981894	22989894	22987301	8000	22985894	-4000	4000	1407
chr14	74855435	74863435	74863170	8000	74859435	-4000	4000	3735
chr14	24415283	24423283	24417341	8000	24419283	-4000	4000	-1942
chr14	61546976	61554976	61547752	8000	61550976	-4000	4000	-3224
chr14	88623596	88631596	88625034	8000	88627596	-4000	4000	-2562
chr14	105045395	105053395	105051370	8000	105049395	-4000	4000	1975
chr14	30733694	30741694	30735656	8000	30737694	-4000	4000	-2038
chr14	24375604	24383604	24376433	8000	24379604	-4000	4000	-3171
chr14	64585381	64593381	64587047	8000	64589381	-4000	4000	-2334
chr14	21012763	21020763	21017742	8000	21016763	-4000	4000	979
chr14	39393684	39401684	39401656	8000	39397684	-4000	4000	3972
chr14	45111599	45119599	45114520	8000	45115599	-4000	4000	-1079
chr14	71737229	71745229	71739290	8000	71741229	-4000	4000	-1939
chr14	77757104	77765104	77761109	8000	77761104	-4000	4000	5
chr14	105006482	105014482	105011806	8000	105010482	-4000	4000	1324
chr14	90181853	90189853	90184262	8000	90185853	-4000	4000	-1591
chr14	30891065	30899065	30895493	8000	30895065	-4000	4000	428
chr14	64445106	64453106	64449384	8000	64449106	-4000	4000	278
chr14	69046881	69054881	69052393	8000	69050881	-4000	4000	1512
chr14	73591766	73599766	73592180	8000	73595766	-4000	4000	-3586
chr14	95082228	95090228	95089731	8000	95086228	-4000	4000	3503
chr14	24375604	24383604	24377660	8000	24379604	-4000	4000	-1944
chr14	22608963	22616963	22609862	8000	22612963	-4000	4000	-3101
chr14	24415283	24423283	24415459	8000	24419283	-4000	4000	-3824
chr14	21086077	21094077	21089397	8000	21090077	-4000	4000	-680
chr14	23408740	23416740	23414997	8000	23412740	-4000	4000	2257
chr14	20353904	20361904	20357542	8000	20357904	-4000	4000	-362
chr14	24286598	24294598	24292948	8000	24290598	-4000	4000	2350
chr14	35397513	35405513	35402010	8000	35401513	-4000	4000	497
chr14	52324598	52332598	52327220	8000	52328598	-4000	4000	-1378
chr14	67577955	67585955	67581886	8000	67581955	-4000	4000	-69
chr14	99938060	99946060	99939282	8000	99942060	-4000	4000	-2778
chr14	99938060	99946060	99940034	8000	99942060	-4000	4000	-2026
chr14	61744259	61752259	61744799	8000	61748259	-4000	4000	-3460
chr14	24569518	24577518	24573569	8000	24573518	-4000	4000	51
chr14	64222433	64230433	64225010	8000	64226433	-4000	4000	-1423
chr14	64222433	64230433	64225526	8000	64226433	-4000	4000	-907
chr14	104933244	104941244	104940493	8000	104937244	-4000	4000	3249
chr14	24074662	24082662	24082641	8000	24078662	-4000	4000	3979
chr14	24602480	24610480	24606730	8000	24606480	-4000	4000	250
chr14	45070431	45078431	45073607	8000	45074431	-4000	4000	-824
chr14	49619481	49627481	49622112	8000	49623481	-4000	4000	-1369
chr14	50331558	50339558	50332180	8000	50335558	-4000	4000	-3378
chr14	72965451	72973451	72969745	8000	72969451	-4000	4000	294
chr14	72965451	72973451	72969945	8000	72969451	-4000	4000	494
chr14	75954097	75962097	75959087	8000	75958097	-4000	4000	990
chr14	81467547	81475547	81475304	8000	81471547	-4000	4000	3757
chr14	90404268	90412268	90408156	8000	90408268	-4000	4000	-112
chr14	95082228	95090228	95086737	8000	95086228	-4000	4000	509
chr14	95403266	95411266	95409493	8000	95407266	-4000	4000	2227
chr14	101559452	101567452	101562880	8000	101563452	-4000	4000	-572
chr14	20361667	20369667	20368808	8000	20365667	-4000	4000	3141
chr14	35109130	35117130	35109932	8000	35113130	-4000	4000	-3198
chr14	39132973	39140973	39136547	8000	39136973	-4000	4000	-426
chr14	67290371	67298371	67292533	8000	67294371	-4000	4000	-1838
chr14	75049237	75057237	75049665	8000	75053237	-4000	4000	-3572
chr14	22769042	22777042	22771323	8000	22773042	-4000	4000	-1719
chr14	93214586	93222586	93222333	8000	93218586	-4000	4000	3747
chr14	20473089	20481089	20474903	8000	20477089	-4000	4000	-2186
chr14	20697216	20705216	20700595	8000	20701216	-4000	4000	-621
chr14	94372747	94380747	94379499	8000	94376747	-4000	4000	2752
chr14	74494183	74502183	74501526	8000	74498183	-4000	4000	3343
chr14	91961991	91969991	91969784	8000	91965991	-4000	4000	3793
chr14	73591766	73599766	73592106	8000	73595766	-4000	4000	-3660
chr14	24375604	24383604	24377673	8000	24379604	-4000	4000	-1931
chr14	58404495	58412495	58408535	8000	58408495	-4000	4000	40
chr14	24134959	24142959	24136292	8000	24138959	-4000	4000	-2667
chr14	24602480	24610480	24608320	8000	24606480	-4000	4000	1840
chr14	21012763	21020763	21018206	8000	21016763	-4000	4000	1443
chr14	23408740	23416740	23415212	8000	23412740	-4000	4000	2472
chr14	102076742	102084742	102081605	8000	102080742	-4000	4000	863
chr14	60967441	60975441	60968485	8000	60971441	-4000	4000	-2956
chr14	64470503	64478503	64473570	8000	64474503	-4000	4000	-933
chr14	23043062	23051062	23049699	8000	23047062	-4000	4000	2637
chr14	91453508	91461508	91461427	8000	91457508	-4000	4000	3919
chr14	24162452	24170452	24163927	8000	24166452	-4000	4000	-2525
chr14	24162452	24170452	24164769	8000	24166452	-4000	4000	-1683
chr14	67585612	67593612	67587159	8000	67589612	-4000	4000	-2453
chr14	45196890	45204890	45204150	8000	45200890	-4000	4000	3260
chr14	52853268	52861268	52858541	8000	52857268	-4000	4000	1273
chr14	24332025	24340025	24339482	8000	24336025	-4000	4000	3457
chr14	23408740	23416740	23416016	8000	23412740	-4000	4000	3276
chr14	58644321	58652321	58645777	8000	58648321	-4000	4000	-2544
chr14	63289508	63297508	63290979	8000	63293508	-4000	4000	-2529
chr14	24569518	24577518	24575288	8000	24573518	-4000	4000	1770
chr14	52006694	52014694	52014431	8000	52010694	-4000	4000	3737
chr14	94764223	94772223	94768614	8000	94768223	-4000	4000	391
chr14	24261538	24269538	24269111	8000	24265538	-4000	4000	3573
chr14	24332025	24340025	24338666	8000	24336025	-4000	4000	2641
chr14	60705539	60713539	60713453	8000	60709539	-4000	4000	3914
chr14	31126996	31134996	31128675	8000	31130996	-4000	4000	-2321
chr14	24332025	24340025	24338666	8000	24336025	-4000	4000	2641
chr14	24569518	24577518	24573677	8000	24573518	-4000	4000	159
chr14	23043062	23051062	23043410	8000	23047062	-4000	4000	-3652
chr14	52771193	52779193	52771239	8000	52775193	-4000	4000	-3954
chr14	75049237	75057237	75053611	8000	75053237	-4000	4000	374
chr14	104933244	104941244	104940739	8000	104937244	-4000	4000	3495
chr14	21494133	21502133	21496814	8000	21498133	-4000	4000	-1319
chr14	22981894	22989894	22987392	8000	22985894	-4000	4000	1498
chr14	23054564	23062564	23054571	8000	23058564	-4000	4000	-3993
chr14	23408740	23416740	23415081	8000	23412740	-4000	4000	2341
chr14	24261538	24269538	24262350	8000	24265538	-4000	4000	-3188
chr14	24415283	24423283	24415859	8000	24419283	-4000	4000	-3424
chr14	73271107	73279107	73276721	8000	73275107	-4000	4000	1614
chr14	73539796	73547796	73543047	8000	73543796	-4000	4000	-749
chr14	73591766	73599766	73595342	8000	73595766	-4000	4000	-424
chr14	52000809	52008809	52005373	8000	52004809	-4000	4000	564
chr14	91961991	91969991	91969523	8000	91965991	-4000	4000	3532
chr14	96259929	96267929	96264299	8000	96263929	-4000	4000	370
chr14	21381194	21389194	21385311	8000	21385194	-4000	4000	117
chr14	24314036	24322036	24318470	8000	24318036	-4000	4000	434
chr14	92684994	92692994	92685145	8000	92688994	-4000	4000	-3849
chr14	64542173	64550173	64542631	8000	64546173	-4000	4000	-3542
chr14	23641639	23649639	23643120	8000	23645639	-4000	4000	-2519
chr14	24415283	24423283	24417387	8000	24419283	-4000	4000	-1896
chr14	45199190	45207190	45206162	8000	45203190	-4000	4000	2972
chr14	24569518	24577518	24574487	8000	24573518	-4000	4000	969
chr14	96259929	96267929	96263997	8000	96263929	-4000	4000	68
chr14	104764494	104772494	104772377	8000	104768494	-4000	4000	3883
chr14	50715763	50723763	50722458	8000	50719763	-4000	4000	2695
chr14	24065729	24073729	24069155	8000	24069729	-4000	4000	-574
chr14	20353904	20361904	20354874	8000	20357904	-4000	4000	-3030
chr14	20353904	20361904	20357443	8000	20357904	-4000	4000	-461
chr14	20993035	21001035	21000980	8000	20997035	-4000	4000	3945
chr14	22883678	22891678	22884696	8000	22887678	-4000	4000	-2982
chr14	22981894	22989894	22987919	8000	22985894	-4000	4000	2025
chr14	24074662	24082662	24075859	8000	24078662	-4000	4000	-2803
chr14	24209955	24217955	24211557	8000	24213955	-4000	4000	-2398
chr14	24415283	24423283	24416809	8000	24419283	-4000	4000	-2474
chr14	24415283	24423283	24417359	8000	24419283	-4000	4000	-1924
chr14	30733694	30741694	30735733	8000	30737694	-4000	4000	-1961
chr14	31126996	31134996	31128960	8000	31130996	-4000	4000	-2036
chr14	49782385	49790385	49786738	8000	49786385	-4000	4000	353
chr14	50322265	50330265	50330150	8000	50326265	-4000	4000	3885
chr14	52324598	52332598	52327224	8000	52328598	-4000	4000	-1374
chr14	54838008	54846008	54843107	8000	54842008	-4000	4000	1099
chr14	58231636	58239636	58232219	8000	58235636	-4000	4000	-3417
chr14	58231636	58239636	58232220	8000	58235636	-4000	4000	-3416
chr14	58644321	58652321	58645742	8000	58648321	-4000	4000	-2579
chr14	59367405	59375405	59367488	8000	59371405	-4000	4000	-3917
chr14	67723374	67731374	67725248	8000	67727374	-4000	4000	-2126
chr14	73954010	73962010	73958876	8000	73958010	-4000	4000	866
chr14	74855435	74863435	74856947	8000	74859435	-4000	4000	-2488
chr14	74855435	74863435	74863032	8000	74859435	-4000	4000	3597
chr14	89790669	89798669	89797314	8000	89794669	-4000	4000	2645
chr14	91961991	91969991	91969533	8000	91965991	-4000	4000	3542
chr14	22981894	22989894	22987930	8000	22985894	-4000	4000	2036
chr14	51253655	51261655	51254382	8000	51257655	-4000	4000	-3273
chr14	55144112	55152112	55145167	8000	55148112	-4000	4000	-2945
chr14	63289508	63297508	63290919	8000	63293508	-4000	4000	-2589
chr14	63680216	63688216	63686569	8000	63684216	-4000	4000	2353
chr14	67655820	67663820	67662528	8000	67659820	-4000	4000	2708
chr14	93930166	93938166	93934512	8000	93934166	-4000	4000	346
chr14	96259929	96267929	96263690	8000	96263929	-4000	4000	-239
chr14	23268422	23276422	23276111	8000	23272422	-4000	4000	3689
chr14	52000809	52008809	52005226	8000	52004809	-4000	4000	417
chr14	21494133	21502133	21495244	8000	21498133	-4000	4000	-2889
chr14	54838008	54846008	54843878	8000	54842008	-4000	4000	1870
chr14	105045395	105053395	105051284	8000	105049395	-4000	4000	1889
chr14	20993035	21001035	20997002	8000	20997035	-4000	4000	-33
chr14	38250000	38258000	38255643	8000	38254000	-4000	4000	1643
chr14	63680216	63688216	63686183	8000	63684216	-4000	4000	1967
chr14	68783660	68791660	68790090	8000	68787660	-4000	4000	2430
chr14	92699807	92707807	92704091	8000	92703807	-4000	4000	284
chr14	58644321	58652321	58647203	8000	58648321	-4000	4000	-1118
chr14	63593039	63601039	63598789	8000	63597039	-4000	4000	1750
chr14	102726561	102734561	102729186	8000	102730561	-4000	4000	-1375
chr14	21517080	21525080	21522526	8000	21521080	-4000	4000	1446
chr14	23408740	23416740	23416257	8000	23412740	-4000	4000	3517
chr14	24074662	24082662	24076679	8000	24078662	-4000	4000	-1983
chr14	67655820	67663820	67659923	8000	67659820	-4000	4000	103
chr14	23342314	23350314	23349325	8000	23346314	-4000	4000	3011
chr14	61792428	61800428	61792872	8000	61796428	-4000	4000	-3556
chr14	24375604	24383604	24376676	8000	24379604	-4000	4000	-2928
chr14	54535292	54543292	54538448	8000	54539292	-4000	4000	-844
chr14	54535292	54543292	54538450	8000	54539292	-4000	4000	-842
chr14	55144112	55152112	55148308	8000	55148112	-4000	4000	196
chr14	24134959	24142959	24136185	8000	24138959	-4000	4000	-2774
chr14	93198894	93206894	93203451	8000	93202894	-4000	4000	557
chr14	74855435	74863435	74862820	8000	74859435	-4000	4000	3385
chr14	101559452	101567452	101562316	8000	101563452	-4000	4000	-1136
chr14	39393684	39401684	39401479	8000	39397684	-4000	4000	3795
chr14	52770989	52778989	52771033	8000	52774989	-4000	4000	-3956
chr14	67177803	67185803	67180836	8000	67181803	-4000	4000	-967
chr14	69376128	69384128	69380393	8000	69380128	-4000	4000	265
chr14	73489394	73497394	73495362	8000	73493394	-4000	4000	1968
chr14	73954010	73962010	73959029	8000	73958010	-4000	4000	1019
chr14	105247093	105255093	105250195	8000	105251093	-4000	4000	-898
chr14	99496190	99504190	99502287	8000	99500190	-4000	4000	2097
chr14	100734224	100742224	100734810	8000	100738224	-4000	4000	-3414
chr14	23096456	23104456	23098575	8000	23100456	-4000	4000	-1881
chr14	75075353	75083353	75077631	8000	75079353	-4000	4000	-1722
chr14	67577955	67585955	67583880	8000	67581955	-4000	4000	1925
chr14	20993035	21001035	20996796	8000	20997035	-4000	4000	-239
chr14	70028366	70036366	70030427	8000	70032366	-4000	4000	-1939
chr14	94275734	94283734	94278618	8000	94279734	-4000	4000	-1116
chr14	23408740	23416740	23415035	8000	23412740	-4000	4000	2295
chr14	24002408	24010408	24004409	8000	24006408	-4000	4000	-1999
chr14	52724590	52732590	52727560	8000	52728590	-4000	4000	-1030
chr14	39393684	39401684	39401518	8000	39397684	-4000	4000	3834
chr14	35109130	35117130	35110596	8000	35113130	-4000	4000	-2534
chr14	64222433	64230433	64226189	8000	64226433	-4000	4000	-244
chr14	74855435	74863435	74862874	8000	74859435	-4000	4000	3439
chr14	102220500	102228500	102222956	8000	102224500	-4000	4000	-1544
chr14	58547297	58555297	58548156	8000	58551297	-4000	4000	-3141
chr14	21494133	21502133	21496589	8000	21498133	-4000	4000	-1544
chr14	77255495	77263495	77256811	8000	77259495	-4000	4000	-2684
chr14	93214586	93222586	93218697	8000	93218586	-4000	4000	111
chr14	23408740	23416740	23415689	8000	23412740	-4000	4000	2949
chr14	70577257	70585257	70584938	8000	70581257	-4000	4000	3681
chr14	77668404	77676404	77674036	8000	77672404	-4000	4000	1632
chr14	44903257	44911257	44905697	8000	44907257	-4000	4000	-1560
chr14	77255495	77263495	77256717	8000	77259495	-4000	4000	-2778
chr14	59367405	59375405	59369423	8000	59371405	-4000	4000	-1982
chr14	21205136	21213136	21212977	8000	21209136	-4000	4000	3841
chr14	58644321	58652321	58645696	8000	58648321	-4000	4000	-2625
chr14	24245114	24253114	24249373	8000	24249114	-4000	4000	259
chr14	24235242	24243242	24239937	8000	24239242	-4000	4000	695
chr14	73571658	73579658	73575315	8000	73575658	-4000	4000	-343
chr14	23408740	23416740	23416055	8000	23412740	-4000	4000	3315
chr14	44903257	44911257	44904599	8000	44907257	-4000	4000	-2658
chr14	22769042	22777042	22770266	8000	22773042	-4000	4000	-2776
chr14	20993035	21001035	20994860	8000	20997035	-4000	4000	-2175
chr14	24134959	24142959	24139430	8000	24138959	-4000	4000	471
chr14	50113130	50121130	50118317	8000	50117130	-4000	4000	1187
chr14	73474484	73482484	73478635	8000	73478484	-4000	4000	151
chr14	88608431	88616431	88610907	8000	88612431	-4000	4000	-1524
chr14	90404268	90412268	90404862	8000	90408268	-4000	4000	-3406
chr14	105247093	105255093	105250245	8000	105251093	-4000	4000	-848
chr14	24375604	24383604	24377624	8000	24379604	-4000	4000	-1980
chr14	38250000	38258000	38254704	8000	38254000	-4000	4000	704
chr14	54838008	54846008	54842912	8000	54842008	-4000	4000	904
chr14	30616064	30624064	30616679	8000	30620064	-4000	4000	-3385
chr14	31442036	31450036	31447989	8000	31446036	-4000	4000	1953
chr14	36675362	36683362	36676447	8000	36679362	-4000	4000	-2915
chr14	49619481	49627481	49621993	8000	49623481	-4000	4000	-1488
chr14	59591976	59599976	59596676	8000	59595976	-4000	4000	700
chr14	63289508	63297508	63291034	8000	63293508	-4000	4000	-2474
chr14	67647708	67655708	67650745	8000	67651708	-4000	4000	-963
chr14	20353904	20361904	20356400	8000	20357904	-4000	4000	-1504
chr14	52000809	52008809	52005255	8000	52004809	-4000	4000	446
chr14	53945736	53953736	53953377	8000	53949736	-4000	4000	3641
chr14	77668404	77676404	77674108	8000	77672404	-4000	4000	1704
chr14	30891065	30899065	30895724	8000	30895065	-4000	4000	659
chr15	52063375	52071375	52063993	8000	52067375	-4000	4000	-3382
chr15	98960530	98968530	98962642	8000	98964530	-4000	4000	-1888
chr15	24974723	24982723	24974841	8000	24978723	-4000	4000	-3882
chr15	38353249	38361249	38353325	8000	38357249	-4000	4000	-3924
chr15	98960530	98968530	98964323	8000	98964530	-4000	4000	-207
chr15	70825130	70833130	70832994	8000	70829130	-4000	4000	3864
chr15	75931969	75939969	75932904	8000	75935969	-4000	4000	-3065
chr15	34375068	34383068	34381737	8000	34379068	-4000	4000	2669
chr15	78273835	78281835	78275730	8000	78277835	-4000	4000	-2105
chr15	83251884	83259884	83257936	8000	83255884	-4000	4000	2052
chr15	84665538	84673538	84670756	8000	84669538	-4000	4000	1218
chr15	96336263	96344263	96337471	8000	96340263	-4000	4000	-2792
chr15	101171727	101179727	101177858	8000	101175727	-4000	4000	2131
chr15	78100606	78108606	78105326	8000	78104606	-4000	4000	720
chr15	51717026	51725026	51719475	8000	51721026	-4000	4000	-1551
chr15	83251884	83259884	83257606	8000	83255884	-4000	4000	1722
chr15	25673273	25681273	25679411	8000	25677273	-4000	4000	2138
chr15	43405771	43413771	43408049	8000	43409771	-4000	4000	-1722
chr15	75017495	75025495	75019073	8000	75021495	-4000	4000	-2422
chr15	82435153	82443153	82436568	8000	82439153	-4000	4000	-2585
chr15	34521095	34529095	34527935	8000	34525095	-4000	4000	2840
chr15	43600901	43608901	43601008	8000	43604901	-4000	4000	-3893
chr15	41383218	41391218	41387391	8000	41387218	-4000	4000	173
chr15	69268217	69276217	69268813	8000	69272217	-4000	4000	-3404
chr15	65190760	65198760	65198153	8000	65194760	-4000	4000	3393
chr15	36806248	36814248	36808574	8000	36810248	-4000	4000	-1674
chr15	43600901	43608901	43601507	8000	43604901	-4000	4000	-3394
chr15	44714851	44722851	44715603	8000	44718851	-4000	4000	-3248
chr15	74172872	74180872	74180014	8000	74176872	-4000	4000	3142
chr15	67196667	67204667	67204092	8000	67200667	-4000	4000	3425
chr15	43354172	43362172	43361786	8000	43358172	-4000	4000	3614
chr15	66778849	66786849	66781987	8000	66782849	-4000	4000	-862
chr15	63138061	63146061	63141717	8000	63142061	-4000	4000	-344
chr15	51717026	51725026	51719600	8000	51721026	-4000	4000	-1426
chr15	74172872	74180872	74180139	8000	74176872	-4000	4000	3267
chr15	74172872	74180872	74180140	8000	74176872	-4000	4000	3268
chr15	80751621	80759621	80754214	8000	80755621	-4000	4000	-1407
chr15	90225679	90233679	90225689	8000	90229679	-4000	4000	-3990
chr15	90891776	90899776	90893409	8000	90895776	-4000	4000	-2367
chr15	36885204	36893204	36891427	8000	36889204	-4000	4000	2223
chr15	98960530	98968530	98961568	8000	98964530	-4000	4000	-2962
chr15	88476776	88484776	88477042	8000	88480776	-4000	4000	-3734
chr15	45672314	45680314	45676201	8000	45676314	-4000	4000	-113
chr15	73301205	73309205	73301380	8000	73305205	-4000	4000	-3825
chr15	25673273	25681273	25679743	8000	25677273	-4000	4000	2470
chr15	29116252	29124252	29123383	8000	29120252	-4000	4000	3131
chr15	43768617	43776617	43776513	8000	43772617	-4000	4000	3896
chr15	65574349	65582349	65581997	8000	65578349	-4000	4000	3648
chr15	81327088	81335088	81332966	8000	81331088	-4000	4000	1878
chr15	88652483	88660483	88655544	8000	88656483	-4000	4000	-939
chr15	72155806	72163806	72163386	8000	72159806	-4000	4000	3580
chr15	96336263	96344263	96338808	8000	96340263	-4000	4000	-1455
chr15	66546130	66554130	66553142	8000	66550130	-4000	4000	3012
chr15	24974723	24982723	24976367	8000	24978723	-4000	4000	-2356
chr15	34354633	34362633	34362580	8000	34358633	-4000	4000	3947
chr15	41277887	41285887	41278821	8000	41281887	-4000	4000	-3066
chr15	42734730	42742730	42735937	8000	42738730	-4000	4000	-2793
chr15	61848389	61856389	61854524	8000	61852389	-4000	4000	2135
chr15	72747294	72755294	72752299	8000	72751294	-4000	4000	1005
chr15	78167945	78175945	78173652	8000	78171945	-4000	4000	1707
chr15	81305053	81313053	81306589	8000	81309053	-4000	4000	-2464
chr15	85135145	85143145	85138083	8000	85139145	-4000	4000	-1062
chr15	88455501	88463501	88459542	8000	88459501	-4000	4000	41
chr15	90891776	90899776	90893767	8000	90895776	-4000	4000	-2009
chr15	99967437	99975437	99974425	8000	99971437	-4000	4000	2988
chr15	41499551	41507551	41505257	8000	41503551	-4000	4000	1706
chr15	49363869	49371869	49367468	8000	49367869	-4000	4000	-401
chr15	90879564	90887564	90881660	8000	90883564	-4000	4000	-1904
chr15	70825130	70833130	70832982	8000	70829130	-4000	4000	3852
chr15	52063375	52071375	52064761	8000	52067375	-4000	4000	-2614
chr15	78497453	78505453	78498113	8000	78501453	-4000	4000	-3340
chr15	48819741	48827741	48825599	8000	48823741	-4000	4000	1858
chr15	48876173	48884173	48879915	8000	48880173	-4000	4000	-258
chr15	70825130	70833130	70832816	8000	70829130	-4000	4000	3686
chr15	30934941	30942941	30937179	8000	30938941	-4000	4000	-1762
chr15	39795008	39803008	39801435	8000	39799008	-4000	4000	2427
chr15	41499551	41507551	41504195	8000	41503551	-4000	4000	644
chr15	33854782	33862782	33859701	8000	33858782	-4000	4000	919
chr15	65323127	65331127	65330388	8000	65327127	-4000	4000	3261
chr15	90891776	90899776	90893146	8000	90895776	-4000	4000	-2630
chr15	40935073	40943073	40936402	8000	40939073	-4000	4000	-2671
chr15	101171727	101179727	101178962	8000	101175727	-4000	4000	3235
chr15	49854238	49862238	49860345	8000	49858238	-4000	4000	2107
chr15	40728340	40736340	40729888	8000	40732340	-4000	4000	-2452
chr15	23681400	23689400	23686793	8000	23685400	-4000	4000	1393
chr15	77609027	77617027	77615479	8000	77613027	-4000	4000	2452
chr15	34354633	34362633	34362602	8000	34358633	-4000	4000	3969
chr15	75931969	75939969	75933182	8000	75935969	-4000	4000	-2787
chr15	90891776	90899776	90893784	8000	90895776	-4000	4000	-1992
chr15	43399061	43407061	43404514	8000	43403061	-4000	4000	1453
chr15	36806248	36814248	36808640	8000	36810248	-4000	4000	-1608
chr15	44550818	44558818	44557501	8000	44554818	-4000	4000	2683
chr15	51443711	51451711	51449123	8000	51447711	-4000	4000	1412
chr15	90498239	90506239	90500144	8000	90502239	-4000	4000	-2095
chr15	82655281	82663281	82659646	8000	82659281	-4000	4000	365
chr15	89301198	89309198	89306064	8000	89305198	-4000	4000	866
chr15	74043827	74051827	74044537	8000	74047827	-4000	4000	-3290
chr15	83251884	83259884	83257087	8000	83255884	-4000	4000	1203
chr15	68723806	68731806	68726002	8000	68727806	-4000	4000	-1804
chr15	77609027	77617027	77615381	8000	77613027	-4000	4000	2354
chr15	88871353	88879353	88872880	8000	88875353	-4000	4000	-2473
chr15	43769279	43777279	43777107	8000	43773279	-4000	4000	3828
chr15	43864412	43872412	43866155	8000	43868412	-4000	4000	-2257
chr15	65049337	65057337	65055199	8000	65053337	-4000	4000	1862
chr15	72747294	72755294	72751584	8000	72751294	-4000	4000	290
chr15	88476776	88484776	88476988	8000	88480776	-4000	4000	-3788
chr15	34521095	34529095	34527466	8000	34525095	-4000	4000	2371
chr15	75208169	75216169	75208755	8000	75212169	-4000	4000	-3414
chr15	77033475	77041475	77037270	8000	77037475	-4000	4000	-205
chr15	79468304	79476304	79468403	8000	79472304	-4000	4000	-3901
chr15	68774535	68782535	68779918	8000	68778535	-4000	4000	1383
chr15	77481607	77489607	77485446	8000	77485607	-4000	4000	-161
chr15	33862121	33870121	33864156	8000	33866121	-4000	4000	-1965
chr15	43866761	43874761	43873959	8000	43870761	-4000	4000	3198
chr15	70650554	70658554	70657126	8000	70654554	-4000	4000	2572
chr15	81305053	81313053	81306588	8000	81309053	-4000	4000	-2465
chr15	48819741	48827741	48825722	8000	48823741	-4000	4000	1981
chr15	89660367	89668367	89667011	8000	89664367	-4000	4000	2644
chr15	40031690	40039690	40032210	8000	40035690	-4000	4000	-3480
chr15	57949424	57957424	57955227	8000	57953424	-4000	4000	1803
chr15	66494015	66502015	66501799	8000	66498015	-4000	4000	3784
chr15	41513176	41521176	41513745	8000	41517176	-4000	4000	-3431
chr15	90879564	90887564	90881367	8000	90883564	-4000	4000	-2197
chr15	99131593	99139593	99131630	8000	99135593	-4000	4000	-3963
chr15	24974723	24982723	24974918	8000	24978723	-4000	4000	-3805
chr15	33854782	33862782	33859647	8000	33858782	-4000	4000	865
chr15	55351648	55359648	55354874	8000	55355648	-4000	4000	-774
chr15	65323127	65331127	65329561	8000	65327127	-4000	4000	2434
chr15	34974341	34982341	34981699	8000	34978341	-4000	4000	3358
chr15	34974341	34982341	34981817	8000	34978341	-4000	4000	3476
chr15	83251884	83259884	83257509	8000	83255884	-4000	4000	1625
chr15	48404313	48412313	48410981	8000	48408313	-4000	4000	2668
chr15	42541356	42549356	42548139	8000	42545356	-4000	4000	2783
chr15	43228590	43236590	43233284	8000	43232590	-4000	4000	694
chr15	55351648	55359648	55359471	8000	55355648	-4000	4000	3823
chr15	96336263	96344263	96337562	8000	96340263	-4000	4000	-2701
chr15	75670322	75678322	75675562	8000	75674322	-4000	4000	1240
chr15	65323127	65331127	65329058	8000	65327127	-4000	4000	1931
chr15	75897078	75905078	75904504	8000	75901078	-4000	4000	3426
chr15	100912626	100920626	100914711	8000	100916626	-4000	4000	-1915
chr15	39795008	39803008	39800760	8000	39799008	-4000	4000	1752
chr15	69268217	69276217	69268556	8000	69272217	-4000	4000	-3661
chr15	42938897	42946897	42945232	8000	42942897	-4000	4000	2335
chr15	78344225	78352225	78348124	8000	78348225	-4000	4000	-101
chr15	23681400	23689400	23686867	8000	23685400	-4000	4000	1467
chr15	25673273	25681273	25679902	8000	25677273	-4000	4000	2629
chr15	39795008	39803008	39801995	8000	39799008	-4000	4000	2987
chr15	48404313	48412313	48408668	8000	48408313	-4000	4000	355
chr15	47770228	47778228	47770871	8000	47774228	-4000	4000	-3357
chr15	89774754	89782754	89778178	8000	89778754	-4000	4000	-576
chr15	65049337	65057337	65053658	8000	65053337	-4000	4000	321
chr15	34337719	34345719	34343050	8000	34341719	-4000	4000	1331
chr15	89627056	89635056	89628709	8000	89631056	-4000	4000	-2347
chr15	97969833	97977833	97970007	8000	97973833	-4000	4000	-3826
chr15	52063375	52071375	52064106	8000	52067375	-4000	4000	-3269
chr15	43405771	43413771	43409684	8000	43409771	-4000	4000	-87
chr15	36806248	36814248	36808604	8000	36810248	-4000	4000	-1644
chr15	43405771	43413771	43409031	8000	43409771	-4000	4000	-740
chr15	45161576	45169576	45161799	8000	45165576	-4000	4000	-3777
chr15	72747294	72755294	72752186	8000	72751294	-4000	4000	892
chr15	75339224	75347224	75339809	8000	75343224	-4000	4000	-3415
chr15	84035842	84043842	84037838	8000	84039842	-4000	4000	-2004
chr15	23681400	23689400	23686531	8000	23685400	-4000	4000	1131
chr15	89467398	89475398	89471665	8000	89471398	-4000	4000	267
chr15	101171727	101179727	101177962	8000	101175727	-4000	4000	2235
chr15	29116252	29124252	29123384	8000	29120252	-4000	4000	3132
chr15	48138672	48146672	48141261	8000	48142672	-4000	4000	-1411
chr15	101649596	101657596	101650093	8000	101653596	-4000	4000	-3503
chr15	70825130	70833130	70832470	8000	70829130	-4000	4000	3340
chr15	34225784	34233784	34230024	8000	34229784	-4000	4000	240
chr15	68774535	68782535	68780076	8000	68778535	-4000	4000	1541
chr15	89780895	89788895	89785422	8000	89784895	-4000	4000	527
chr15	45161576	45169576	45161818	8000	45165576	-4000	4000	-3758
chr15	72139692	72147692	72139792	8000	72143692	-4000	4000	-3900
chr15	74405289	74413289	74411968	8000	74409289	-4000	4000	2679
chr15	48819741	48827741	48825917	8000	48823741	-4000	4000	2176
chr15	41513176	41521176	41520967	8000	41517176	-4000	4000	3791
chr15	65049337	65057337	65054861	8000	65053337	-4000	4000	1524
chr15	48339373	48347373	48341471	8000	48343373	-4000	4000	-1902
chr15	65190760	65198760	65198344	8000	65194760	-4000	4000	3584
chr15	99132323	99140323	99132977	8000	99136323	-4000	4000	-3346
chr15	100647701	100655701	100648426	8000	100651701	-4000	4000	-3275
chr15	43768617	43776617	43775844	8000	43772617	-4000	4000	3227
chr15	88652483	88660483	88655544	8000	88656483	-4000	4000	-939
chr15	40217123	40225123	40220792	8000	40221123	-4000	4000	-331
chr15	40728340	40736340	40729513	8000	40732340	-4000	4000	-2827
chr15	77033475	77041475	77037069	8000	77037475	-4000	4000	-406
chr15	101171727	101179727	101177978	8000	101175727	-4000	4000	2251
chr15	34354633	34362633	34355077	8000	34358633	-4000	4000	-3556
chr15	66329898	66337898	66336831	8000	66333898	-4000	4000	2933
chr15	43695222	43703222	43699178	8000	43699222	-4000	4000	-44
chr15	43600901	43608901	43608109	8000	43604901	-4000	4000	3208
chr15	65323127	65331127	65328463	8000	65327127	-4000	4000	1336
chr15	40083890	40091890	40088189	8000	40087890	-4000	4000	299
chr15	43405771	43413771	43409038	8000	43409771	-4000	4000	-733
chr15	75897078	75905078	75899600	8000	75901078	-4000	4000	-1478
chr15	55198966	55206966	55205563	8000	55202966	-4000	4000	2597
chr15	38484103	38492103	38490219	8000	38488103	-4000	4000	2116
chr15	41499551	41507551	41505290	8000	41503551	-4000	4000	1739
chr15	42206447	42214447	42211027	8000	42210447	-4000	4000	580
chr15	43405771	43413771	43409034	8000	43409771	-4000	4000	-737
chr15	65323127	65331127	65329443	8000	65327127	-4000	4000	2316
chr15	70877342	70885342	70882502	8000	70881342	-4000	4000	1160
chr15	41499551	41507551	41502968	8000	41503551	-4000	4000	-583
chr15	48138672	48146672	48142890	8000	48142672	-4000	4000	218
chr15	43529462	43537462	43534929	8000	43533462	-4000	4000	1467
chr15	43529462	43537462	43535132	8000	43533462	-4000	4000	1670
chr15	57546717	57554717	57547641	8000	57550717	-4000	4000	-3076
chr15	43354172	43362172	43360864	8000	43358172	-4000	4000	2692
chr15	75594083	75602083	75598433	8000	75598083	-4000	4000	350
chr15	74172872	74180872	74175451	8000	74176872	-4000	4000	-1421
chr15	74172872	74180872	74175955	8000	74176872	-4000	4000	-917
chr15	40952512	40960512	40955645	8000	40956512	-4000	4000	-867
chr15	42565994	42573994	42566647	8000	42569994	-4000	4000	-3347
chr15	45113366	45121366	45117745	8000	45117366	-4000	4000	379
chr15	65323127	65331127	65329564	8000	65327127	-4000	4000	2437
chr15	66546130	66554130	66553012	8000	66550130	-4000	4000	2882
chr15	74405289	74413289	74410898	8000	74409289	-4000	4000	1609
chr15	82280930	82288930	82283032	8000	82284930	-4000	4000	-1898
chr15	77609027	77617027	77615060	8000	77613027	-4000	4000	2033
chr15	24974723	24982723	24976904	8000	24978723	-4000	4000	-1819
chr15	40763708	40771708	40771527	8000	40767708	-4000	4000	3819
chr15	40952512	40960512	40953437	8000	40956512	-4000	4000	-3075
chr15	43181144	43189144	43181207	8000	43185144	-4000	4000	-3937
chr15	64735891	64743891	64740926	8000	64739891	-4000	4000	1035
chr15	66546130	66554130	66551811	8000	66550130	-4000	4000	1681
chr15	72280727	72288727	72286077	8000	72284727	-4000	4000	1350
chr15	74626558	74634558	74627360	8000	74630558	-4000	4000	-3198
chr15	75635085	75643085	75639144	8000	75639085	-4000	4000	59
chr15	80593933	80601933	80597779	8000	80597933	-4000	4000	-154
chr15	93023996	93031996	93026056	8000	93027996	-4000	4000	-1940
chr15	34375068	34383068	34379158	8000	34379068	-4000	4000	90
chr15	45672314	45680314	45673720	8000	45676314	-4000	4000	-2594
chr15	51001895	51009895	51004629	8000	51005895	-4000	4000	-1266
chr15	38353249	38361249	38353597	8000	38357249	-4000	4000	-3652
chr15	101171727	101179727	101177131	8000	101175727	-4000	4000	1404
chr15	41891933	41899933	41892938	8000	41895933	-4000	4000	-2995
chr15	39795008	39803008	39801566	8000	39799008	-4000	4000	2558
chr15	41277887	41285887	41278820	8000	41281887	-4000	4000	-3067
chr15	43181144	43189144	43184418	8000	43185144	-4000	4000	-726
chr15	69268217	69276217	69268791	8000	69272217	-4000	4000	-3426
chr15	22825789	22833789	22829403	8000	22829789	-4000	4000	-386
chr15	41499551	41507551	41507119	8000	41503551	-4000	4000	3568
chr15	44411758	44419758	44415197	8000	44415758	-4000	4000	-561
chr15	45161576	45169576	45161830	8000	45165576	-4000	4000	-3746
chr15	50271389	50279389	50277952	8000	50275389	-4000	4000	2563
chr15	50271389	50279389	50278452	8000	50275389	-4000	4000	3063
chr15	64451303	64459303	64455186	8000	64455303	-4000	4000	-117
chr15	65574349	65582349	65576647	8000	65578349	-4000	4000	-1702
chr15	66546130	66554130	66552166	8000	66550130	-4000	4000	2036
chr15	73301205	73309205	73303266	8000	73305205	-4000	4000	-1939
chr15	74441977	74449977	74449197	8000	74445977	-4000	4000	3220
chr15	78273835	78281835	78275720	8000	78277835	-4000	4000	-2115
chr15	85135145	85143145	85138407	8000	85139145	-4000	4000	-738
chr15	90959125	90967125	90966378	8000	90963125	-4000	4000	3253
chr15	55822922	55830922	55829758	8000	55826922	-4000	4000	2836
chr15	82280930	82288930	82282641	8000	82284930	-4000	4000	-2289
chr15	52543045	52551045	52550743	8000	52547045	-4000	4000	3698
chr15	24974723	24982723	24978301	8000	24978723	-4000	4000	-422
chr15	30939108	30947108	30941821	8000	30943108	-4000	4000	-1287
chr15	40390288	40398288	40393686	8000	40394288	-4000	4000	-602
chr15	80947776	80955776	80950721	8000	80951776	-4000	4000	-1055
chr15	82435153	82443153	82436664	8000	82439153	-4000	4000	-2489
chr15	82435153	82443153	82437145	8000	82439153	-4000	4000	-2008
chr15	97969833	97977833	97972569	8000	97973833	-4000	4000	-1264
chr15	45113366	45121366	45117824	8000	45117366	-4000	4000	458
chr15	63263776	63271776	63263824	8000	63267776	-4000	4000	-3952
chr15	63604618	63612618	63609067	8000	63608618	-4000	4000	449
chr15	42349666	42357666	42354455	8000	42353666	-4000	4000	789
chr15	47770228	47778228	47771825	8000	47774228	-4000	4000	-2403
chr15	48984476	48992476	48988849	8000	48988476	-4000	4000	373
chr15	45113366	45121366	45117871	8000	45117366	-4000	4000	505
chr15	63121872	63129872	63127397	8000	63125872	-4000	4000	1525
chr15	78591269	78599269	78596401	8000	78595269	-4000	4000	1132
chr15	42349666	42357666	42351333	8000	42353666	-4000	4000	-2333
chr15	75670322	75678322	75676390	8000	75674322	-4000	4000	2068
chr15	65144219	65152219	65150670	8000	65148219	-4000	4000	2451
chr15	33862121	33870121	33864177	8000	33866121	-4000	4000	-1944
chr15	63604618	63612618	63612309	8000	63608618	-4000	4000	3691
chr15	42154701	42162701	42160812	8000	42158701	-4000	4000	2111
chr15	52577317	52585317	52584749	8000	52581317	-4000	4000	3432
chr15	88652483	88660483	88655555	8000	88656483	-4000	4000	-928
chr15	62840631	62848631	62840652	8000	62844631	-4000	4000	-3979
chr15	82335993	82343993	82342735	8000	82339993	-4000	4000	2742
chr15	43800427	43808427	43800470	8000	43804427	-4000	4000	-3957
chr15	72155806	72163806	72163661	8000	72159806	-4000	4000	3855
chr15	65049337	65057337	65054130	8000	65053337	-4000	4000	793
chr15	75670322	75678322	75677845	8000	75674322	-4000	4000	3523
chr15	64683573	64691573	64690493	8000	64687573	-4000	4000	2920
chr15	92464728	92472728	92468293	8000	92468728	-4000	4000	-435
chr15	40952512	40960512	40955752	8000	40956512	-4000	4000	-760
chr15	82335993	82343993	82342553	8000	82339993	-4000	4000	2560
chr15	73710514	73718514	73711361	8000	73714514	-4000	4000	-3153
chr15	30939108	30947108	30941752	8000	30943108	-4000	4000	-1356
chr15	34337719	34345719	34341875	8000	34341719	-4000	4000	156
chr15	45113366	45121366	45117499	8000	45117366	-4000	4000	133
chr15	43350569	43358569	43351929	8000	43354569	-4000	4000	-2640
chr15	63305126	63313126	63305649	8000	63309126	-4000	4000	-3477
chr15	90879564	90887564	90881449	8000	90883564	-4000	4000	-2115
chr15	43228590	43236590	43233661	8000	43232590	-4000	4000	1071
chr15	83012423	83020423	83018802	8000	83016423	-4000	4000	2379
chr15	51052598	51060598	51057619	8000	51056598	-4000	4000	1021
chr15	84035842	84043842	84036991	8000	84039842	-4000	4000	-2851
chr15	22865362	22873362	22866904	8000	22869362	-4000	4000	-2458
chr15	23681400	23689400	23686921	8000	23685400	-4000	4000	1521
chr15	34974341	34982341	34982200	8000	34978341	-4000	4000	3859
chr15	41499551	41507551	41504113	8000	41503551	-4000	4000	562
chr15	42135034	42143034	42141891	8000	42139034	-4000	4000	2857
chr15	43181144	43189144	43186047	8000	43185144	-4000	4000	903
chr15	43864412	43872412	43866257	8000	43868412	-4000	4000	-2155
chr15	44661732	44669732	44665951	8000	44665732	-4000	4000	219
chr15	48138672	48146672	48142304	8000	48142672	-4000	4000	-368
chr15	51052598	51060598	51058425	8000	51056598	-4000	4000	1827
chr15	66486135	66494135	66490732	8000	66490135	-4000	4000	597
chr15	72734475	72742475	72735206	8000	72738475	-4000	4000	-3269
chr15	74172872	74180872	74174982	8000	74176872	-4000	4000	-1890
chr15	74172872	74180872	74175356	8000	74176872	-4000	4000	-1516
chr15	74172872	74180872	74176028	8000	74176872	-4000	4000	-844
chr15	77609027	77617027	77614982	8000	77613027	-4000	4000	1955
chr15	77609027	77617027	77615576	8000	77613027	-4000	4000	2549
chr15	78278196	78286196	78283308	8000	78282196	-4000	4000	1112
chr15	82655281	82663281	82659661	8000	82659281	-4000	4000	380
chr15	101171727	101179727	101177900	8000	101175727	-4000	4000	2173
chr15	101649596	101657596	101654596	8000	101653596	-4000	4000	1000
chr15	44411758	44419758	44415257	8000	44415758	-4000	4000	-501
chr15	55822922	55830922	55829962	8000	55826922	-4000	4000	3040
chr15	79468304	79476304	79468328	8000	79472304	-4000	4000	-3976
chr15	89198355	89206355	89200881	8000	89202355	-4000	4000	-1474
chr15	43864412	43872412	43866274	8000	43868412	-4000	4000	-2138
chr15	43695222	43703222	43699155	8000	43699222	-4000	4000	-67
chr15	60415609	60423609	60423519	8000	60419609	-4000	4000	3910
chr15	43193227	43201227	43194451	8000	43197227	-4000	4000	-2776
chr15	63903036	63911036	63908575	8000	63907036	-4000	4000	1539
chr15	92613448	92621448	92618247	8000	92617448	-4000	4000	799
chr15	61848389	61856389	61854524	8000	61852389	-4000	4000	2135
chr15	43529462	43537462	43534668	8000	43533462	-4000	4000	1206
chr15	44763829	44771829	44767691	8000	44767829	-4000	4000	-138
chr15	45073185	45081185	45073377	8000	45077185	-4000	4000	-3808
chr15	45113366	45121366	45117647	8000	45117366	-4000	4000	281
chr15	48339373	48347373	48341530	8000	48343373	-4000	4000	-1843
chr15	48404313	48412313	48410892	8000	48408313	-4000	4000	2579
chr15	51717026	51725026	51724800	8000	51721026	-4000	4000	3774
chr15	65049337	65057337	65052994	8000	65053337	-4000	4000	-343
chr15	66329898	66337898	66337095	8000	66333898	-4000	4000	3197
chr15	69444427	69452427	69445041	8000	69448427	-4000	4000	-3386
chr15	72747294	72755294	72752412	8000	72751294	-4000	4000	1118
chr15	78163468	78171468	78163534	8000	78167468	-4000	4000	-3934
chr15	78591269	78599269	78596535	8000	78595269	-4000	4000	1266
chr15	78955906	78963906	78962025	8000	78959906	-4000	4000	2119
chr15	82037778	82045778	82043489	8000	82041778	-4000	4000	1711
chr15	82037778	82045778	82043689	8000	82041778	-4000	4000	1911
chr15	82126233	82134233	82130296	8000	82130233	-4000	4000	63
chr15	82655281	82663281	82662755	8000	82659281	-4000	4000	3474
chr15	83251884	83259884	83257516	8000	83255884	-4000	4000	1632
chr15	90879564	90887564	90885038	8000	90883564	-4000	4000	1474
chr15	90959125	90967125	90966996	8000	90963125	-4000	4000	3871
chr15	92464728	92472728	92472274	8000	92468728	-4000	4000	3546
chr15	40570949	40578949	40573664	8000	40574949	-4000	4000	-1285
chr15	48404313	48412313	48411014	8000	48408313	-4000	4000	2701
chr15	88871353	88879353	88871468	8000	88875353	-4000	4000	-3885
chr15	34354633	34362633	34356438	8000	34358633	-4000	4000	-2195
chr15	23681400	23689400	23686050	8000	23685400	-4000	4000	650
chr15	36885204	36893204	36892361	8000	36889204	-4000	4000	3157
chr15	89739638	89747638	89743368	8000	89743638	-4000	4000	-270
chr15	81327088	81335088	81332829	8000	81331088	-4000	4000	1741
chr15	84035842	84043842	84039400	8000	84039842	-4000	4000	-442
chr15	84035842	84043842	84039401	8000	84039842	-4000	4000	-441
chr15	80134393	80142393	80137707	8000	80138393	-4000	4000	-686
chr15	23681400	23689400	23686420	8000	23685400	-4000	4000	1020
chr15	33862121	33870121	33866047	8000	33866121	-4000	4000	-74
chr15	65574349	65582349	65576504	8000	65578349	-4000	4000	-1845
chr15	74172872	74180872	74175712	8000	74176872	-4000	4000	-1160
chr15	88476776	88484776	88477039	8000	88480776	-4000	4000	-3737
chr15	65190760	65198760	65198596	8000	65194760	-4000	4000	3836
chr15	101266817	101274817	101272802	8000	101270817	-4000	4000	1985
chr15	52577317	52585317	52585094	8000	52581317	-4000	4000	3777
chr15	78273835	78281835	78274315	8000	78277835	-4000	4000	-3520
chr15	90950093	90958093	90950504	8000	90954093	-4000	4000	-3589
chr15	82037778	82045778	82044138	8000	82041778	-4000	4000	2360
chr15	48339373	48347373	48341398	8000	48343373	-4000	4000	-1975
chr15	78167945	78175945	78173668	8000	78171945	-4000	4000	1723
chr15	59636239	59644239	59639063	8000	59640239	-4000	4000	-1176
chr15	70877342	70885342	70882775	8000	70881342	-4000	4000	1433
chr15	99132323	99140323	99132736	8000	99136323	-4000	4000	-3587
chr15	65190760	65198760	65197263	8000	65194760	-4000	4000	2503
chr15	43529462	43537462	43535245	8000	43533462	-4000	4000	1783
chr15	78497453	78505453	78498340	8000	78501453	-4000	4000	-3113
chr15	40083890	40091890	40090367	8000	40087890	-4000	4000	2477
chr15	90891776	90899776	90893657	8000	90895776	-4000	4000	-2119
chr15	65049337	65057337	65053024	8000	65053337	-4000	4000	-313
chr15	73710514	73718514	73711325	8000	73714514	-4000	4000	-3189
chr15	34974341	34982341	34981557	8000	34978341	-4000	4000	3216
chr15	42154701	42162701	42162481	8000	42158701	-4000	4000	3780
chr15	90891776	90899776	90893810	8000	90895776	-4000	4000	-1966
chr15	72280727	72288727	72287283	8000	72284727	-4000	4000	2556
chr15	88476776	88484776	88477969	8000	88480776	-4000	4000	-2807
chr15	43695222	43703222	43698731	8000	43699222	-4000	4000	-491
chr15	83251884	83259884	83257523	8000	83255884	-4000	4000	1639
chr15	81327088	81335088	81333103	8000	81331088	-4000	4000	2015
chr15	43864412	43872412	43866202	8000	43868412	-4000	4000	-2210
chr15	40390288	40398288	40391525	8000	40394288	-4000	4000	-2763
chr15	43768617	43776617	43771315	8000	43772617	-4000	4000	-1302
chr15	77609027	77617027	77613695	8000	77613027	-4000	4000	668
chr15	64068565	64076565	64073016	8000	64072565	-4000	4000	451
chr15	47770228	47778228	47771673	8000	47774228	-4000	4000	-2555
chr15	42716998	42724998	42717786	8000	42720998	-4000	4000	-3212
chr15	78273835	78281835	78275537	8000	78277835	-4000	4000	-2298
chr15	65049337	65057337	65054168	8000	65053337	-4000	4000	831
chr15	50232385	50240385	50233913	8000	50236385	-4000	4000	-2472
chr15	100912626	100920626	100914700	8000	100916626	-4000	4000	-1926
chr15	51443711	51451711	51450274	8000	51447711	-4000	4000	2563
chr15	43405771	43413771	43408931	8000	43409771	-4000	4000	-840
chr15	42716998	42724998	42718062	8000	42720998	-4000	4000	-2936
chr15	41499551	41507551	41505452	8000	41503551	-4000	4000	1901
chr15	43695222	43703222	43699164	8000	43699222	-4000	4000	-58
chr15	55822922	55830922	55829726	8000	55826922	-4000	4000	2804
chr15	99132323	99140323	99132643	8000	99136323	-4000	4000	-3680
chr15	89301198	89309198	89307629	8000	89305198	-4000	4000	2431
chr15	84035842	84043842	84037779	8000	84039842	-4000	4000	-2063
chr15	90891776	90899776	90892741	8000	90895776	-4000	4000	-3035
chr15	43866761	43874761	43874432	8000	43870761	-4000	4000	3671
chr15	59093419	59101419	59095228	8000	59097419	-4000	4000	-2191
chr15	78273835	78281835	78275463	8000	78277835	-4000	4000	-2372
chr15	43354172	43362172	43360960	8000	43358172	-4000	4000	2788
chr15	89627056	89635056	89630454	8000	89631056	-4000	4000	-602
chr15	34354633	34362633	34359129	8000	34358633	-4000	4000	496
chr15	75670322	75678322	75676024	8000	75674322	-4000	4000	1702
chr15	45113366	45121366	45114644	8000	45117366	-4000	4000	-2722
chr15	89627056	89635056	89630324	8000	89631056	-4000	4000	-732
chr15	66778849	66786849	66781069	8000	66782849	-4000	4000	-1780
chr15	80182946	80190946	80186280	8000	80186946	-4000	4000	-666
chr15	40031690	40039690	40036232	8000	40035690	-4000	4000	542
chr15	66329898	66337898	66337083	8000	66333898	-4000	4000	3185
chr15	74172872	74180872	74175896	8000	74176872	-4000	4000	-976
chr15	78497453	78505453	78498078	8000	78501453	-4000	4000	-3375
chr15	57710745	57718745	57712007	8000	57714745	-4000	4000	-2738
chr15	74172872	74180872	74175245	8000	74176872	-4000	4000	-1627
chr15	89313261	89321261	89317437	8000	89317261	-4000	4000	176
chr15	25673273	25681273	25680187	8000	25677273	-4000	4000	2914
chr15	73556014	73564014	73559907	8000	73560014	-4000	4000	-107
chr15	74898219	74906219	74905188	8000	74902219	-4000	4000	2969
chr15	89301198	89309198	89306053	8000	89305198	-4000	4000	855
chr15	100555369	100563369	100558779	8000	100559369	-4000	4000	-590
chr15	55336032	55344032	55340812	8000	55340032	-4000	4000	780
chr15	101649596	101657596	101650277	8000	101653596	-4000	4000	-3319
chr15	55414798	55422798	55418123	8000	55418798	-4000	4000	-675
chr15	65377484	65385484	65384368	8000	65381484	-4000	4000	2884
chr15	83012423	83020423	83018096	8000	83016423	-4000	4000	1673
chr15	34974341	34982341	34981352	8000	34978341	-4000	4000	3011
chr15	72734475	72742475	72736775	8000	72738475	-4000	4000	-1700
chr15	78100606	78108606	78105880	8000	78104606	-4000	4000	1274
chr15	89467398	89475398	89472790	8000	89471398	-4000	4000	1392
chr15	40728340	40736340	40731253	8000	40732340	-4000	4000	-1087
chr15	42938897	42946897	42944238	8000	42942897	-4000	4000	1341
chr15	66486135	66494135	66489260	8000	66490135	-4000	4000	-875
chr15	69268217	69276217	69268796	8000	69272217	-4000	4000	-3421
chr15	89301198	89309198	89306167	8000	89305198	-4000	4000	969
chr15	56441997	56449997	56443509	8000	56445997	-4000	4000	-2488
chr16	31127433	31135433	31132438	8000	31131433	-4000	4000	1005
chr16	27217768	27225768	27225155	8000	27221768	-4000	4000	3387
chr16	52432417	52440417	52439733	8000	52436417	-4000	4000	3316
chr16	50730041	50738041	50732227	8000	50734041	-4000	4000	-1814
chr16	66971149	66979149	66972893	8000	66975149	-4000	4000	-2256
chr16	3010505	3018505	3015371	8000	3014505	-4000	4000	866
chr16	56680196	56688196	56684048	8000	56684196	-4000	4000	-148
chr16	11964068	11972068	11967631	8000	11968068	-4000	4000	-437
chr16	20619235	20627235	20623285	8000	20623235	-4000	4000	50
chr16	27776344	27784344	27777617	8000	27780344	-4000	4000	-2727
chr16	48161773	48169773	48167611	8000	48165773	-4000	4000	1838
chr16	57754217	57762217	57761146	8000	57758217	-4000	4000	2929
chr16	67824157	67832157	67827660	8000	67828157	-4000	4000	-497
chr16	69737871	69745871	69742491	8000	69741871	-4000	4000	620
chr16	3218325	3226325	3224067	8000	3222325	-4000	4000	1742
chr16	10939021	10947021	10941850	8000	10943021	-4000	4000	-1171
chr16	28494964	28502964	28496532	8000	28498964	-4000	4000	-2432
chr16	28494964	28502964	28496983	8000	28498964	-4000	4000	-1981
chr16	28494964	28502964	28497242	8000	28498964	-4000	4000	-1722
chr16	28494964	28502964	28497990	8000	28498964	-4000	4000	-974
chr16	31913357	31921357	31915464	8000	31917357	-4000	4000	-1893
chr16	31913357	31921357	31915658	8000	31917357	-4000	4000	-1699
chr16	72057055	72065055	72060281	8000	72061055	-4000	4000	-774
chr16	51131982	51139982	51138889	8000	51135982	-4000	4000	2907
chr16	84561596	84569596	84566782	8000	84565596	-4000	4000	1186
chr16	28935342	28943342	28937099	8000	28939342	-4000	4000	-2243
chr16	31913357	31921357	31916224	8000	31917357	-4000	4000	-1133
chr16	3218325	3226325	3224435	8000	3222325	-4000	4000	2110
chr16	48359122	48367122	48361368	8000	48363122	-4000	4000	-1754
chr16	3535033	3543033	3541705	8000	3539033	-4000	4000	2672
chr16	28494964	28502964	28498525	8000	28498964	-4000	4000	-439
chr16	4452775	4460775	4456631	8000	4456775	-4000	4000	-144
chr16	4799203	4807203	4801425	8000	4803203	-4000	4000	-1778
chr16	15730691	15738691	15735526	8000	15734691	-4000	4000	835
chr16	48076882	48084882	48083943	8000	48080882	-4000	4000	3061
chr16	3378081	3386081	3384862	8000	3382081	-4000	4000	2781
chr16	2848730	2856730	2856138	8000	2852730	-4000	4000	3408
chr16	27360778	27368778	27363495	8000	27364778	-4000	4000	-1283
chr16	90040975	90048975	90043066	8000	90044975	-4000	4000	-1909
chr16	29867159	29875159	29873577	8000	29871159	-4000	4000	2418
chr16	30757176	30765176	30761604	8000	30761176	-4000	4000	428
chr16	48359122	48367122	48362419	8000	48363122	-4000	4000	-703
chr16	50730041	50738041	50731843	8000	50734041	-4000	4000	-2198
chr16	67824157	67832157	67827362	8000	67828157	-4000	4000	-795
chr16	67983394	67991394	67990092	8000	67987394	-4000	4000	2698
chr16	70656682	70664682	70661628	8000	70660682	-4000	4000	946
chr16	2779953	2787953	2786553	8000	2783953	-4000	4000	2600
chr16	68297823	68305823	68304042	8000	68301823	-4000	4000	2219
chr16	64939753	64947753	64947187	8000	64943753	-4000	4000	3434
chr16	764865	772865	766661	8000	768865	-4000	4000	-2204
chr16	67285499	67293499	67286809	8000	67289499	-4000	4000	-2690
chr16	51131982	51139982	51139735	8000	51135982	-4000	4000	3753
chr16	764865	772865	770069	8000	768865	-4000	4000	1204
chr16	1934229	1942229	1938908	8000	1938229	-4000	4000	679
chr16	71855680	71863680	71860188	8000	71859680	-4000	4000	508
chr16	71855680	71863680	71861925	8000	71859680	-4000	4000	2245
chr16	89934761	89942761	89935424	8000	89938761	-4000	4000	-3337
chr16	27360778	27368778	27363761	8000	27364778	-4000	4000	-1017
chr16	268183	276183	271298	8000	272183	-4000	4000	-885
chr16	3314852	3322852	3317335	8000	3318852	-4000	4000	-1517
chr16	28494964	28502964	28496384	8000	28498964	-4000	4000	-2580
chr16	28963092	28971092	28963883	8000	28967092	-4000	4000	-3209
chr16	57424187	57432187	57429268	8000	57428187	-4000	4000	1081
chr16	58402147	58410147	58404668	8000	58406147	-4000	4000	-1479
chr16	68831537	68839537	68833300	8000	68835537	-4000	4000	-2237
chr16	71927199	71935199	71929644	8000	71931199	-4000	4000	-1555
chr16	31328892	31336892	31329252	8000	31332892	-4000	4000	-3640
chr16	550636	558636	552903	8000	554636	-4000	4000	-1733
chr16	69937741	69945741	69940836	8000	69941741	-4000	4000	-905
chr16	15056033	15064033	15063284	8000	15060033	-4000	4000	3251
chr16	15730691	15738691	15737617	8000	15734691	-4000	4000	2926
chr16	21979660	21987660	21984465	8000	21983660	-4000	4000	805
chr16	23377294	23385294	23380482	8000	23381294	-4000	4000	-812
chr16	27360778	27368778	27363801	8000	27364778	-4000	4000	-977
chr16	30985256	30993256	30988185	8000	30989256	-4000	4000	-1071
chr16	31328892	31336892	31331246	8000	31332892	-4000	4000	-1646
chr16	67670531	67678531	67675427	8000	67674531	-4000	4000	896
chr16	71855680	71863680	71860364	8000	71859680	-4000	4000	684
chr16	71277389	71285389	71285127	8000	71281389	-4000	4000	3738
chr16	5020844	5028844	5025522	8000	5024844	-4000	4000	678
chr16	11964068	11972068	11965218	8000	11968068	-4000	4000	-2850
chr16	28980548	28988548	28981459	8000	28984548	-4000	4000	-3089
chr16	51131982	51139982	51139142	8000	51135982	-4000	4000	3160
chr16	89964060	89972060	89971747	8000	89968060	-4000	4000	3687
chr16	30757176	30765176	30763164	8000	30761176	-4000	4000	1988
chr16	46951362	46959362	46957198	8000	46955362	-4000	4000	1836
chr16	56353444	56361444	56354997	8000	56357444	-4000	4000	-2447
chr16	29969050	29977050	29974270	8000	29973050	-4000	4000	1220
chr16	28494964	28502964	28495761	8000	28498964	-4000	4000	-3203
chr16	16145565	16153565	16150717	8000	16149565	-4000	4000	1152
chr16	85090230	85098230	85093407	8000	85094230	-4000	4000	-823
chr16	2599188	2607188	2601307	8000	2603188	-4000	4000	-1881
chr16	47150387	47158387	47155679	8000	47154387	-4000	4000	1292
chr16	28900466	28908466	28904344	8000	28904466	-4000	4000	-122
chr16	29801385	29809385	29808593	8000	29805385	-4000	4000	3208
chr16	56623112	56631112	56626616	8000	56627112	-4000	4000	-496
chr16	56636087	56644087	56636920	8000	56640087	-4000	4000	-3167
chr16	81851	89851	86810	8000	85851	-4000	4000	959
chr16	84561596	84569596	84566869	8000	84565596	-4000	4000	1273
chr16	31378999	31386999	31380015	8000	31382999	-4000	4000	-2984
chr16	70798084	70806084	70800941	8000	70802084	-4000	4000	-1143
chr16	406367	414367	407323	8000	410367	-4000	4000	-3044
chr16	794041	802041	794160	8000	798041	-4000	4000	-3881
chr16	28494964	28502964	28496534	8000	28498964	-4000	4000	-2430
chr16	3010505	3018505	3015757	8000	3014505	-4000	4000	1252
chr16	1238554	1246554	1241280	8000	1242554	-4000	4000	-1274
chr16	58279836	58287836	58284670	8000	58283836	-4000	4000	834
chr16	10524422	10532422	10530616	8000	10528422	-4000	4000	2194
chr16	50033088	50041088	50036680	8000	50037088	-4000	4000	-408
chr16	75532741	75540741	75539963	8000	75536741	-4000	4000	3222
chr16	22912338	22920338	22915053	8000	22916338	-4000	4000	-1285
chr16	67390152	67398152	67390293	8000	67394152	-4000	4000	-3859
chr16	75623474	75631474	75629450	8000	75627474	-4000	4000	1976
chr16	22532521	22540521	22534410	8000	22536521	-4000	4000	-2111
chr16	1836207	1844207	1839429	8000	1840207	-4000	4000	-778
chr16	50103272	50111272	50105163	8000	50107272	-4000	4000	-2109
chr16	66941096	66949096	66941211	8000	66945096	-4000	4000	-3885
chr16	20776193	20784193	20777520	8000	20780193	-4000	4000	-2673
chr16	4799203	4807203	4801351	8000	4803203	-4000	4000	-1852
chr16	3010505	3018505	3015516	8000	3014505	-4000	4000	1011
chr16	85918606	85926606	85918781	8000	85922606	-4000	4000	-3825
chr16	2895382	2903382	2896578	8000	2899382	-4000	4000	-2804
chr16	55502691	55510691	55502866	8000	55506691	-4000	4000	-3825
chr16	89703134	89711134	89709840	8000	89707134	-4000	4000	2706
chr16	24568863	24576863	24568910	8000	24572863	-4000	4000	-3953
chr16	5080284	5088284	5082556	8000	5084284	-4000	4000	-1728
chr16	21979660	21987660	21983096	8000	21983660	-4000	4000	-564
chr16	31328892	31336892	31330165	8000	31332892	-4000	4000	-2727
chr16	55326756	55334756	55328843	8000	55330756	-4000	4000	-1913
chr16	56629981	56637981	56632735	8000	56633981	-4000	4000	-1246
chr16	15699135	15707135	15703890	8000	15703135	-4000	4000	755
chr16	23673472	23681472	23679271	8000	23677472	-4000	4000	1799
chr16	30419615	30427615	30424514	8000	30423615	-4000	4000	899
chr16	50309487	50317487	50315394	8000	50313487	-4000	4000	1907
chr16	58515951	58523951	58520916	8000	58519951	-4000	4000	965
chr16	69339106	69347106	69341578	8000	69343106	-4000	4000	-1528
chr16	84118141	84126141	84123738	8000	84122141	-4000	4000	1597
chr16	84118141	84126141	84124593	8000	84122141	-4000	4000	2452
chr16	89634456	89642456	89638142	8000	89638456	-4000	4000	-314
chr16	57457270	57465270	57460642	8000	57461270	-4000	4000	-628
chr16	4878401	4886401	4880219	8000	4882401	-4000	4000	-2182
chr16	31913357	31921357	31915156	8000	31917357	-4000	4000	-2201
chr16	28494964	28502964	28495444	8000	28498964	-4000	4000	-3520
chr16	89964060	89972060	89971913	8000	89968060	-4000	4000	3853
chr16	28587790	28595790	28593546	8000	28591790	-4000	4000	1756
chr16	1238554	1246554	1242186	8000	1242554	-4000	4000	-368
chr16	23384493	23392493	23392426	8000	23388493	-4000	4000	3933
chr16	47697523	47705523	47699408	8000	47701523	-4000	4000	-2115
chr16	31134926	31142926	31140538	8000	31138926	-4000	4000	1612
chr16	46694394	46702394	46696140	8000	46698394	-4000	4000	-2254
chr16	22912338	22920338	22915087	8000	22916338	-4000	4000	-1251
chr16	48359122	48367122	48362464	8000	48363122	-4000	4000	-658
chr16	2779953	2787953	2784662	8000	2783953	-4000	4000	709
chr16	71855680	71863680	71860421	8000	71859680	-4000	4000	741
chr16	1255008	1263008	1257050	8000	1259008	-4000	4000	-1958
chr16	56629981	56637981	56633350	8000	56633981	-4000	4000	-631
chr16	23686367	23694367	23691368	8000	23690367	-4000	4000	1001
chr16	71561660	71569660	71568729	8000	71565660	-4000	4000	3069
chr16	57148466	57156466	57154462	8000	57152466	-4000	4000	1996
chr16	69351567	69359567	69351746	8000	69355567	-4000	4000	-3821
chr16	184969	192969	190111	8000	188969	-4000	4000	1142
chr16	24568863	24576863	24569329	8000	24572863	-4000	4000	-3534
chr16	30753423	30761423	30760358	8000	30757423	-4000	4000	2935
chr16	31328892	31336892	31330078	8000	31332892	-4000	4000	-2814
chr16	53487648	53495648	53492496	8000	53491648	-4000	4000	848
chr16	19117629	19125629	19118320	8000	19121629	-4000	4000	-3309
chr16	67150185	67158185	67156563	8000	67154185	-4000	4000	2378
chr16	89964060	89972060	89964503	8000	89968060	-4000	4000	-3557
chr16	88436757	88444757	88438425	8000	88440757	-4000	4000	-2332
chr16	88673688	88681688	88681197	8000	88677688	-4000	4000	3509
chr16	1551580	1559580	1554884	8000	1555580	-4000	4000	-696
chr16	4878401	4886401	4883761	8000	4882401	-4000	4000	1360
chr16	56353444	56361444	56354885	8000	56357444	-4000	4000	-2559
chr16	56636087	56644087	56636239	8000	56640087	-4000	4000	-3848
chr16	19549408	19557408	19555613	8000	19553408	-4000	4000	2205
chr16	20619235	20627235	20624203	8000	20623235	-4000	4000	968
chr16	58515951	58523951	58520829	8000	58519951	-4000	4000	878
chr16	849634	857634	854580	8000	853634	-4000	4000	946
chr16	88673688	88681688	88681178	8000	88677688	-4000	4000	3490
chr16	56605497	56613497	56608615	8000	56609497	-4000	4000	-882
chr16	1238554	1246554	1241517	8000	1242554	-4000	4000	-1037
chr16	4878401	4886401	4885678	8000	4882401	-4000	4000	3277
chr16	14665236	14673236	14672623	8000	14669236	-4000	4000	3387
chr16	57990676	57998676	57997566	8000	57994676	-4000	4000	2890
chr16	57990676	57998676	57997841	8000	57994676	-4000	4000	3165
chr16	3314852	3322852	3316955	8000	3318852	-4000	4000	-1897
chr16	85918606	85926606	85921207	8000	85922606	-4000	4000	-1399
chr16	22532521	22540521	22533972	8000	22536521	-4000	4000	-2549
chr16	23570389	23578389	23571768	8000	23574389	-4000	4000	-2621
chr16	57244547	57252547	57252171	8000	57248547	-4000	4000	3624
chr16	20793581	20801581	20801289	8000	20797581	-4000	4000	3708
chr16	15730691	15738691	15737529	8000	15734691	-4000	4000	2838
chr16	22912338	22920338	22915542	8000	22916338	-4000	4000	-796
chr16	50314135	50322135	50319918	8000	50318135	-4000	4000	1783
chr16	5083379	5091379	5083740	8000	5087379	-4000	4000	-3639
chr16	56629981	56637981	56635989	8000	56633981	-4000	4000	2008
chr16	29867159	29875159	29873541	8000	29871159	-4000	4000	2382
chr16	1255008	1263008	1256930	8000	1259008	-4000	4000	-2078
chr16	4745396	4753396	4752806	8000	4749396	-4000	4000	3410
chr16	89964060	89972060	89969938	8000	89968060	-4000	4000	1878
chr16	29854357	29862357	29861141	8000	29858357	-4000	4000	2784
chr16	46951362	46959362	46957148	8000	46955362	-4000	4000	1786
chr16	15359628	15367628	15363951	8000	15363628	-4000	4000	323
chr16	88436757	88444757	88439246	8000	88440757	-4000	4000	-1511
chr16	81043350	81051350	81043805	8000	81047350	-4000	4000	-3545
chr16	28935342	28943342	28937065	8000	28939342	-4000	4000	-2277
chr16	69114010	69122010	69116457	8000	69118010	-4000	4000	-1553
chr16	1255008	1263008	1258495	8000	1259008	-4000	4000	-513
chr16	20793581	20801581	20796796	8000	20797581	-4000	4000	-785
chr16	28980548	28988548	28984469	8000	28984548	-4000	4000	-79
chr16	66716893	66724893	66720935	8000	66720893	-4000	4000	42
chr16	56979845	56987845	56981185	8000	56983845	-4000	4000	-2660
chr16	67390152	67398152	67395027	8000	67394152	-4000	4000	875
chr16	27360778	27368778	27363157	8000	27364778	-4000	4000	-1621
chr16	27776344	27784344	27776896	8000	27780344	-4000	4000	-3448
chr16	28494964	28502964	28496815	8000	28498964	-4000	4000	-2149
chr16	53669	61669	59810	8000	57669	-4000	4000	2141
chr16	982979	990979	984797	8000	986979	-4000	4000	-2182
chr16	13948348	13956348	13948374	8000	13952348	-4000	4000	-3974
chr16	89634456	89642456	89637338	8000	89638456	-4000	4000	-1118
chr16	184969	192969	189161	8000	188969	-4000	4000	192
chr16	71927199	71935199	71933458	8000	71931199	-4000	4000	2259
chr16	84460187	84468187	84463661	8000	84464187	-4000	4000	-526
chr16	30569740	30577740	30571928	8000	30573740	-4000	4000	-1812
chr16	30569740	30577740	30571929	8000	30573740	-4000	4000	-1811
chr16	21635550	21643550	21641324	8000	21639550	-4000	4000	1774
chr16	27360778	27368778	27363612	8000	27364778	-4000	4000	-1166
chr16	29738463	29746463	29744351	8000	29742463	-4000	4000	1888
chr16	30020427	30028427	30023810	8000	30024427	-4000	4000	-617
chr16	51131982	51139982	51139782	8000	51135982	-4000	4000	3800
chr16	57661580	57669580	57661820	8000	57665580	-4000	4000	-3760
chr16	58703131	58711131	58708155	8000	58707131	-4000	4000	1024
chr16	68225033	68233033	68226417	8000	68229033	-4000	4000	-2616
chr16	71855680	71863680	71860083	8000	71859680	-4000	4000	403
chr16	67880499	67888499	67882967	8000	67884499	-4000	4000	-1532
chr16	1238554	1246554	1242349	8000	1242554	-4000	4000	-205
chr16	81851	89851	85463	8000	85851	-4000	4000	-388
chr16	794041	802041	795741	8000	798041	-4000	4000	-2300
chr16	2249116	2257116	2253253	8000	2253116	-4000	4000	137
chr16	3010505	3018505	3014272	8000	3014505	-4000	4000	-233
chr16	4878401	4886401	4884663	8000	4882401	-4000	4000	2262
chr16	18800860	18808860	18805890	8000	18804860	-4000	4000	1030
chr16	22083534	22091534	22083926	8000	22087534	-4000	4000	-3608
chr16	28494964	28502964	28497832	8000	28498964	-4000	4000	-1132
chr16	30569740	30577740	30569858	8000	30573740	-4000	4000	-3882
chr16	53594153	53602153	53601472	8000	53598153	-4000	4000	3319
chr16	66917679	66925679	66924913	8000	66921679	-4000	4000	3234
chr16	71927199	71935199	71933951	8000	71931199	-4000	4000	2752
chr16	87402246	87410246	87409074	8000	87406246	-4000	4000	2828
chr16	57754217	57762217	57760385	8000	57758217	-4000	4000	2168
chr16	68257058	68265058	68259152	8000	68261058	-4000	4000	-1906
chr16	4452775	4460775	4454877	8000	4456775	-4000	4000	-1898
chr16	21653471	21661471	21655257	8000	21657471	-4000	4000	-2214
chr16	23577014	23585014	23581104	8000	23581014	-4000	4000	90
chr16	51131982	51139982	51139515	8000	51135982	-4000	4000	3533
chr16	68831537	68839537	68833355	8000	68835537	-4000	4000	-2182
chr16	10939021	10947021	10941619	8000	10943021	-4000	4000	-1402
chr16	3535033	3543033	3536146	8000	3539033	-4000	4000	-2887
chr16	30353102	30361102	30354815	8000	30357102	-4000	4000	-2287
chr16	67824157	67832157	67827757	8000	67828157	-4000	4000	-400
chr16	67880499	67888499	67886101	8000	67884499	-4000	4000	1602
chr16	69339106	69347106	69340297	8000	69343106	-4000	4000	-2809
chr16	28093976	28101976	28101635	8000	28097976	-4000	4000	3659
chr16	550636	558636	553616	8000	554636	-4000	4000	-1020
chr16	550636	558636	554479	8000	554636	-4000	4000	-157
chr16	764865	772865	766765	8000	768865	-4000	4000	-2100
chr16	10524422	10532422	10531827	8000	10528422	-4000	4000	3405
chr16	28494964	28502964	28497520	8000	28498964	-4000	4000	-1444
chr16	28494964	28502964	28497841	8000	28498964	-4000	4000	-1123
chr16	28494964	28502964	28498334	8000	28498964	-4000	4000	-630
chr16	48076882	48084882	48083945	8000	48080882	-4000	4000	3063
chr16	49483524	49491524	49490938	8000	49487524	-4000	4000	3414
chr16	66716893	66724893	66722166	8000	66720893	-4000	4000	1273
chr16	71277389	71285389	71285091	8000	71281389	-4000	4000	3702
chr16	67824157	67832157	67825744	8000	67828157	-4000	4000	-2413
chr16	86565728	86573728	86567790	8000	86569728	-4000	4000	-1938
chr16	24823632	24831632	24824442	8000	24827632	-4000	4000	-3190
chr16	28494964	28502964	28495164	8000	28498964	-4000	4000	-3800
chr16	58519842	58527842	58525278	8000	58523842	-4000	4000	1436
chr16	58519842	58527842	58525279	8000	58523842	-4000	4000	1437
chr16	71561660	71569660	71568798	8000	71565660	-4000	4000	3138
chr16	4799203	4807203	4801387	8000	4803203	-4000	4000	-1816
chr16	22912338	22920338	22915613	8000	22916338	-4000	4000	-725
chr16	57144369	57152369	57146176	8000	57148369	-4000	4000	-2193
chr16	84460187	84468187	84463916	8000	84464187	-4000	4000	-271
chr16	55582666	55590666	55582911	8000	55586666	-4000	4000	-3755
chr16	46574591	46582591	46581625	8000	46578591	-4000	4000	3034
chr16	31211962	31219962	31219377	8000	31215962	-4000	4000	3415
chr16	67097058	67105058	67099105	8000	67101058	-4000	4000	-1953
chr16	57457270	57465270	57458242	8000	57461270	-4000	4000	-3028
chr16	19076095	19084095	19078133	8000	19080095	-4000	4000	-1962
chr16	66798875	66806875	66802956	8000	66802875	-4000	4000	81
chr16	67868567	67876567	67870783	8000	67872567	-4000	4000	-1784
chr16	3010505	3018505	3014147	8000	3014505	-4000	4000	-358
chr16	52432417	52440417	52439437	8000	52436417	-4000	4000	3020
chr16	85672204	85680204	85673208	8000	85676204	-4000	4000	-2996
chr16	30020427	30028427	30023372	8000	30024427	-4000	4000	-1055
chr16	22912338	22920338	22915275	8000	22916338	-4000	4000	-1063
chr16	46694394	46702394	46698129	8000	46698394	-4000	4000	-265
chr16	56629981	56637981	56632726	8000	56633981	-4000	4000	-1255
chr16	67880499	67888499	67883297	8000	67884499	-4000	4000	-1202
chr16	88436757	88444757	88439367	8000	88440757	-4000	4000	-1390
chr16	28494964	28502964	28495440	8000	28498964	-4000	4000	-3524
chr16	71725000	71733000	71729639	8000	71729000	-4000	4000	639
chr16	10479638	10487638	10482276	8000	10483638	-4000	4000	-1362
chr16	2779953	2787953	2784883	8000	2783953	-4000	4000	930
chr16	31378999	31386999	31380040	8000	31382999	-4000	4000	-2959
chr16	19497693	19505693	19503518	8000	19501693	-4000	4000	1825
chr16	69462264	69470264	69462582	8000	69466264	-4000	4000	-3682
chr16	31463166	31471166	31465157	8000	31467166	-4000	4000	-2009
chr16	57079531	57087531	57079578	8000	57083531	-4000	4000	-3953
chr16	21979660	21987660	21984409	8000	21983660	-4000	4000	749
chr16	15699135	15707135	15704009	8000	15703135	-4000	4000	874
chr16	53487648	53495648	53492393	8000	53491648	-4000	4000	745
chr16	53669	61669	55793	8000	57669	-4000	4000	-1876
chr16	22912338	22920338	22915307	8000	22916338	-4000	4000	-1031
chr16	23673472	23681472	23679256	8000	23677472	-4000	4000	1784
chr16	3535033	3543033	3536052	8000	3539033	-4000	4000	-2981
chr16	89634456	89642456	89636550	8000	89638456	-4000	4000	-1906
chr16	3294808	3302808	3299850	8000	3298808	-4000	4000	1042
chr16	57381044	57389044	57383060	8000	57385044	-4000	4000	-1984
chr16	58042901	58050901	58046784	8000	58046901	-4000	4000	-117
chr16	15861719	15869719	15867462	8000	15865719	-4000	4000	1743
chr16	31378999	31386999	31380898	8000	31382999	-4000	4000	-2101
chr16	17097769	17105769	17102337	8000	17101769	-4000	4000	568
chr16	1551580	1559580	1555069	8000	1555580	-4000	4000	-511
chr16	30985256	30993256	30991048	8000	30989256	-4000	4000	1792
chr16	1238554	1246554	1242332	8000	1242554	-4000	4000	-222
chr16	3294808	3302808	3299173	8000	3298808	-4000	4000	365
chr16	27360778	27368778	27363814	8000	27364778	-4000	4000	-964
chr16	42407	50407	47531	8000	46407	-4000	4000	1124
chr16	1551580	1559580	1557932	8000	1555580	-4000	4000	2352
chr16	1673908	1681908	1673943	8000	1677908	-4000	4000	-3965
chr16	3010505	3018505	3015665	8000	3014505	-4000	4000	1160
chr16	3218325	3226325	3224081	8000	3222325	-4000	4000	1756
chr16	3535033	3543033	3541874	8000	3539033	-4000	4000	2841
chr16	5020844	5028844	5027329	8000	5024844	-4000	4000	2485
chr16	11746586	11754586	11752746	8000	11750586	-4000	4000	2160
chr16	20793581	20801581	20798407	8000	20797581	-4000	4000	826
chr16	28494964	28502964	28497145	8000	28498964	-4000	4000	-1819
chr16	29801385	29809385	29808682	8000	29805385	-4000	4000	3297
chr16	30757176	30765176	30764325	8000	30761176	-4000	4000	3149
chr16	30985256	30993256	30992849	8000	30989256	-4000	4000	3593
chr16	31134926	31142926	31141879	8000	31138926	-4000	4000	2953
chr16	50103272	50111272	50105052	8000	50107272	-4000	4000	-2220
chr16	53487648	53495648	53494823	8000	53491648	-4000	4000	3175
chr16	56605497	56613497	56609427	8000	56609497	-4000	4000	-70
chr16	56636087	56644087	56636124	8000	56640087	-4000	4000	-3963
chr16	57381044	57389044	57382413	8000	57385044	-4000	4000	-2631
chr16	58109592	58117592	58114918	8000	58113592	-4000	4000	1326
chr16	58279836	58287836	58280165	8000	58283836	-4000	4000	-3671
chr16	66917679	66925679	66922316	8000	66921679	-4000	4000	637
chr16	67285499	67293499	67291683	8000	67289499	-4000	4000	2184
chr16	75592868	75600868	75600293	8000	75596868	-4000	4000	3425
chr16	84775922	84783922	84779211	8000	84779922	-4000	4000	-711
chr16	88436757	88444757	88438862	8000	88440757	-4000	4000	-1895
chr16	89733549	89741549	89737822	8000	89737549	-4000	4000	273
chr16	27360778	27368778	27363407	8000	27364778	-4000	4000	-1371
chr16	3010505	3018505	3014070	8000	3014505	-4000	4000	-435
chr16	11964068	11972068	11965218	8000	11968068	-4000	4000	-2850
chr16	52432417	52440417	52439167	8000	52436417	-4000	4000	2750
chr16	67880499	67888499	67884098	8000	67884499	-4000	4000	-401
chr16	3010505	3018505	3015803	8000	3014505	-4000	4000	1298
chr16	69114010	69122010	69119010	8000	69118010	-4000	4000	1000
chr16	53669	61669	58990	8000	57669	-4000	4000	1321
chr16	1551580	1559580	1557967	8000	1555580	-4000	4000	2387
chr16	3218325	3226325	3224113	8000	3222325	-4000	4000	1788
chr16	3314852	3322852	3317200	8000	3318852	-4000	4000	-1652
chr16	4745396	4753396	4752732	8000	4749396	-4000	4000	3336
chr16	4799203	4807203	4801526	8000	4803203	-4000	4000	-1677
chr16	20776193	20784193	20777525	8000	20780193	-4000	4000	-2668
chr16	24216611	24224611	24220178	8000	24220611	-4000	4000	-433
chr16	28338555	28346555	28342603	8000	28342555	-4000	4000	48
chr16	28935342	28943342	28937508	8000	28939342	-4000	4000	-1834
chr16	28980548	28988548	28982010	8000	28984548	-4000	4000	-2538
chr16	29454219	29462219	29457985	8000	29458219	-4000	4000	-234
chr16	31378999	31386999	31379639	8000	31382999	-4000	4000	-3360
chr16	31378999	31386999	31382004	8000	31382999	-4000	4000	-995
chr16	31913357	31921357	31915532	8000	31917357	-4000	4000	-1825
chr16	48359122	48367122	48361707	8000	48363122	-4000	4000	-1415
chr16	56940864	56948864	56943282	8000	56944864	-4000	4000	-1582
chr16	57754217	57762217	57760326	8000	57758217	-4000	4000	2109
chr16	58279836	58287836	58280277	8000	58283836	-4000	4000	-3559
chr16	58402147	58410147	58404517	8000	58406147	-4000	4000	-1630
chr16	71855680	71863680	71860052	8000	71859680	-4000	4000	372
chr16	74388115	74396115	74392052	8000	74392115	-4000	4000	-63
chr16	77738260	77746260	77741879	8000	77742260	-4000	4000	-381
chr16	81043350	81051350	81044412	8000	81047350	-4000	4000	-2938
chr16	82143798	82151798	82149394	8000	82147798	-4000	4000	1596
chr16	89964060	89972060	89971398	8000	89968060	-4000	4000	3338
chr16	15056033	15064033	15061725	8000	15060033	-4000	4000	1692
chr16	22532521	22540521	22534041	8000	22536521	-4000	4000	-2480
chr16	29969050	29977050	29971544	8000	29973050	-4000	4000	-1506
chr16	58703131	58711131	58708137	8000	58707131	-4000	4000	1006
chr16	67670531	67678531	67675868	8000	67674531	-4000	4000	1337
chr16	74388115	74396115	74389847	8000	74392115	-4000	4000	-2268
chr16	794041	802041	795711	8000	798041	-4000	4000	-2330
chr16	268183	276183	274238	8000	272183	-4000	4000	2055
chr16	29738463	29746463	29744739	8000	29742463	-4000	4000	2276
chr16	74388115	74396115	74392017	8000	74392115	-4000	4000	-98
chr16	30193561	30201561	30194606	8000	30197561	-4000	4000	-2955
chr16	56605497	56613497	56608672	8000	56609497	-4000	4000	-825
chr16	5040122	5048122	5047953	8000	5044122	-4000	4000	3831
chr16	71725000	71733000	71731674	8000	71729000	-4000	4000	2674
chr16	51131982	51139982	51139059	8000	51135982	-4000	4000	3077
chr16	22912338	22920338	22915484	8000	22916338	-4000	4000	-854
chr16	58703131	58711131	58708251	8000	58707131	-4000	4000	1120
chr16	15056033	15064033	15061742	8000	15060033	-4000	4000	1709
chr16	31913357	31921357	31915294	8000	31917357	-4000	4000	-2063
chr16	57148466	57156466	57154323	8000	57152466	-4000	4000	1857
chr16	3218325	3226325	3224374	8000	3222325	-4000	4000	2049
chr16	67180379	67188379	67180584	8000	67184379	-4000	4000	-3795
chr16	66575135	66583135	66579670	8000	66579135	-4000	4000	535
chr16	58402147	58410147	58404653	8000	58406147	-4000	4000	-1494
chr16	31913357	31921357	31915761	8000	31917357	-4000	4000	-1596
chr16	3314852	3322852	3317403	8000	3318852	-4000	4000	-1449
chr16	10939021	10947021	10941772	8000	10943021	-4000	4000	-1249
chr16	13948348	13956348	13948370	8000	13952348	-4000	4000	-3978
chr16	30569740	30577740	30570424	8000	30573740	-4000	4000	-3316
chr16	30944783	30952783	30946758	8000	30948783	-4000	4000	-2025
chr16	57249635	57257635	57256873	8000	57253635	-4000	4000	3238
chr16	74617399	74625399	74624049	8000	74621399	-4000	4000	2650
chr16	75168236	75176236	75170124	8000	75172236	-4000	4000	-2112
chr16	66917679	66925679	66923910	8000	66921679	-4000	4000	2231
chr16	15730691	15738691	15737532	8000	15734691	-4000	4000	2841
chr16	31378999	31386999	31381866	8000	31382999	-4000	4000	-1133
chr16	1673908	1681908	1674027	8000	1677908	-4000	4000	-3881
chr16	28494964	28502964	28495962	8000	28498964	-4000	4000	-3002
chr16	69700666	69708666	69702128	8000	69704666	-4000	4000	-2538
chr16	1673908	1681908	1673936	8000	1677908	-4000	4000	-3972
chr16	46694394	46702394	46698115	8000	46698394	-4000	4000	-279
chr16	51131982	51139982	51137217	8000	51135982	-4000	4000	1235
chr16	731525	739525	737197	8000	735525	-4000	4000	1672
chr16	20619235	20627235	20625447	8000	20623235	-4000	4000	2212
chr16	31328892	31336892	31329830	8000	31332892	-4000	4000	-3062
chr16	4878401	4886401	4885559	8000	4882401	-4000	4000	3158
chr16	51131982	51139982	51139353	8000	51135982	-4000	4000	3371
chr16	3294808	3302808	3300458	8000	3298808	-4000	4000	1650
chr16	22532521	22540521	22534764	8000	22536521	-4000	4000	-1757
chr16	23686367	23694367	23690112	8000	23690367	-4000	4000	-255
chr16	23686367	23694367	23690905	8000	23690367	-4000	4000	538
chr16	31328892	31336892	31330321	8000	31332892	-4000	4000	-2571
chr16	31127433	31135433	31132469	8000	31131433	-4000	4000	1036
chr16	90040975	90048975	90042389	8000	90044975	-4000	4000	-2586
chr16	50730041	50738041	50731829	8000	50734041	-4000	4000	-2212
chr16	89934761	89942761	89935435	8000	89938761	-4000	4000	-3326
chr16	268183	276183	271085	8000	272183	-4000	4000	-1098
chr16	28494964	28502964	28499731	8000	28498964	-4000	4000	767
chr16	1255008	1263008	1256821	8000	1259008	-4000	4000	-2187
chr16	3535033	3543033	3542723	8000	3539033	-4000	4000	3690
chr16	20776193	20784193	20780643	8000	20780193	-4000	4000	450
chr16	23673472	23681472	23680975	8000	23677472	-4000	4000	3503
chr16	20619235	20627235	20623551	8000	20623235	-4000	4000	316
chr16	69737871	69745871	69742256	8000	69741871	-4000	4000	385
chr16	23673472	23681472	23679229	8000	23677472	-4000	4000	1757
chr16	23673472	23681472	23680994	8000	23677472	-4000	4000	3522
chr16	68831537	68839537	68833450	8000	68835537	-4000	4000	-2087
chr16	24568863	24576863	24568947	8000	24572863	-4000	4000	-3916
chr16	31211962	31219962	31219407	8000	31215962	-4000	4000	3445
chr16	51131982	51139982	51137368	8000	51135982	-4000	4000	1386
chr16	19264332	19272332	19267065	8000	19268332	-4000	4000	-1267
chr16	30569740	30577740	30569980	8000	30573740	-4000	4000	-3760
chr16	21979660	21987660	21980658	8000	21983660	-4000	4000	-3002
chr16	2705030	2713030	2708257	8000	2709030	-4000	4000	-773
chr16	19497693	19505693	19505077	8000	19501693	-4000	4000	3384
chr16	173522	181522	180684	8000	177522	-4000	4000	3162
chr16	30374135	30382135	30377862	8000	30378135	-4000	4000	-273
chr16	23686367	23694367	23689321	8000	23690367	-4000	4000	-1046
chr16	30110105	30118105	30117767	8000	30114105	-4000	4000	3662
chr16	58109592	58117592	58115435	8000	58113592	-4000	4000	1843
chr16	30110105	30118105	30116871	8000	30114105	-4000	4000	2766
chr16	30110105	30118105	30116872	8000	30114105	-4000	4000	2767
chr16	69702996	69710996	69710836	8000	69706996	-4000	4000	3840
chr16	14948060	14956060	14951956	8000	14952060	-4000	4000	-104
chr16	67840195	67848195	67842955	8000	67844195	-4000	4000	-1240
chr16	71277389	71285389	71285179	8000	71281389	-4000	4000	3790
chr16	56636087	56644087	56636930	8000	56640087	-4000	4000	-3157
chr16	30020427	30028427	30025757	8000	30024427	-4000	4000	1330
chr16	4878401	4886401	4884650	8000	4882401	-4000	4000	2249
chr16	70656682	70664682	70657030	8000	70660682	-4000	4000	-3652
chr16	53487648	53495648	53490360	8000	53491648	-4000	4000	-1288
chr16	71927199	71935199	71927616	8000	71931199	-4000	4000	-3583
chr16	81043350	81051350	81044884	8000	81047350	-4000	4000	-2466
chr16	75592868	75600868	75599502	8000	75596868	-4000	4000	2634
chr16	75623474	75631474	75627975	8000	75627474	-4000	4000	501
chr16	23384493	23392493	23392398	8000	23388493	-4000	4000	3905
chr16	31378999	31386999	31379789	8000	31382999	-4000	4000	-3210
chr16	11178186	11186186	11178497	8000	11182186	-4000	4000	-3689
chr16	31913357	31921357	31915284	8000	31917357	-4000	4000	-2073
chr16	31913357	31921357	31916562	8000	31917357	-4000	4000	-795
chr16	46951362	46959362	46959089	8000	46955362	-4000	4000	3727
chr16	56461640	56469640	56467195	8000	56465640	-4000	4000	1555
chr16	89553766	89561766	89556938	8000	89557766	-4000	4000	-828
chr16	71927199	71935199	71933924	8000	71931199	-4000	4000	2725
chr16	28494964	28502964	28495307	8000	28498964	-4000	4000	-3657
chr16	67285499	67293499	67291444	8000	67289499	-4000	4000	1945
chr16	10524422	10532422	10532232	8000	10528422	-4000	4000	3810
chr16	19852691	19860691	19859858	8000	19856691	-4000	4000	3167
chr16	24823632	24831632	24825331	8000	24827632	-4000	4000	-2301
chr16	46694394	46702394	46698212	8000	46698394	-4000	4000	-182
chr16	31428593	31436593	31436243	8000	31432593	-4000	4000	3650
chr16	30020427	30028427	30025635	8000	30024427	-4000	4000	1208
chr16	81043350	81051350	81044582	8000	81047350	-4000	4000	-2768
chr17	30891869	30899869	30893837	8000	30895869	-4000	4000	-2032
chr17	76034775	76042775	76039673	8000	76038775	-4000	4000	898
chr17	79788132	79796132	79795557	8000	79792132	-4000	4000	3425
chr17	7510616	7518616	7514401	8000	7514616	-4000	4000	-215
chr17	38526031	38534031	38533171	8000	38530031	-4000	4000	3140
chr17	63934554	63942554	63941893	8000	63938554	-4000	4000	3339
chr17	61938605	61946605	61944389	8000	61942605	-4000	4000	1784
chr17	80462834	80470834	80470789	8000	80466834	-4000	4000	3955
chr17	50688253	50696253	50696143	8000	50692253	-4000	4000	3890
chr17	8045134	8053134	8047852	8000	8049134	-4000	4000	-1282
chr17	4626919	4634919	4631951	8000	4630919	-4000	4000	1032
chr17	5092374	5100374	5093047	8000	5096374	-4000	4000	-3327
chr17	7415860	7423860	7416056	8000	7419860	-4000	4000	-3804
chr17	50470845	50478845	50473901	8000	50474845	-4000	4000	-944
chr17	50858223	50866223	50863395	8000	50862223	-4000	4000	1172
chr17	68043364	68051364	68044031	8000	68047364	-4000	4000	-3333
chr17	12139830	12147830	12141213	8000	12143830	-4000	4000	-2617
chr17	34284334	34292334	34287607	8000	34288334	-4000	4000	-727
chr17	48603232	48611232	48607818	8000	48607232	-4000	4000	586
chr17	79788132	79796132	79795251	8000	79792132	-4000	4000	3119
chr17	34354610	34362610	34357536	8000	34358610	-4000	4000	-1074
chr17	49219225	49227225	49222144	8000	49223225	-4000	4000	-1081
chr17	50377483	50385483	50379127	8000	50381483	-4000	4000	-2356
chr17	59211239	59219239	59213237	8000	59215239	-4000	4000	-2002
chr17	59211239	59219239	59215171	8000	59215239	-4000	4000	-68
chr17	4626919	4634919	4632201	8000	4630919	-4000	4000	1282
chr17	44005068	44013068	44013045	8000	44009068	-4000	4000	3977
chr17	44845948	44853948	44851778	8000	44849948	-4000	4000	1830
chr17	55388622	55396622	55394319	8000	55392622	-4000	4000	1697
chr17	60173327	60181327	60179153	8000	60177327	-4000	4000	1826
chr17	7013520	7021520	7017264	8000	7017520	-4000	4000	-256
chr17	40384525	40392525	40389239	8000	40388525	-4000	4000	714
chr17	7026290	7034290	7026789	8000	7030290	-4000	4000	-3501
chr17	81914270	81922270	81914410	8000	81918270	-4000	4000	-3860
chr17	43212941	43220941	43216574	8000	43216941	-4000	4000	-367
chr17	47833719	47841719	47834612	8000	47837719	-4000	4000	-3107
chr17	75747594	75755594	75752488	8000	75751594	-4000	4000	894
chr17	12987643	12995643	12990273	8000	12991643	-4000	4000	-1370
chr17	58485529	58493529	58492521	8000	58489529	-4000	4000	2992
chr17	67980378	67988378	67983691	8000	67984378	-4000	4000	-687
chr17	7510616	7518616	7511431	8000	7514616	-4000	4000	-3185
chr17	67052797	67060797	67056208	8000	67056797	-4000	4000	-589
chr17	1751265	1759265	1754369	8000	1755265	-4000	4000	-896
chr17	73203353	73211353	73209334	8000	73207353	-4000	4000	1981
chr17	7415860	7423860	7417129	8000	7419860	-4000	4000	-2731
chr17	58731611	58739611	58734290	8000	58735611	-4000	4000	-1321
chr17	44557262	44565262	44559070	8000	44561262	-4000	4000	-2192
chr17	30465989	30473989	30468415	8000	30469989	-4000	4000	-1574
chr17	79045788	79053788	79046661	8000	79049788	-4000	4000	-3127
chr17	29067122	29075122	29074774	8000	29071122	-4000	4000	3652
chr17	6771647	6779647	6773122	8000	6775647	-4000	4000	-2525
chr17	17343663	17351663	17344901	8000	17347663	-4000	4000	-2762
chr17	48544870	48552870	48549177	8000	48548870	-4000	4000	307
chr17	75821799	75829799	75825477	8000	75825799	-4000	4000	-322
chr17	82747196	82755196	82748899	8000	82751196	-4000	4000	-2297
chr17	18205954	18213954	18206834	8000	18209954	-4000	4000	-3120
chr17	3033741	3041741	3037034	8000	3037741	-4000	4000	-707
chr17	40015097	40023097	40016933	8000	40019097	-4000	4000	-2164
chr17	51167744	51175744	51171640	8000	51171744	-4000	4000	-104
chr17	68043364	68051364	68046771	8000	68047364	-4000	4000	-593
chr17	76708832	76716832	76716634	8000	76712832	-4000	4000	3802
chr17	21415870	21423870	21419619	8000	21419870	-4000	4000	-251
chr17	41578279	41586279	41583863	8000	41582279	-4000	4000	1584
chr17	12139830	12147830	12139885	8000	12143830	-4000	4000	-3945
chr17	36535310	36543310	36537682	8000	36539310	-4000	4000	-1628
chr17	35979656	35987656	35986656	8000	35983656	-4000	4000	3000
chr17	36190869	36198869	36196749	8000	36194869	-4000	4000	1880
chr17	47945308	47953308	47946380	8000	47949308	-4000	4000	-2928
chr17	50481974	50489974	50482151	8000	50485974	-4000	4000	-3823
chr17	59948240	59956240	59948454	8000	59952240	-4000	4000	-3786
chr17	67740531	67748531	67743922	8000	67744531	-4000	4000	-609
chr17	78138968	78146968	78139235	8000	78142968	-4000	4000	-3733
chr17	50371059	50379059	50375896	8000	50375059	-4000	4000	837
chr17	30995911	31003911	30998871	8000	30999911	-4000	4000	-1040
chr17	68531113	68539113	68537654	8000	68535113	-4000	4000	2541
chr17	20315026	20323026	20321413	8000	20319026	-4000	4000	2387
chr17	42854130	42862130	42856364	8000	42858130	-4000	4000	-1766
chr17	35739521	35747521	35740493	8000	35743521	-4000	4000	-3028
chr17	39743291	39751291	39744135	8000	39747291	-4000	4000	-3156
chr17	72122416	72130416	72124386	8000	72126416	-4000	4000	-2030
chr17	82043902	82051902	82049938	8000	82047902	-4000	4000	2036
chr17	76620761	76628761	76627222	8000	76624761	-4000	4000	2461
chr17	435978	443978	443448	8000	439978	-4000	4000	3470
chr17	1629858	1637858	1635362	8000	1633858	-4000	4000	1504
chr17	5101541	5109541	5106013	8000	5105541	-4000	4000	472
chr17	7829742	7837742	7830679	8000	7833742	-4000	4000	-3063
chr17	19379442	19387442	19380880	8000	19383442	-4000	4000	-2562
chr17	29569475	29577475	29574869	8000	29573475	-4000	4000	1394
chr17	42398449	42406449	42405063	8000	42402449	-4000	4000	2614
chr17	49696934	49704934	49704098	8000	49700934	-4000	4000	3164
chr17	63998594	64006594	64001773	8000	64002594	-4000	4000	-821
chr17	65223703	65231703	65225329	8000	65227703	-4000	4000	-2374
chr17	4955226	4963226	4957069	8000	4959226	-4000	4000	-2157
chr17	36190869	36198869	36195312	8000	36194869	-4000	4000	443
chr17	32487253	32495253	32494829	8000	32491253	-4000	4000	3576
chr17	36084256	36092256	36088693	8000	36088256	-4000	4000	437
chr17	4183310	4191310	4184975	8000	4187310	-4000	4000	-2335
chr17	4955226	4963226	4955436	8000	4959226	-4000	4000	-3790
chr17	4984130	4992130	4989511	8000	4988130	-4000	4000	1381
chr17	19016656	19024656	19020322	8000	19020656	-4000	4000	-334
chr17	58201441	58209441	58207105	8000	58205441	-4000	4000	1664
chr17	59105857	59113857	59112124	8000	59109857	-4000	4000	2267
chr17	59271970	59279970	59273788	8000	59275970	-4000	4000	-2182
chr17	61861367	61869367	61867917	8000	61865367	-4000	4000	2550
chr17	62689597	62697597	62690651	8000	62693597	-4000	4000	-2946
chr17	63934554	63942554	63941725	8000	63938554	-4000	4000	3171
chr17	68043364	68051364	68044004	8000	68047364	-4000	4000	-3360
chr17	68263026	68271026	68269288	8000	68267026	-4000	4000	2262
chr17	75102162	75110162	75104193	8000	75106162	-4000	4000	-1969
chr17	76620761	76628761	76627482	8000	76624761	-4000	4000	2721
chr17	76946393	76954393	76947869	8000	76950393	-4000	4000	-2524
chr17	64464643	64472643	64467640	8000	64468643	-4000	4000	-1003
chr17	30891869	30899869	30894863	8000	30895869	-4000	4000	-1006
chr17	76620761	76628761	76627479	8000	76624761	-4000	4000	2718
chr17	50858223	50866223	50863719	8000	50862223	-4000	4000	1496
chr17	55715627	55723627	55720855	8000	55719627	-4000	4000	1228
chr17	47833719	47841719	47839567	8000	47837719	-4000	4000	1848
chr17	70131608	70139608	70132130	8000	70135608	-4000	4000	-3478
chr17	67980378	67988378	67983183	8000	67984378	-4000	4000	-1195
chr17	43859639	43867639	43861825	8000	43863639	-4000	4000	-1814
chr17	58264518	58272518	58270720	8000	58268518	-4000	4000	2202
chr17	47437312	47445312	47440584	8000	47441312	-4000	4000	-728
chr17	43040295	43048295	43047678	8000	43044295	-4000	4000	3383
chr17	36208878	36216878	36212486	8000	36212878	-4000	4000	-392
chr17	4265259	4273259	4270303	8000	4269259	-4000	4000	1044
chr17	29556547	29564547	29562862	8000	29560547	-4000	4000	2315
chr17	80462834	80470834	80467481	8000	80466834	-4000	4000	647
chr17	48544870	48552870	48552294	8000	48548870	-4000	4000	3424
chr17	50377483	50385483	50378681	8000	50381483	-4000	4000	-2802
chr17	68253712	68261712	68256900	8000	68257712	-4000	4000	-812
chr17	1646629	1654629	1650803	8000	1650629	-4000	4000	174
chr17	38319217	38327217	38326704	8000	38323217	-4000	4000	3487
chr17	44557262	44565262	44558897	8000	44561262	-4000	4000	-2365
chr17	41615442	41623442	41619520	8000	41619442	-4000	4000	78
chr17	7574715	7582715	7574745	8000	7578715	-4000	4000	-3970
chr17	61861367	61869367	61867696	8000	61865367	-4000	4000	2329
chr17	5175535	5183535	5181286	8000	5179535	-4000	4000	1751
chr17	61938605	61946605	61946480	8000	61942605	-4000	4000	3875
chr17	49511008	49519008	49512004	8000	49515008	-4000	4000	-3004
chr17	28644346	28652346	28648947	8000	28648346	-4000	4000	601
chr17	83091122	83099122	83094309	8000	83095122	-4000	4000	-813
chr17	30523592	30531592	30526779	8000	30527592	-4000	4000	-813
chr17	28857061	28865061	28858450	8000	28861061	-4000	4000	-2611
chr17	82650973	82658973	82658099	8000	82654973	-4000	4000	3126
chr17	42097404	42105404	42105097	8000	42101404	-4000	4000	3693
chr17	76270049	76278049	76278034	8000	76274049	-4000	4000	3985
chr17	18175802	18183802	18178822	8000	18179802	-4000	4000	-980
chr17	63517848	63525848	63524206	8000	63521848	-4000	4000	2358
chr17	34635318	34643318	34636045	8000	34639318	-4000	4000	-3273
chr17	58264518	58272518	58268013	8000	58268518	-4000	4000	-505
chr17	57117346	57125346	57120312	8000	57121346	-4000	4000	-1034
chr17	39206541	39214541	39213049	8000	39210541	-4000	4000	2508
chr17	40549769	40557769	40555263	8000	40553769	-4000	4000	1494
chr17	46333794	46341794	46337676	8000	46337794	-4000	4000	-118
chr17	75001800	75009800	75002063	8000	75005800	-4000	4000	-3737
chr17	63998594	64006594	64003535	8000	64002594	-4000	4000	941
chr17	50470845	50478845	50473945	8000	50474845	-4000	4000	-900
chr17	62689597	62697597	62693436	8000	62693597	-4000	4000	-161
chr17	4931023	4939023	4939009	8000	4935023	-4000	4000	3986
chr17	39632626	39640626	39635685	8000	39636626	-4000	4000	-941
chr17	19379442	19387442	19386393	8000	19383442	-4000	4000	2951
chr17	55715627	55723627	55720863	8000	55719627	-4000	4000	1236
chr17	57117346	57125346	57120416	8000	57121346	-4000	4000	-930
chr17	30995911	31003911	30998821	8000	30999911	-4000	4000	-1090
chr17	44030328	44038328	44037474	8000	44034328	-4000	4000	3146
chr17	8091900	8099900	8096650	8000	8095900	-4000	4000	750
chr17	12139830	12147830	12141146	8000	12143830	-4000	4000	-2684
chr17	63934554	63942554	63941376	8000	63938554	-4000	4000	2822
chr17	10695015	10703015	10697471	8000	10699015	-4000	4000	-1544
chr17	72122416	72130416	72126126	8000	72126416	-4000	4000	-290
chr17	12987643	12995643	12991533	8000	12991643	-4000	4000	-110
chr17	41605778	41613778	41610957	8000	41609778	-4000	4000	1179
chr17	78138968	78146968	78146405	8000	78142968	-4000	4000	3437
chr17	47840908	47848908	47848002	8000	47844908	-4000	4000	3094
chr17	4552927	4560927	4560579	8000	4556927	-4000	4000	3652
chr17	7070537	7078537	7076101	8000	7074537	-4000	4000	1564
chr17	7221266	7229266	7229213	8000	7225266	-4000	4000	3947
chr17	40088793	40096793	40089230	8000	40092793	-4000	4000	-3563
chr17	61405466	61413466	61405755	8000	61409466	-4000	4000	-3711
chr17	58264518	58272518	58264902	8000	58268518	-4000	4000	-3616
chr17	60037008	60045008	60043629	8000	60041008	-4000	4000	2621
chr17	43028041	43036041	43028641	8000	43032041	-4000	4000	-3400
chr17	8283763	8291763	8289134	8000	8287763	-4000	4000	1371
chr17	17343663	17351663	17344915	8000	17347663	-4000	4000	-2748
chr17	16025157	16033157	16026880	8000	16029157	-4000	4000	-2277
chr17	3892592	3900592	3897781	8000	3896592	-4000	4000	1189
chr17	75102162	75110162	75104037	8000	75106162	-4000	4000	-2125
chr17	82825434	82833434	82831275	8000	82829434	-4000	4000	1841
chr17	49696934	49704934	49702951	8000	49700934	-4000	4000	2017
chr17	43212941	43220941	43213200	8000	43216941	-4000	4000	-3741
chr17	38796441	38804441	38801943	8000	38800441	-4000	4000	1502
chr17	48720763	48728763	48724625	8000	48724763	-4000	4000	-138
chr17	50688253	50696253	50691206	8000	50692253	-4000	4000	-1047
chr17	12139830	12147830	12141214	8000	12143830	-4000	4000	-2616
chr17	16025157	16033157	16026796	8000	16029157	-4000	4000	-2361
chr17	58201441	58209441	58208142	8000	58205441	-4000	4000	2701
chr17	45431900	45439900	45437788	8000	45435900	-4000	4000	1888
chr17	48720763	48728763	48726689	8000	48724763	-4000	4000	1926
chr17	82825434	82833434	82830649	8000	82829434	-4000	4000	1215
chr17	13490032	13498032	13496635	8000	13494032	-4000	4000	2603
chr17	29569475	29577475	29574509	8000	29573475	-4000	4000	1034
chr17	34284334	34292334	34285760	8000	34288334	-4000	4000	-2574
chr17	34284334	34292334	34287643	8000	34288334	-4000	4000	-691
chr17	34317402	34325402	34319477	8000	34321402	-4000	4000	-1925
chr17	35739521	35747521	35745156	8000	35743521	-4000	4000	1635
chr17	36161683	36169683	36165757	8000	36165683	-4000	4000	74
chr17	40384525	40392525	40391635	8000	40388525	-4000	4000	3110
chr17	44557262	44565262	44558052	8000	44561262	-4000	4000	-3210
chr17	48536894	48544894	48542946	8000	48540894	-4000	4000	2052
chr17	51293936	51301936	51293964	8000	51297936	-4000	4000	-3972
chr17	59211239	59219239	59211332	8000	59215239	-4000	4000	-3907
chr17	59838255	59846255	59840060	8000	59842255	-4000	4000	-2195
chr17	64143227	64151227	64148729	8000	64147227	-4000	4000	1502
chr17	67980378	67988378	67983487	8000	67984378	-4000	4000	-891
chr17	36101621	36109621	36104625	8000	36105621	-4000	4000	-996
chr17	8045134	8053134	8048434	8000	8049134	-4000	4000	-700
chr17	70131608	70139608	70132618	8000	70135608	-4000	4000	-2990
chr17	21415870	21423870	21418864	8000	21419870	-4000	4000	-1006
chr17	59948240	59956240	59953080	8000	59952240	-4000	4000	840
chr17	44845948	44853948	44851311	8000	44849948	-4000	4000	1363
chr17	58201441	58209441	58204292	8000	58205441	-4000	4000	-1149
chr17	44845948	44853948	44850805	8000	44849948	-4000	4000	857
chr17	28610446	28618446	28611643	8000	28614446	-4000	4000	-2803
chr17	62689597	62697597	62690973	8000	62693597	-4000	4000	-2624
chr17	75747594	75755594	75748959	8000	75751594	-4000	4000	-2635
chr17	13490032	13498032	13496758	8000	13494032	-4000	4000	2726
chr17	50460496	50468496	50468421	8000	50464496	-4000	4000	3925
chr17	47742122	47750122	47744773	8000	47746122	-4000	4000	-1349
chr17	47840908	47848908	47848238	8000	47844908	-4000	4000	3330
chr17	76729936	76737936	76733715	8000	76733936	-4000	4000	-221
chr17	48544870	48552870	48550445	8000	48548870	-4000	4000	1575
chr17	6574147	6582147	6579711	8000	6578147	-4000	4000	1564
chr17	8486411	8494411	8493814	8000	8490411	-4000	4000	3403
chr17	70131608	70139608	70132147	8000	70135608	-4000	4000	-3461
chr17	70131608	70139608	70132369	8000	70135608	-4000	4000	-3239
chr17	67029398	67037398	67030799	8000	67033398	-4000	4000	-2599
chr17	1930677	1938677	1936559	8000	1934677	-4000	4000	1882
chr17	4933130	4941130	4939077	8000	4937130	-4000	4000	1947
chr17	58731611	58739611	58732657	8000	58735611	-4000	4000	-2954
chr17	58731611	58739611	58734169	8000	58735611	-4000	4000	-1442
chr17	1296978	1304978	1298423	8000	1300978	-4000	4000	-2555
chr17	42854130	42862130	42854543	8000	42858130	-4000	4000	-3587
chr17	15971746	15979746	15974697	8000	15975746	-4000	4000	-1049
chr17	38917770	38925770	38918642	8000	38921770	-4000	4000	-3128
chr17	79788132	79796132	79794861	8000	79792132	-4000	4000	2729
chr17	28493781	28501781	28494390	8000	28497781	-4000	4000	-3391
chr17	76620761	76628761	76627460	8000	76624761	-4000	4000	2699
chr17	5092374	5100374	5092942	8000	5096374	-4000	4000	-3432
chr17	67980378	67988378	67982482	8000	67984378	-4000	4000	-1896
chr17	58201441	58209441	58206370	8000	58205441	-4000	4000	929
chr17	74537073	74545073	74542881	8000	74541073	-4000	4000	1808
chr17	30891869	30899869	30894069	8000	30895869	-4000	4000	-1800
chr17	30891869	30899869	30899388	8000	30895869	-4000	4000	3519
chr17	34253203	34261203	34256727	8000	34257203	-4000	4000	-476
chr17	35739521	35747521	35745519	8000	35743521	-4000	4000	1998
chr17	40015097	40023097	40015517	8000	40019097	-4000	4000	-3580
chr17	46753464	46761464	46755833	8000	46757464	-4000	4000	-1631
chr17	50527501	50535501	50529186	8000	50531501	-4000	4000	-2315
chr17	50623474	50631474	50626706	8000	50627474	-4000	4000	-768
chr17	73279624	73287624	73285218	8000	73283624	-4000	4000	1594
chr17	82747196	82755196	82750529	8000	82751196	-4000	4000	-667
chr17	39667122	39675122	39670249	8000	39671122	-4000	4000	-873
chr17	42991142	42999142	42998791	8000	42995142	-4000	4000	3649
chr17	35979656	35987656	35985780	8000	35983656	-4000	4000	2124
chr17	75131248	75139248	75136170	8000	75135248	-4000	4000	922
chr17	9725687	9733687	9729100	8000	9729687	-4000	4000	-587
chr17	63934554	63942554	63941665	8000	63938554	-4000	4000	3111
chr17	5428877	5436877	5432818	8000	5432877	-4000	4000	-59
chr17	40015097	40023097	40019851	8000	40019097	-4000	4000	754
chr17	5101541	5109541	5106041	8000	5105541	-4000	4000	500
chr17	7006754	7014754	7010463	8000	7010754	-4000	4000	-291
chr17	8091900	8099900	8096807	8000	8095900	-4000	4000	907
chr17	39632626	39640626	39635871	8000	39636626	-4000	4000	-755
chr17	68970488	68978488	68975811	8000	68974488	-4000	4000	1323
chr17	76620761	76628761	76627238	8000	76624761	-4000	4000	2477
chr17	42309324	42317324	42316859	8000	42313324	-4000	4000	3535
chr17	73330384	73338384	73335955	8000	73334384	-4000	4000	1571
chr17	43871357	43879357	43877738	8000	43875357	-4000	4000	2381
chr17	13490032	13498032	13496320	8000	13494032	-4000	4000	2288
chr17	49219225	49227225	49219933	8000	49223225	-4000	4000	-3292
chr17	82610562	82618562	82616529	8000	82614562	-4000	4000	1967
chr17	30465989	30473989	30468218	8000	30469989	-4000	4000	-1771
chr17	50470845	50478845	50474585	8000	50474845	-4000	4000	-260
chr17	8798722	8806722	8803229	8000	8802722	-4000	4000	507
chr17	1930677	1938677	1937221	8000	1934677	-4000	4000	2544
chr17	7070537	7078537	7075386	8000	7074537	-4000	4000	849
chr17	47045932	47053932	47049972	8000	47049932	-4000	4000	40
chr17	46753464	46761464	46755887	8000	46757464	-4000	4000	-1577
chr17	48720763	48728763	48728060	8000	48724763	-4000	4000	3297
chr17	61586421	61594421	61591048	8000	61590421	-4000	4000	627
chr17	7584178	7592178	7591914	8000	7588178	-4000	4000	3736
chr17	47833719	47841719	47840255	8000	47837719	-4000	4000	2536
chr17	50180101	50188101	50180707	8000	50184101	-4000	4000	-3394
chr17	76620761	76628761	76625472	8000	76624761	-4000	4000	711
chr17	50460496	50468496	50461280	8000	50464496	-4000	4000	-3216
chr17	7440937	7448937	7447082	8000	7444937	-4000	4000	2145
chr17	65223703	65231703	65225505	8000	65227703	-4000	4000	-2198
chr17	29251839	29259839	29254381	8000	29255839	-4000	4000	-1458
chr17	7908760	7916760	7910901	8000	7912760	-4000	4000	-1859
chr17	38319217	38327217	38322753	8000	38323217	-4000	4000	-464
chr17	58978638	58986638	58980428	8000	58982638	-4000	4000	-2210
chr17	76466891	76474891	76471537	8000	76470891	-4000	4000	646
chr17	19016656	19024656	19020406	8000	19020656	-4000	4000	-250
chr17	64473785	64481785	64477980	8000	64477785	-4000	4000	195
chr17	82030204	82038204	82033856	8000	82034204	-4000	4000	-348
chr17	50623474	50631474	50624048	8000	50627474	-4000	4000	-3426
chr17	82941914	82949914	82942311	8000	82945914	-4000	4000	-3603
chr17	49594884	49602884	49599728	8000	49598884	-4000	4000	844
chr17	41615442	41623442	41620807	8000	41619442	-4000	4000	1365
chr17	42569239	42577239	42572810	8000	42573239	-4000	4000	-429
chr17	59211239	59219239	59213369	8000	59215239	-4000	4000	-1870
chr17	3722699	3730699	3729495	8000	3726699	-4000	4000	2796
chr17	5175535	5183535	5181286	8000	5179535	-4000	4000	1751
chr17	68416948	68424948	68424475	8000	68420948	-4000	4000	3527
chr17	28192381	28200381	28196295	8000	28196381	-4000	4000	-86
chr17	38731605	38739605	38738429	8000	38735605	-4000	4000	2824
chr17	63934554	63942554	63941178	8000	63938554	-4000	4000	2624
chr17	69074702	69082702	69079227	8000	69078702	-4000	4000	525
chr17	76620761	76628761	76626762	8000	76624761	-4000	4000	2001
chr17	82825434	82833434	82830427	8000	82829434	-4000	4000	993
chr17	7350944	7358944	7352680	8000	7354944	-4000	4000	-2264
chr17	40015097	40023097	40016511	8000	40019097	-4000	4000	-2586
chr17	61938605	61946605	61944268	8000	61942605	-4000	4000	1663
chr17	67980378	67988378	67982577	8000	67984378	-4000	4000	-1801
chr17	29251839	29259839	29253670	8000	29255839	-4000	4000	-2169
chr17	76620761	76628761	76627167	8000	76624761	-4000	4000	2406
chr17	8373516	8381516	8377625	8000	8377516	-4000	4000	109
chr17	7584178	7592178	7591486	8000	7588178	-4000	4000	3308
chr17	49511008	49519008	49513267	8000	49515008	-4000	4000	-1741
chr17	49594884	49602884	49599139	8000	49598884	-4000	4000	255
chr17	49594884	49602884	49599638	8000	49598884	-4000	4000	754
chr17	49594884	49602884	49600185	8000	49598884	-4000	4000	1301
chr17	58516250	58524250	58520337	8000	58520250	-4000	4000	87
chr17	58516250	58524250	58520914	8000	58520250	-4000	4000	664
chr17	65223703	65231703	65225300	8000	65227703	-4000	4000	-2403
chr17	76729936	76737936	76734643	8000	76733936	-4000	4000	707
chr17	76729936	76737936	76735802	8000	76733936	-4000	4000	1866
chr17	8136472	8144472	8141051	8000	8140472	-4000	4000	579
chr17	29251839	29259839	29252145	8000	29255839	-4000	4000	-3694
chr17	82317024	82325024	82322330	8000	82321024	-4000	4000	1306
chr17	7622234	7630234	7627581	8000	7626234	-4000	4000	1347
chr17	62689597	62697597	62690639	8000	62693597	-4000	4000	-2958
chr17	82043902	82051902	82049796	8000	82047902	-4000	4000	1894
chr17	40300657	40308657	40300902	8000	40304657	-4000	4000	-3755
chr17	40300657	40308657	40301957	8000	40304657	-4000	4000	-2700
chr17	43212941	43220941	43217945	8000	43216941	-4000	4000	1004
chr17	30995911	31003911	30999145	8000	30999911	-4000	4000	-766
chr17	80462834	80470834	80470730	8000	80466834	-4000	4000	3896
chr17	10517148	10525148	10521337	8000	10521148	-4000	4000	189
chr17	30891869	30899869	30899250	8000	30895869	-4000	4000	3381
chr17	35739521	35747521	35744841	8000	35743521	-4000	4000	1320
chr17	28610446	28618446	28611398	8000	28614446	-4000	4000	-3048
chr17	59838255	59846255	59839806	8000	59842255	-4000	4000	-2449
chr17	34354610	34362610	34361879	8000	34358610	-4000	4000	3269
chr17	34354610	34362610	34361880	8000	34358610	-4000	4000	3270
chr17	47708052	47716052	47708449	8000	47712052	-4000	4000	-3603
chr17	5171034	5179034	5174796	8000	5175034	-4000	4000	-238
chr17	39400285	39408285	39405161	8000	39404285	-4000	4000	876
chr17	49594884	49602884	49601872	8000	49598884	-4000	4000	2988
chr17	36535310	36543310	36538554	8000	36539310	-4000	4000	-756
chr17	28857061	28865061	28858671	8000	28861061	-4000	4000	-2390
chr17	40191656	40199656	40192947	8000	40195656	-4000	4000	-2709
chr17	65223703	65231703	65227587	8000	65227703	-4000	4000	-116
chr17	76466891	76474891	76471822	8000	76470891	-4000	4000	931
chr17	35570795	35578795	35578198	8000	35574795	-4000	4000	3403
chr17	50460496	50468496	50463896	8000	50464496	-4000	4000	-600
chr17	18964789	18972789	18969357	8000	18968789	-4000	4000	568
chr17	18964789	18972789	18969358	8000	18968789	-4000	4000	569
chr17	5356963	5364963	5361499	8000	5360963	-4000	4000	536
chr17	7622234	7630234	7626996	8000	7626234	-4000	4000	762
chr17	15971746	15979746	15975382	8000	15975746	-4000	4000	-364
chr17	34284334	34292334	34285753	8000	34288334	-4000	4000	-2581
chr17	35346305	35354305	35352993	8000	35350305	-4000	4000	2688
chr17	36535310	36543310	36538188	8000	36539310	-4000	4000	-1122
chr17	41844518	41852518	41845709	8000	41848518	-4000	4000	-2809
chr17	44557262	44565262	44558556	8000	44561262	-4000	4000	-2706
chr17	44748264	44756264	44751268	8000	44752264	-4000	4000	-996
chr17	47833719	47841719	47840351	8000	47837719	-4000	4000	2632
chr17	50108152	50116152	50115890	8000	50112152	-4000	4000	3738
chr17	59211239	59219239	59211589	8000	59215239	-4000	4000	-3650
chr17	64143227	64151227	64148792	8000	64147227	-4000	4000	1565
chr17	68043364	68051364	68044051	8000	68047364	-4000	4000	-3313
chr17	68416948	68424948	68420537	8000	68420948	-4000	4000	-411
chr17	8793110	8801110	8798699	8000	8797110	-4000	4000	1589
chr17	58516250	58524250	58521900	8000	58520250	-4000	4000	1650
chr17	50180101	50188101	50185640	8000	50184101	-4000	4000	1539
chr17	7852099	7860099	7859419	8000	7856099	-4000	4000	3320
chr17	28857061	28865061	28858318	8000	28861061	-4000	4000	-2743
chr17	19766829	19774829	19774122	8000	19770829	-4000	4000	3293
chr17	28857061	28865061	28860526	8000	28861061	-4000	4000	-535
chr17	28901250	28909250	28906055	8000	28905250	-4000	4000	805
chr17	29621938	29629938	29626507	8000	29625938	-4000	4000	569
chr17	35867491	35875491	35872296	8000	35871491	-4000	4000	805
chr17	40191656	40199656	40195067	8000	40195656	-4000	4000	-589
chr17	49970959	49978959	49972855	8000	49974959	-4000	4000	-2104
chr17	57967547	57975547	57973539	8000	57971547	-4000	4000	1992
chr17	59397729	59405729	59399670	8000	59401729	-4000	4000	-2059
chr17	59397729	59405729	59399829	8000	59401729	-4000	4000	-1900
chr17	61405466	61413466	61409020	8000	61409466	-4000	4000	-446
chr17	64143227	64151227	64148733	8000	64147227	-4000	4000	1506
chr17	64850130	64858130	64854545	8000	64854130	-4000	4000	415
chr17	74351820	74359820	74352922	8000	74355820	-4000	4000	-2898
chr17	75821799	75829799	75825449	8000	75825799	-4000	4000	-350
chr17	76729936	76737936	76734405	8000	76733936	-4000	4000	469
chr17	74765353	74773353	74768652	8000	74769353	-4000	4000	-701
chr17	38508385	38516385	38511202	8000	38512385	-4000	4000	-1183
chr17	36161683	36169683	36169146	8000	36165683	-4000	4000	3463
chr17	18175802	18183802	18179114	8000	18179802	-4000	4000	-688
chr17	76270049	76278049	76277239	8000	76274049	-4000	4000	3190
chr17	62689597	62697597	62691083	8000	62693597	-4000	4000	-2514
chr17	39900595	39908595	39906963	8000	39904595	-4000	4000	2368
chr17	43028041	43036041	43028584	8000	43032041	-4000	4000	-3457
chr17	48536894	48544894	48543219	8000	48540894	-4000	4000	2325
chr17	48544870	48552870	48551025	8000	48548870	-4000	4000	2155
chr17	16025157	16033157	16027356	8000	16029157	-4000	4000	-1801
chr17	36084256	36092256	36090125	8000	36088256	-4000	4000	1869
chr17	48536894	48544894	48543006	8000	48540894	-4000	4000	2112
chr17	50858223	50866223	50863735	8000	50862223	-4000	4000	1512
chr17	50858223	50866223	50864008	8000	50862223	-4000	4000	1785
chr17	62689597	62697597	62689647	8000	62693597	-4000	4000	-3950
chr17	65223703	65231703	65227572	8000	65227703	-4000	4000	-131
chr17	74946742	74954742	74947098	8000	74950742	-4000	4000	-3644
chr17	76270049	76278049	76275883	8000	76274049	-4000	4000	1834
chr17	20445395	20453395	20446901	8000	20449395	-4000	4000	-2494
chr17	72122416	72130416	72123691	8000	72126416	-4000	4000	-2725
chr17	80130369	80138369	80136259	8000	80134369	-4000	4000	1890
chr17	4626919	4634919	4633466	8000	4630919	-4000	4000	2547
chr17	7311628	7319628	7315141	8000	7315628	-4000	4000	-487
chr17	9906606	9914606	9910880	8000	9910606	-4000	4000	274
chr17	12139830	12147830	12143327	8000	12143830	-4000	4000	-503
chr17	30523592	30531592	30526593	8000	30527592	-4000	4000	-999
chr17	31301213	31309213	31304544	8000	31305213	-4000	4000	-669
chr17	35739521	35747521	35746019	8000	35743521	-4000	4000	2498
chr17	42575513	42583513	42581808	8000	42579513	-4000	4000	2295
chr17	43207689	43215689	43211378	8000	43211689	-4000	4000	-311
chr17	44005068	44013068	44011887	8000	44009068	-4000	4000	2819
chr17	50460496	50468496	50468457	8000	50464496	-4000	4000	3961
chr17	60439158	60447158	60446844	8000	60443158	-4000	4000	3686
chr17	60662280	60670280	60663137	8000	60666280	-4000	4000	-3143
chr17	64464643	64472643	64465462	8000	64468643	-4000	4000	-3181
chr17	70131608	70139608	70133030	8000	70135608	-4000	4000	-2578
chr17	80462834	80470834	80467577	8000	80466834	-4000	4000	743
chr17	81224277	81232277	81230661	8000	81228277	-4000	4000	2384
chr17	7829742	7837742	7830823	8000	7833742	-4000	4000	-2919
chr17	35406922	35414922	35411411	8000	35410922	-4000	4000	489
chr17	43010607	43018607	43016352	8000	43014607	-4000	4000	1745
chr17	48066052	48074052	48071432	8000	48070052	-4000	4000	1380
chr17	48720763	48728763	48728029	8000	48724763	-4000	4000	3266
chr17	70176044	70184044	70176160	8000	70180044	-4000	4000	-3884
chr17	78203702	78211702	78206987	8000	78207702	-4000	4000	-715
chr17	4626919	4634919	4632271	8000	4630919	-4000	4000	1352
chr17	70131608	70139608	70132318	8000	70135608	-4000	4000	-3290
chr17	61388838	61396838	61392156	8000	61392838	-4000	4000	-682
chr17	28710281	28718281	28714688	8000	28714281	-4000	4000	407
chr17	40549769	40557769	40555464	8000	40553769	-4000	4000	1695
chr17	58264518	58272518	58267797	8000	58268518	-4000	4000	-721
chr17	58264518	58272518	58267798	8000	58268518	-4000	4000	-720
chr17	59838255	59846255	59839863	8000	59842255	-4000	4000	-2392
chr17	29610756	29618756	29616760	8000	29614756	-4000	4000	2004
chr17	78848977	78856977	78853265	8000	78852977	-4000	4000	288
chr17	36068032	36076032	36071113	8000	36072032	-4000	4000	-919
chr17	74258020	74266020	74260330	8000	74262020	-4000	4000	-1690
chr17	65223703	65231703	65225587	8000	65227703	-4000	4000	-2116
chr17	68253712	68261712	68257019	8000	68257712	-4000	4000	-693
chr17	435978	443978	443449	8000	439978	-4000	4000	3471
chr17	50623474	50631474	50627018	8000	50627474	-4000	4000	-456
chr17	67029398	67037398	67030778	8000	67033398	-4000	4000	-2620
chr17	76729936	76737936	76733648	8000	76733936	-4000	4000	-288
chr17	34635318	34643318	34637307	8000	34639318	-4000	4000	-2011
chr17	50108152	50116152	50114203	8000	50112152	-4000	4000	2051
chr17	47840908	47848908	47848052	8000	47844908	-4000	4000	3144
chr17	7385774	7393774	7392878	8000	7389774	-4000	4000	3104
chr17	48720763	48728763	48728456	8000	48724763	-4000	4000	3693
chr17	50108152	50116152	50115596	8000	50112152	-4000	4000	3444
chr17	17973409	17981409	17977594	8000	17977409	-4000	4000	185
chr17	50958174	50966174	50966147	8000	50962174	-4000	4000	3973
chr17	78967238	78975238	78972113	8000	78971238	-4000	4000	875
chr17	79788132	79796132	79794650	8000	79792132	-4000	4000	2518
chr17	30891869	30899869	30893872	8000	30895869	-4000	4000	-1997
chr17	42398449	42406449	42404800	8000	42402449	-4000	4000	2351
chr17	30893336	30901336	30900348	8000	30897336	-4000	4000	3012
chr17	36101621	36109621	36103840	8000	36105621	-4000	4000	-1781
chr17	36161683	36169683	36165845	8000	36165683	-4000	4000	162
chr17	42569239	42577239	42572810	8000	42573239	-4000	4000	-429
chr17	5175535	5183535	5182720	8000	5179535	-4000	4000	3185
chr17	74537073	74545073	74541460	8000	74541073	-4000	4000	387
chr17	40871889	40879889	40878274	8000	40875889	-4000	4000	2385
chr17	18964789	18972789	18969096	8000	18968789	-4000	4000	307
chr17	15432021	15440021	15437921	8000	15436021	-4000	4000	1900
chr17	8168457	8176457	8174591	8000	8172457	-4000	4000	2134
chr17	58552678	58560678	58559495	8000	58556678	-4000	4000	2817
chr17	74351820	74359820	74356736	8000	74355820	-4000	4000	916
chr17	76729936	76737936	76733622	8000	76733936	-4000	4000	-314
chr17	7622234	7630234	7628059	8000	7626234	-4000	4000	1825
chr17	5101541	5109541	5106023	8000	5105541	-4000	4000	482
chr17	7622234	7630234	7626405	8000	7626234	-4000	4000	171
chr17	29053216	29061216	29053423	8000	29057216	-4000	4000	-3793
chr17	36535310	36543310	36537367	8000	36539310	-4000	4000	-1943
chr17	39900595	39908595	39906221	8000	39904595	-4000	4000	1626
chr17	16616734	16624734	16623653	8000	16620734	-4000	4000	2919
chr17	45431900	45439900	45439499	8000	45435900	-4000	4000	3599
chr17	50108152	50116152	50114264	8000	50112152	-4000	4000	2112
chr17	58201441	58209441	58208543	8000	58205441	-4000	4000	3102
chr17	61586421	61594421	61591184	8000	61590421	-4000	4000	763
chr17	63934554	63942554	63941931	8000	63938554	-4000	4000	3377
chr17	74743335	74751335	74744386	8000	74747335	-4000	4000	-2949
chr17	76708832	76716832	76716508	8000	76712832	-4000	4000	3676
chr17	80130369	80138369	80136063	8000	80134369	-4000	4000	1694
chr17	1773565	1781565	1781354	8000	1777565	-4000	4000	3789
chr17	35570795	35578795	35575844	8000	35574795	-4000	4000	1049
chr17	35979656	35987656	35985780	8000	35983656	-4000	4000	2124
chr17	29610756	29618756	29614173	8000	29614756	-4000	4000	-583
chr17	44845948	44853948	44851324	8000	44849948	-4000	4000	1376
chr17	30765388	30773388	30766564	8000	30769388	-4000	4000	-2824
chr17	34317402	34325402	34319471	8000	34321402	-4000	4000	-1931
chr17	59211239	59219239	59214853	8000	59215239	-4000	4000	-386
chr17	82825434	82833434	82831277	8000	82829434	-4000	4000	1843
chr17	62689597	62697597	62690269	8000	62693597	-4000	4000	-3328
chr17	7707372	7715372	7709585	8000	7711372	-4000	4000	-1787
chr17	42398449	42406449	42404885	8000	42402449	-4000	4000	2436
chr17	31301213	31309213	31305135	8000	31305213	-4000	4000	-78
chr17	48066052	48074052	48071510	8000	48070052	-4000	4000	1458
chr17	58516250	58524250	58520908	8000	58520250	-4000	4000	658
chr17	50623474	50631474	50626485	8000	50627474	-4000	4000	-989
chr17	61586421	61594421	61591043	8000	61590421	-4000	4000	622
chr17	34354610	34362610	34358034	8000	34358610	-4000	4000	-576
chr17	1460186	1468186	1465650	8000	1464186	-4000	4000	1464
chr17	47833719	47841719	47834652	8000	47837719	-4000	4000	-3067
chr17	82317024	82325024	82322297	8000	82321024	-4000	4000	1273
chr17	40280136	40288136	40287965	8000	40284136	-4000	4000	3829
chr17	35346305	35354305	35352906	8000	35350305	-4000	4000	2601
chr17	59948240	59956240	59952896	8000	59952240	-4000	4000	656
chr17	60662280	60670280	60663168	8000	60666280	-4000	4000	-3112
chr17	50371059	50379059	50375846	8000	50375059	-4000	4000	787
chr17	65223703	65231703	65225137	8000	65227703	-4000	4000	-2566
chr17	48544870	48552870	48550676	8000	48548870	-4000	4000	1806
chr17	58201441	58209441	58208515	8000	58205441	-4000	4000	3074
chr17	8486411	8494411	8492423	8000	8490411	-4000	4000	2012
chr17	31301213	31309213	31304019	8000	31305213	-4000	4000	-1194
chr17	42398449	42406449	42405196	8000	42402449	-4000	4000	2747
chr17	41496981	41504981	41503040	8000	41500981	-4000	4000	2059
chr17	29621938	29629938	29622742	8000	29625938	-4000	4000	-3196
chr17	80462834	80470834	80467400	8000	80466834	-4000	4000	566
chr17	28610446	28618446	28611165	8000	28614446	-4000	4000	-3281
chr17	41962503	41970503	41965609	8000	41966503	-4000	4000	-894
chr17	69074702	69082702	69081086	8000	69078702	-4000	4000	2384
chr17	28610446	28618446	28612633	8000	28614446	-4000	4000	-1813
chr17	39917041	39925041	39923217	8000	39921041	-4000	4000	2176
chr17	31301213	31309213	31304637	8000	31305213	-4000	4000	-576
chr17	35722413	35730413	35723861	8000	35726413	-4000	4000	-2552
chr17	82486537	82494537	82487977	8000	82490537	-4000	4000	-2560
chr17	75131248	75139248	75136168	8000	75135248	-4000	4000	920
chr17	76729936	76737936	76733042	8000	76733936	-4000	4000	-894
chr17	80130369	80138369	80136321	8000	80134369	-4000	4000	1952
chr17	44669069	44677069	44669561	8000	44673069	-4000	4000	-3508
chr17	32320659	32328659	32321076	8000	32324659	-4000	4000	-3583
chr17	35867491	35875491	35872343	8000	35871491	-4000	4000	852
chr17	738968	746968	745962	8000	742968	-4000	4000	2994
chr17	2059241	2067241	2065558	8000	2063241	-4000	4000	2317
chr17	4781285	4789285	4785953	8000	4785285	-4000	4000	668
chr17	5092374	5100374	5092495	8000	5096374	-4000	4000	-3879
chr17	5495427	5503427	5501674	8000	5499427	-4000	4000	2247
chr17	7013520	7021520	7016966	8000	7017520	-4000	4000	-554
chr17	7440937	7448937	7447386	8000	7444937	-4000	4000	2449
chr17	8184345	8192345	8189156	8000	8188345	-4000	4000	811
chr17	8283763	8291763	8289380	8000	8287763	-4000	4000	1617
chr17	8318514	8326514	8318908	8000	8322514	-4000	4000	-3606
chr17	8318514	8326514	8319335	8000	8322514	-4000	4000	-3179
chr17	8486411	8494411	8492484	8000	8490411	-4000	4000	2073
chr17	10624526	10632526	10632005	8000	10628526	-4000	4000	3479
chr17	14345404	14353404	14345451	8000	14349404	-4000	4000	-3953
chr17	18205954	18213954	18206840	8000	18209954	-4000	4000	-3114
chr17	19016656	19024656	19019498	8000	19020656	-4000	4000	-1158
chr17	28493781	28501781	28494407	8000	28497781	-4000	4000	-3374
chr17	30891869	30899869	30893527	8000	30895869	-4000	4000	-2342
chr17	30891869	30899869	30899568	8000	30895869	-4000	4000	3699
chr17	34923859	34931859	34931040	8000	34927859	-4000	4000	3181
chr17	36535310	36543310	36538389	8000	36539310	-4000	4000	-921
chr17	38843860	38851860	38850407	8000	38847860	-4000	4000	2547
chr17	39900595	39908595	39905892	8000	39904595	-4000	4000	1297
chr17	41496981	41504981	41503364	8000	41500981	-4000	4000	2383
chr17	41605778	41613778	41609856	8000	41609778	-4000	4000	78
chr17	44901390	44909390	44908097	8000	44905390	-4000	4000	2707
chr17	46551650	46559650	46553427	8000	46555650	-4000	4000	-2223
chr17	46753464	46761464	46755313	8000	46757464	-4000	4000	-2151
chr17	47819272	47827272	47820058	8000	47823272	-4000	4000	-3214
chr17	47819272	47827272	47824089	8000	47823272	-4000	4000	817
chr17	47833719	47841719	47838641	8000	47837719	-4000	4000	922
chr17	48119601	48127601	48121776	8000	48123601	-4000	4000	-1825
chr17	48536894	48544894	48543148	8000	48540894	-4000	4000	2254
chr17	48536894	48544894	48544572	8000	48540894	-4000	4000	3678
chr17	48536894	48544894	48544805	8000	48540894	-4000	4000	3911
chr17	48544870	48552870	48550291	8000	48548870	-4000	4000	1421
chr17	48603232	48611232	48607877	8000	48607232	-4000	4000	645
chr17	50377483	50385483	50379554	8000	50381483	-4000	4000	-1929
chr17	50460496	50468496	50464264	8000	50464496	-4000	4000	-232
chr17	50481974	50489974	50482163	8000	50485974	-4000	4000	-3811
chr17	50623474	50631474	50624377	8000	50627474	-4000	4000	-3097
chr17	50623474	50631474	50626644	8000	50627474	-4000	4000	-830
chr17	50858223	50866223	50863771	8000	50862223	-4000	4000	1548
chr17	50858223	50866223	50864044	8000	50862223	-4000	4000	1821
chr17	51167744	51175744	51171631	8000	51171744	-4000	4000	-113
chr17	51173425	51181425	51180577	8000	51177425	-4000	4000	3152
chr17	51293936	51301936	51294008	8000	51297936	-4000	4000	-3928
chr17	54957956	54965956	54961339	8000	54961956	-4000	4000	-617
chr17	54957956	54965956	54963262	8000	54961956	-4000	4000	1306
chr17	58978638	58986638	58980610	8000	58982638	-4000	4000	-2028
chr17	59202709	59210709	59210231	8000	59206709	-4000	4000	3522
chr17	59211239	59219239	59211350	8000	59215239	-4000	4000	-3889
chr17	59211239	59219239	59212454	8000	59215239	-4000	4000	-2785
chr17	59211239	59219239	59213007	8000	59215239	-4000	4000	-2232
chr17	59604345	59612345	59605470	8000	59608345	-4000	4000	-2875
chr17	59838255	59846255	59839871	8000	59842255	-4000	4000	-2384
chr17	59855479	59863479	59860408	8000	59859479	-4000	4000	929
chr17	59946574	59954574	59946896	8000	59950574	-4000	4000	-3678
chr17	61586421	61594421	61591093	8000	61590421	-4000	4000	672
chr17	61938605	61946605	61946500	8000	61942605	-4000	4000	3895
chr17	62689597	62697597	62692446	8000	62693597	-4000	4000	-1151
chr17	63741255	63749255	63746708	8000	63745255	-4000	4000	1453
chr17	63998594	64006594	64005052	8000	64002594	-4000	4000	2458
chr17	68416948	68424948	68420268	8000	68420948	-4000	4000	-680
chr17	68863289	68871289	68868141	8000	68867289	-4000	4000	852
chr17	75102162	75110162	75104025	8000	75106162	-4000	4000	-2137
chr17	76729936	76737936	76733192	8000	76733936	-4000	4000	-744
chr17	77213101	77221101	77216685	8000	77217101	-4000	4000	-416
chr17	67980378	67988378	67984345	8000	67984378	-4000	4000	-33
chr17	30182475	30190475	30184865	8000	30186475	-4000	4000	-1610
chr17	30891869	30899869	30899304	8000	30895869	-4000	4000	3435
chr17	50858223	50866223	50863578	8000	50862223	-4000	4000	1355
chr17	36535310	36543310	36537654	8000	36539310	-4000	4000	-1656
chr17	16616734	16624734	16624563	8000	16620734	-4000	4000	3829
chr17	61586421	61594421	61590800	8000	61590421	-4000	4000	379
chr17	7707372	7715372	7708175	8000	7711372	-4000	4000	-3197
chr17	35739521	35747521	35745724	8000	35743521	-4000	4000	2203
chr17	47977781	47985781	47980604	8000	47981781	-4000	4000	-1177
chr17	62611481	62619481	62613450	8000	62615481	-4000	4000	-2031
chr17	5092374	5100374	5093113	8000	5096374	-4000	4000	-3261
chr17	7070537	7078537	7075213	8000	7074537	-4000	4000	676
chr17	3581149	3589149	3585855	8000	3585149	-4000	4000	706
chr17	3710628	3718628	3714853	8000	3714628	-4000	4000	225
chr17	5356963	5364963	5361458	8000	5360963	-4000	4000	495
chr17	8091900	8099900	8096378	8000	8095900	-4000	4000	478
chr17	19575034	19583034	19577358	8000	19579034	-4000	4000	-1676
chr17	28359683	28367683	28364512	8000	28363683	-4000	4000	829
chr17	29053216	29061216	29056390	8000	29057216	-4000	4000	-826
chr17	30893336	30901336	30900310	8000	30897336	-4000	4000	2974
chr17	30955322	30963322	30956249	8000	30959322	-4000	4000	-3073
chr17	30995911	31003911	30999176	8000	30999911	-4000	4000	-735
chr17	31301213	31309213	31305017	8000	31305213	-4000	4000	-196
chr17	34354610	34362610	34360505	8000	34358610	-4000	4000	1895
chr17	36068032	36076032	36071072	8000	36072032	-4000	4000	-960
chr17	40814117	40822117	40822093	8000	40818117	-4000	4000	3976
chr17	41578279	41586279	41582485	8000	41582279	-4000	4000	206
chr17	42793066	42801066	42793623	8000	42797066	-4000	4000	-3443
chr17	43010607	43018607	43015902	8000	43014607	-4000	4000	1295
chr17	47620665	47628665	47622130	8000	47624665	-4000	4000	-2535
chr17	49219225	49227225	49224770	8000	49223225	-4000	4000	1545
chr17	50689198	50697198	50697002	8000	50693198	-4000	4000	3804
chr17	54957956	54965956	54963207	8000	54961956	-4000	4000	1251
chr17	58485529	58493529	58492859	8000	58489529	-4000	4000	3330
chr17	58516250	58524250	58521415	8000	58520250	-4000	4000	1165
chr17	59211239	59219239	59215185	8000	59215239	-4000	4000	-54
chr17	60662280	60670280	60663583	8000	60666280	-4000	4000	-2697
chr17	76729936	76737936	76733292	8000	76733936	-4000	4000	-644
chr17	76946393	76954393	76947880	8000	76950393	-4000	4000	-2513
chr17	77213101	77221101	77216530	8000	77217101	-4000	4000	-571
chr17	79788132	79796132	79794644	8000	79792132	-4000	4000	2512
chr17	27645560	27653560	27647065	8000	27649560	-4000	4000	-2495
chr17	39993959	40001959	39997555	8000	39997959	-4000	4000	-404
chr17	59604345	59612345	59605542	8000	59608345	-4000	4000	-2803
chr17	59670636	59678636	59674766	8000	59674636	-4000	4000	130
chr17	60662280	60670280	60663281	8000	60666280	-4000	4000	-2999
chr17	67987099	67995099	67993222	8000	67991099	-4000	4000	2123
chr17	73279624	73287624	73286038	8000	73283624	-4000	4000	2414
chr17	50371059	50379059	50375448	8000	50375059	-4000	4000	389
chr17	59211239	59219239	59212425	8000	59215239	-4000	4000	-2814
chr17	59211239	59219239	59212870	8000	59215239	-4000	4000	-2369
chr17	78848977	78856977	78855715	8000	78852977	-4000	4000	2738
chr17	29067122	29075122	29074106	8000	29071122	-4000	4000	2984
chr17	74258020	74266020	74260307	8000	74262020	-4000	4000	-1713
chr17	6689202	6697202	6690849	8000	6693202	-4000	4000	-2353
chr17	50180101	50188101	50185881	8000	50184101	-4000	4000	1780
chr17	50180101	50188101	50187086	8000	50184101	-4000	4000	2985
chr17	38796441	38804441	38802125	8000	38800441	-4000	4000	1684
chr17	61586421	61594421	61590906	8000	61590421	-4000	4000	485
chr17	41615442	41623442	41621613	8000	41619442	-4000	4000	2171
chr17	50481974	50489974	50482666	8000	50485974	-4000	4000	-3308
chr17	42021644	42029644	42027088	8000	42025644	-4000	4000	1444
chr17	41713742	41721742	41715532	8000	41717742	-4000	4000	-2210
chr17	48536894	48544894	48543262	8000	48540894	-4000	4000	2368
chr17	68263026	68271026	68270914	8000	68267026	-4000	4000	3888
chr17	29053216	29061216	29053567	8000	29057216	-4000	4000	-3649
chr17	58978638	58986638	58980493	8000	58982638	-4000	4000	-2145
chr17	47840908	47848908	47847545	8000	47844908	-4000	4000	2637
chr17	48720763	48728763	48722504	8000	48724763	-4000	4000	-2259
chr17	59948240	59956240	59952703	8000	59952240	-4000	4000	463
chr17	63934554	63942554	63941976	8000	63938554	-4000	4000	3422
chr17	55388622	55396622	55394490	8000	55392622	-4000	4000	1868
chr17	15225773	15233773	15231016	8000	15229773	-4000	4000	1243
chr17	8486411	8494411	8487552	8000	8490411	-4000	4000	-2859
chr17	42839760	42847760	42841554	8000	42843760	-4000	4000	-2206
chr17	16800453	16808453	16803362	8000	16804453	-4000	4000	-1091
chr17	45431900	45439900	45437088	8000	45435900	-4000	4000	1188
chr17	63934554	63942554	63940990	8000	63938554	-4000	4000	2436
chr17	69074702	69082702	69078994	8000	69078702	-4000	4000	292
chr17	1296978	1304978	1298409	8000	1300978	-4000	4000	-2569
chr17	3710628	3718628	3716709	8000	3714628	-4000	4000	2081
chr17	48536894	48544894	48543542	8000	48540894	-4000	4000	2648
chr17	42611238	42619238	42613690	8000	42615238	-4000	4000	-1548
chr17	49986005	49994005	49993574	8000	49990005	-4000	4000	3569
chr17	39667122	39675122	39669741	8000	39671122	-4000	4000	-1381
chr17	41862917	41870917	41869529	8000	41866917	-4000	4000	2612
chr17	5428877	5436877	5433010	8000	5432877	-4000	4000	133
chr17	41578279	41586279	41584411	8000	41582279	-4000	4000	2132
chr17	82747196	82755196	82750427	8000	82751196	-4000	4000	-769
chr17	58978638	58986638	58980396	8000	58982638	-4000	4000	-2242
chr17	7070537	7078537	7074923	8000	7074537	-4000	4000	386
chr17	7070537	7078537	7076917	8000	7074537	-4000	4000	2380
chr17	7350944	7358944	7356423	8000	7354944	-4000	4000	1479
chr17	31301213	31309213	31304489	8000	31305213	-4000	4000	-724
chr17	42309324	42317324	42316875	8000	42313324	-4000	4000	3551
chr17	47833719	47841719	47840256	8000	47837719	-4000	4000	2537
chr17	75102162	75110162	75104189	8000	75106162	-4000	4000	-1973
chr17	81224277	81232277	81231629	8000	81228277	-4000	4000	3352
chr17	59838255	59846255	59838355	8000	59842255	-4000	4000	-3900
chr17	76946393	76954393	76948877	8000	76950393	-4000	4000	-1516
chr17	50689198	50697198	50697006	8000	50693198	-4000	4000	3808
chr17	42021644	42029644	42028133	8000	42025644	-4000	4000	2489
chr17	79788132	79796132	79794819	8000	79792132	-4000	4000	2687
chr17	79788132	79796132	79795158	8000	79792132	-4000	4000	3026
chr17	61938605	61946605	61945994	8000	61942605	-4000	4000	3389
chr17	64143227	64151227	64148324	8000	64147227	-4000	4000	1097
chr17	40015097	40023097	40015765	8000	40019097	-4000	4000	-3332
chr17	48720763	48728763	48726980	8000	48724763	-4000	4000	2217
chr17	61938605	61946605	61946563	8000	61942605	-4000	4000	3958
chr17	44748264	44756264	44748573	8000	44752264	-4000	4000	-3691
chr17	28493781	28501781	28497199	8000	28497781	-4000	4000	-582
chr17	29556547	29564547	29563048	8000	29560547	-4000	4000	2501
chr17	58516250	58524250	58521205	8000	58520250	-4000	4000	955
chr17	58978638	58986638	58982846	8000	58982638	-4000	4000	208
chr17	81677187	81685187	81683706	8000	81681187	-4000	4000	2519
chr17	48119601	48127601	48122284	8000	48123601	-4000	4000	-1317
chr17	5428877	5436877	5432577	8000	5432877	-4000	4000	-300
chr17	16616734	16624734	16622898	8000	16620734	-4000	4000	2164
chr17	28901250	28909250	28906339	8000	28905250	-4000	4000	1089
chr17	40814117	40822117	40819620	8000	40818117	-4000	4000	1503
chr17	1490577	1498577	1497985	8000	1494577	-4000	4000	3408
chr17	36084256	36092256	36090075	8000	36088256	-4000	4000	1819
chr17	36535310	36543310	36538095	8000	36539310	-4000	4000	-1215
chr17	41972421	41980421	41977439	8000	41976421	-4000	4000	1018
chr17	73203353	73211353	73209521	8000	73207353	-4000	4000	2168
chr17	41496981	41504981	41503364	8000	41500981	-4000	4000	2383
chr17	39900595	39908595	39906233	8000	39904595	-4000	4000	1638
chr17	50858223	50866223	50863306	8000	50862223	-4000	4000	1083
chr17	74537073	74545073	74541306	8000	74541073	-4000	4000	233
chr17	58264518	58272518	58267443	8000	58268518	-4000	4000	-1075
chr17	7829742	7837742	7831309	8000	7833742	-4000	4000	-2433
chr17	36535310	36543310	36538244	8000	36539310	-4000	4000	-1066
chr17	47708052	47716052	47708401	8000	47712052	-4000	4000	-3651
chr17	5092374	5100374	5092388	8000	5096374	-4000	4000	-3986
chr17	8486411	8494411	8492941	8000	8490411	-4000	4000	2530
chr17	36208878	36216878	36212657	8000	36212878	-4000	4000	-221
chr17	81914270	81922270	81914348	8000	81918270	-4000	4000	-3922
chr17	30891869	30899869	30894029	8000	30895869	-4000	4000	-1840
chr17	67740531	67748531	67743979	8000	67744531	-4000	4000	-552
chr17	39206541	39214541	39213019	8000	39210541	-4000	4000	2478
chr17	795310	803310	801092	8000	799310	-4000	4000	1782
chr17	44686308	44694308	44689570	8000	44690308	-4000	4000	-738
chr17	8486411	8494411	8492838	8000	8490411	-4000	4000	2427
chr17	54957956	54965956	54963167	8000	54961956	-4000	4000	1211
chr17	44899159	44907159	44901098	8000	44903159	-4000	4000	-2061
chr17	48603232	48611232	48610863	8000	48607232	-4000	4000	3631
chr17	69143214	69151214	69149050	8000	69147214	-4000	4000	1836
chr17	7070537	7078537	7076988	8000	7074537	-4000	4000	2451
chr17	5382340	5390340	5386232	8000	5386340	-4000	4000	-108
chr17	37475725	37483725	37476913	8000	37479725	-4000	4000	-2812
chr17	68416948	68424948	68420486	8000	68420948	-4000	4000	-462
chr17	68416948	68424948	68420652	8000	68420948	-4000	4000	-296
chr17	47840908	47848908	47848073	8000	47844908	-4000	4000	3165
chr17	36495310	36503310	36501162	8000	36499310	-4000	4000	1852
chr17	7026290	7034290	7026534	8000	7030290	-4000	4000	-3756
chr17	28699197	28707197	28700173	8000	28703197	-4000	4000	-3024
chr17	4781285	4789285	4783190	8000	4785285	-4000	4000	-2095
chr17	28857061	28865061	28858163	8000	28861061	-4000	4000	-2898
chr17	30893336	30901336	30900267	8000	30897336	-4000	4000	2931
chr17	44845948	44853948	44852490	8000	44849948	-4000	4000	2542
chr17	54947902	54955902	54950118	8000	54951902	-4000	4000	-1784
chr17	59948240	59956240	59954123	8000	59952240	-4000	4000	1883
chr17	61938605	61946605	61946532	8000	61942605	-4000	4000	3927
chr17	64850130	64858130	64854400	8000	64854130	-4000	4000	270
chr17	81185593	81193593	81191244	8000	81189593	-4000	4000	1651
chr17	81240811	81248811	81246310	8000	81244811	-4000	4000	1499
chr17	61586421	61594421	61590641	8000	61590421	-4000	4000	220
chr17	6639311	6647311	6644421	8000	6643311	-4000	4000	1110
chr17	16025157	16033157	16032429	8000	16029157	-4000	4000	3272
chr17	78203702	78211702	78205706	8000	78207702	-4000	4000	-1996
chr17	46753464	46761464	46755916	8000	46757464	-4000	4000	-1548
chr17	47045932	47053932	47050469	8000	47049932	-4000	4000	537
chr17	50688253	50696253	50695946	8000	50692253	-4000	4000	3693
chr17	74351820	74359820	74354787	8000	74355820	-4000	4000	-1033
chr17	76777449	76785449	76778247	8000	76781449	-4000	4000	-3202
chr17	41844518	41852518	41848012	8000	41848518	-4000	4000	-506
chr17	35752249	35760249	35752504	8000	35756249	-4000	4000	-3745
chr17	28192381	28200381	28196036	8000	28196381	-4000	4000	-345
chr17	62611481	62619481	62612668	8000	62615481	-4000	4000	-2813
chr17	1460186	1468186	1465704	8000	1464186	-4000	4000	1518
chr17	34354610	34362610	34358029	8000	34358610	-4000	4000	-581
chr17	38319217	38327217	38327070	8000	38323217	-4000	4000	3853
chr17	58978638	58986638	58980175	8000	58982638	-4000	4000	-2463
chr17	60037008	60045008	60043519	8000	60041008	-4000	4000	2511
chr17	74946742	74954742	74949297	8000	74950742	-4000	4000	-1445
chr17	20445395	20453395	20453060	8000	20449395	-4000	4000	3665
chr17	8045134	8053134	8047796	8000	8049134	-4000	4000	-1338
chr17	8318514	8326514	8319042	8000	8322514	-4000	4000	-3472
chr17	16616734	16624734	16622796	8000	16620734	-4000	4000	2062
chr17	19379442	19387442	19380924	8000	19383442	-4000	4000	-2518
chr17	29556547	29564547	29562653	8000	29560547	-4000	4000	2106
chr17	35346305	35354305	35353905	8000	35350305	-4000	4000	3600
chr17	35346305	35354305	35354042	8000	35350305	-4000	4000	3737
chr17	50371059	50379059	50375952	8000	50375059	-4000	4000	893
chr17	55715627	55723627	55720806	8000	55719627	-4000	4000	1179
chr17	59211239	59219239	59211707	8000	59215239	-4000	4000	-3532
chr17	70131608	70139608	70133000	8000	70135608	-4000	4000	-2608
chr17	75102162	75110162	75104109	8000	75106162	-4000	4000	-2053
chr17	76620761	76628761	76626390	8000	76624761	-4000	4000	1629
chr17	7070537	7078537	7075257	8000	7074537	-4000	4000	720
chr17	49594884	49602884	49600444	8000	49598884	-4000	4000	1560
chr17	5101541	5109541	5109519	8000	5105541	-4000	4000	3978
chr17	8283763	8291763	8289841	8000	8287763	-4000	4000	2078
chr17	8486411	8494411	8492484	8000	8490411	-4000	4000	2073
chr17	17343663	17351663	17346969	8000	17347663	-4000	4000	-694
chr17	29067122	29075122	29074786	8000	29071122	-4000	4000	3664
chr17	39632626	39640626	39636374	8000	39636626	-4000	4000	-252
chr17	40168171	40176171	40169633	8000	40172171	-4000	4000	-2538
chr17	48536894	48544894	48543525	8000	48540894	-4000	4000	2631
chr17	80462834	80470834	80468146	8000	80466834	-4000	4000	1312
chr17	48536894	48544894	48544697	8000	48540894	-4000	4000	3803
chr17	48544870	48552870	48552059	8000	48548870	-4000	4000	3189
chr17	82317024	82325024	82324765	8000	82321024	-4000	4000	3741
chr18	24158045	24166045	24165067	8000	24162045	-4000	4000	3022
chr18	669578	677578	674213	8000	673578	-4000	4000	635
chr18	13659347	13667347	13666383	8000	13663347	-4000	4000	3036
chr18	24158045	24166045	24159717	8000	24162045	-4000	4000	-2328
chr18	3252236	3260236	3253330	8000	3256236	-4000	4000	-2906
chr18	26012253	26020253	26018233	8000	26016253	-4000	4000	1980
chr18	63633259	63641259	63637615	8000	63637259	-4000	4000	356
chr18	63633259	63641259	63637693	8000	63637259	-4000	4000	434
chr18	9130345	9138345	9134272	8000	9134345	-4000	4000	-73
chr18	6937742	6945742	6942215	8000	6941742	-4000	4000	473
chr18	75061671	75069671	75063386	8000	75065671	-4000	4000	-2285
chr18	5388381	5396381	5392979	8000	5392381	-4000	4000	598
chr18	8635383	8643383	8638655	8000	8639383	-4000	4000	-728
chr18	54897509	54905509	54904323	8000	54901509	-4000	4000	2814
chr18	75285950	75293950	75287416	8000	75289950	-4000	4000	-2534
chr18	36104531	36112531	36111127	8000	36108531	-4000	4000	2596
chr18	63633259	63641259	63637948	8000	63637259	-4000	4000	689
chr18	21522112	21530112	21529819	8000	21526112	-4000	4000	3707
chr18	63651197	63659197	63655767	8000	63655197	-4000	4000	570
chr18	51170550	51178550	51177121	8000	51174550	-4000	4000	2571
chr18	11878622	11886622	11885732	8000	11882622	-4000	4000	3110
chr18	35707834	35715834	35709769	8000	35711834	-4000	4000	-2065
chr18	22409599	22417599	22415474	8000	22413599	-4000	4000	1875
chr18	75285950	75293950	75288367	8000	75289950	-4000	4000	-1583
chr18	59323823	59331823	59330674	8000	59327823	-4000	4000	2851
chr18	75061671	75069671	75063940	8000	75065671	-4000	4000	-1731
chr18	12026877	12034877	12028957	8000	12030877	-4000	4000	-1920
chr18	50727826	50735826	50729789	8000	50731826	-4000	4000	-2037
chr18	11881685	11889685	11886745	8000	11885685	-4000	4000	1060
chr18	20942906	20950906	20950686	8000	20946906	-4000	4000	3780
chr18	26012253	26020253	26016783	8000	26016253	-4000	4000	530
chr18	21522112	21530112	21529933	8000	21526112	-4000	4000	3821
chr18	20942906	20950906	20950826	8000	20946906	-4000	4000	3920
chr18	74069353	74077353	74073512	8000	74073353	-4000	4000	159
chr18	63633259	63641259	63637941	8000	63637259	-4000	4000	682
chr18	63651197	63659197	63658551	8000	63655197	-4000	4000	3354
chr18	75285950	75293950	75287798	8000	75289950	-4000	4000	-2152
chr18	50727826	50735826	50729178	8000	50731826	-4000	4000	-2648
chr18	22409599	22417599	22415596	8000	22413599	-4000	4000	1997
chr18	36104531	36112531	36111127	8000	36108531	-4000	4000	2596
chr18	23952222	23960222	23954716	8000	23956222	-4000	4000	-1506
chr18	50727826	50735826	50729251	8000	50731826	-4000	4000	-2575
chr18	50262882	50270882	50270073	8000	50266882	-4000	4000	3191
chr18	10485949	10493949	10487620	8000	10489949	-4000	4000	-2329
chr18	36104531	36112531	36112504	8000	36108531	-4000	4000	3973
chr18	50727826	50735826	50729680	8000	50731826	-4000	4000	-2146
chr18	32668673	32676673	32674533	8000	32672673	-4000	4000	1860
chr18	5950706	5958706	5956252	8000	5954706	-4000	4000	1546
chr18	58982480	58990480	58985799	8000	58986480	-4000	4000	-681
chr18	35975286	35983286	35977459	8000	35979286	-4000	4000	-1827
chr18	2912994	2920994	2920358	8000	2916994	-4000	4000	3364
chr18	69999031	70007031	70006386	8000	70003031	-4000	4000	3355
chr18	70326199	70334199	70327225	8000	70330199	-4000	4000	-2974
chr18	6937742	6945742	6942105	8000	6941742	-4000	4000	363
chr18	75285950	75293950	75286120	8000	75289950	-4000	4000	-3830
chr18	36776220	36784220	36779451	8000	36780220	-4000	4000	-769
chr18	24158045	24166045	24161515	8000	24162045	-4000	4000	-530
chr18	75285950	75293950	75288009	8000	75289950	-4000	4000	-1941
chr18	58477247	58485247	58481892	8000	58481247	-4000	4000	645
chr18	22409599	22417599	22416431	8000	22413599	-4000	4000	2832
chr18	669578	677578	674229	8000	673578	-4000	4000	651
chr18	12026877	12034877	12030414	8000	12030877	-4000	4000	-463
chr18	68669688	68677688	68677157	8000	68673688	-4000	4000	3469
chr18	63801376	63809376	63804273	8000	63805376	-4000	4000	-1103
chr18	9956021	9964021	9956794	8000	9960021	-4000	4000	-3227
chr18	2912003	2920003	2913123	8000	2916003	-4000	4000	-2880
chr18	54147606	54155606	54155107	8000	54151606	-4000	4000	3501
chr18	210520	218520	211389	8000	214520	-4000	4000	-3131
chr18	32127561	32135561	32130969	8000	32131561	-4000	4000	-592
chr18	47104188	47112188	47108624	8000	47108188	-4000	4000	436
chr18	63651197	63659197	63657299	8000	63655197	-4000	4000	2102
chr18	35707834	35715834	35709656	8000	35711834	-4000	4000	-2178
chr18	58477247	58485247	58481365	8000	58481247	-4000	4000	118
chr18	2801017	2809017	2802573	8000	2805017	-4000	4000	-2444
chr18	35362694	35370694	35369343	8000	35366694	-4000	4000	2649
chr18	3455978	3463978	3458339	8000	3459978	-4000	4000	-1639
chr18	24158045	24166045	24159812	8000	24162045	-4000	4000	-2233
chr18	24158045	24166045	24159969	8000	24162045	-4000	4000	-2076
chr18	51170550	51178550	51176597	8000	51174550	-4000	4000	2047
chr18	49818789	49826789	49826521	8000	49822789	-4000	4000	3732
chr18	22409599	22417599	22415710	8000	22413599	-4000	4000	2111
chr18	11878622	11886622	11884161	8000	11882622	-4000	4000	1539
chr18	3062807	3070807	3067228	8000	3066807	-4000	4000	421
chr18	74069353	74077353	74073521	8000	74073353	-4000	4000	168
chr18	24131610	24139610	24132532	8000	24135610	-4000	4000	-3078
chr18	26450910	26458910	26455846	8000	26454910	-4000	4000	936
chr18	59900305	59908305	59903296	8000	59904305	-4000	4000	-1009
chr18	210520	218520	213498	8000	214520	-4000	4000	-1022
chr18	80153232	80161232	80159825	8000	80157232	-4000	4000	2593
chr18	54897509	54905509	54904224	8000	54901509	-4000	4000	2715
chr18	80153232	80161232	80160129	8000	80157232	-4000	4000	2897
chr18	75061671	75069671	75064000	8000	75065671	-4000	4000	-1671
chr18	63119346	63127346	63124915	8000	63123346	-4000	4000	1569
chr18	22409599	22417599	22415897	8000	22413599	-4000	4000	2298
chr18	75285950	75293950	75288363	8000	75289950	-4000	4000	-1587
chr18	31474702	31482702	31475724	8000	31478702	-4000	4000	-2978
chr18	11878622	11886622	11884559	8000	11882622	-4000	4000	1937
chr18	58982480	58990480	58984589	8000	58986480	-4000	4000	-1891
chr18	23952222	23960222	23954547	8000	23956222	-4000	4000	-1675
chr18	54147606	54155606	54154825	8000	54151606	-4000	4000	3219
chr18	23527822	23535822	23531970	8000	23531822	-4000	4000	148
chr18	51054144	51062144	51058190	8000	51058144	-4000	4000	46
chr18	63501085	63509085	63503375	8000	63505085	-4000	4000	-1710
chr18	75061671	75069671	75064100	8000	75065671	-4000	4000	-1571
chr18	9534114	9542114	9535713	8000	9538114	-4000	4000	-2401
chr18	21866953	21874953	21869714	8000	21870953	-4000	4000	-1239
chr18	22198528	22206528	22201375	8000	22202528	-4000	4000	-1153
chr18	34887844	34895844	34891321	8000	34891844	-4000	4000	-523
chr18	31474702	31482702	31475721	8000	31478702	-4000	4000	-2981
chr18	11878622	11886622	11886610	8000	11882622	-4000	4000	3988
chr18	12026877	12034877	12030416	8000	12030877	-4000	4000	-461
chr18	43263892	43271892	43270325	8000	43267892	-4000	4000	2433
chr18	72532680	72540680	72538678	8000	72536680	-4000	4000	1998
chr18	5388381	5396381	5395095	8000	5392381	-4000	4000	2714
chr18	50727826	50735826	50729222	8000	50731826	-4000	4000	-2604
chr18	11878622	11886622	11885691	8000	11882622	-4000	4000	3069
chr18	24158045	24166045	24165079	8000	24162045	-4000	4000	3034
chr18	669578	677578	674341	8000	673578	-4000	4000	763
chr18	5285019	5293019	5290726	8000	5289019	-4000	4000	1707
chr18	12983536	12991536	12985312	8000	12987536	-4000	4000	-2224
chr18	12781478	12789478	12785901	8000	12785478	-4000	4000	423
chr18	3062807	3070807	3067398	8000	3066807	-4000	4000	591
chr18	63651197	63659197	63658596	8000	63655197	-4000	4000	3399
chr18	75285950	75293950	75287723	8000	75289950	-4000	4000	-2227
chr18	47099478	47107478	47101095	8000	47103478	-4000	4000	-2383
chr18	3252236	3260236	3253903	8000	3256236	-4000	4000	-2333
chr18	3252236	3260236	3254035	8000	3256236	-4000	4000	-2201
chr18	12983536	12991536	12984037	8000	12987536	-4000	4000	-3499
chr18	23527822	23535822	23529464	8000	23531822	-4000	4000	-2358
chr18	35247058	35255058	35253367	8000	35251058	-4000	4000	2309
chr18	75061671	75069671	75063271	8000	75065671	-4000	4000	-2400
chr18	46262992	46270992	46264892	8000	46266992	-4000	4000	-2100
chr18	646334	654334	649917	8000	650334	-4000	4000	-417
chr18	50727826	50735826	50730599	8000	50731826	-4000	4000	-1227
chr18	47104188	47112188	47108660	8000	47108188	-4000	4000	472
chr18	50727826	50735826	50729282	8000	50731826	-4000	4000	-2544
chr18	75285950	75293950	75288256	8000	75289950	-4000	4000	-1694
chr18	75285950	75293950	75288448	8000	75289950	-4000	4000	-1502
chr18	210520	218520	216572	8000	214520	-4000	4000	2052
chr18	3455978	3463978	3458002	8000	3459978	-4000	4000	-1976
chr18	8635383	8643383	8638173	8000	8639383	-4000	4000	-1210
chr18	32120877	32128877	32124831	8000	32124877	-4000	4000	-46
chr18	35975286	35983286	35979026	8000	35979286	-4000	4000	-260
chr18	36104531	36112531	36109739	8000	36108531	-4000	4000	1208
chr18	51170550	51178550	51177533	8000	51174550	-4000	4000	2983
chr18	62976433	62984433	62979185	8000	62980433	-4000	4000	-1248
chr18	63633259	63641259	63639715	8000	63637259	-4000	4000	2456
chr18	79525325	79533325	79527246	8000	79529325	-4000	4000	-2079
chr18	63651197	63659197	63656040	8000	63655197	-4000	4000	843
chr18	36104531	36112531	36111113	8000	36108531	-4000	4000	2582
chr18	669578	677578	673017	8000	673578	-4000	4000	-561
chr18	2801017	2809017	2802694	8000	2805017	-4000	4000	-2323
chr18	3455978	3463978	3457417	8000	3459978	-4000	4000	-2561
chr18	6911716	6919716	6912104	8000	6915716	-4000	4000	-3612
chr18	12721740	12729740	12725725	8000	12725740	-4000	4000	-15
chr18	14850667	14858667	14852067	8000	14854667	-4000	4000	-2600
chr18	21646901	21654901	21651752	8000	21650901	-4000	4000	851
chr18	22409599	22417599	22415792	8000	22413599	-4000	4000	2193
chr18	23193144	23201144	23194453	8000	23197144	-4000	4000	-2691
chr18	24449531	24457531	24450802	8000	24453531	-4000	4000	-2729
chr18	57025811	57033811	57027030	8000	57029811	-4000	4000	-2781
chr18	59154832	59162832	59155885	8000	59158832	-4000	4000	-2947
chr18	63633259	63641259	63637784	8000	63637259	-4000	4000	525
chr18	63801376	63809376	63804651	8000	63805376	-4000	4000	-725
chr18	75285950	75293950	75287903	8000	75289950	-4000	4000	-2047
chr18	669578	677578	672986	8000	673578	-4000	4000	-592
chr18	58477247	58485247	58481821	8000	58481247	-4000	4000	574
chr18	43263892	43271892	43270077	8000	43267892	-4000	4000	2185
chr18	8402861	8410861	8406135	8000	8406861	-4000	4000	-726
chr18	46262992	46270992	46266412	8000	46266992	-4000	4000	-580
chr18	9130345	9138345	9134324	8000	9134345	-4000	4000	-21
chr18	47099478	47107478	47101049	8000	47103478	-4000	4000	-2429
chr18	6911716	6919716	6912069	8000	6915716	-4000	4000	-3647
chr18	24131610	24139610	24132595	8000	24135610	-4000	4000	-3015
chr18	36268157	36276157	36268691	8000	36272157	-4000	4000	-3466
chr18	21525284	21533284	21530275	8000	21529284	-4000	4000	991
chr18	23256470	23264470	23257358	8000	23260470	-4000	4000	-3112
chr18	31545008	31553008	31546233	8000	31549008	-4000	4000	-2775
chr18	14850667	14858667	14852312	8000	14854667	-4000	4000	-2355
chr18	55218185	55226185	55225306	8000	55222185	-4000	4000	3121
chr18	75285950	75293950	75286655	8000	75289950	-4000	4000	-3295
chr18	3274461	3282461	3277360	8000	3278461	-4000	4000	-1101
chr18	5388381	5396381	5393275	8000	5392381	-4000	4000	894
chr18	69051189	69059189	69054074	8000	69055189	-4000	4000	-1115
chr18	12442512	12450512	12449607	8000	12446512	-4000	4000	3095
chr18	22409599	22417599	22415549	8000	22413599	-4000	4000	1950
chr18	75061671	75069671	75064002	8000	75065671	-4000	4000	-1669
chr18	63651197	63659197	63655731	8000	63655197	-4000	4000	534
chr18	62976433	62984433	62979042	8000	62980433	-4000	4000	-1391
chr18	75285950	75293950	75287918	8000	75289950	-4000	4000	-2032
chr18	6937742	6945742	6943263	8000	6941742	-4000	4000	1521
chr18	63651197	63659197	63658544	8000	63655197	-4000	4000	3347
chr18	36104531	36112531	36111162	8000	36108531	-4000	4000	2631
chr18	75285950	75293950	75286830	8000	75289950	-4000	4000	-3120
chr18	51170550	51178550	51176850	8000	51174550	-4000	4000	2300
chr18	57596656	57604656	57602357	8000	57600656	-4000	4000	1701
chr19	51327536	51335536	51334200	8000	51331536	-4000	4000	2664
chr19	35674483	35682483	35678247	8000	35678483	-4000	4000	-236
chr19	11780078	11788078	11781599	8000	11784078	-4000	4000	-2479
chr19	19508418	19516418	19516163	8000	19512418	-4000	4000	3745
chr19	37610179	37618179	37612682	8000	37614179	-4000	4000	-1497
chr19	44130822	44138822	44132903	8000	44134822	-4000	4000	-1919
chr19	44470428	44478428	44477772	8000	44474428	-4000	4000	3344
chr19	57715751	57723751	57720622	8000	57719751	-4000	4000	871
chr19	44233268	44241268	44235124	8000	44237268	-4000	4000	-2144
chr19	47516690	47524690	47521935	8000	47520690	-4000	4000	1245
chr19	22087480	22095480	22089086	8000	22091480	-4000	4000	-2394
chr19	15447624	15455624	15451808	8000	15451624	-4000	4000	184
chr19	34952354	34960354	34958450	8000	34956354	-4000	4000	2096
chr19	37692371	37700371	37698534	8000	37696371	-4000	4000	2163
chr19	52793408	52801408	52798859	8000	52797408	-4000	4000	1451
chr19	2914473	2922473	2918318	8000	2918473	-4000	4000	-155
chr19	8370370	8378370	8371373	8000	8374370	-4000	4000	-2997
chr19	18573550	18581550	18574947	8000	18577550	-4000	4000	-2603
chr19	34941170	34949170	34943246	8000	34945170	-4000	4000	-1924
chr19	36813428	36821428	36818887	8000	36817428	-4000	4000	1459
chr19	36884124	36892124	36891479	8000	36888124	-4000	4000	3355
chr19	43618368	43626368	43623342	8000	43622368	-4000	4000	974
chr19	44130822	44138822	44132757	8000	44134822	-4000	4000	-2065
chr19	52414412	52422412	52416030	8000	52418412	-4000	4000	-2382
chr19	48716585	48724585	48716786	8000	48720585	-4000	4000	-3799
chr19	15658825	15666825	15659570	8000	15662825	-4000	4000	-3255
chr19	56552808	56560808	56555731	8000	56556808	-4000	4000	-1077
chr19	34741378	34749378	34741520	8000	34745378	-4000	4000	-3858
chr19	38874555	38882555	38880889	8000	38878555	-4000	4000	2334
chr19	44083318	44091318	44086189	8000	44087318	-4000	4000	-1129
chr19	48633946	48641946	48640097	8000	48637946	-4000	4000	2151
chr19	52414412	52422412	52416248	8000	52418412	-4000	4000	-2164
chr19	52793408	52801408	52801145	8000	52797408	-4000	4000	3737
chr19	19248233	19256233	19248832	8000	19252233	-4000	4000	-3401
chr19	51987332	51995332	51993543	8000	51991332	-4000	4000	2211
chr19	50902351	50910351	50909244	8000	50906351	-4000	4000	2893
chr19	11831216	11839216	11831411	8000	11835216	-4000	4000	-3805
chr19	11831216	11839216	11832199	8000	11835216	-4000	4000	-3017
chr19	41092195	41100195	41093672	8000	41096195	-4000	4000	-2523
chr19	2929218	2937218	2934683	8000	2933218	-4000	4000	1465
chr19	11805622	11813622	11807373	8000	11809622	-4000	4000	-2249
chr19	1035068	1043068	1041510	8000	1039068	-4000	4000	2442
chr19	52698813	52706813	52705377	8000	52702813	-4000	4000	2564
chr19	55177247	55185247	55181796	8000	55181247	-4000	4000	549
chr19	54232592	54240592	54239723	8000	54236592	-4000	4000	3131
chr19	58453833	58461833	58454482	8000	58457833	-4000	4000	-3351
chr19	7898021	7906021	7899491	8000	7902021	-4000	4000	-2530
chr19	42194598	42202598	42199480	8000	42198598	-4000	4000	882
chr19	10346529	10354529	10351107	8000	10350529	-4000	4000	578
chr19	44156313	44164313	44156627	8000	44160313	-4000	4000	-3686
chr19	8370370	8378370	8371245	8000	8374370	-4000	4000	-3125
chr19	19706472	19714472	19712867	8000	19710472	-4000	4000	2395
chr19	35875792	35883792	35878636	8000	35879792	-4000	4000	-1156
chr19	52698813	52706813	52706565	8000	52702813	-4000	4000	3752
chr19	3589541	3597541	3591087	8000	3593541	-4000	4000	-2454
chr19	52109091	52117091	52116959	8000	52113091	-4000	4000	3868
chr19	53062606	53070606	53070095	8000	53066606	-4000	4000	3489
chr19	57589890	57597890	57590017	8000	57593890	-4000	4000	-3873
chr19	57973076	57981076	57978313	8000	57977076	-4000	4000	1237
chr19	57973076	57981076	57979389	8000	57977076	-4000	4000	2313
chr19	16813963	16821963	16815199	8000	16817963	-4000	4000	-2764
chr19	48440931	48448931	48441826	8000	48444931	-4000	4000	-3105
chr19	11831216	11839216	11832166	8000	11835216	-4000	4000	-3050
chr19	54232592	54240592	54239082	8000	54236592	-4000	4000	2490
chr19	57290069	57298069	57291548	8000	57294069	-4000	4000	-2521
chr19	5838888	5846888	5844130	8000	5842888	-4000	4000	1242
chr19	54634022	54642022	54636996	8000	54638022	-4000	4000	-1026
chr19	56371846	56379846	56377277	8000	56375846	-4000	4000	1431
chr19	8505678	8513678	8512413	8000	8509678	-4000	4000	2735
chr19	49709731	49717731	49713479	8000	49713731	-4000	4000	-252
chr19	8516778	8524778	8522809	8000	8520778	-4000	4000	2031
chr19	51822190	51830190	51824482	8000	51826190	-4000	4000	-1708
chr19	51708387	51716387	51714069	8000	51712387	-4000	4000	1682
chr19	35519367	35527367	35523500	8000	35523367	-4000	4000	133
chr19	57589890	57597890	57590919	8000	57593890	-4000	4000	-2971
chr19	8061402	8069402	8066098	8000	8065402	-4000	4000	696
chr19	37126368	37134368	37128699	8000	37130368	-4000	4000	-1669
chr19	37407155	37415155	37413649	8000	37411155	-4000	4000	2494
chr19	38405088	38413088	38405380	8000	38409088	-4000	4000	-3708
chr19	51018216	51026216	51022515	8000	51022216	-4000	4000	299
chr19	56552808	56560808	56555308	8000	56556808	-4000	4000	-1500
chr19	35900377	35908377	35904260	8000	35904377	-4000	4000	-117
chr19	51073495	51081495	51077937	8000	51077495	-4000	4000	442
chr19	21384582	21392582	21386661	8000	21388582	-4000	4000	-1921
chr19	35165881	35173881	35169716	8000	35169881	-4000	4000	-165
chr19	41203539	41211539	41206601	8000	41207539	-4000	4000	-938
chr19	38813471	38821471	38817196	8000	38817471	-4000	4000	-275
chr19	52109091	52117091	52115458	8000	52113091	-4000	4000	2367
chr19	56552808	56560808	56555177	8000	56556808	-4000	4000	-1631
chr19	35483324	35491324	35487367	8000	35487324	-4000	4000	43
chr19	56657980	56665980	56664506	8000	56661980	-4000	4000	2526
chr19	10282615	10290615	10287604	8000	10286615	-4000	4000	989
chr19	57589890	57597890	57591037	8000	57593890	-4000	4000	-2853
chr19	21056050	21064050	21057993	8000	21060050	-4000	4000	-2057
chr19	56057810	56065810	56058276	8000	56061810	-4000	4000	-3534
chr19	19641198	19649198	19645423	8000	19645198	-4000	4000	225
chr19	11805622	11813622	11806918	8000	11809622	-4000	4000	-2704
chr19	40871439	40879439	40878784	8000	40875439	-4000	4000	3345
chr19	5826408	5834408	5832244	8000	5830408	-4000	4000	1836
chr19	5838888	5846888	5844449	8000	5842888	-4000	4000	1561
chr19	15693174	15701174	15696193	8000	15697174	-4000	4000	-981
chr19	15693174	15701174	15696498	8000	15697174	-4000	4000	-676
chr19	40839541	40847541	40845364	8000	40843541	-4000	4000	1823
chr19	57936833	57944833	57941116	8000	57940833	-4000	4000	283
chr19	35875792	35883792	35879427	8000	35879792	-4000	4000	-365
chr19	23143221	23151221	23146560	8000	23147221	-4000	4000	-661
chr19	37692371	37700371	37698655	8000	37696371	-4000	4000	2284
chr19	46643551	46651551	46648511	8000	46647551	-4000	4000	960
chr19	48791062	48799062	48795235	8000	48795062	-4000	4000	173
chr19	11831216	11839216	11831808	8000	11835216	-4000	4000	-3408
chr19	54090668	54098668	54095969	8000	54094668	-4000	4000	1301
chr19	301573	309573	306631	8000	305573	-4000	4000	1058
chr19	2929218	2937218	2933702	8000	2933218	-4000	4000	484
chr19	2929218	2937218	2933849	8000	2933218	-4000	4000	631
chr19	13957449	13965449	13963937	8000	13961449	-4000	4000	2488
chr19	14115512	14123512	14120465	8000	14119512	-4000	4000	953
chr19	17245171	17253171	17251682	8000	17249171	-4000	4000	2511
chr19	18617039	18625039	18618404	8000	18621039	-4000	4000	-2635
chr19	19272018	19280018	19277799	8000	19276018	-4000	4000	1781
chr19	34952354	34960354	34957801	8000	34956354	-4000	4000	1447
chr19	34952354	34960354	34957802	8000	34956354	-4000	4000	1448
chr19	38787754	38795754	38790764	8000	38791754	-4000	4000	-990
chr19	40389766	40397766	40395478	8000	40393766	-4000	4000	1712
chr19	49522428	49530428	49524522	8000	49526428	-4000	4000	-1906
chr19	50902351	50910351	50908538	8000	50906351	-4000	4000	2187
chr19	50939303	50947303	50943572	8000	50943303	-4000	4000	269
chr19	56657980	56665980	56664700	8000	56661980	-4000	4000	2720
chr19	57973076	57981076	57974145	8000	57977076	-4000	4000	-2931
chr19	15447624	15455624	15454372	8000	15451624	-4000	4000	2748
chr19	8318584	8326584	8321364	8000	8322584	-4000	4000	-1220
chr19	56770547	56778547	56775174	8000	56774547	-4000	4000	627
chr19	24125968	24133968	24127592	8000	24129968	-4000	4000	-2376
chr19	47516690	47524690	47521973	8000	47520690	-4000	4000	1283
chr19	51025092	51033092	51027571	8000	51029092	-4000	4000	-1521
chr19	40376439	40384439	40383885	8000	40380439	-4000	4000	3446
chr19	613159	621159	613253	8000	617159	-4000	4000	-3906
chr19	2914473	2922473	2917095	8000	2918473	-4000	4000	-1378
chr19	9849718	9857718	9854082	8000	9853718	-4000	4000	364
chr19	10482125	10490125	10486566	8000	10486125	-4000	4000	441
chr19	13759296	13767296	13766129	8000	13763296	-4000	4000	2833
chr19	15658825	15666825	15659391	8000	15662825	-4000	4000	-3434
chr19	18667721	18675721	18669167	8000	18671721	-4000	4000	-2554
chr19	19248233	19256233	19249857	8000	19252233	-4000	4000	-2376
chr19	22175089	22183089	22180837	8000	22179089	-4000	4000	1748
chr19	24125968	24133968	24128024	8000	24129968	-4000	4000	-1944
chr19	34422168	34430168	34426157	8000	34426168	-4000	4000	-11
chr19	37692371	37700371	37699422	8000	37696371	-4000	4000	3051
chr19	39324353	39332353	39328621	8000	39328353	-4000	4000	268
chr19	40572464	40580464	40578163	8000	40576464	-4000	4000	1699
chr19	52793408	52801408	52800209	8000	52797408	-4000	4000	2801
chr19	53062606	53070606	53069515	8000	53066606	-4000	4000	2909
chr19	53492255	53500255	53492901	8000	53496255	-4000	4000	-3354
chr19	54245003	54253003	54252522	8000	54249003	-4000	4000	3519
chr19	57531257	57539257	57538206	8000	57535257	-4000	4000	2949
chr19	58079838	58087838	58086027	8000	58083838	-4000	4000	2189
chr19	58122248	58130248	58128052	8000	58126248	-4000	4000	1804
chr19	58122248	58130248	58128323	8000	58126248	-4000	4000	2075
chr19	19248233	19256233	19252153	8000	19252233	-4000	4000	-80
chr19	53120072	53128072	53122498	8000	53124072	-4000	4000	-1574
chr19	51944759	51952759	51945013	8000	51948759	-4000	4000	-3746
chr19	43908624	43916624	43914615	8000	43912624	-4000	4000	1991
chr19	8061402	8069402	8066113	8000	8065402	-4000	4000	711
chr19	17245171	17253171	17251620	8000	17249171	-4000	4000	2449
chr19	52027378	52035378	52034272	8000	52031378	-4000	4000	2894
chr19	42224201	42232201	42225400	8000	42228201	-4000	4000	-2801
chr19	46616468	46624468	46621391	8000	46620468	-4000	4000	923
chr19	1778075	1786075	1783042	8000	1782075	-4000	4000	967
chr19	19641198	19649198	19646209	8000	19645198	-4000	4000	1011
chr19	51944759	51952759	51945177	8000	51948759	-4000	4000	-3582
chr19	53352906	53360906	53353886	8000	53356906	-4000	4000	-3020
chr19	47318066	47326066	47319969	8000	47322066	-4000	4000	-2097
chr19	42082110	42090110	42089650	8000	42086110	-4000	4000	3540
chr19	36506687	36514687	36514268	8000	36510687	-4000	4000	3581
chr19	40389766	40397766	40396627	8000	40393766	-4000	4000	2861
chr19	43359172	43367172	43360321	8000	43363172	-4000	4000	-2851
chr19	51025092	51033092	51031928	8000	51029092	-4000	4000	2836
chr19	58122248	58130248	58128117	8000	58126248	-4000	4000	1869
chr19	58122248	58130248	58128852	8000	58126248	-4000	4000	2604
chr19	22387019	22395019	22391513	8000	22391019	-4000	4000	494
chr19	2507219	2515219	2514853	8000	2511219	-4000	4000	3634
chr19	11805622	11813622	11806864	8000	11809622	-4000	4000	-2758
chr19	42424278	42432278	42426758	8000	42428278	-4000	4000	-1520
chr19	52414412	52422412	52415276	8000	52418412	-4000	4000	-3136
chr19	14049218	14057218	14054511	8000	14053218	-4000	4000	1293
chr19	35519367	35527367	35527250	8000	35523367	-4000	4000	3883
chr19	46462491	46470491	46469913	8000	46466491	-4000	4000	3422
chr19	43359172	43367172	43362177	8000	43363172	-4000	4000	-995
chr19	47739134	47747134	47741325	8000	47743134	-4000	4000	-1809
chr19	2991179	2999179	2997729	8000	2995179	-4000	4000	2550
chr19	22175089	22183089	22180747	8000	22179089	-4000	4000	1658
chr19	51987332	51995332	51993868	8000	51991332	-4000	4000	2536
chr19	19557707	19565707	19564986	8000	19561707	-4000	4000	3279
chr19	36813428	36821428	36819110	8000	36817428	-4000	4000	1682
chr19	10508742	10516742	10514685	8000	10512742	-4000	4000	1943
chr19	44009924	44017924	44010641	8000	44013924	-4000	4000	-3283
chr19	12341944	12349944	12349508	8000	12345944	-4000	4000	3564
chr19	24125968	24133968	24126327	8000	24129968	-4000	4000	-3641
chr19	34682397	34690397	34684637	8000	34686397	-4000	4000	-1760
chr19	36813428	36821428	36819982	8000	36817428	-4000	4000	2554
chr19	41092195	41100195	41095793	8000	41096195	-4000	4000	-402
chr19	43610498	43618498	43613603	8000	43614498	-4000	4000	-895
chr19	44105886	44113886	44107676	8000	44109886	-4000	4000	-2210
chr19	53231381	53239381	53237713	8000	53235381	-4000	4000	2332
chr19	57355898	57363898	57356783	8000	57359898	-4000	4000	-3115
chr19	11831216	11839216	11833278	8000	11835216	-4000	4000	-1938
chr19	6490319	6498319	6495383	8000	6494319	-4000	4000	1064
chr19	22387019	22395019	22392929	8000	22391019	-4000	4000	1910
chr19	36884124	36892124	36891512	8000	36888124	-4000	4000	3388
chr19	36994700	37002700	36997455	8000	36998700	-4000	4000	-1245
chr19	40389766	40397766	40394993	8000	40393766	-4000	4000	1227
chr19	44470428	44478428	44477467	8000	44474428	-4000	4000	3039
chr19	49709731	49717731	49711877	8000	49713731	-4000	4000	-1854
chr19	52109091	52117091	52115742	8000	52113091	-4000	4000	2651
chr19	55705858	55713858	55711967	8000	55709858	-4000	4000	2109
chr19	56552808	56560808	56553783	8000	56556808	-4000	4000	-3025
chr19	53352906	53360906	53354310	8000	53356906	-4000	4000	-2596
chr19	20946697	20954697	20949845	8000	20950697	-4000	4000	-852
chr19	36234771	36242771	36238715	8000	36238771	-4000	4000	-56
chr19	52225518	52233518	52226046	8000	52229518	-4000	4000	-3472
chr19	12744323	12752323	12748024	8000	12748323	-4000	4000	-299
chr19	56657980	56665980	56664946	8000	56661980	-4000	4000	2966
chr19	7898021	7906021	7899515	8000	7902021	-4000	4000	-2506
chr19	50972468	50980468	50977535	8000	50976468	-4000	4000	1067
chr19	43359172	43367172	43360283	8000	43363172	-4000	4000	-2889
chr19	14049218	14057218	14053652	8000	14053218	-4000	4000	434
chr19	51960340	51968340	51966069	8000	51964340	-4000	4000	1729
chr19	37126368	37134368	37128184	8000	37130368	-4000	4000	-2184
chr19	57973076	57981076	57978523	8000	57977076	-4000	4000	1447
chr19	30012612	30020612	30014925	8000	30016612	-4000	4000	-1687
chr19	51741172	51749172	51745898	8000	51745172	-4000	4000	726
chr19	56435325	56443325	56442645	8000	56439325	-4000	4000	3320
chr19	54269812	54277812	54274811	8000	54273812	-4000	4000	999
chr19	52793408	52801408	52799545	8000	52797408	-4000	4000	2137
chr19	2991179	2999179	2993574	8000	2995179	-4000	4000	-1605
chr19	23143221	23151221	23146697	8000	23147221	-4000	4000	-524
chr19	50815146	50823146	50820016	8000	50819146	-4000	4000	870
chr19	54997142	55005142	54997316	8000	55001142	-4000	4000	-3826
chr19	52414412	52422412	52416844	8000	52418412	-4000	4000	-1568
chr19	44470428	44478428	44476687	8000	44474428	-4000	4000	2259
chr19	44233268	44241268	44235990	8000	44237268	-4000	4000	-1278
chr19	49285638	49293638	49293273	8000	49289638	-4000	4000	3635
chr19	51008739	51016739	51014949	8000	51012739	-4000	4000	2210
chr19	57290069	57298069	57290716	8000	57294069	-4000	4000	-3353
chr19	23218755	23226755	23223757	8000	23222755	-4000	4000	1002
chr19	57954437	57962437	57958660	8000	57958437	-4000	4000	223
chr19	744329	752329	746627	8000	748329	-4000	4000	-1702
chr19	35022471	35030471	35023441	8000	35026471	-4000	4000	-3030
chr19	43868365	43876365	43873410	8000	43872365	-4000	4000	1045
chr19	56371846	56379846	56377055	8000	56375846	-4000	4000	1209
chr19	57531257	57539257	57538388	8000	57535257	-4000	4000	3131
chr19	49709731	49717731	49711736	8000	49713731	-4000	4000	-1995
chr19	7954573	7962573	7959064	8000	7958573	-4000	4000	491
chr19	53576269	53584269	53577373	8000	53580269	-4000	4000	-2896
chr19	11975290	11983290	11979872	8000	11979290	-4000	4000	582
chr19	36234771	36242771	36236956	8000	36238771	-4000	4000	-1815
chr19	37389066	37397066	37389371	8000	37393066	-4000	4000	-3695
chr19	38904893	38912893	38905097	8000	38908893	-4000	4000	-3796
chr19	40218208	40226208	40222435	8000	40222208	-4000	4000	227
chr19	56657980	56665980	56664149	8000	56661980	-4000	4000	2169
chr19	36632618	36640618	36638834	8000	36636618	-4000	4000	2216
chr19	14946033	14954033	14950333	8000	14950033	-4000	4000	300
chr19	54303070	54311070	54307505	8000	54307070	-4000	4000	435
chr19	57715751	57723751	57720178	8000	57719751	-4000	4000	427
chr19	57715751	57723751	57721244	8000	57719751	-4000	4000	1493
chr19	57715751	57723751	57721341	8000	57719751	-4000	4000	1590
chr19	36632618	36640618	36639740	8000	36636618	-4000	4000	3122
chr19	44105886	44113886	44106509	8000	44109886	-4000	4000	-3377
chr19	17820780	17828780	17826683	8000	17824780	-4000	4000	1903
chr19	50427314	50435314	50428053	8000	50431314	-4000	4000	-3261
chr19	53062606	53070606	53070057	8000	53066606	-4000	4000	3451
chr19	49339335	49347335	49347252	8000	49343335	-4000	4000	3917
chr19	52698813	52706813	52704531	8000	52702813	-4000	4000	1718
chr19	40389766	40397766	40395792	8000	40393766	-4000	4000	2026
chr19	40389766	40397766	40397002	8000	40393766	-4000	4000	3236
chr19	40389766	40397766	40397212	8000	40393766	-4000	4000	3446
chr19	5862171	5870171	5866748	8000	5866171	-4000	4000	577
chr19	12313477	12321477	12319022	8000	12317477	-4000	4000	1545
chr19	11831216	11839216	11831933	8000	11835216	-4000	4000	-3283
chr19	14049218	14057218	14054475	8000	14053218	-4000	4000	1257
chr19	15447624	15455624	15448226	8000	15451624	-4000	4000	-3398
chr19	8061402	8069402	8066180	8000	8065402	-4000	4000	778
chr19	8516778	8524778	8522729	8000	8520778	-4000	4000	1951
chr19	12642511	12650511	12646570	8000	12646511	-4000	4000	59
chr19	36178276	36186276	36182814	8000	36182276	-4000	4000	538
chr19	50902351	50910351	50908532	8000	50906351	-4000	4000	2181
chr19	55147767	55155767	55154172	8000	55151767	-4000	4000	2405
chr19	34952354	34960354	34959291	8000	34956354	-4000	4000	2937
chr19	36632618	36640618	36638889	8000	36636618	-4000	4000	2271
chr19	36632618	36640618	36638977	8000	36636618	-4000	4000	2359
chr19	36632618	36640618	36639236	8000	36636618	-4000	4000	2618
chr19	36632618	36640618	36639477	8000	36636618	-4000	4000	2859
chr19	42230583	42238583	42234588	8000	42234583	-4000	4000	5
chr19	51406020	51414020	51411051	8000	51410020	-4000	4000	1031
chr19	54090668	54098668	54095251	8000	54094668	-4000	4000	583
chr19	54269812	54277812	54276452	8000	54273812	-4000	4000	2640
chr19	35750519	35758519	35752620	8000	35754519	-4000	4000	-1899
chr19	39197884	39205884	39200350	8000	39201884	-4000	4000	-1534
chr19	48111445	48119445	48117659	8000	48115445	-4000	4000	2214
chr19	5838888	5846888	5844351	8000	5842888	-4000	4000	1463
chr19	10482125	10490125	10486521	8000	10486125	-4000	4000	396
chr19	11975290	11983290	11978478	8000	11979290	-4000	4000	-812
chr19	54090668	54098668	54095272	8000	54094668	-4000	4000	604
chr19	19706472	19714472	19711961	8000	19710472	-4000	4000	1489
chr19	52698813	52706813	52705030	8000	52702813	-4000	4000	2217
chr19	38874555	38882555	38879175	8000	38878555	-4000	4000	620
chr19	36178276	36186276	36182909	8000	36182276	-4000	4000	633
chr19	37610179	37618179	37612577	8000	37614179	-4000	4000	-1602
chr19	1778075	1786075	1784826	8000	1782075	-4000	4000	2751
chr19	47516690	47524690	47521984	8000	47520690	-4000	4000	1294
chr19	11805622	11813622	11807581	8000	11809622	-4000	4000	-2041
chr19	11975290	11983290	11978929	8000	11979290	-4000	4000	-361
chr19	58082310	58090310	58089953	8000	58086310	-4000	4000	3643
chr19	16888606	16896606	16890403	8000	16892606	-4000	4000	-2203
chr19	17820780	17828780	17826888	8000	17824780	-4000	4000	2108
chr19	21800946	21808946	21808658	8000	21804946	-4000	4000	3712
chr19	35519367	35527367	35523474	8000	35523367	-4000	4000	107
chr19	36178276	36186276	36183165	8000	36182276	-4000	4000	889
chr19	37610179	37618179	37611665	8000	37614179	-4000	4000	-2514
chr19	51446847	51454847	51454748	8000	51450847	-4000	4000	3901
chr19	57973076	57981076	57979248	8000	57977076	-4000	4000	2172
chr19	42224201	42232201	42226018	8000	42228201	-4000	4000	-2183
chr19	44105886	44113886	44107065	8000	44109886	-4000	4000	-2821
chr19	1778075	1786075	1782209	8000	1782075	-4000	4000	134
chr19	1778075	1786075	1783123	8000	1782075	-4000	4000	1048
chr19	52698813	52706813	52704844	8000	52702813	-4000	4000	2031
chr19	55649161	55657161	55652683	8000	55653161	-4000	4000	-478
chr19	56657980	56665980	56664364	8000	56661980	-4000	4000	2384
chr19	15658825	15666825	15659445	8000	15662825	-4000	4000	-3380
chr19	56552808	56560808	56554751	8000	56556808	-4000	4000	-2057
chr19	56770547	56778547	56774836	8000	56774547	-4000	4000	289
chr19	15447624	15455624	15454810	8000	15451624	-4000	4000	3186
chr19	51708387	51716387	51714053	8000	51712387	-4000	4000	1666
chr19	11831216	11839216	11832646	8000	11835216	-4000	4000	-2570
chr19	52414412	52422412	52416857	8000	52418412	-4000	4000	-1555
chr19	50856764	50864764	50858550	8000	50860764	-4000	4000	-2214
chr19	48633946	48641946	48639388	8000	48637946	-4000	4000	1442
chr19	57531257	57539257	57538127	8000	57535257	-4000	4000	2870
chr19	17809576	17817576	17816993	8000	17813576	-4000	4000	3417
chr19	10508742	10516742	10514420	8000	10512742	-4000	4000	1678
chr19	40389766	40397766	40396210	8000	40393766	-4000	4000	2444
chr19	41303787	41311787	41310240	8000	41307787	-4000	4000	2453
chr19	47318066	47326066	47320471	8000	47322066	-4000	4000	-1595
chr19	48701951	48709951	48703553	8000	48705951	-4000	4000	-2398
chr19	9408429	9416429	9413338	8000	9412429	-4000	4000	909
chr19	9408429	9416429	9413582	8000	9412429	-4000	4000	1153
chr19	9849718	9857718	9854248	8000	9853718	-4000	4000	530
chr19	12313477	12321477	12318419	8000	12317477	-4000	4000	942
chr19	21800946	21808946	21807657	8000	21804946	-4000	4000	2711
chr19	50815146	50823146	50821892	8000	50819146	-4000	4000	2746
chr19	52109091	52117091	52116126	8000	52113091	-4000	4000	3035
chr19	7898021	7906021	7899419	8000	7902021	-4000	4000	-2602
chr19	44083318	44091318	44085854	8000	44087318	-4000	4000	-1464
chr19	52149864	52157864	52157181	8000	52153864	-4000	4000	3317
chr19	52414412	52422412	52416050	8000	52418412	-4000	4000	-2362
chr19	19641198	19649198	19645423	8000	19645198	-4000	4000	225
chr19	54269812	54277812	54276966	8000	54273812	-4000	4000	3154
chr19	50306542	50314542	50307092	8000	50310542	-4000	4000	-3450
chr19	57290069	57298069	57292269	8000	57294069	-4000	4000	-1800
chr19	50954631	50962631	50959107	8000	50958631	-4000	4000	476
chr19	35750519	35758519	35753180	8000	35754519	-4000	4000	-1339
chr19	57715751	57723751	57720908	8000	57719751	-4000	4000	1157
chr19	52793408	52801408	52800548	8000	52797408	-4000	4000	3140
chr19	54245003	54253003	54252923	8000	54249003	-4000	4000	3920
chr19	51944759	51952759	51944942	8000	51948759	-4000	4000	-3817
chr19	9408429	9416429	9413548	8000	9412429	-4000	4000	1119
chr19	20196488	20204488	20197824	8000	20200488	-4000	4000	-2664
chr19	6490319	6498319	6495809	8000	6494319	-4000	4000	1490
chr19	58363618	58371618	58368969	8000	58367618	-4000	4000	1351
chr19	56657980	56665980	56663969	8000	56661980	-4000	4000	1989
chr19	42230583	42238583	42234635	8000	42234583	-4000	4000	52
chr19	10089252	10097252	10090008	8000	10093252	-4000	4000	-3244
chr19	11975290	11983290	11978946	8000	11979290	-4000	4000	-344
chr19	50856764	50864764	50859785	8000	50860764	-4000	4000	-979
chr19	11780078	11788078	11780410	8000	11784078	-4000	4000	-3668
chr19	15447624	15455624	15452797	8000	15451624	-4000	4000	1173
chr19	34398413	34406413	34399224	8000	34402413	-4000	4000	-3189
chr19	40376439	40384439	40379508	8000	40380439	-4000	4000	-931
chr19	42424278	42432278	42427261	8000	42428278	-4000	4000	-1017
chr19	46462491	46470491	46468513	8000	46466491	-4000	4000	2022
chr19	52698813	52706813	52704847	8000	52702813	-4000	4000	2034
chr19	2991179	2999179	2997748	8000	2995179	-4000	4000	2569
chr19	43610498	43618498	43613108	8000	43614498	-4000	4000	-1390
chr19	55154661	55162661	55154763	8000	55158661	-4000	4000	-3898
chr19	36178276	36186276	36183601	8000	36182276	-4000	4000	1325
chr19	9408429	9416429	9413744	8000	9412429	-4000	4000	1315
chr19	46462491	46470491	46470131	8000	46466491	-4000	4000	3640
chr19	35734880	35742880	35737664	8000	35738880	-4000	4000	-1216
chr19	2226084	2234084	2233278	8000	2230084	-4000	4000	3194
chr19	45498513	45506513	45499226	8000	45502513	-4000	4000	-3287
chr19	37692371	37700371	37698130	8000	37696371	-4000	4000	1759
chr19	13100902	13108902	13107794	8000	13104902	-4000	4000	2892
chr19	17398939	17406939	17405464	8000	17402939	-4000	4000	2525
chr19	46339433	46347433	46339581	8000	46343433	-4000	4000	-3852
chr19	50972468	50980468	50977617	8000	50976468	-4000	4000	1149
chr19	53062606	53070606	53069540	8000	53066606	-4000	4000	2934
chr19	48292457	48300457	48297543	8000	48296457	-4000	4000	1086
chr19	51987332	51995332	51992828	8000	51991332	-4000	4000	1496
chr19	52321922	52329922	52322328	8000	52325922	-4000	4000	-3594
chr19	7627611	7635611	7631809	8000	7631611	-4000	4000	198
chr19	37126368	37134368	37127912	8000	37130368	-4000	4000	-2456
chr19	56215670	56223670	56223637	8000	56219670	-4000	4000	3967
chr19	11831216	11839216	11833123	8000	11835216	-4000	4000	-2093
chr19	50721708	50729708	50723473	8000	50725708	-4000	4000	-2235
chr19	45481294	45489294	45488641	8000	45485294	-4000	4000	3347
chr19	52698813	52706813	52704818	8000	52702813	-4000	4000	2005
chr19	52698813	52706813	52704381	8000	52702813	-4000	4000	1568
chr19	17820780	17828780	17826796	8000	17824780	-4000	4000	2016
chr19	42397514	42405514	42402926	8000	42401514	-4000	4000	1412
chr19	49709731	49717731	49711982	8000	49713731	-4000	4000	-1749
chr19	32825580	32833580	32830611	8000	32829580	-4000	4000	1031
chr19	52414412	52422412	52415125	8000	52418412	-4000	4000	-3287
chr19	43994326	44002326	43996229	8000	43998326	-4000	4000	-2097
chr19	51822190	51830190	51824263	8000	51826190	-4000	4000	-1927
chr19	52149864	52157864	52155354	8000	52153864	-4000	4000	1490
chr19	44009924	44017924	44010302	8000	44013924	-4000	4000	-3622
chr19	40376439	40384439	40383865	8000	40380439	-4000	4000	3426
chr19	52008765	52016765	52016620	8000	52012765	-4000	4000	3855
chr19	52414412	52422412	52415768	8000	52418412	-4000	4000	-2644
chr19	54598381	54606381	54599358	8000	54602381	-4000	4000	-3023
chr19	57589890	57597890	57591330	8000	57593890	-4000	4000	-2560
chr19	38405088	38413088	38412944	8000	38409088	-4000	4000	3856
chr19	8576240	8584240	8577375	8000	8580240	-4000	4000	-2865
chr19	44174381	44182381	44175471	8000	44178381	-4000	4000	-2910
chr19	11831216	11839216	11833021	8000	11835216	-4000	4000	-2195
chr19	44105886	44113886	44106294	8000	44109886	-4000	4000	-3592
chr19	57640041	57648041	57641902	8000	57644041	-4000	4000	-2139
chr19	4538593	4546593	4546236	8000	4542593	-4000	4000	3643
chr19	11831216	11839216	11833703	8000	11835216	-4000	4000	-1513
chr19	14071062	14079062	14074273	8000	14075062	-4000	4000	-789
chr19	17549839	17557839	17551977	8000	17553839	-4000	4000	-1862
chr19	37407155	37415155	37414043	8000	37411155	-4000	4000	2888
chr19	44174381	44182381	44176782	8000	44178381	-4000	4000	-1599
chr19	51367606	51375606	51371656	8000	51371606	-4000	4000	50
chr19	56435325	56443325	56441443	8000	56439325	-4000	4000	2118
chr19	9408429	9416429	9413637	8000	9412429	-4000	4000	1208
chr19	13137147	13145147	13137326	8000	13141147	-4000	4000	-3821
chr19	22663671	22671671	22664163	8000	22667671	-4000	4000	-3508
chr19	2929218	2937218	2933698	8000	2933218	-4000	4000	480
chr19	17549839	17557839	17553520	8000	17553839	-4000	4000	-319
chr19	44470428	44478428	44476617	8000	44474428	-4000	4000	2189
chr19	52027378	52035378	52034601	8000	52031378	-4000	4000	3223
chr19	54997142	55005142	55000845	8000	55001142	-4000	4000	-297
chr19	1477428	1485428	1482993	8000	1481428	-4000	4000	1565
chr19	48440931	48448931	48442209	8000	48444931	-4000	4000	-2722
chr19	49622439	49630439	49625192	8000	49626439	-4000	4000	-1247
chr19	6490319	6498319	6495765	8000	6494319	-4000	4000	1446
chr19	8370370	8378370	8371417	8000	8374370	-4000	4000	-2953
chr19	35734880	35742880	35738327	8000	35738880	-4000	4000	-553
chr19	43963709	43971709	43966489	8000	43967709	-4000	4000	-1220
chr19	6748160	6756160	6751226	8000	6752160	-4000	4000	-934
chr19	43359172	43367172	43362242	8000	43363172	-4000	4000	-930
chr19	40839541	40847541	40845373	8000	40843541	-4000	4000	1832
chr19	301573	309573	307133	8000	305573	-4000	4000	1560
chr19	11416604	11424604	11417048	8000	11420604	-4000	4000	-3556
chr19	40389766	40397766	40395217	8000	40393766	-4000	4000	1451
chr19	49522428	49530428	49525408	8000	49526428	-4000	4000	-1020
chr19	15447624	15455624	15448363	8000	15451624	-4000	4000	-3261
chr19	49709731	49717731	49710536	8000	49713731	-4000	4000	-3195
chr19	53576269	53584269	53577814	8000	53580269	-4000	4000	-2455
chr19	45498513	45506513	45499661	8000	45502513	-4000	4000	-2852
chr19	11361698	11369698	11364753	8000	11365698	-4000	4000	-945
chr19	37407155	37415155	37413353	8000	37411155	-4000	4000	2198
chr19	51327536	51335536	51328692	8000	51331536	-4000	4000	-2844
chr19	56435325	56443325	56442289	8000	56439325	-4000	4000	2964
chr19	38366943	38374943	38370616	8000	38370943	-4000	4000	-327
chr19	21287160	21295160	21294672	8000	21291160	-4000	4000	3512
chr19	41877372	41885372	41879597	8000	41881372	-4000	4000	-1775
chr19	57749575	57757575	57756969	8000	57753575	-4000	4000	3394
chr19	13878348	13886348	13880470	8000	13882348	-4000	4000	-1878
chr19	39859323	39867323	39866882	8000	39863323	-4000	4000	3559
chr19	37610179	37618179	37612346	8000	37614179	-4000	4000	-1833
chr19	55308562	55316562	55308647	8000	55312562	-4000	4000	-3915
chr19	8516778	8524778	8521228	8000	8520778	-4000	4000	450
chr19	13100902	13108902	13107616	8000	13104902	-4000	4000	2714
chr19	36994700	37002700	36997267	8000	36998700	-4000	4000	-1433
chr19	40389766	40397766	40394943	8000	40393766	-4000	4000	1177
chr19	52698813	52706813	52705571	8000	52702813	-4000	4000	2758
chr19	53062606	53070606	53068836	8000	53066606	-4000	4000	2230
chr19	11717265	11725265	11722091	8000	11721265	-4000	4000	826
chr19	13926879	13934879	13929414	8000	13930879	-4000	4000	-1465
chr19	51341169	51349169	51347006	8000	51345169	-4000	4000	1837
chr19	53576269	53584269	53577688	8000	53580269	-4000	4000	-2581
chr19	53576269	53584269	53577689	8000	53580269	-4000	4000	-2580
chr19	22175089	22183089	22180184	8000	22179089	-4000	4000	1095
chr19	40871439	40879439	40877270	8000	40875439	-4000	4000	1831
chr19	42374769	42382769	42376063	8000	42378769	-4000	4000	-2706
chr19	48701951	48709951	48703616	8000	48705951	-4000	4000	-2335
chr19	58363618	58371618	58368538	8000	58367618	-4000	4000	920
chr19	53231381	53239381	53238075	8000	53235381	-4000	4000	2694
chr19	32583453	32591453	32586076	8000	32587453	-4000	4000	-1377
chr19	52363778	52371778	52366374	8000	52367778	-4000	4000	-1404
chr19	57531257	57539257	57538309	8000	57535257	-4000	4000	3052
chr19	50972468	50980468	50980458	8000	50976468	-4000	4000	3990
chr19	58453833	58461833	58455806	8000	58457833	-4000	4000	-2027
chr19	38591273	38599273	38597540	8000	38595273	-4000	4000	2267
chr19	51018216	51026216	51023095	8000	51022216	-4000	4000	879
chr19	44271317	44279317	44274505	8000	44275317	-4000	4000	-812
chr19	2832735	2840735	2834044	8000	2836735	-4000	4000	-2691
chr19	48633946	48641946	48635348	8000	48637946	-4000	4000	-2598
chr19	57531257	57539257	57537486	8000	57535257	-4000	4000	2229
chr19	52698813	52706813	52704413	8000	52702813	-4000	4000	1600
chr19	4834341	4842341	4839167	8000	4838341	-4000	4000	826
chr19	6936459	6944459	6937645	8000	6940459	-4000	4000	-2814
chr19	11416604	11424604	11421760	8000	11420604	-4000	4000	1156
chr19	12341944	12349944	12349904	8000	12345944	-4000	4000	3960
chr19	17288131	17296131	17294350	8000	17292131	-4000	4000	2219
chr19	17784568	17792568	17784809	8000	17788568	-4000	4000	-3759
chr19	34741378	34749378	34741452	8000	34745378	-4000	4000	-3926
chr19	34754073	34762073	34759582	8000	34758073	-4000	4000	1509
chr19	58122248	58130248	58128782	8000	58126248	-4000	4000	2534
chr19	9378617	9386617	9381784	8000	9382617	-4000	4000	-833
chr19	48708725	48716725	48713738	8000	48712725	-4000	4000	1013
chr19	54586287	54594287	54594200	8000	54590287	-4000	4000	3913
chr19	49972468	49980468	49979141	8000	49976468	-4000	4000	2673
chr19	52321922	52329922	52322928	8000	52325922	-4000	4000	-2994
chr19	53062606	53070606	53068325	8000	53066606	-4000	4000	1719
chr19	53062606	53070606	53070210	8000	53066606	-4000	4000	3604
chr19	43618368	43626368	43623219	8000	43622368	-4000	4000	851
chr19	5862171	5870171	5867528	8000	5866171	-4000	4000	1357
chr19	3589541	3597541	3592207	8000	3593541	-4000	4000	-1334
chr19	7557764	7565764	7561697	8000	7561764	-4000	4000	-67
chr19	9378617	9386617	9380848	8000	9382617	-4000	4000	-1769
chr19	13878348	13886348	13880472	8000	13882348	-4000	4000	-1876
chr19	13878348	13886348	13880595	8000	13882348	-4000	4000	-1753
chr19	14071062	14079062	14074518	8000	14075062	-4000	4000	-544
chr19	19706472	19714472	19711456	8000	19710472	-4000	4000	984
chr19	32825580	32833580	32826137	8000	32829580	-4000	4000	-3443
chr19	34682397	34690397	34684678	8000	34686397	-4000	4000	-1719
chr19	36813428	36821428	36820032	8000	36817428	-4000	4000	2604
chr19	37610179	37618179	37611836	8000	37614179	-4000	4000	-2343
chr19	39859323	39867323	39863714	8000	39863323	-4000	4000	391
chr19	44174381	44182381	44176574	8000	44178381	-4000	4000	-1807
chr19	44233268	44241268	44236721	8000	44237268	-4000	4000	-547
chr19	47739134	47747134	47740914	8000	47743134	-4000	4000	-2220
chr19	51018216	51026216	51023184	8000	51022216	-4000	4000	968
chr19	52027378	52035378	52034767	8000	52031378	-4000	4000	3389
chr19	58363618	58371618	58367755	8000	58367618	-4000	4000	137
chr19	19508418	19516418	19516159	8000	19512418	-4000	4000	3741
chr19	2929218	2937218	2933363	8000	2933218	-4000	4000	145
chr19	16517352	16525352	16520530	8000	16521352	-4000	4000	-822
chr19	53062606	53070606	53068661	8000	53066606	-4000	4000	2055
chr19	11780078	11788078	11781340	8000	11784078	-4000	4000	-2738
chr19	14071062	14079062	14074436	8000	14075062	-4000	4000	-626
chr19	45302413	45310413	45307488	8000	45306413	-4000	4000	1075
chr19	44156313	44164313	44156759	8000	44160313	-4000	4000	-3554
chr19	18438663	18446663	18446379	8000	18442663	-4000	4000	3716
chr19	47516690	47524690	47521241	8000	47520690	-4000	4000	551
chr19	16475067	16483067	16482684	8000	16479067	-4000	4000	3617
chr19	47001077	47009077	47004730	8000	47005077	-4000	4000	-347
chr19	47318066	47326066	47320141	8000	47322066	-4000	4000	-1925
chr19	17809576	17817576	17816833	8000	17813576	-4000	4000	3257
chr19	11780078	11788078	11780192	8000	11784078	-4000	4000	-3886
chr19	15658825	15666825	15659289	8000	15662825	-4000	4000	-3536
chr19	17288131	17296131	17292774	8000	17292131	-4000	4000	643
chr19	21056050	21064050	21057291	8000	21060050	-4000	4000	-2759
chr19	22175089	22183089	22181488	8000	22179089	-4000	4000	2399
chr19	36178276	36186276	36182492	8000	36182276	-4000	4000	216
chr19	48633946	48641946	48639338	8000	48637946	-4000	4000	1392
chr19	48633946	48641946	48640207	8000	48637946	-4000	4000	2261
chr19	51606960	51614960	51612370	8000	51610960	-4000	4000	1410
chr19	55147767	55155767	55151842	8000	55151767	-4000	4000	75
chr19	58209562	58217562	58212831	8000	58213562	-4000	4000	-731
chr19	58453833	58461833	58455521	8000	58457833	-4000	4000	-2312
chr19	10482125	10490125	10489834	8000	10486125	-4000	4000	3709
chr19	51073495	51081495	51078152	8000	51077495	-4000	4000	657
chr19	54245003	54253003	54252426	8000	54249003	-4000	4000	3423
chr19	55670716	55678716	55677704	8000	55674716	-4000	4000	2988
chr19	58122248	58130248	58128502	8000	58126248	-4000	4000	2254
chr19	9378617	9386617	9381422	8000	9382617	-4000	4000	-1195
chr19	11615161	11623161	11616782	8000	11619161	-4000	4000	-2379
chr19	12642511	12650511	12646648	8000	12646511	-4000	4000	137
chr19	13759296	13767296	13764561	8000	13763296	-4000	4000	1265
chr19	15693174	15701174	15696929	8000	15697174	-4000	4000	-245
chr19	33204664	33212664	33210482	8000	33208664	-4000	4000	1818
chr19	34682397	34690397	34684016	8000	34686397	-4000	4000	-2381
chr19	40572464	40580464	40576060	8000	40576464	-4000	4000	-404
chr19	40572464	40580464	40577299	8000	40576464	-4000	4000	835
chr19	44130822	44138822	44131278	8000	44134822	-4000	4000	-3544
chr19	44945565	44953565	44948775	8000	44949565	-4000	4000	-790
chr19	49669916	49677916	49677280	8000	49673916	-4000	4000	3364
chr19	51132651	51140651	51136075	8000	51136651	-4000	4000	-576
chr19	56435325	56443325	56442633	8000	56439325	-4000	4000	3308
chr19	57258728	57266728	57261744	8000	57262728	-4000	4000	-984
chr19	58453833	58461833	58455763	8000	58457833	-4000	4000	-2070
chr19	45403334	45411334	45409608	8000	45407334	-4000	4000	2274
chr19	14946033	14954033	14953000	8000	14950033	-4000	4000	2967
chr19	36178276	36186276	36182594	8000	36182276	-4000	4000	318
chr19	34351566	34359566	34352814	8000	34355566	-4000	4000	-2752
chr19	34754073	34762073	34759057	8000	34758073	-4000	4000	984
chr19	38726187	38734187	38727040	8000	38730187	-4000	4000	-3147
chr19	38874555	38882555	38881151	8000	38878555	-4000	4000	2596
chr19	48633946	48641946	48638982	8000	48637946	-4000	4000	1036
chr19	50354477	50362477	50362065	8000	50358477	-4000	4000	3588
chr19	55154661	55162661	55157102	8000	55158661	-4000	4000	-1559
chr19	4265088	4273088	4268645	8000	4269088	-4000	4000	-443
chr19	40871439	40879439	40875841	8000	40875439	-4000	4000	402
chr19	55167196	55175196	55174547	8000	55171196	-4000	4000	3351
chr19	58551712	58559712	58556117	8000	58555712	-4000	4000	405
chr19	51367606	51375606	51372601	8000	51371606	-4000	4000	995
chr19	51944759	51952759	51945707	8000	51948759	-4000	4000	-3052
chr19	54245003	54253003	54252021	8000	54249003	-4000	4000	3018
chr19	39324353	39332353	39328406	8000	39328353	-4000	4000	53
chr19	11372951	11380951	11375752	8000	11376951	-4000	4000	-1199
chr19	32825580	32833580	32830523	8000	32829580	-4000	4000	943
chr19	29820312	29828312	29822550	8000	29824312	-4000	4000	-1762
chr19	32593006	32601006	32600044	8000	32597006	-4000	4000	3038
chr19	8061402	8069402	8062307	8000	8065402	-4000	4000	-3095
chr19	36909029	36917029	36916070	8000	36913029	-4000	4000	3041
chr19	58363618	58371618	58368542	8000	58367618	-4000	4000	924
chr19	29820312	29828312	29822588	8000	29824312	-4000	4000	-1724
chr19	4671224	4679224	4675342	8000	4675224	-4000	4000	118
chr19	2832735	2840735	2834361	8000	2836735	-4000	4000	-2374
chr19	35343361	35351361	35345653	8000	35347361	-4000	4000	-1708
chr19	22175089	22183089	22180460	8000	22179089	-4000	4000	1371
chr19	44271317	44279317	44274021	8000	44275317	-4000	4000	-1296
chr19	29201320	29209320	29207587	8000	29205320	-4000	4000	2267
chr19	42306814	42314814	42309679	8000	42310814	-4000	4000	-1135
chr19	56770547	56778547	56775402	8000	56774547	-4000	4000	855
chr19	36632618	36640618	36639774	8000	36636618	-4000	4000	3156
chr19	22663671	22671671	22664712	8000	22667671	-4000	4000	-2959
chr19	50049414	50057414	50050825	8000	50053414	-4000	4000	-2589
chr19	42230583	42238583	42234587	8000	42234583	-4000	4000	4
chr19	54634022	54642022	54635707	8000	54638022	-4000	4000	-2315
chr19	11372951	11380951	11375549	8000	11376951	-4000	4000	-1402
chr19	11831216	11839216	11832416	8000	11835216	-4000	4000	-2800
chr19	19890674	19898674	19891562	8000	19894674	-4000	4000	-3112
chr19	40871439	40879439	40875603	8000	40875439	-4000	4000	164
chr19	51341169	51349169	51345252	8000	51345169	-4000	4000	83
chr19	11780078	11788078	11780794	8000	11784078	-4000	4000	-3284
chr19	18565387	18573387	18569346	8000	18569387	-4000	4000	-41
chr19	36178276	36186276	36183460	8000	36182276	-4000	4000	1184
chr19	54634022	54642022	54635101	8000	54638022	-4000	4000	-2921
chr19	15447624	15455624	15454260	8000	15451624	-4000	4000	2636
chr19	36884124	36892124	36891676	8000	36888124	-4000	4000	3552
chr19	48043843	48051843	48048243	8000	48047843	-4000	4000	400
chr19	44271317	44279317	44273688	8000	44275317	-4000	4000	-1629
chr19	35875792	35883792	35879136	8000	35879792	-4000	4000	-656
chr19	13878348	13886348	13882831	8000	13882348	-4000	4000	483
chr19	34754073	34762073	34760550	8000	34758073	-4000	4000	2477
chr19	34941170	34949170	34944489	8000	34945170	-4000	4000	-681
chr19	36178276	36186276	36182797	8000	36182276	-4000	4000	521
chr19	39302566	39310566	39307787	8000	39306566	-4000	4000	1221
chr19	50856764	50864764	50859803	8000	50860764	-4000	4000	-961
chr19	11615161	11623161	11617740	8000	11619161	-4000	4000	-1421
chr19	43550692	43558692	43551580	8000	43554692	-4000	4000	-3112
chr19	51446847	51454847	51454757	8000	51450847	-4000	4000	3910
chr19	1778075	1786075	1784856	8000	1782075	-4000	4000	2781
chr19	36632618	36640618	36638764	8000	36636618	-4000	4000	2146
chr19	44083318	44091318	44086626	8000	44087318	-4000	4000	-692
chr19	42224201	42232201	42225542	8000	42228201	-4000	4000	-2659
chr19	54347384	54355384	54355369	8000	54351384	-4000	4000	3985
chr19	14087688	14095688	14088519	8000	14091688	-4000	4000	-3169
chr19	21718771	21726771	21726721	8000	21722771	-4000	4000	3950
chr19	41092195	41100195	41095812	8000	41096195	-4000	4000	-383
chr19	36178276	36186276	36183000	8000	36182276	-4000	4000	724
chr19	38591273	38599273	38597441	8000	38595273	-4000	4000	2168
chr19	53231381	53239381	53237194	8000	53235381	-4000	4000	1813
chr19	19141569	19149569	19146601	8000	19145569	-4000	4000	1032
chr19	40389766	40397766	40397287	8000	40393766	-4000	4000	3521
chr19	43456787	43464787	43461691	8000	43460787	-4000	4000	904
chr19	43848017	43856017	43848352	8000	43852017	-4000	4000	-3665
chr19	917005	925005	918593	8000	921005	-4000	4000	-2412
chr19	22663671	22671671	22664401	8000	22667671	-4000	4000	-3270
chr19	5862171	5870171	5867303	8000	5866171	-4000	4000	1132
chr19	8516778	8524778	8521266	8000	8520778	-4000	4000	488
chr19	47378704	47386704	47380855	8000	47382704	-4000	4000	-1849
chr19	58428814	58436814	58434912	8000	58432814	-4000	4000	2098
chr19	52225518	52233518	52225807	8000	52229518	-4000	4000	-3711
chr19	8516778	8524778	8522715	8000	8520778	-4000	4000	1937
chr19	18573550	18581550	18575073	8000	18577550	-4000	4000	-2477
chr19	2832735	2840735	2834254	8000	2836735	-4000	4000	-2481
chr19	18192784	18200784	18198826	8000	18196784	-4000	4000	2042
chr19	18192784	18200784	18200347	8000	18196784	-4000	4000	3563
chr19	22175089	22183089	22180733	8000	22179089	-4000	4000	1644
chr19	42306814	42314814	42314314	8000	42310814	-4000	4000	3500
chr19	54329185	54337185	54333605	8000	54333185	-4000	4000	420
chr19	56657980	56665980	56665096	8000	56661980	-4000	4000	3116
chr19	4532402	4540402	4534054	8000	4536402	-4000	4000	-2348
chr19	21800946	21808946	21807653	8000	21804946	-4000	4000	2707
chr19	44470428	44478428	44477930	8000	44474428	-4000	4000	3502
chr19	51051626	51059626	51058624	8000	51055626	-4000	4000	2998
chr19	55649161	55657161	55651383	8000	55653161	-4000	4000	-1778
chr19	48633946	48641946	48638954	8000	48637946	-4000	4000	1008
chr19	47216822	47224822	47221866	8000	47220822	-4000	4000	1044
chr19	15231519	15239519	15238233	8000	15235519	-4000	4000	2714
chr19	45403334	45411334	45409076	8000	45407334	-4000	4000	1742
chr19	53492255	53500255	53492264	8000	53496255	-4000	4000	-3991
chr19	51149526	51157526	51153153	8000	51153526	-4000	4000	-373
chr19	51606960	51614960	51612243	8000	51610960	-4000	4000	1283
chr19	8516778	8524778	8522487	8000	8520778	-4000	4000	1709
chr19	55177247	55185247	55181654	8000	55181247	-4000	4000	407
chr19	57355898	57363898	57357807	8000	57359898	-4000	4000	-2091
chr19	11195295	11203295	11202599	8000	11199295	-4000	4000	3304
chr19	11615161	11623161	11616828	8000	11619161	-4000	4000	-2333
chr19	11570660	11578660	11575246	8000	11574660	-4000	4000	586
chr19	12313477	12321477	12318419	8000	12317477	-4000	4000	942
chr19	44083318	44091318	44086125	8000	44087318	-4000	4000	-1193
chr19	22087480	22095480	22089578	8000	22091480	-4000	4000	-1902
chr19	35120513	35128513	35125477	8000	35124513	-4000	4000	964
chr19	15447624	15455624	15448268	8000	15451624	-4000	4000	-3356
chr19	55147767	55155767	55154173	8000	55151767	-4000	4000	2406
chr19	34225288	34233288	34228648	8000	34229288	-4000	4000	-640
chr19	35784822	35792822	35788401	8000	35788822	-4000	4000	-421
chr19	412589	420589	416932	8000	416589	-4000	4000	343
chr19	36994700	37002700	36997745	8000	36998700	-4000	4000	-955
chr19	42082110	42090110	42088775	8000	42086110	-4000	4000	2665
chr19	47001077	47009077	47004646	8000	47005077	-4000	4000	-431
chr19	47739134	47747134	47742867	8000	47743134	-4000	4000	-267
chr19	48292457	48300457	48297063	8000	48296457	-4000	4000	606
chr19	48633946	48641946	48639402	8000	48637946	-4000	4000	1456
chr19	44174381	44182381	44174785	8000	44178381	-4000	4000	-3596
chr19	58209562	58217562	58212769	8000	58213562	-4000	4000	-793
chr19	35784822	35792822	35785477	8000	35788822	-4000	4000	-3345
chr19	57589890	57597890	57591293	8000	57593890	-4000	4000	-2597
chr19	15658825	15666825	15659365	8000	15662825	-4000	4000	-3460
chr19	5838888	5846888	5843897	8000	5842888	-4000	4000	1009
chr19	40389766	40397766	40396375	8000	40393766	-4000	4000	2609
chr19	19248233	19256233	19250095	8000	19252233	-4000	4000	-2138
chr19	51008739	51016739	51016058	8000	51012739	-4000	4000	3319
chr19	3176332	3184332	3179504	8000	3180332	-4000	4000	-828
chr19	42424278	42432278	42427158	8000	42428278	-4000	4000	-1120
chr19	40389766	40397766	40395722	8000	40393766	-4000	4000	1956
chr19	54634022	54642022	54635775	8000	54638022	-4000	4000	-2247
chr19	19706472	19714472	19713013	8000	19710472	-4000	4000	2541
chr19	52381795	52389795	52385040	8000	52385795	-4000	4000	-755
chr19	6673704	6681704	6679161	8000	6677704	-4000	4000	1457
chr19	613159	621159	618747	8000	617159	-4000	4000	1588
chr19	2423638	2431638	2430866	8000	2427638	-4000	4000	3228
chr19	2929218	2937218	2934277	8000	2933218	-4000	4000	1059
chr19	2991179	2999179	2997925	8000	2995179	-4000	4000	2746
chr19	3773970	3781970	3779177	8000	3777970	-4000	4000	1207
chr19	4538593	4546593	4538698	8000	4542593	-4000	4000	-3895
chr19	4538593	4546593	4538889	8000	4542593	-4000	4000	-3704
chr19	7557764	7565764	7560668	8000	7561764	-4000	4000	-1096
chr19	9159424	9167424	9160218	8000	9163424	-4000	4000	-3206
chr19	9408429	9416429	9413214	8000	9412429	-4000	4000	785
chr19	10282615	10290615	10287127	8000	10286615	-4000	4000	512
chr19	11831216	11839216	11833532	8000	11835216	-4000	4000	-1684
chr19	12138090	12146090	12145480	8000	12142090	-4000	4000	3390
chr19	12313477	12321477	12321306	8000	12317477	-4000	4000	3829
chr19	13770282	13778282	13772210	8000	13774282	-4000	4000	-2072
chr19	14049218	14057218	14054838	8000	14053218	-4000	4000	1620
chr19	17517288	17525288	17520953	8000	17521288	-4000	4000	-335
chr19	17809576	17817576	17816719	8000	17813576	-4000	4000	3143
chr19	17820780	17828780	17826747	8000	17824780	-4000	4000	1967
chr19	19706472	19714472	19711549	8000	19710472	-4000	4000	1077
chr19	21800946	21808946	21808611	8000	21804946	-4000	4000	3665
chr19	29201320	29209320	29207517	8000	29205320	-4000	4000	2197
chr19	34422168	34430168	34426070	8000	34426168	-4000	4000	-98
chr19	34941170	34949170	34944542	8000	34945170	-4000	4000	-628
chr19	35139109	35147109	35141166	8000	35143109	-4000	4000	-1943
chr19	35447767	35455767	35450719	8000	35451767	-4000	4000	-1048
chr19	36234771	36242771	36237209	8000	36238771	-4000	4000	-1562
chr19	37126368	37134368	37128844	8000	37130368	-4000	4000	-1524
chr19	37389066	37397066	37389607	8000	37393066	-4000	4000	-3459
chr19	37610179	37618179	37611738	8000	37614179	-4000	4000	-2441
chr19	38405088	38413088	38405532	8000	38409088	-4000	4000	-3556
chr19	38583641	38591641	38584951	8000	38587641	-4000	4000	-2690
chr19	39405412	39413412	39408562	8000	39409412	-4000	4000	-850
chr19	40315536	40323536	40321947	8000	40319536	-4000	4000	2411
chr19	42224201	42232201	42225963	8000	42228201	-4000	4000	-2238
chr19	42424278	42432278	42426267	8000	42428278	-4000	4000	-2011
chr19	44174381	44182381	44176112	8000	44178381	-4000	4000	-2269
chr19	44233268	44241268	44234979	8000	44237268	-4000	4000	-2289
chr19	44470428	44478428	44476723	8000	44474428	-4000	4000	2295
chr19	44470428	44478428	44477296	8000	44474428	-4000	4000	2868
chr19	44470428	44478428	44477399	8000	44474428	-4000	4000	2971
chr19	48626030	48634030	48633710	8000	48630030	-4000	4000	3680
chr19	48716585	48724585	48720774	8000	48720585	-4000	4000	189
chr19	50815146	50823146	50819949	8000	50819146	-4000	4000	803
chr19	51018216	51026216	51024744	8000	51022216	-4000	4000	2528
chr19	51367606	51375606	51368536	8000	51371606	-4000	4000	-3070
chr19	51944759	51952759	51945539	8000	51948759	-4000	4000	-3220
chr19	51960340	51968340	51965802	8000	51964340	-4000	4000	1462
chr19	52027378	52035378	52034328	8000	52031378	-4000	4000	2950
chr19	52363778	52371778	52366789	8000	52367778	-4000	4000	-989
chr19	52414412	52422412	52416740	8000	52418412	-4000	4000	-1672
chr19	52793408	52801408	52799913	8000	52797408	-4000	4000	2505
chr19	55147767	55155767	55151807	8000	55151767	-4000	4000	40
chr19	55515099	55523099	55517832	8000	55519099	-4000	4000	-1267
chr19	55515099	55523099	55518066	8000	55519099	-4000	4000	-1033
chr19	56770547	56778547	56774847	8000	56774547	-4000	4000	300
chr19	57326770	57334770	57328489	8000	57330770	-4000	4000	-2281
chr19	57567566	57575566	57573565	8000	57571566	-4000	4000	1999
chr19	57589890	57597890	57591021	8000	57593890	-4000	4000	-2869
chr19	57973076	57981076	57979071	8000	57977076	-4000	4000	1995
chr19	58428814	58436814	58433408	8000	58432814	-4000	4000	594
chr19	58428814	58436814	58435194	8000	58432814	-4000	4000	2380
chr19	4538593	4546593	4538667	8000	4542593	-4000	4000	-3926
chr19	37484652	37492652	37485240	8000	37488652	-4000	4000	-3412
chr19	9378617	9386617	9381460	8000	9382617	-4000	4000	-1157
chr19	54634022	54642022	54635612	8000	54638022	-4000	4000	-2410
chr19	41092195	41100195	41094980	8000	41096195	-4000	4000	-1215
chr19	44756044	44764044	44756284	8000	44760044	-4000	4000	-3760
chr19	8061402	8069402	8066136	8000	8065402	-4000	4000	734
chr19	17288131	17296131	17294490	8000	17292131	-4000	4000	2359
chr19	1477428	1485428	1481715	8000	1481428	-4000	4000	287
chr19	6490319	6498319	6495526	8000	6494319	-4000	4000	1207
chr19	38863830	38871830	38869210	8000	38867830	-4000	4000	1380
chr19	23143221	23151221	23146263	8000	23147221	-4000	4000	-958
chr19	44796652	44804652	44800405	8000	44800652	-4000	4000	-247
chr19	6432079	6440079	6432204	8000	6436079	-4000	4000	-3875
chr19	39977764	39985764	39979836	8000	39981764	-4000	4000	-1928
chr19	11717265	11725265	11722690	8000	11721265	-4000	4000	1425
chr19	43642095	43650095	43646348	8000	43646095	-4000	4000	253
chr19	3176332	3184332	3179902	8000	3180332	-4000	4000	-430
chr19	36813428	36821428	36819722	8000	36817428	-4000	4000	2294
chr19	44233268	44241268	44236383	8000	44237268	-4000	4000	-885
chr19	50992018	51000018	50996103	8000	50996018	-4000	4000	85
chr19	36178276	36186276	36183140	8000	36182276	-4000	4000	864
chr19	56657980	56665980	56664920	8000	56661980	-4000	4000	2940
chr19	43963709	43971709	43966823	8000	43967709	-4000	4000	-886
chr19	46462491	46470491	46470318	8000	46466491	-4000	4000	3827
chr19	8505678	8513678	8512480	8000	8509678	-4000	4000	2802
chr19	38874555	38882555	38879289	8000	38878555	-4000	4000	734
chr19	37610179	37618179	37612355	8000	37614179	-4000	4000	-1824
chr19	42224201	42232201	42224788	8000	42228201	-4000	4000	-3413
chr19	2914473	2922473	2917352	8000	2918473	-4000	4000	-1121
chr19	5862171	5870171	5867038	8000	5866171	-4000	4000	867
chr19	6463221	6471221	6468030	8000	6467221	-4000	4000	809
chr19	6673704	6681704	6680206	8000	6677704	-4000	4000	2502
chr19	8516778	8524778	8521498	8000	8520778	-4000	4000	720
chr19	9159424	9167424	9160928	8000	9163424	-4000	4000	-2496
chr19	9955561	9963561	9960540	8000	9959561	-4000	4000	979
chr19	11361698	11369698	11364730	8000	11365698	-4000	4000	-968
chr19	11416604	11424604	11420813	8000	11420604	-4000	4000	209
chr19	11615161	11623161	11617050	8000	11619161	-4000	4000	-2111
chr19	11717265	11725265	11722491	8000	11721265	-4000	4000	1226
chr19	11780078	11788078	11780795	8000	11784078	-4000	4000	-3283
chr19	11780078	11788078	11781044	8000	11784078	-4000	4000	-3034
chr19	11780078	11788078	11781853	8000	11784078	-4000	4000	-2225
chr19	11805622	11813622	11806476	8000	11809622	-4000	4000	-3146
chr19	11805622	11813622	11806980	8000	11809622	-4000	4000	-2642
chr19	11831216	11839216	11831490	8000	11835216	-4000	4000	-3726
chr19	12138090	12146090	12145311	8000	12142090	-4000	4000	3221
chr19	12457559	12465559	12464028	8000	12461559	-4000	4000	2469
chr19	12457559	12465559	12464990	8000	12461559	-4000	4000	3431
chr19	14049218	14057218	14050832	8000	14053218	-4000	4000	-2386
chr19	15054293	15062293	15055211	8000	15058293	-4000	4000	-3082
chr19	18054995	18062995	18062184	8000	18058995	-4000	4000	3189
chr19	19706472	19714472	19711810	8000	19710472	-4000	4000	1338
chr19	21056050	21064050	21056803	8000	21060050	-4000	4000	-3247
chr19	21287160	21295160	21294663	8000	21291160	-4000	4000	3503
chr19	22087480	22095480	22088217	8000	22091480	-4000	4000	-3263
chr19	22175089	22183089	22180914	8000	22179089	-4000	4000	1825
chr19	22387019	22395019	22391360	8000	22391019	-4000	4000	341
chr19	23218755	23226755	23223943	8000	23222755	-4000	4000	1188
chr19	24125968	24133968	24127697	8000	24129968	-4000	4000	-2271
chr19	29201320	29209320	29207837	8000	29205320	-4000	4000	2517
chr19	32974592	32982592	32976606	8000	32978592	-4000	4000	-1986
chr19	32974592	32982592	32980158	8000	32978592	-4000	4000	1566
chr19	34682397	34690397	34685287	8000	34686397	-4000	4000	-1110
chr19	34952354	34960354	34958313	8000	34956354	-4000	4000	1959
chr19	34952354	34960354	34960332	8000	34956354	-4000	4000	3978
chr19	35343361	35351361	35346602	8000	35347361	-4000	4000	-759
chr19	35447767	35455767	35450755	8000	35451767	-4000	4000	-1012
chr19	35875792	35883792	35877813	8000	35879792	-4000	4000	-1979
chr19	35875792	35883792	35879074	8000	35879792	-4000	4000	-718
chr19	36101108	36109108	36103364	8000	36105108	-4000	4000	-1744
chr19	37407155	37415155	37413786	8000	37411155	-4000	4000	2631
chr19	37610179	37618179	37613160	8000	37614179	-4000	4000	-1019
chr19	37692371	37700371	37698389	8000	37696371	-4000	4000	2018
chr19	40065152	40073152	40072868	8000	40069152	-4000	4000	3716
chr19	41421001	41429001	41424599	8000	41425001	-4000	4000	-402
chr19	41877372	41885372	41879578	8000	41881372	-4000	4000	-1794
chr19	43359172	43367172	43361185	8000	43363172	-4000	4000	-1987
chr19	43868365	43876365	43872437	8000	43872365	-4000	4000	72
chr19	43868365	43876365	43873286	8000	43872365	-4000	4000	921
chr19	43908624	43916624	43913531	8000	43912624	-4000	4000	907
chr19	44083318	44091318	44086162	8000	44087318	-4000	4000	-1156
chr19	44470428	44478428	44476523	8000	44474428	-4000	4000	2095
chr19	47318066	47326066	47320711	8000	47322066	-4000	4000	-1355
chr19	48292457	48300457	48297325	8000	48296457	-4000	4000	868
chr19	48701951	48709951	48703932	8000	48705951	-4000	4000	-2019
chr19	48833097	48841097	48837541	8000	48837097	-4000	4000	444
chr19	48964130	48972130	48966708	8000	48968130	-4000	4000	-1422
chr19	49709731	49717731	49710423	8000	49713731	-4000	4000	-3308
chr19	50856764	50864764	50858213	8000	50860764	-4000	4000	-2551
chr19	50902351	50910351	50908217	8000	50906351	-4000	4000	1866
chr19	51944759	51952759	51945310	8000	51948759	-4000	4000	-3449
chr19	51960340	51968340	51965692	8000	51964340	-4000	4000	1352
chr19	51987332	51995332	51994617	8000	51991332	-4000	4000	3285
chr19	52008765	52016765	52016510	8000	52012765	-4000	4000	3745
chr19	52027378	52035378	52033745	8000	52031378	-4000	4000	2367
chr19	52109091	52117091	52114665	8000	52113091	-4000	4000	1574
chr19	52109091	52117091	52116659	8000	52113091	-4000	4000	3568
chr19	52149864	52157864	52156046	8000	52153864	-4000	4000	2182
chr19	52321922	52329922	52322170	8000	52325922	-4000	4000	-3752
chr19	52321922	52329922	52322506	8000	52325922	-4000	4000	-3416
chr19	52363778	52371778	52365911	8000	52367778	-4000	4000	-1867
chr19	52414412	52422412	52415550	8000	52418412	-4000	4000	-2862
chr19	52414412	52422412	52415687	8000	52418412	-4000	4000	-2725
chr19	52414412	52422412	52416527	8000	52418412	-4000	4000	-1885
chr19	52856851	52864851	52864124	8000	52860851	-4000	4000	3273
chr19	54212278	54220278	54216931	8000	54216278	-4000	4000	653
chr19	54212278	54220278	54219197	8000	54216278	-4000	4000	2919
chr19	54303070	54311070	54307667	8000	54307070	-4000	4000	597
chr19	56215670	56223670	56222689	8000	56219670	-4000	4000	3019
chr19	56552808	56560808	56553981	8000	56556808	-4000	4000	-2827
chr19	56552808	56560808	56554291	8000	56556808	-4000	4000	-2517
chr19	56657980	56665980	56665177	8000	56661980	-4000	4000	3197
chr19	57954437	57962437	57958702	8000	57958437	-4000	4000	265
chr19	57973076	57981076	57978665	8000	57977076	-4000	4000	1589
chr19	57973076	57981076	57979621	8000	57977076	-4000	4000	2545
chr19	58122248	58130248	58128836	8000	58126248	-4000	4000	2588
chr19	58209562	58217562	58212749	8000	58213562	-4000	4000	-813
chr19	11717265	11725265	11721894	8000	11721265	-4000	4000	629
chr19	11975290	11983290	11979938	8000	11979290	-4000	4000	648
chr19	15155038	15163038	15160569	8000	15159038	-4000	4000	1531
chr19	16475067	16483067	16482557	8000	16479067	-4000	4000	3490
chr19	20946697	20954697	20949765	8000	20950697	-4000	4000	-932
chr19	21800946	21808946	21807724	8000	21804946	-4000	4000	2778
chr19	52027378	52035378	52034664	8000	52031378	-4000	4000	3286
chr19	52149864	52157864	52155376	8000	52153864	-4000	4000	1512
chr19	57640041	57648041	57641239	8000	57644041	-4000	4000	-2802
chr19	57620724	57628724	57621456	8000	57624724	-4000	4000	-3268
chr19	39859323	39867323	39863364	8000	39863323	-4000	4000	41
chr19	3589541	3597541	3592297	8000	3593541	-4000	4000	-1244
chr19	58079838	58087838	58086321	8000	58083838	-4000	4000	2483
chr19	54303070	54311070	54307647	8000	54307070	-4000	4000	577
chr19	11361698	11369698	11363820	8000	11365698	-4000	4000	-1878
chr19	6490319	6498319	6495875	8000	6494319	-4000	4000	1556
chr19	40389766	40397766	40396671	8000	40393766	-4000	4000	2905
chr19	12138090	12146090	12145892	8000	12142090	-4000	4000	3802
chr19	15447624	15455624	15451897	8000	15451624	-4000	4000	273
chr19	37389066	37397066	37389824	8000	37393066	-4000	4000	-3242
chr19	57640041	57648041	57640947	8000	57644041	-4000	4000	-3094
chr19	38405088	38413088	38412989	8000	38409088	-4000	4000	3901
chr19	48791062	48799062	48795227	8000	48795062	-4000	4000	165
chr19	401445	409445	407162	8000	405445	-4000	4000	1717
chr19	20946697	20954697	20949595	8000	20950697	-4000	4000	-1102
chr19	55308562	55316562	55312980	8000	55312562	-4000	4000	418
chr19	42291797	42299797	42294898	8000	42295797	-4000	4000	-899
chr19	36178276	36186276	36182950	8000	36182276	-4000	4000	674
chr19	47739134	47747134	47741138	8000	47743134	-4000	4000	-1996
chr19	53231381	53239381	53237795	8000	53235381	-4000	4000	2414
chr19	11570660	11578660	11575160	8000	11574660	-4000	4000	500
chr19	11831216	11839216	11831924	8000	11835216	-4000	4000	-3292
chr19	42082110	42090110	42088767	8000	42086110	-4000	4000	2657
chr19	44130822	44138822	44132018	8000	44134822	-4000	4000	-2804
chr19	51025092	51033092	51029226	8000	51029092	-4000	4000	134
chr19	51051626	51059626	51058642	8000	51055626	-4000	4000	3016
chr19	5862171	5870171	5866879	8000	5866171	-4000	4000	708
chr19	37731833	37739833	37738469	8000	37735833	-4000	4000	2636
chr19	50721708	50729708	50723535	8000	50725708	-4000	4000	-2173
chr19	56215670	56223670	56221464	8000	56219670	-4000	4000	1794
chr19	2929218	2937218	2934638	8000	2933218	-4000	4000	1420
chr19	48633946	48641946	48639787	8000	48637946	-4000	4000	1841
chr19	24125968	24133968	24127968	8000	24129968	-4000	4000	-2000
chr19	52008765	52016765	52015618	8000	52012765	-4000	4000	2853
chr19	55515099	55523099	55518088	8000	55519099	-4000	4000	-1011
chr19	35750519	35758519	35754133	8000	35754519	-4000	4000	-386
chr19	46157298	46165298	46161266	8000	46161298	-4000	4000	-32
chr19	53062606	53070606	53068340	8000	53066606	-4000	4000	1734
chr19	35784822	35792822	35785321	8000	35788822	-4000	4000	-3501
chr19	44174381	44182381	44176654	8000	44178381	-4000	4000	-1727
chr19	54634022	54642022	54636637	8000	54638022	-4000	4000	-1385
chr19	36632618	36640618	36639449	8000	36636618	-4000	4000	2831
chr19	51008739	51016739	51014600	8000	51012739	-4000	4000	1861
chr19	55147767	55155767	55148023	8000	55151767	-4000	4000	-3744
chr19	52414412	52422412	52416401	8000	52418412	-4000	4000	-2011
chr19	57326770	57334770	57328603	8000	57330770	-4000	4000	-2167
chr19	44130822	44138822	44131038	8000	44134822	-4000	4000	-3784
chr19	52793408	52801408	52801143	8000	52797408	-4000	4000	3735
chr19	971939	979939	972706	8000	975939	-4000	4000	-3233
chr19	37126368	37134368	37128278	8000	37130368	-4000	4000	-2090
chr19	38591273	38599273	38597337	8000	38595273	-4000	4000	2064
chr19	16475067	16483067	16482711	8000	16479067	-4000	4000	3644
chr19	52698813	52706813	52706037	8000	52702813	-4000	4000	3224
chr19	38813471	38821471	38817182	8000	38817471	-4000	4000	-289
chr19	11831216	11839216	11834356	8000	11835216	-4000	4000	-860
chr19	11910329	11918329	11913618	8000	11914329	-4000	4000	-711
chr19	50856764	50864764	50858591	8000	50860764	-4000	4000	-2173
chr19	20946697	20954697	20949257	8000	20950697	-4000	4000	-1440
chr19	8505678	8513678	8512415	8000	8509678	-4000	4000	2737
chr19	15447624	15455624	15454500	8000	15451624	-4000	4000	2876
chr19	15447624	15455624	15454717	8000	15451624	-4000	4000	3093
chr19	19706472	19714472	19711123	8000	19710472	-4000	4000	651
chr19	32974592	32982592	32980064	8000	32978592	-4000	4000	1472
chr19	37610179	37618179	37613459	8000	37614179	-4000	4000	-720
chr19	37731833	37739833	37739417	8000	37735833	-4000	4000	3584
chr19	43908624	43916624	43914110	8000	43912624	-4000	4000	1486
chr19	44130822	44138822	44131611	8000	44134822	-4000	4000	-3211
chr19	48440931	48448931	48442318	8000	48444931	-4000	4000	-2613
chr19	51341169	51349169	51346977	8000	51345169	-4000	4000	1808
chr19	52008765	52016765	52015919	8000	52012765	-4000	4000	3154
chr19	53231381	53239381	53237915	8000	53235381	-4000	4000	2534
chr19	53352906	53360906	53354343	8000	53356906	-4000	4000	-2563
chr19	54598381	54606381	54600725	8000	54602381	-4000	4000	-1656
chr19	54634022	54642022	54636924	8000	54638022	-4000	4000	-1098
chr19	54245003	54253003	54252503	8000	54249003	-4000	4000	3500
chr19	18667721	18675721	18668970	8000	18671721	-4000	4000	-2751
chr19	11195295	11203295	11200929	8000	11199295	-4000	4000	1634
chr19	11361698	11369698	11364640	8000	11365698	-4000	4000	-1058
chr19	1477428	1485428	1482438	8000	1481428	-4000	4000	1010
chr19	46406329	46414329	46412571	8000	46410329	-4000	4000	2242
chr19	14049218	14057218	14054871	8000	14053218	-4000	4000	1653
chr19	37126368	37134368	37128298	8000	37130368	-4000	4000	-2070
chr19	37389066	37397066	37389927	8000	37393066	-4000	4000	-3139
chr19	2991179	2999179	2994073	8000	2995179	-4000	4000	-1106
chr19	20946697	20954697	20948928	8000	20950697	-4000	4000	-1769
chr19	46406329	46414329	46411032	8000	46410329	-4000	4000	703
chr19	12138090	12146090	12145542	8000	12142090	-4000	4000	3452
chr19	12759003	12767003	12763425	8000	12763003	-4000	4000	422
chr19	12759003	12767003	12763426	8000	12763003	-4000	4000	423
chr19	34741378	34749378	34741707	8000	34745378	-4000	4000	-3671
chr19	5862171	5870171	5867197	8000	5866171	-4000	4000	1026
chr19	43359172	43367172	43362097	8000	43363172	-4000	4000	-1075
chr19	58338332	58346332	58339621	8000	58342332	-4000	4000	-2711
chr19	15447624	15455624	15454182	8000	15451624	-4000	4000	2558
chr19	12138090	12146090	12145947	8000	12142090	-4000	4000	3857
chr19	18192784	18200784	18198850	8000	18196784	-4000	4000	2066
chr19	18617039	18625039	18618230	8000	18621039	-4000	4000	-2809
chr19	41752737	41760737	41755633	8000	41756737	-4000	4000	-1104
chr19	48633946	48641946	48639797	8000	48637946	-4000	4000	1851
chr19	51025092	51033092	51031918	8000	51029092	-4000	4000	2826
chr19	52414412	52422412	52415870	8000	52418412	-4000	4000	-2542
chr19	54212278	54220278	54219163	8000	54216278	-4000	4000	2885
chr19	54598381	54606381	54600885	8000	54602381	-4000	4000	-1496
chr19	55154661	55162661	55159217	8000	55158661	-4000	4000	556
chr19	11975290	11983290	11978743	8000	11979290	-4000	4000	-547
chr19	21800946	21808946	21808350	8000	21804946	-4000	4000	3404
chr19	57567566	57575566	57572172	8000	57571566	-4000	4000	606
chr19	8844844	8852844	8851284	8000	8848844	-4000	4000	2440
chr19	43618368	43626368	43625078	8000	43622368	-4000	4000	2710
chr19	4532402	4540402	4538455	8000	4536402	-4000	4000	2053
chr19	48440931	48448931	48442251	8000	48444931	-4000	4000	-2680
chr19	57290069	57298069	57290834	8000	57294069	-4000	4000	-3235
chr19	51008739	51016739	51009276	8000	51012739	-4000	4000	-3463
chr19	57326770	57334770	57329183	8000	57330770	-4000	4000	-1587
chr19	52008765	52016765	52016188	8000	52012765	-4000	4000	3423
chr19	12313477	12321477	12318369	8000	12317477	-4000	4000	892
chr19	45403334	45411334	45409517	8000	45407334	-4000	4000	2183
chr19	2832735	2840735	2834601	8000	2836735	-4000	4000	-2134
chr19	37407155	37415155	37413873	8000	37411155	-4000	4000	2718
chr19	44470428	44478428	44476639	8000	44474428	-4000	4000	2211
chr19	46406329	46414329	46411348	8000	46410329	-4000	4000	1019
chr19	6490319	6498319	6495758	8000	6494319	-4000	4000	1439
chr19	34398413	34406413	34400147	8000	34402413	-4000	4000	-2266
chr19	56371846	56379846	56377096	8000	56375846	-4000	4000	1250
chr19	11975290	11983290	11980126	8000	11979290	-4000	4000	836
chr19	44105886	44113886	44107986	8000	44109886	-4000	4000	-1900
chr19	46406329	46414329	46411242	8000	46410329	-4000	4000	913
chr19	34754073	34762073	34759677	8000	34758073	-4000	4000	1604
chr19	40572464	40580464	40575631	8000	40576464	-4000	4000	-833
chr19	34682397	34690397	34684984	8000	34686397	-4000	4000	-1413
chr19	1872810	1880810	1877566	8000	1876810	-4000	4000	756
chr19	12138090	12146090	12145355	8000	12142090	-4000	4000	3265
chr19	22663671	22671671	22665107	8000	22667671	-4000	4000	-2564
chr19	38874555	38882555	38879629	8000	38878555	-4000	4000	1074
chr19	50427314	50435314	50428240	8000	50431314	-4000	4000	-3074
chr19	57531257	57539257	57538637	8000	57535257	-4000	4000	3380
chr19	9378617	9386617	9381883	8000	9382617	-4000	4000	-734
chr19	44233268	44241268	44234817	8000	44237268	-4000	4000	-2451
chr19	51960340	51968340	51965299	8000	51964340	-4000	4000	959
chr19	52793408	52801408	52800654	8000	52797408	-4000	4000	3246
chr19	57326770	57334770	57328514	8000	57330770	-4000	4000	-2256
chr19	32974592	32982592	32980029	8000	32978592	-4000	4000	1437
chr19	45403334	45411334	45409519	8000	45407334	-4000	4000	2185
chr19	52698813	52706813	52706184	8000	52702813	-4000	4000	3371
chr19	37407155	37415155	37413127	8000	37411155	-4000	4000	1972
chr19	12138090	12146090	12140266	8000	12142090	-4000	4000	-1824
chr19	46406329	46414329	46411577	8000	46410329	-4000	4000	1248
chr19	5826408	5834408	5832180	8000	5830408	-4000	4000	1772
chr19	44470428	44478428	44477294	8000	44474428	-4000	4000	2866
chr19	16686023	16694023	16688291	8000	16690023	-4000	4000	-1732
chr19	37126368	37134368	37129170	8000	37130368	-4000	4000	-1198
chr19	37389066	37397066	37389628	8000	37393066	-4000	4000	-3438
chr19	37731833	37739833	37739630	8000	37735833	-4000	4000	3797
chr19	38726187	38734187	38727011	8000	38730187	-4000	4000	-3176
chr19	44009924	44017924	44010850	8000	44013924	-4000	4000	-3074
chr19	51025092	51033092	51029442	8000	51029092	-4000	4000	350
chr19	54586287	54594287	54587244	8000	54590287	-4000	4000	-3043
chr19	15447624	15455624	15452741	8000	15451624	-4000	4000	1117
chr19	35875792	35883792	35878644	8000	35879792	-4000	4000	-1148
chr19	4320043	4328043	4325398	8000	4324043	-4000	4000	1355
chr19	32593006	32601006	32600028	8000	32597006	-4000	4000	3022
chr19	39405412	39413412	39408710	8000	39409412	-4000	4000	-702
chr19	51708387	51716387	51713986	8000	51712387	-4000	4000	1599
chr19	43762533	43770533	43769439	8000	43766533	-4000	4000	2906
chr19	44130822	44138822	44131202	8000	44134822	-4000	4000	-3620
chr19	35519367	35527367	35526854	8000	35523367	-4000	4000	3487
chr19	18617039	18625039	18618482	8000	18621039	-4000	4000	-2557
chr19	9408429	9416429	9414543	8000	9412429	-4000	4000	2114
chr19	51708387	51716387	51714088	8000	51712387	-4000	4000	1701
chr19	44105886	44113886	44107750	8000	44109886	-4000	4000	-2136
chr19	1778075	1786075	1785558	8000	1782075	-4000	4000	3483
chr19	6432079	6440079	6432149	8000	6436079	-4000	4000	-3930
chr19	58428814	58436814	58434919	8000	58432814	-4000	4000	2105
chr19	4320043	4328043	4325449	8000	4324043	-4000	4000	1406
chr19	11780078	11788078	11780829	8000	11784078	-4000	4000	-3249
chr19	51018216	51026216	51023827	8000	51022216	-4000	4000	1611
chr19	51960340	51968340	51966081	8000	51964340	-4000	4000	1741
chr19	43359172	43367172	43360293	8000	43363172	-4000	4000	-2879
chr19	22175089	22183089	22179738	8000	22179089	-4000	4000	649
chr19	1778075	1786075	1783050	8000	1782075	-4000	4000	975
chr19	4538593	4546593	4538646	8000	4542593	-4000	4000	-3947
chr19	18573550	18581550	18575293	8000	18577550	-4000	4000	-2257
chr19	18617039	18625039	18620450	8000	18621039	-4000	4000	-589
chr19	22663671	22671671	22664466	8000	22667671	-4000	4000	-3205
chr19	6657253	6665253	6665211	8000	6661253	-4000	4000	3958
chr19	42224201	42232201	42226246	8000	42228201	-4000	4000	-1955
chr19	11160270	11168270	11166596	8000	11164270	-4000	4000	2326
chr19	37610179	37618179	37613150	8000	37614179	-4000	4000	-1029
chr19	14049218	14057218	14050874	8000	14053218	-4000	4000	-2344
chr19	43908624	43916624	43913392	8000	43912624	-4000	4000	768
chr19	51960340	51968340	51965468	8000	51964340	-4000	4000	1128
chr19	56657980	56665980	56664880	8000	56661980	-4000	4000	2900
chr19	8061402	8069402	8062265	8000	8065402	-4000	4000	-3137
chr19	11717265	11725265	11722524	8000	11721265	-4000	4000	1259
chr19	35750519	35758519	35752315	8000	35754519	-4000	4000	-2204
chr19	52698813	52706813	52706230	8000	52702813	-4000	4000	3417
chr19	48791062	48799062	48796430	8000	48795062	-4000	4000	1368
chr19	52027378	52035378	52034886	8000	52031378	-4000	4000	3508
chr19	53231381	53239381	53237951	8000	53235381	-4000	4000	2570
chr19	41203539	41211539	41206017	8000	41207539	-4000	4000	-1522
chr19	50902351	50910351	50907023	8000	50906351	-4000	4000	672
chr19	57973076	57981076	57978587	8000	57977076	-4000	4000	1511
chr19	51822190	51830190	51823909	8000	51826190	-4000	4000	-2281
chr19	39859323	39867323	39866827	8000	39863323	-4000	4000	3504
chr19	16888606	16896606	16893183	8000	16892606	-4000	4000	577
chr19	42374769	42382769	42376356	8000	42378769	-4000	4000	-2413
chr19	52027378	52035378	52035215	8000	52031378	-4000	4000	3837
chr19	52027378	52035378	52035333	8000	52031378	-4000	4000	3955
chr19	52149864	52157864	52155029	8000	52153864	-4000	4000	1165
chr19	11975290	11983290	11979943	8000	11979290	-4000	4000	653
chr19	7557764	7565764	7561764	8000	7561764	-4000	4000	0
chr19	3764575	3772575	3771700	8000	3768575	-4000	4000	3125
chr19	9955561	9963561	9960877	8000	9959561	-4000	4000	1316
chr19	12313477	12321477	12317991	8000	12317477	-4000	4000	514
chr19	12341944	12349944	12349763	8000	12345944	-4000	4000	3819
chr19	24125968	24133968	24126867	8000	24129968	-4000	4000	-3101
chr19	33126542	33134542	33130362	8000	33130542	-4000	4000	-180
chr19	35674483	35682483	35675978	8000	35678483	-4000	4000	-2505
chr19	36813428	36821428	36818674	8000	36817428	-4000	4000	1246
chr19	37389066	37397066	37389078	8000	37393066	-4000	4000	-3988
chr19	41092195	41100195	41095960	8000	41096195	-4000	4000	-235
chr19	43642095	43650095	43649069	8000	43646095	-4000	4000	2974
chr19	43963709	43971709	43967155	8000	43967709	-4000	4000	-554
chr19	44130822	44138822	44131962	8000	44134822	-4000	4000	-2860
chr19	46406329	46414329	46412107	8000	46410329	-4000	4000	1778
chr19	51960340	51968340	51965015	8000	51964340	-4000	4000	675
chr19	51987332	51995332	51993089	8000	51991332	-4000	4000	1757
chr19	52414412	52422412	52415356	8000	52418412	-4000	4000	-3056
chr19	52698813	52706813	52705471	8000	52702813	-4000	4000	2658
chr19	18667721	18675721	18668841	8000	18671721	-4000	4000	-2880
chr19	47471150	47479150	47477774	8000	47475150	-4000	4000	2624
chr19	42306814	42314814	42310368	8000	42310814	-4000	4000	-446
chr19	18054995	18062995	18062218	8000	18058995	-4000	4000	3223
chr19	41303787	41311787	41310279	8000	41307787	-4000	4000	2492
chr19	57973076	57981076	57978573	8000	57977076	-4000	4000	1497
chr19	22175089	22183089	22180297	8000	22179089	-4000	4000	1208
chr19	39424415	39432415	39425462	8000	39428415	-4000	4000	-2953
chr19	8400434	8408434	8403619	8000	8404434	-4000	4000	-815
chr19	14049218	14057218	14055213	8000	14053218	-4000	4000	1995
chr19	33204664	33212664	33208880	8000	33208664	-4000	4000	216
chr19	33204664	33212664	33209305	8000	33208664	-4000	4000	641
chr19	34952354	34960354	34958226	8000	34956354	-4000	4000	1872
chr19	40417589	40425589	40422975	8000	40421589	-4000	4000	1386
chr19	41014398	41022398	41016674	8000	41018398	-4000	4000	-1724
chr19	42306814	42314814	42314323	8000	42310814	-4000	4000	3509
chr19	42424278	42432278	42428963	8000	42428278	-4000	4000	685
chr19	49522428	49530428	49525326	8000	49526428	-4000	4000	-1102
chr19	49709731	49717731	49711795	8000	49713731	-4000	4000	-1936
chr19	51588510	51596510	51592916	8000	51592510	-4000	4000	406
chr19	51822190	51830190	51825748	8000	51826190	-4000	4000	-442
chr19	55515099	55523099	55518228	8000	55519099	-4000	4000	-871
chr19	57326770	57334770	57328825	8000	57330770	-4000	4000	-1945
chr19	30012612	30020612	30015007	8000	30016612	-4000	4000	-1605
chr19	46157298	46165298	46160686	8000	46161298	-4000	4000	-612
chr19	46462491	46470491	46469802	8000	46466491	-4000	4000	3311
chr19	57326770	57334770	57327940	8000	57330770	-4000	4000	-2830
chr19	21056050	21064050	21056848	8000	21060050	-4000	4000	-3202
chr19	35165881	35173881	35166380	8000	35169881	-4000	4000	-3501
chr19	52698813	52706813	52704413	8000	52702813	-4000	4000	1600
chr20	36647766	36655766	36653622	8000	36651766	-4000	4000	1856
chr20	50999656	51007656	51004544	8000	51003656	-4000	4000	888
chr20	45881266	45889266	45884746	8000	45885266	-4000	4000	-520
chr20	57644392	57652392	57651609	8000	57648392	-4000	4000	3217
chr20	13296651	13304651	13299483	8000	13300651	-4000	4000	-1168
chr20	35697347	35705347	35705232	8000	35701347	-4000	4000	3885
chr20	44938130	44946130	44943456	8000	44942130	-4000	4000	1326
chr20	17480578	17488578	17481637	8000	17484578	-4000	4000	-2941
chr20	18184387	18192387	18184703	8000	18188387	-4000	4000	-3684
chr20	23369062	23377062	23369596	8000	23373062	-4000	4000	-3466
chr20	31602515	31610515	31606051	8000	31606515	-4000	4000	-464
chr20	41356582	41364582	41362332	8000	41360582	-4000	4000	1750
chr20	56402362	56410362	56403640	8000	56406362	-4000	4000	-2722
chr20	61949469	61957469	61953607	8000	61953469	-4000	4000	138
chr20	33019703	33027703	33020391	8000	33023703	-4000	4000	-3312
chr20	37097226	37105226	37102788	8000	37101226	-4000	4000	1562
chr20	14318985	14326985	14325231	8000	14322985	-4000	4000	2246
chr20	2477817	2485817	2483050	8000	2481817	-4000	4000	1233
chr20	6776246	6784246	6778934	8000	6780246	-4000	4000	-1312
chr20	23743562	23751562	23747872	8000	23747562	-4000	4000	310
chr20	56364663	56372663	56366199	8000	56368663	-4000	4000	-2464
chr20	33671477	33679477	33676943	8000	33675477	-4000	4000	1466
chr20	2477817	2485817	2482918	8000	2481817	-4000	4000	1101
chr20	33403957	33411957	33408403	8000	33407957	-4000	4000	446
chr20	47652877	47660877	47653504	8000	47656877	-4000	4000	-3373
chr20	63554086	63562086	63556112	8000	63558086	-4000	4000	-1974
chr20	45884625	45892625	45892405	8000	45888625	-4000	4000	3780
chr20	4848356	4856356	4854998	8000	4852356	-4000	4000	2642
chr20	53563071	53571071	53567985	8000	53567071	-4000	4000	914
chr20	57599846	57607846	57604702	8000	57603846	-4000	4000	856
chr20	45172544	45180544	45176030	8000	45176544	-4000	4000	-514
chr20	58991133	58999133	58995694	8000	58995133	-4000	4000	561
chr20	25002230	25010230	25007903	8000	25006230	-4000	4000	1673
chr20	45477532	45485532	45479971	8000	45481532	-4000	4000	-1561
chr20	25224075	25232075	25225225	8000	25228075	-4000	4000	-2850
chr20	50884916	50892916	50892193	8000	50888916	-4000	4000	3277
chr20	35949617	35957617	35949823	8000	35953617	-4000	4000	-3794
chr20	49984886	49992886	49987919	8000	49988886	-4000	4000	-967
chr20	34709439	34717439	34710341	8000	34713439	-4000	4000	-3098
chr20	50581241	50589241	50581368	8000	50585241	-4000	4000	-3873
chr20	51778331	51786331	51784271	8000	51782331	-4000	4000	1940
chr20	23871934	23879934	23879493	8000	23875934	-4000	4000	3559
chr20	33019703	33027703	33023421	8000	33023703	-4000	4000	-282
chr20	19718926	19726926	19721232	8000	19722926	-4000	4000	-1694
chr20	38768520	38776520	38771843	8000	38772520	-4000	4000	-677
chr20	50188668	50196668	50192415	8000	50192668	-4000	4000	-253
chr20	23369062	23377062	23370224	8000	23373062	-4000	4000	-2838
chr20	36547447	36555447	36548075	8000	36551447	-4000	4000	-3372
chr20	2790074	2798074	2796005	8000	2794074	-4000	4000	1931
chr20	23871934	23879934	23877595	8000	23875934	-4000	4000	1661
chr20	63554086	63562086	63556336	8000	63558086	-4000	4000	-1750
chr20	23598410	23606410	23603556	8000	23602410	-4000	4000	1146
chr20	35697347	35705347	35705252	8000	35701347	-4000	4000	3905
chr20	5921353	5929353	5923439	8000	5925353	-4000	4000	-1914
chr20	49628945	49636945	49636434	8000	49632945	-4000	4000	3489
chr20	59859564	59867564	59866371	8000	59863564	-4000	4000	2807
chr20	50884916	50892916	50892194	8000	50888916	-4000	4000	3278
chr20	14318985	14326985	14325935	8000	14322985	-4000	4000	2950
chr20	20030368	20038368	20038366	8000	20034368	-4000	4000	3998
chr20	31797805	31805805	31801158	8000	31801805	-4000	4000	-647
chr20	35272998	35280998	35280717	8000	35276998	-4000	4000	3719
chr20	36890235	36898235	36892981	8000	36894235	-4000	4000	-1254
chr20	38574859	38582859	38581270	8000	38578859	-4000	4000	2411
chr20	41356582	41364582	41362711	8000	41360582	-4000	4000	2129
chr20	49899391	49907391	49905768	8000	49903391	-4000	4000	2377
chr20	9526524	9534524	9529688	8000	9530524	-4000	4000	-836
chr20	11922609	11930609	11923307	8000	11926609	-4000	4000	-3302
chr20	45881266	45889266	45883463	8000	45885266	-4000	4000	-1803
chr20	64096643	64104643	64098011	8000	64100643	-4000	4000	-2632
chr20	756080	764080	761565	8000	760080	-4000	4000	1485
chr20	63554086	63562086	63556383	8000	63558086	-4000	4000	-1703
chr20	17489905	17497905	17494306	8000	17493905	-4000	4000	401
chr20	44065616	44073616	44068984	8000	44069616	-4000	4000	-632
chr20	1936592	1944592	1937417	8000	1940592	-4000	4000	-3175
chr20	23743562	23751562	23750753	8000	23747562	-4000	4000	3191
chr20	56515449	56523449	56518198	8000	56519449	-4000	4000	-1251
chr20	10633684	10641684	10641499	8000	10637684	-4000	4000	3815
chr20	17987122	17995122	17989976	8000	17991122	-4000	4000	-1146
chr20	33671477	33679477	33677256	8000	33675477	-4000	4000	1779
chr20	62292213	62300213	62293824	8000	62296213	-4000	4000	-2389
chr20	642626	650626	648790	8000	646626	-4000	4000	2164
chr20	2790074	2798074	2796610	8000	2794074	-4000	4000	2536
chr20	45172544	45180544	45176031	8000	45176544	-4000	4000	-513
chr20	4724460	4732460	4725336	8000	4728460	-4000	4000	-3124
chr20	38123780	38131780	38131109	8000	38127780	-4000	4000	3329
chr20	53563071	53571071	53567266	8000	53567071	-4000	4000	195
chr20	14318985	14326985	14326807	8000	14322985	-4000	4000	3822
chr20	35628340	35636340	35630911	8000	35632340	-4000	4000	-1429
chr20	46056150	46064150	46057270	8000	46060150	-4000	4000	-2880
chr20	50999656	51007656	51004280	8000	51003656	-4000	4000	624
chr20	44615522	44623522	44618524	8000	44619522	-4000	4000	-998
chr20	35111364	35119364	35118702	8000	35115364	-4000	4000	3338
chr20	45807427	45815427	45811251	8000	45811427	-4000	4000	-176
chr20	45881266	45889266	45887139	8000	45885266	-4000	4000	1873
chr20	19998457	20006457	20001098	8000	20002457	-4000	4000	-1359
chr20	2790074	2798074	2794235	8000	2794074	-4000	4000	161
chr20	32435319	32443319	32436720	8000	32439319	-4000	4000	-2599
chr20	41398083	41406083	41404715	8000	41402083	-4000	4000	2632
chr20	41356582	41364582	41362062	8000	41360582	-4000	4000	1480
chr20	46495630	46503630	46501901	8000	46499630	-4000	4000	2271
chr20	35628340	35636340	35631170	8000	35632340	-4000	4000	-1170
chr20	46495630	46503630	46502469	8000	46499630	-4000	4000	2839
chr20	36886229	36894229	36889395	8000	36890229	-4000	4000	-834
chr20	62384520	62392520	62390236	8000	62388520	-4000	4000	1716
chr20	44615522	44623522	44621058	8000	44619522	-4000	4000	1536
chr20	49984886	49992886	49987942	8000	49988886	-4000	4000	-944
chr20	59944680	59952680	59946175	8000	59948680	-4000	4000	-2505
chr20	50077124	50085124	50082923	8000	50081124	-4000	4000	1799
chr20	57483959	57491959	57488847	8000	57487959	-4000	4000	888
chr20	59021475	59029475	59024027	8000	59025475	-4000	4000	-1448
chr20	45894621	45902621	45894712	8000	45898621	-4000	4000	-3909
chr20	41356582	41364582	41362684	8000	41360582	-4000	4000	2102
chr20	57375211	57383211	57378059	8000	57379211	-4000	4000	-1152
chr20	11922609	11930609	11922643	8000	11926609	-4000	4000	-3966
chr20	49628945	49636945	49636079	8000	49632945	-4000	4000	3134
chr20	1936592	1944592	1937705	8000	1940592	-4000	4000	-2887
chr20	44620247	44628247	44626554	8000	44624247	-4000	4000	2307
chr20	49628945	49636945	49636260	8000	49632945	-4000	4000	3315
chr20	14318985	14326985	14325724	8000	14322985	-4000	4000	2739
chr20	20356703	20364703	20360608	8000	20360703	-4000	4000	-95
chr20	24955928	24963928	24963900	8000	24959928	-4000	4000	3972
chr20	35949617	35957617	35954599	8000	35953617	-4000	4000	982
chr20	45881266	45889266	45882787	8000	45885266	-4000	4000	-2479
chr20	63554086	63562086	63555702	8000	63558086	-4000	4000	-2384
chr20	46125863	46133863	46128124	8000	46129863	-4000	4000	-1739
chr20	49499874	49507874	49507859	8000	49503874	-4000	4000	3985
chr20	49240077	49248077	49242112	8000	49244077	-4000	4000	-1965
chr20	62837005	62845005	62842063	8000	62841005	-4000	4000	1058
chr20	50999656	51007656	51004021	8000	51003656	-4000	4000	365
chr20	36547447	36555447	36549228	8000	36551447	-4000	4000	-2219
chr20	37519690	37527690	37522672	8000	37523690	-4000	4000	-1018
chr20	5921353	5929353	5923027	8000	5925353	-4000	4000	-2326
chr20	20030368	20038368	20033173	8000	20034368	-4000	4000	-1195
chr20	6070845	6078845	6077337	8000	6074845	-4000	4000	2492
chr20	2477817	2485817	2483427	8000	2481817	-4000	4000	1610
chr20	33305871	33313871	33309714	8000	33309871	-4000	4000	-157
chr20	21242622	21250622	21246517	8000	21246622	-4000	4000	-105
chr20	23350771	23358771	23354037	8000	23354771	-4000	4000	-734
chr20	31940337	31948337	31943112	8000	31944337	-4000	4000	-1225
chr20	2790074	2798074	2797194	8000	2794074	-4000	4000	3120
chr20	63970116	63978116	63977022	8000	63974116	-4000	4000	2906
chr20	20030368	20038368	20032646	8000	20034368	-4000	4000	-1722
chr20	17489905	17497905	17494108	8000	17493905	-4000	4000	203
chr20	21507017	21515017	21512331	8000	21511017	-4000	4000	1314
chr20	45875122	45883122	45877544	8000	45879122	-4000	4000	-1578
chr20	5933228	5941228	5941107	8000	5937228	-4000	4000	3879
chr20	46553823	46561823	46560090	8000	46557823	-4000	4000	2267
chr20	50884916	50892916	50891470	8000	50888916	-4000	4000	2554
chr20	50884916	50892916	50891627	8000	50888916	-4000	4000	2711
chr20	50884916	50892916	50892150	8000	50888916	-4000	4000	3234
chr20	4724460	4732460	4724548	8000	4728460	-4000	4000	-3912
chr20	56515449	56523449	56517171	8000	56519449	-4000	4000	-2278
chr20	2790074	2798074	2796137	8000	2794074	-4000	4000	2063
chr20	5921353	5929353	5923110	8000	5925353	-4000	4000	-2243
chr20	18312996	18320996	18315471	8000	18316996	-4000	4000	-1525
chr20	25448628	25456628	25453639	8000	25452628	-4000	4000	1011
chr20	32846405	32854405	32846653	8000	32850405	-4000	4000	-3752
chr20	38206503	38214503	38213147	8000	38210503	-4000	4000	2644
chr20	57164753	57172753	57171083	8000	57168753	-4000	4000	2330
chr20	33671477	33679477	33677213	8000	33675477	-4000	4000	1736
chr20	17605919	17613919	17607387	8000	17609919	-4000	4000	-2532
chr20	57644392	57652392	57648512	8000	57648392	-4000	4000	120
chr20	50077124	50085124	50082800	8000	50081124	-4000	4000	1676
chr20	4724460	4732460	4724742	8000	4728460	-4000	4000	-3718
chr20	17489905	17497905	17494608	8000	17493905	-4000	4000	703
chr20	17489905	17497905	17494610	8000	17493905	-4000	4000	705
chr20	33305871	33313871	33307441	8000	33309871	-4000	4000	-2430
chr20	58907192	58915192	58909748	8000	58911192	-4000	4000	-1444
chr20	41398083	41406083	41404730	8000	41402083	-4000	4000	2647
chr20	56515449	56523449	56518219	8000	56519449	-4000	4000	-1230
chr20	57644392	57652392	57652148	8000	57648392	-4000	4000	3756
chr20	59321992	59329992	59324427	8000	59325992	-4000	4000	-1565
chr20	46125863	46133863	46129014	8000	46129863	-4000	4000	-849
chr20	64096643	64104643	64098951	8000	64100643	-4000	4000	-1692
chr20	64238253	64246253	64240550	8000	64242253	-4000	4000	-1703
chr20	50959929	50967929	50960807	8000	50963929	-4000	4000	-3122
chr20	31660452	31668452	31664770	8000	31664452	-4000	4000	318
chr20	41120487	41128487	41123609	8000	41124487	-4000	4000	-878
chr20	33354839	33362839	33359229	8000	33358839	-4000	4000	390
chr20	47652348	47660348	47652469	8000	47656348	-4000	4000	-3879
chr20	46056150	46064150	46056231	8000	46060150	-4000	4000	-3919
chr20	50873177	50881177	50876597	8000	50877177	-4000	4000	-580
chr20	56364663	56372663	56366384	8000	56368663	-4000	4000	-2279
chr20	3663965	3671965	3669315	8000	3667965	-4000	4000	1350
chr20	36747791	36755791	36752874	8000	36751791	-4000	4000	1083
chr20	44615522	44623522	44618450	8000	44619522	-4000	4000	-1072
chr20	45875122	45883122	45877938	8000	45879122	-4000	4000	-1184
chr20	37097226	37105226	37102776	8000	37101226	-4000	4000	1550
chr20	58455101	58463101	58460965	8000	58459101	-4000	4000	1864
chr20	38768520	38776520	38771723	8000	38772520	-4000	4000	-797
chr20	49628945	49636945	49634390	8000	49632945	-4000	4000	1445
chr20	62965585	62973585	62966833	8000	62969585	-4000	4000	-2752
chr20	50930867	50938867	50935120	8000	50934867	-4000	4000	253
chr20	3682970	3690970	3689510	8000	3686970	-4000	4000	2540
chr20	32435319	32443319	32436704	8000	32439319	-4000	4000	-2615
chr20	64096643	64104643	64098104	8000	64100643	-4000	4000	-2539
chr20	63635705	63643705	63640572	8000	63639705	-4000	4000	867
chr20	4724460	4732460	4724801	8000	4728460	-4000	4000	-3659
chr20	33403957	33411957	33408512	8000	33407957	-4000	4000	555
chr20	33354839	33362839	33358898	8000	33358839	-4000	4000	59
chr20	2756108	2764108	2758920	8000	2760108	-4000	4000	-1188
chr20	4848356	4856356	4852655	8000	4852356	-4000	4000	299
chr20	23350771	23358771	23354134	8000	23354771	-4000	4000	-637
chr20	40681848	40689848	40688823	8000	40685848	-4000	4000	2975
chr20	41120487	41128487	41122083	8000	41124487	-4000	4000	-2404
chr20	45875122	45883122	45877969	8000	45879122	-4000	4000	-1153
chr20	18312996	18320996	18316269	8000	18316996	-4000	4000	-727
chr20	1313571	1321571	1319607	8000	1317571	-4000	4000	2036
chr20	34084309	34092309	34089645	8000	34088309	-4000	4000	1336
chr20	36026700	36034700	36030552	8000	36030700	-4000	4000	-148
chr20	45248239	45256239	45252404	8000	45252239	-4000	4000	165
chr20	45894949	45902949	45899062	8000	45898949	-4000	4000	113
chr20	3663965	3671965	3669306	8000	3667965	-4000	4000	1341
chr20	18379367	18387367	18384544	8000	18383367	-4000	4000	1177
chr20	5921353	5929353	5923445	8000	5925353	-4000	4000	-1908
chr20	44615522	44623522	44619830	8000	44619522	-4000	4000	308
chr20	6776246	6784246	6778789	8000	6780246	-4000	4000	-1457
chr20	59321992	59329992	59324375	8000	59325992	-4000	4000	-1617
chr20	64238253	64246253	64240343	8000	64242253	-4000	4000	-1910
chr20	49499874	49507874	49507769	8000	49503874	-4000	4000	3895
chr20	33788269	33796269	33789520	8000	33792269	-4000	4000	-2749
chr20	40681848	40689848	40687876	8000	40685848	-4000	4000	2028
chr20	63970116	63978116	63975725	8000	63974116	-4000	4000	1609
chr20	2477817	2485817	2484253	8000	2481817	-4000	4000	2436
chr20	13296651	13304651	13299190	8000	13300651	-4000	4000	-1461
chr20	20356703	20364703	20360301	8000	20360703	-4000	4000	-402
chr20	36890235	36898235	36893057	8000	36894235	-4000	4000	-1178
chr20	44724509	44732509	44727104	8000	44728509	-4000	4000	-1405
chr20	49233946	49241946	49235081	8000	49237946	-4000	4000	-2865
chr20	326224	334224	329193	8000	330224	-4000	4000	-1031
chr20	326224	334224	329968	8000	330224	-4000	4000	-256
chr20	3647118	3655118	3648446	8000	3651118	-4000	4000	-2672
chr20	18312996	18320996	18316702	8000	18316996	-4000	4000	-294
chr20	20385530	20393530	20393089	8000	20389530	-4000	4000	3559
chr20	35111364	35119364	35115775	8000	35115364	-4000	4000	411
chr20	56515449	56523449	56517166	8000	56519449	-4000	4000	-2283
chr20	61949469	61957469	61953625	8000	61953469	-4000	4000	156
chr20	642626	650626	648797	8000	646626	-4000	4000	2171
chr20	11922609	11930609	11922757	8000	11926609	-4000	4000	-3852
chr20	56364663	56372663	56366203	8000	56368663	-4000	4000	-2460
chr20	34084309	34092309	34089783	8000	34088309	-4000	4000	1474
chr20	44724509	44732509	44724829	8000	44728509	-4000	4000	-3680
chr20	25669195	25677195	25676690	8000	25673195	-4000	4000	3495
chr20	45368557	45376557	45375144	8000	45372557	-4000	4000	2587
chr20	45894949	45902949	45902571	8000	45898949	-4000	4000	3622
chr20	32331011	32339011	32331667	8000	32335011	-4000	4000	-3344
chr20	51778331	51786331	51784253	8000	51782331	-4000	4000	1922
chr20	5933228	5941228	5938590	8000	5937228	-4000	4000	1362
chr20	36747791	36755791	36752793	8000	36751791	-4000	4000	1002
chr20	10633684	10641684	10639432	8000	10637684	-4000	4000	1748
chr20	11922609	11930609	11923178	8000	11926609	-4000	4000	-3431
chr20	23369062	23377062	23370693	8000	23373062	-4000	4000	-2369
chr20	36647766	36655766	36653225	8000	36651766	-4000	4000	1459
chr20	45172544	45180544	45174961	8000	45176544	-4000	4000	-1583
chr20	49499874	49507874	49505907	8000	49503874	-4000	4000	2033
chr20	50999656	51007656	51004052	8000	51003656	-4000	4000	396
chr20	53563071	53571071	53567548	8000	53567071	-4000	4000	477
chr20	57599846	57607846	57604447	8000	57603846	-4000	4000	601
chr20	59021475	59029475	59024569	8000	59025475	-4000	4000	-906
chr20	59944680	59952680	59946499	8000	59948680	-4000	4000	-2181
chr20	62292213	62300213	62294601	8000	62296213	-4000	4000	-1612
chr20	3923309	3931309	3923418	8000	3927309	-4000	4000	-3891
chr20	17489905	17497905	17495012	8000	17493905	-4000	4000	1107
chr20	32805356	32813356	32807976	8000	32809356	-4000	4000	-1380
chr20	33850366	33858366	33852152	8000	33854366	-4000	4000	-2214
chr20	35111364	35119364	35115464	8000	35115364	-4000	4000	100
chr20	45875122	45883122	45877733	8000	45879122	-4000	4000	-1389
chr20	46495630	46503630	46501698	8000	46499630	-4000	4000	2068
chr20	37519690	37527690	37522950	8000	37523690	-4000	4000	-740
chr20	5860395	5868395	5863387	8000	5864395	-4000	4000	-1008
chr20	58907192	58915192	58909964	8000	58911192	-4000	4000	-1228
chr20	37941350	37949350	37944058	8000	37945350	-4000	4000	-1292
chr20	14318985	14326985	14326806	8000	14322985	-4000	4000	3821
chr20	43643299	43651299	43646977	8000	43647299	-4000	4000	-322
chr20	54149446	54157446	54157184	8000	54153446	-4000	4000	3738
chr20	46056150	46064150	46057769	8000	46060150	-4000	4000	-2381
chr20	35111364	35119364	35118547	8000	35115364	-4000	4000	3183
chr20	45172544	45180544	45176105	8000	45176544	-4000	4000	-439
chr20	41398083	41406083	41402818	8000	41402083	-4000	4000	735
chr20	64096643	64104643	64098780	8000	64100643	-4000	4000	-1863
chr20	59021475	59029475	59023919	8000	59025475	-4000	4000	-1556
chr20	1176561	1184561	1183889	8000	1180561	-4000	4000	3328
chr20	25669195	25677195	25676761	8000	25673195	-4000	4000	3566
chr20	63534489	63542489	63542192	8000	63538489	-4000	4000	3703
chr20	49628945	49636945	49636149	8000	49632945	-4000	4000	3204
chr20	64238253	64246253	64239871	8000	64242253	-4000	4000	-2382
chr20	5921353	5929353	5922973	8000	5925353	-4000	4000	-2380
chr20	44065616	44073616	44068671	8000	44069616	-4000	4000	-945
chr20	43643299	43651299	43647099	8000	43647299	-4000	4000	-200
chr20	2790074	2798074	2794411	8000	2794074	-4000	4000	337
chr20	34840720	34848720	34845477	8000	34844720	-4000	4000	757
chr20	23819769	23827769	23826447	8000	23823769	-4000	4000	2678
chr20	46012561	46020561	46016423	8000	46016561	-4000	4000	-138
chr20	51778331	51786331	51784187	8000	51782331	-4000	4000	1856
chr20	23598410	23606410	23603473	8000	23602410	-4000	4000	1063
chr20	62178514	62186514	62181557	8000	62182514	-4000	4000	-957
chr20	50930867	50938867	50935034	8000	50934867	-4000	4000	167
chr20	33354839	33362839	33359225	8000	33358839	-4000	4000	386
chr20	41356582	41364582	41362892	8000	41360582	-4000	4000	2310
chr20	34998437	35006437	35005746	8000	35002437	-4000	4000	3309
chr20	62384520	62392520	62388332	8000	62388520	-4000	4000	-188
chr20	62837005	62845005	62838740	8000	62841005	-4000	4000	-2265
chr20	10304258	10312258	10306335	8000	10308258	-4000	4000	-1923
chr20	46553823	46561823	46559968	8000	46557823	-4000	4000	2145
chr20	58907192	58915192	58910827	8000	58911192	-4000	4000	-365
chr20	23819769	23827769	23826447	8000	23823769	-4000	4000	2678
chr20	9526524	9534524	9529770	8000	9530524	-4000	4000	-754
chr20	5921353	5929353	5923455	8000	5925353	-4000	4000	-1898
chr20	57483959	57491959	57488409	8000	57487959	-4000	4000	450
chr20	45881266	45889266	45883686	8000	45885266	-4000	4000	-1580
chr20	58455101	58463101	58461103	8000	58459101	-4000	4000	2002
chr20	32097856	32105856	32101413	8000	32101856	-4000	4000	-443
chr20	36886229	36894229	36889380	8000	36890229	-4000	4000	-849
chr20	47205214	47213214	47210497	8000	47209214	-4000	4000	1283
chr20	44298840	44306840	44306769	8000	44302840	-4000	4000	3929
chr20	5110953	5118953	5115114	8000	5114953	-4000	4000	161
chr20	2477817	2485817	2484138	8000	2481817	-4000	4000	2321
chr20	18312996	18320996	18316280	8000	18316996	-4000	4000	-716
chr20	393559	401559	396414	8000	397559	-4000	4000	-1145
chr20	3773504	3781504	3778450	8000	3777504	-4000	4000	946
chr20	5921353	5929353	5923150	8000	5925353	-4000	4000	-2203
chr20	16049197	16057197	16049844	8000	16053197	-4000	4000	-3353
chr20	16738564	16746564	16740987	8000	16742564	-4000	4000	-1577
chr20	18184387	18192387	18184709	8000	18188387	-4000	4000	-3678
chr20	18184387	18192387	18187363	8000	18188387	-4000	4000	-1024
chr20	18312996	18320996	18315463	8000	18316996	-4000	4000	-1533
chr20	18312996	18320996	18316702	8000	18316996	-4000	4000	-294
chr20	18482540	18490540	18483627	8000	18486540	-4000	4000	-2913
chr20	21507017	21515017	21512315	8000	21511017	-4000	4000	1298
chr20	23369062	23377062	23370187	8000	23373062	-4000	4000	-2875
chr20	25608935	25616935	25616403	8000	25612935	-4000	4000	3468
chr20	35949617	35957617	35954169	8000	35953617	-4000	4000	552
chr20	36890235	36898235	36893100	8000	36894235	-4000	4000	-1135
chr20	44065616	44073616	44066746	8000	44069616	-4000	4000	-2870
chr20	50884916	50892916	50892514	8000	50888916	-4000	4000	3598
chr20	57644392	57652392	57652001	8000	57648392	-4000	4000	3609
chr20	59859564	59867564	59866339	8000	59863564	-4000	4000	2775
chr20	58991133	58999133	58991978	8000	58995133	-4000	4000	-3155
chr20	45368557	45376557	45375047	8000	45372557	-4000	4000	2490
chr20	41398083	41406083	41405181	8000	41402083	-4000	4000	3098
chr20	45875122	45883122	45877479	8000	45879122	-4000	4000	-1643
chr20	50930867	50938867	50936240	8000	50934867	-4000	4000	1373
chr20	50999656	51007656	51004620	8000	51003656	-4000	4000	964
chr20	40681848	40689848	40687815	8000	40685848	-4000	4000	1967
chr20	59021475	59029475	59022919	8000	59025475	-4000	4000	-2556
chr20	10633684	10641684	10641203	8000	10637684	-4000	4000	3519
chr20	41174448	41182448	41180239	8000	41178448	-4000	4000	1791
chr20	38333505	38341505	38334492	8000	38337505	-4000	4000	-3013
chr20	49092960	49100960	49096761	8000	49096960	-4000	4000	-199
chr20	419596	427596	422207	8000	423596	-4000	4000	-1389
chr20	642626	650626	648890	8000	646626	-4000	4000	2264
chr20	2790074	2798074	2796259	8000	2794074	-4000	4000	2185
chr20	2790074	2798074	2797055	8000	2794074	-4000	4000	2981
chr20	14318985	14326985	14325993	8000	14322985	-4000	4000	3008
chr20	17987122	17995122	17990067	8000	17991122	-4000	4000	-1055
chr20	18312996	18320996	18315958	8000	18316996	-4000	4000	-1038
chr20	25669195	25677195	25674919	8000	25673195	-4000	4000	1724
chr20	31480895	31488895	31482478	8000	31484895	-4000	4000	-2417
chr20	31602515	31610515	31605670	8000	31606515	-4000	4000	-845
chr20	34840720	34848720	34845442	8000	34844720	-4000	4000	722
chr20	37313260	37321260	37316644	8000	37317260	-4000	4000	-616
chr20	38123780	38131780	38130331	8000	38127780	-4000	4000	2551
chr20	38574859	38582859	38574986	8000	38578859	-4000	4000	-3873
chr20	44904532	44912532	44905048	8000	44908532	-4000	4000	-3484
chr20	45368557	45376557	45375507	8000	45372557	-4000	4000	2950
chr20	45875122	45883122	45878407	8000	45879122	-4000	4000	-715
chr20	46495630	46503630	46501211	8000	46499630	-4000	4000	1581
chr20	46495630	46503630	46501795	8000	46499630	-4000	4000	2165
chr20	46495630	46503630	46502669	8000	46499630	-4000	4000	3039
chr20	49240077	49248077	49243831	8000	49244077	-4000	4000	-246
chr20	57483959	57491959	57488482	8000	57487959	-4000	4000	523
chr20	57564121	57572121	57565714	8000	57568121	-4000	4000	-2407
chr20	57599846	57607846	57604742	8000	57603846	-4000	4000	896
chr20	59021475	59029475	59023508	8000	59025475	-4000	4000	-1967
chr20	10633684	10641684	10640932	8000	10637684	-4000	4000	3248
chr20	14318985	14326985	14325724	8000	14322985	-4000	4000	2739
chr20	37097226	37105226	37102694	8000	37101226	-4000	4000	1468
chr20	37097226	37105226	37102792	8000	37101226	-4000	4000	1566
chr20	41356582	41364582	41357879	8000	41360582	-4000	4000	-2703
chr20	47652348	47660348	47652483	8000	47656348	-4000	4000	-3865
chr20	44065616	44073616	44066798	8000	44069616	-4000	4000	-2818
chr20	46495630	46503630	46502835	8000	46499630	-4000	4000	3205
chr20	46553823	46561823	46560074	8000	46557823	-4000	4000	2251
chr20	50884916	50892916	50890578	8000	50888916	-4000	4000	1662
chr20	64096643	64104643	64098280	8000	64100643	-4000	4000	-2363
chr20	59859564	59867564	59866510	8000	59863564	-4000	4000	2946
chr20	23681640	23689640	23685771	8000	23685640	-4000	4000	131
chr20	44065616	44073616	44069609	8000	44069616	-4000	4000	-7
chr20	31602515	31610515	31606358	8000	31606515	-4000	4000	-157
chr20	32846405	32854405	32849937	8000	32850405	-4000	4000	-468
chr20	35946370	35954370	35947533	8000	35950370	-4000	4000	-2837
chr20	1313571	1321571	1318413	8000	1317571	-4000	4000	842
chr20	38123780	38131780	38131124	8000	38127780	-4000	4000	3344
chr20	36992349	37000349	36998830	8000	36996349	-4000	4000	2481
chr20	296321	304321	298727	8000	300321	-4000	4000	-1594
chr20	31843637	31851637	31848409	8000	31847637	-4000	4000	772
chr20	64096643	64104643	64097894	8000	64100643	-4000	4000	-2749
chr20	36647766	36655766	36653639	8000	36651766	-4000	4000	1873
chr20	13385392	13393392	13390226	8000	13389392	-4000	4000	834
chr20	49984886	49992886	49987989	8000	49988886	-4000	4000	-897
chr20	36524637	36532637	36527164	8000	36528637	-4000	4000	-1473
chr20	23819769	23827769	23826503	8000	23823769	-4000	4000	2734
chr20	38574859	38582859	38575075	8000	38578859	-4000	4000	-3784
chr20	56515449	56523449	56518389	8000	56519449	-4000	4000	-1060
chr20	62965585	62973585	62966833	8000	62969585	-4000	4000	-2752
chr20	1438162	1446162	1446022	8000	1442162	-4000	4000	3860
chr20	19998457	20006457	20000943	8000	20002457	-4000	4000	-1514
chr20	20030368	20038368	20032544	8000	20034368	-4000	4000	-1824
chr20	23743562	23751562	23749063	8000	23747562	-4000	4000	1501
chr20	24955928	24963928	24963690	8000	24959928	-4000	4000	3762
chr20	50884916	50892916	50892096	8000	50888916	-4000	4000	3180
chr20	4724460	4732460	4724892	8000	4728460	-4000	4000	-3568
chr20	25669195	25677195	25676476	8000	25673195	-4000	4000	3281
chr20	17489905	17497905	17494379	8000	17493905	-4000	4000	474
chr20	45406610	45414610	45410216	8000	45410610	-4000	4000	-394
chr20	25294012	25302012	25300859	8000	25298012	-4000	4000	2847
chr20	49092960	49100960	49096485	8000	49096960	-4000	4000	-475
chr20	14318985	14326985	14326226	8000	14322985	-4000	4000	3241
chr20	4724460	4732460	4724620	8000	4728460	-4000	4000	-3840
chr20	18312996	18320996	18315890	8000	18316996	-4000	4000	-1106
chr20	13710322	13718322	13715059	8000	13714322	-4000	4000	737
chr20	58157150	58165150	58160983	8000	58161150	-4000	4000	-167
chr20	59944680	59952680	59945024	8000	59948680	-4000	4000	-3656
chr20	17605919	17613919	17607557	8000	17609919	-4000	4000	-2362
chr20	14318985	14326985	14326950	8000	14322985	-4000	4000	3965
chr20	50884916	50892916	50891813	8000	50888916	-4000	4000	2897
chr20	17952979	17960979	17954118	8000	17956979	-4000	4000	-2861
chr20	57564121	57572121	57564387	8000	57568121	-4000	4000	-3734
chr20	11922609	11930609	11923456	8000	11926609	-4000	4000	-3153
chr20	11922609	11930609	11923657	8000	11926609	-4000	4000	-2952
chr20	58907192	58915192	58909365	8000	58911192	-4000	4000	-1827
chr20	32028180	32036180	32029820	8000	32032180	-4000	4000	-2360
chr20	23681640	23689640	23688955	8000	23685640	-4000	4000	3315
chr20	19998457	20006457	20001414	8000	20002457	-4000	4000	-1043
chr20	38574859	38582859	38578829	8000	38578859	-4000	4000	-30
chr20	2790074	2798074	2796137	8000	2794074	-4000	4000	2063
chr20	17489905	17497905	17494497	8000	17493905	-4000	4000	592
chr20	53563071	53571071	53569141	8000	53567071	-4000	4000	2070
chr20	3035076	3043076	3038469	8000	3039076	-4000	4000	-607
chr20	50752795	50760795	50753027	8000	50756795	-4000	4000	-3768
chr20	33671477	33679477	33677512	8000	33675477	-4000	4000	2035
chr20	5921353	5929353	5923831	8000	5925353	-4000	4000	-1522
chr20	46495630	46503630	46501856	8000	46499630	-4000	4000	2226
chr20	45875122	45883122	45877397	8000	45879122	-4000	4000	-1725
chr20	59859564	59867564	59866337	8000	59863564	-4000	4000	2773
chr20	2790074	2798074	2795830	8000	2794074	-4000	4000	1756
chr20	45477532	45485532	45479983	8000	45481532	-4000	4000	-1549
chr20	25669195	25677195	25676208	8000	25673195	-4000	4000	3013
chr20	4848356	4856356	4853377	8000	4852356	-4000	4000	1021
chr20	62384520	62392520	62390139	8000	62388520	-4000	4000	1619
chr20	6776246	6784246	6778769	8000	6780246	-4000	4000	-1477
chr20	5921353	5929353	5923118	8000	5925353	-4000	4000	-2235
chr20	23743562	23751562	23747787	8000	23747562	-4000	4000	225
chr20	16268104	16276104	16273049	8000	16272104	-4000	4000	945
chr20	45477532	45485532	45479988	8000	45481532	-4000	4000	-1544
chr20	2477817	2485817	2483298	8000	2481817	-4000	4000	1481
chr20	46012561	46020561	46013789	8000	46016561	-4000	4000	-2772
chr20	58907192	58915192	58910772	8000	58911192	-4000	4000	-420
chr20	2790074	2798074	2797967	8000	2794074	-4000	4000	3893
chr20	41398083	41406083	41405154	8000	41402083	-4000	4000	3071
chr20	47652877	47660877	47656685	8000	47656877	-4000	4000	-192
chr20	5933228	5941228	5938520	8000	5937228	-4000	4000	1292
chr20	1313571	1321571	1318071	8000	1317571	-4000	4000	500
chr20	6070845	6078845	6077179	8000	6074845	-4000	4000	2334
chr20	33671477	33679477	33678330	8000	33675477	-4000	4000	2853
chr20	37313260	37321260	37316496	8000	37317260	-4000	4000	-764
chr20	45248239	45256239	45252332	8000	45252239	-4000	4000	93
chr20	56364663	56372663	56370110	8000	56368663	-4000	4000	1447
chr20	44065616	44073616	44069580	8000	44069616	-4000	4000	-36
chr20	44904532	44912532	44904978	8000	44908532	-4000	4000	-3554
chr20	5540439	5548439	5546840	8000	5544439	-4000	4000	2401
chr20	40681848	40689848	40688770	8000	40685848	-4000	4000	2922
chr20	49899391	49907391	49904227	8000	49903391	-4000	4000	836
chr20	49899391	49907391	49905234	8000	49903391	-4000	4000	1843
chr20	49628945	49636945	49636095	8000	49632945	-4000	4000	3150
chr21	18263373	18271373	18270006	8000	18267373	-4000	4000	2633
chr21	26831755	26839755	26838509	8000	26835755	-4000	4000	2754
chr21	33573481	33581481	33578430	8000	33577481	-4000	4000	949
chr21	33580687	33588687	33583556	8000	33584687	-4000	4000	-1131
chr21	32264228	32272228	32270427	8000	32268228	-4000	4000	2199
chr21	26462209	26470209	26468472	8000	26466209	-4000	4000	2263
chr21	33895861	33903861	33903548	8000	33899861	-4000	4000	3687
chr21	39401728	39409728	39406230	8000	39405728	-4000	4000	502
chr21	30210006	30218006	30215491	8000	30214006	-4000	4000	1485
chr21	46661124	46669124	46664318	8000	46665124	-4000	4000	-806
chr21	44845585	44853585	44851532	8000	44849585	-4000	4000	1947
chr21	29000384	29008384	29006422	8000	29004384	-4000	4000	2038
chr21	32624759	32632759	32631351	8000	32628759	-4000	4000	2592
chr21	33573481	33581481	33575856	8000	33577481	-4000	4000	-1625
chr21	44764580	44772580	44771328	8000	44768580	-4000	4000	2748
chr21	46001050	46009050	46004029	8000	46005050	-4000	4000	-1021
chr21	42293244	42301244	42294637	8000	42297244	-4000	4000	-2607
chr21	18263373	18271373	18266662	8000	18267373	-4000	4000	-711
chr21	42468486	42476486	42472533	8000	42472486	-4000	4000	47
chr21	32307018	32315018	32314610	8000	32311018	-4000	4000	3592
chr21	36142562	36150562	36146556	8000	36146562	-4000	4000	-6
chr21	44881953	44889953	44888784	8000	44885953	-4000	4000	2831
chr21	32307018	32315018	32314905	8000	32311018	-4000	4000	3887
chr21	26831755	26839755	26837389	8000	26835755	-4000	4000	1634
chr21	26831755	26839755	26838567	8000	26835755	-4000	4000	2812
chr21	32310784	32318784	32316667	8000	32314784	-4000	4000	1883
chr21	32624759	32632759	32631208	8000	32628759	-4000	4000	2449
chr21	41794225	41802225	41801454	8000	41798225	-4000	4000	3229
chr21	42468486	42476486	42472771	8000	42472486	-4000	4000	285
chr21	43029931	43037931	43030141	8000	43033931	-4000	4000	-3790
chr21	29000384	29008384	29007905	8000	29004384	-4000	4000	3521
chr21	33580687	33588687	33584744	8000	33584687	-4000	4000	57
chr21	44881953	44889953	44886368	8000	44885953	-4000	4000	415
chr21	45938454	45946454	45941768	8000	45942454	-4000	4000	-686
chr21	42307667	42315667	42312217	8000	42311667	-4000	4000	550
chr21	46128848	46136848	46129236	8000	46132848	-4000	4000	-3612
chr21	33481530	33489530	33488330	8000	33485530	-4000	4000	2800
chr21	33481530	33489530	33488577	8000	33485530	-4000	4000	3047
chr21	33481530	33489530	33489376	8000	33485530	-4000	4000	3846
chr21	39925397	39933397	39929021	8000	39929397	-4000	4000	-376
chr21	44323376	44331376	44325150	8000	44327376	-4000	4000	-2226
chr21	34714227	34722227	34716403	8000	34718227	-4000	4000	-1824
chr21	32624759	32632759	32630965	8000	32628759	-4000	4000	2206
chr21	29532933	29540933	29537346	8000	29536933	-4000	4000	413
chr21	46001050	46009050	46001200	8000	46005050	-4000	4000	-3850
chr21	43758307	43766307	43759304	8000	43762307	-4000	4000	-3003
chr21	36290274	36298274	36293472	8000	36294274	-4000	4000	-802
chr21	46128848	46136848	46129199	8000	46132848	-4000	4000	-3649
chr21	26831755	26839755	26839721	8000	26835755	-4000	4000	3966
chr21	25768460	25776460	25769682	8000	25772460	-4000	4000	-2778
chr21	33499931	33507931	33504268	8000	33503931	-4000	4000	337
chr21	29171889	29179889	29174925	8000	29175889	-4000	4000	-964
chr21	36290274	36298274	36293674	8000	36294274	-4000	4000	-600
chr21	46001050	46009050	46002535	8000	46005050	-4000	4000	-2515
chr21	31667000	31675000	31667266	8000	31671000	-4000	4000	-3734
chr21	31664931	31672931	31666503	8000	31668931	-4000	4000	-2428
chr21	25581656	25589656	25587774	8000	25585656	-4000	4000	2118
chr21	34783801	34791801	34788403	8000	34787801	-4000	4000	602
chr21	36069166	36077166	36072864	8000	36073166	-4000	4000	-302
chr21	37058846	37066846	37065624	8000	37062846	-4000	4000	2778
chr21	33293160	33301160	33296236	8000	33297160	-4000	4000	-924
chr21	46128848	46136848	46132526	8000	46132848	-4000	4000	-322
chr21	14367115	14375115	14373666	8000	14371115	-4000	4000	2551
chr21	29000384	29008384	29006281	8000	29004384	-4000	4000	1897
chr21	38820955	38828955	38822715	8000	38824955	-4000	4000	-2240
chr21	36290274	36298274	36293338	8000	36294274	-4000	4000	-936
chr21	41735369	41743369	41740956	8000	41739369	-4000	4000	1587
chr21	36142562	36150562	36146484	8000	36146562	-4000	4000	-78
chr21	37219420	37227420	37221404	8000	37223420	-4000	4000	-2016
chr21	37015662	37023662	37017912	8000	37019662	-4000	4000	-1750
chr21	38376027	38384027	38383597	8000	38380027	-4000	4000	3570
chr21	41881112	41889112	41888990	8000	41885112	-4000	4000	3878
chr21	26831755	26839755	26837991	8000	26835755	-4000	4000	2236
chr21	32511397	32519397	32514822	8000	32515397	-4000	4000	-575
chr21	30210006	30218006	30214889	8000	30214006	-4000	4000	883
chr21	26831755	26839755	26838268	8000	26835755	-4000	4000	2513
chr21	32264228	32272228	32269014	8000	32268228	-4000	4000	786
chr21	32511397	32519397	32515084	8000	32515397	-4000	4000	-313
chr21	44881953	44889953	44889394	8000	44885953	-4000	4000	3441
chr21	14957235	14965235	14964937	8000	14961235	-4000	4000	3702
chr21	31667000	31675000	31667333	8000	31671000	-4000	4000	-3667
chr21	39401728	39409728	39405908	8000	39405728	-4000	4000	180
chr21	44881953	44889953	44888893	8000	44885953	-4000	4000	2940
chr21	46566015	46574015	46567747	8000	46570015	-4000	4000	-2268
chr21	41794225	41802225	41801321	8000	41798225	-4000	4000	3096
chr21	30210006	30218006	30215347	8000	30214006	-4000	4000	1341
chr21	26831755	26839755	26837927	8000	26835755	-4000	4000	2172
chr21	29171889	29179889	29174816	8000	29175889	-4000	4000	-1073
chr21	37199112	37207112	37200288	8000	37203112	-4000	4000	-2824
chr21	46566015	46574015	46566668	8000	46570015	-4000	4000	-3347
chr21	15876064	15884064	15878678	8000	15880064	-4000	4000	-1386
chr21	25768460	25776460	25769664	8000	25772460	-4000	4000	-2796
chr21	28924144	28932144	28930428	8000	28928144	-4000	4000	2284
chr21	31114416	31122416	31119682	8000	31118416	-4000	4000	1266
chr21	33580687	33588687	33582030	8000	33584687	-4000	4000	-2657
chr21	42293244	42301244	42294553	8000	42297244	-4000	4000	-2691
chr21	45938454	45946454	45940151	8000	45942454	-4000	4000	-2303
chr21	14224372	14232372	14224507	8000	14228372	-4000	4000	-3865
chr21	14481228	14489228	14486100	8000	14485228	-4000	4000	872
chr21	43029931	43037931	43030027	8000	43033931	-4000	4000	-3904
chr21	33573481	33581481	33579485	8000	33577481	-4000	4000	2004
chr21	46128848	46136848	46132489	8000	46132848	-4000	4000	-359
chr21	26831755	26839755	26839736	8000	26835755	-4000	4000	3981
chr21	46594604	46602604	46602314	8000	46598604	-4000	4000	3710
chr21	31114416	31122416	31120541	8000	31118416	-4000	4000	2125
chr21	36290274	36298274	36293699	8000	36294274	-4000	4000	-575
chr21	25768460	25776460	25769081	8000	25772460	-4000	4000	-3379
chr21	45259928	45267928	45267252	8000	45263928	-4000	4000	3324
chr21	46128848	46136848	46128994	8000	46132848	-4000	4000	-3854
chr21	34783801	34791801	34790893	8000	34787801	-4000	4000	3092
chr21	32729899	32737899	32734923	8000	32733899	-4000	4000	1024
chr21	26462209	26470209	26468618	8000	26466209	-4000	4000	2409
chr21	30210006	30218006	30215554	8000	30214006	-4000	4000	1548
chr21	30210006	30218006	30215821	8000	30214006	-4000	4000	1815
chr21	41405393	41413393	41408135	8000	41409393	-4000	4000	-1258
chr21	44845585	44853585	44851396	8000	44849585	-4000	4000	1811
chr21	45259928	45267928	45266222	8000	45263928	-4000	4000	2294
chr21	29532933	29540933	29537312	8000	29536933	-4000	4000	379
chr21	33293160	33301160	33296286	8000	33297160	-4000	4000	-874
chr21	46001050	46009050	46001363	8000	46005050	-4000	4000	-3687
chr21	14957235	14965235	14964828	8000	14961235	-4000	4000	3593
chr21	15876064	15884064	15877826	8000	15880064	-4000	4000	-2238
chr21	17589579	17597579	17593930	8000	17593579	-4000	4000	351
chr21	25876550	25884550	25881645	8000	25880550	-4000	4000	1095
chr21	32511397	32519397	32515286	8000	32515397	-4000	4000	-111
chr21	33499931	33507931	33505591	8000	33503931	-4000	4000	1660
chr21	33580687	33588687	33581413	8000	33584687	-4000	4000	-3274
chr21	33580687	33588687	33582217	8000	33584687	-4000	4000	-2470
chr21	38820955	38828955	38822805	8000	38824955	-4000	4000	-2150
chr21	30210006	30218006	30215542	8000	30214006	-4000	4000	1536
chr21	34714227	34722227	34716413	8000	34718227	-4000	4000	-1814
chr21	42293244	42301244	42296341	8000	42297244	-4000	4000	-903
chr21	44881953	44889953	44886241	8000	44885953	-4000	4000	288
chr21	33293160	33301160	33296363	8000	33297160	-4000	4000	-797
chr21	38376027	38384027	38383888	8000	38380027	-4000	4000	3861
chr21	43758307	43766307	43762081	8000	43762307	-4000	4000	-226
chr21	46594604	46602604	46602394	8000	46598604	-4000	4000	3790
chr21	33481530	33489530	33488824	8000	33485530	-4000	4000	3294
chr21	32624759	32632759	32630775	8000	32628759	-4000	4000	2016
chr21	39338315	39346315	39342328	8000	39342315	-4000	4000	13
chr21	14957235	14965235	14964865	8000	14961235	-4000	4000	3630
chr21	25768460	25776460	25769382	8000	25772460	-4000	4000	-3078
chr21	43758307	43766307	43761813	8000	43762307	-4000	4000	-494
chr21	25876550	25884550	25881726	8000	25880550	-4000	4000	1176
chr21	25876550	25884550	25881727	8000	25880550	-4000	4000	1177
chr21	32729899	32737899	32734106	8000	32733899	-4000	4000	207
chr21	46128848	46136848	46132343	8000	46132848	-4000	4000	-505
chr21	42468486	42476486	42476006	8000	42472486	-4000	4000	3520
chr21	43758307	43766307	43760079	8000	43762307	-4000	4000	-2228
chr21	33481530	33489530	33488547	8000	33485530	-4000	4000	3017
chr21	33580687	33588687	33583491	8000	33584687	-4000	4000	-1196
chr21	46128848	46136848	46128974	8000	46132848	-4000	4000	-3874
chr21	42307667	42315667	42312223	8000	42311667	-4000	4000	556
chr22	20583632	20591632	20584989	8000	20587632	-4000	4000	-2643
chr22	37675802	37683802	37678652	8000	37679802	-4000	4000	-1150
chr22	19126279	19134279	19132023	8000	19130279	-4000	4000	1744
chr22	20949747	20957747	20949773	8000	20953747	-4000	4000	-3974
chr22	39083743	39091743	39086341	8000	39087743	-4000	4000	-1402
chr22	32494829	32502829	32498726	8000	32498829	-4000	4000	-103
chr22	38479438	38487438	38482711	8000	38483438	-4000	4000	-727
chr22	19128622	19136622	19134299	8000	19132622	-4000	4000	1677
chr22	41176077	41184077	41179638	8000	41180077	-4000	4000	-439
chr22	21024718	21032718	21030916	8000	21028718	-4000	4000	2198
chr22	37966686	37974686	37973657	8000	37970686	-4000	4000	2971
chr22	40855549	40863549	40861379	8000	40859549	-4000	4000	1830
chr22	17112297	17120297	17117254	8000	17116297	-4000	4000	957
chr22	36136330	36144330	36141523	8000	36140330	-4000	4000	1193
chr22	42080284	42088284	42083251	8000	42084284	-4000	4000	-1033
chr22	50176295	50184295	50177651	8000	50180295	-4000	4000	-2644
chr22	32859041	32867041	32859343	8000	32863041	-4000	4000	-3698
chr22	20404461	20412461	20406084	8000	20408461	-4000	4000	-2377
chr22	31432977	31440977	31440787	8000	31436977	-4000	4000	3810
chr22	24438356	24446356	24441128	8000	24442356	-4000	4000	-1228
chr22	20237415	20245415	20242747	8000	20241415	-4000	4000	1332
chr22	26487225	26495225	26488258	8000	26491225	-4000	4000	-2967
chr22	28790555	28798555	28795035	8000	28794555	-4000	4000	480
chr22	19128622	19136622	19134281	8000	19132622	-4000	4000	1659
chr22	19128622	19136622	19134459	8000	19132622	-4000	4000	1837
chr22	23780316	23788316	23787148	8000	23784316	-4000	4000	2832
chr22	29727833	29735833	29729166	8000	29731833	-4000	4000	-2667
chr22	31130807	31138807	31133485	8000	31134807	-4000	4000	-1322
chr22	37813176	37821176	37815796	8000	37817176	-4000	4000	-1380
chr22	29053488	29061488	29059045	8000	29057488	-4000	4000	1557
chr22	37885407	37893407	37886780	8000	37889407	-4000	4000	-2627
chr22	37966686	37974686	37973992	8000	37970686	-4000	4000	3306
chr22	38988778	38996778	38992513	8000	38992778	-4000	4000	-265
chr22	39488194	39496194	39488970	8000	39492194	-4000	4000	-3224
chr22	50520780	50528780	50522876	8000	50524780	-4000	4000	-1904
chr22	38988778	38996778	38991500	8000	38992778	-4000	4000	-1278
chr22	36936439	36944439	36937992	8000	36940439	-4000	4000	-2447
chr22	36874017	36882017	36877783	8000	36878017	-4000	4000	-234
chr22	21447463	21455463	21450764	8000	21451463	-4000	4000	-699
chr22	24536423	24544423	24542971	8000	24540423	-4000	4000	2548
chr22	50482440	50490440	50483310	8000	50486440	-4000	4000	-3130
chr22	19445911	19453911	19450854	8000	19449911	-4000	4000	943
chr22	36222209	36230209	36228038	8000	36226209	-4000	4000	1829
chr22	45291874	45299874	45293224	8000	45295874	-4000	4000	-2650
chr22	36874017	36882017	36877837	8000	36878017	-4000	4000	-180
chr22	41395326	41403326	41399071	8000	41399326	-4000	4000	-255
chr22	39488194	39496194	39488456	8000	39492194	-4000	4000	-3738
chr22	41994221	42002221	41997898	8000	41998221	-4000	4000	-323
chr22	44877162	44885162	44882962	8000	44881162	-4000	4000	1800
chr22	39488194	39496194	39488224	8000	39492194	-4000	4000	-3970
chr22	50055391	50063391	50061604	8000	50059391	-4000	4000	2213
chr22	24581620	24589620	24588261	8000	24585620	-4000	4000	2641
chr22	20404461	20412461	20405677	8000	20408461	-4000	4000	-2784
chr22	19032282	19040282	19039043	8000	19036282	-4000	4000	2761
chr22	37675802	37683802	37677038	8000	37679802	-4000	4000	-2764
chr22	37363960	37371960	37371509	8000	37367960	-4000	4000	3549
chr22	31432977	31440977	31439669	8000	31436977	-4000	4000	2692
chr22	40855549	40863549	40861261	8000	40859549	-4000	4000	1712
chr22	45291874	45299874	45293242	8000	45295874	-4000	4000	-2632
chr22	36483190	36491190	36490236	8000	36487190	-4000	4000	3046
chr22	45184017	45192017	45186761	8000	45188017	-4000	4000	-1256
chr22	46326810	46334810	46330697	8000	46330810	-4000	4000	-113
chr22	20237415	20245415	20242567	8000	20241415	-4000	4000	1152
chr22	31526634	31534634	31531055	8000	31530634	-4000	4000	421
chr22	22643898	22651898	22647638	8000	22647898	-4000	4000	-260
chr22	29766413	29774413	29767510	8000	29770413	-4000	4000	-2903
chr22	36185124	36193124	36191879	8000	36189124	-4000	4000	2755
chr22	50574959	50582959	50576992	8000	50578959	-4000	4000	-1967
chr22	22543701	22551701	22548177	8000	22547701	-4000	4000	476
chr22	19720224	19728224	19720651	8000	19724224	-4000	4000	-3573
chr22	36936439	36944439	36938422	8000	36940439	-4000	4000	-2017
chr22	26027045	26035045	26027230	8000	26031045	-4000	4000	-3815
chr22	40678812	40686812	40679432	8000	40682812	-4000	4000	-3380
chr22	50259713	50267713	50266794	8000	50263713	-4000	4000	3081
chr22	22543701	22551701	22548481	8000	22547701	-4000	4000	780
chr22	24438356	24446356	24441043	8000	24442356	-4000	4000	-1313
chr22	24438356	24446356	24441044	8000	24442356	-4000	4000	-1312
chr22	45841307	45849307	45843712	8000	45845307	-4000	4000	-1595
chr22	46353340	46361340	46355571	8000	46357340	-4000	4000	-1769
chr22	49886080	49894080	49887395	8000	49890080	-4000	4000	-2685
chr22	43035516	43043516	43039844	8000	43039516	-4000	4000	328
chr22	26487225	26495225	26488162	8000	26491225	-4000	4000	-3063
chr22	50441090	50449090	50448551	8000	50445090	-4000	4000	3461
chr22	21024718	21032718	21031419	8000	21028718	-4000	4000	2701
chr22	29694598	29702598	29694912	8000	29698598	-4000	4000	-3686
chr22	19128622	19136622	19134334	8000	19132622	-4000	4000	1712
chr22	38669850	38677850	38671110	8000	38673850	-4000	4000	-2740
chr22	38107495	38115495	38113502	8000	38111495	-4000	4000	2007
chr22	38107495	38115495	38110568	8000	38111495	-4000	4000	-927
chr22	40331808	40339808	40334433	8000	40335808	-4000	4000	-1375
chr22	23055415	23063415	23059519	8000	23059415	-4000	4000	104
chr22	45337955	45345955	45344624	8000	45341955	-4000	4000	2669
chr22	50618754	50626754	50625401	8000	50622754	-4000	4000	2647
chr22	36263530	36271530	36265452	8000	36267530	-4000	4000	-2078
chr22	41994221	42002221	41997210	8000	41998221	-4000	4000	-1011
chr22	45597135	45605135	45600580	8000	45601135	-4000	4000	-555
chr22	49886080	49894080	49886857	8000	49890080	-4000	4000	-3223
chr22	44877162	44885162	44883270	8000	44881162	-4000	4000	2108
chr22	17726855	17734855	17727144	8000	17730855	-4000	4000	-3711
chr22	21024718	21032718	21026485	8000	21028718	-4000	4000	-2233
chr22	21447463	21455463	21447955	8000	21451463	-4000	4000	-3508
chr22	28790555	28798555	28795061	8000	28794555	-4000	4000	506
chr22	29487390	29495390	29489297	8000	29491390	-4000	4000	-2093
chr22	29766413	29774413	29767507	8000	29770413	-4000	4000	-2906
chr22	30903824	30911824	30906782	8000	30907824	-4000	4000	-1042
chr22	32859041	32867041	32864998	8000	32863041	-4000	4000	1957
chr22	28790555	28798555	28795006	8000	28794555	-4000	4000	451
chr22	17112297	17120297	17119282	8000	17116297	-4000	4000	2985
chr22	43125712	43133712	43133370	8000	43129712	-4000	4000	3658
chr22	23121032	23129032	23123192	8000	23125032	-4000	4000	-1840
chr22	44877162	44885162	44883081	8000	44881162	-4000	4000	1919
chr22	23055415	23063415	23059639	8000	23059415	-4000	4000	224
chr22	20583632	20591632	20584410	8000	20587632	-4000	4000	-3222
chr22	21467269	21475269	21469718	8000	21471269	-4000	4000	-1551
chr22	23780316	23788316	23787036	8000	23784316	-4000	4000	2720
chr22	28785301	28793301	28786789	8000	28789301	-4000	4000	-2512
chr22	29766413	29774413	29767510	8000	29770413	-4000	4000	-2903
chr22	30903824	30911824	30907333	8000	30907824	-4000	4000	-491
chr22	36796684	36804684	36800729	8000	36800684	-4000	4000	45
chr22	38681543	38689543	38686466	8000	38685543	-4000	4000	923
chr22	50574959	50582959	50577840	8000	50578959	-4000	4000	-1119
chr22	19445911	19453911	19450798	8000	19449911	-4000	4000	887
chr22	22892111	22900111	22893806	8000	22896111	-4000	4000	-2305
chr22	36263530	36271530	36265411	8000	36267530	-4000	4000	-2119
chr22	50176295	50184295	50176950	8000	50180295	-4000	4000	-3345
chr22	50618754	50626754	50625391	8000	50622754	-4000	4000	2637
chr22	38107495	38115495	38110571	8000	38111495	-4000	4000	-924
chr22	23695176	23703176	23698219	8000	23699176	-4000	4000	-957
chr22	17586995	17594995	17587220	8000	17590995	-4000	4000	-3775
chr22	23055415	23063415	23059506	8000	23059415	-4000	4000	91
chr22	37025821	37033821	37029502	8000	37029821	-4000	4000	-319
chr22	46240011	46248011	46244971	8000	46244011	-4000	4000	960
chr22	17133511	17141511	17138579	8000	17137511	-4000	4000	1068
chr22	22543701	22551701	22550245	8000	22547701	-4000	4000	2544
chr22	19720224	19728224	19720664	8000	19724224	-4000	4000	-3560
chr22	43524744	43532744	43530879	8000	43528744	-4000	4000	2135
chr22	22543701	22551701	22548328	8000	22547701	-4000	4000	627
chr22	28790555	28798555	28795162	8000	28794555	-4000	4000	607
chr22	35390214	35398214	35393972	8000	35394214	-4000	4000	-242
chr22	45337955	45345955	45345482	8000	45341955	-4000	4000	3527
chr22	20144007	20152007	20145292	8000	20148007	-4000	4000	-2715
chr22	19516612	19524612	19524096	8000	19520612	-4000	4000	3484
chr22	22643898	22651898	22646375	8000	22647898	-4000	4000	-1523
chr22	50618754	50626754	50625664	8000	50622754	-4000	4000	2910
chr22	35390214	35398214	35393496	8000	35394214	-4000	4000	-718
chr22	37939050	37947050	37945128	8000	37943050	-4000	4000	2078
chr22	46240011	46248011	46245096	8000	46244011	-4000	4000	1085
chr22	50055391	50063391	50061572	8000	50059391	-4000	4000	2181
chr22	36936439	36944439	36938634	8000	36940439	-4000	4000	-1805
chr22	40039534	40047534	40044952	8000	40043534	-4000	4000	1418
chr22	35734736	35742736	35738906	8000	35738736	-4000	4000	170
chr22	38669850	38677850	38670636	8000	38673850	-4000	4000	-3214
chr22	40855549	40863549	40861700	8000	40859549	-4000	4000	2151
chr22	41994221	42002221	41994838	8000	41998221	-4000	4000	-3383
chr22	31130807	31138807	31136983	8000	31134807	-4000	4000	2176
chr22	19871517	19879517	19878391	8000	19875517	-4000	4000	2874
chr22	49886080	49894080	49886859	8000	49890080	-4000	4000	-3221
chr22	29766413	29774413	29767543	8000	29770413	-4000	4000	-2870
chr22	26487225	26495225	26488142	8000	26491225	-4000	4000	-3083
chr22	26439423	26447423	26443165	8000	26443423	-4000	4000	-258
chr22	17174790	17182790	17181897	8000	17178790	-4000	4000	3107
chr22	50609981	50617981	50610872	8000	50613981	-4000	4000	-3109
chr22	17174790	17182790	17181440	8000	17178790	-4000	4000	2650
chr22	22643898	22651898	22647228	8000	22647898	-4000	4000	-670
chr22	42570382	42578382	42571301	8000	42574382	-4000	4000	-3081
chr22	17726855	17734855	17727157	8000	17730855	-4000	4000	-3698
chr22	19720224	19728224	19721881	8000	19724224	-4000	4000	-2343
chr22	20237415	20245415	20242056	8000	20241415	-4000	4000	641
chr22	22892111	22900111	22893724	8000	22896111	-4000	4000	-2387
chr22	29487390	29495390	29490723	8000	29491390	-4000	4000	-667
chr22	36222209	36230209	36227761	8000	36226209	-4000	4000	1552
chr22	36222209	36230209	36228121	8000	36226209	-4000	4000	1912
chr22	36874017	36882017	36875967	8000	36878017	-4000	4000	-2050
chr22	38107495	38115495	38109145	8000	38111495	-4000	4000	-2350
chr22	39488194	39496194	39488606	8000	39492194	-4000	4000	-3588
chr22	41429494	41437494	41437040	8000	41433494	-4000	4000	3546
chr22	41795456	41803456	41799420	8000	41799456	-4000	4000	-36
chr22	41994221	42002221	41996929	8000	41998221	-4000	4000	-1292
chr22	41994221	42002221	41997083	8000	41998221	-4000	4000	-1138
chr22	49923540	49931540	49927421	8000	49927540	-4000	4000	-119
chr22	50176295	50184295	50177606	8000	50180295	-4000	4000	-2689
chr22	50305030	50313030	50312184	8000	50309030	-4000	4000	3154
chr22	50441090	50449090	50447423	8000	50445090	-4000	4000	2333
chr22	50547023	50555023	50548338	8000	50551023	-4000	4000	-2685
chr22	22543701	22551701	22548257	8000	22547701	-4000	4000	556
chr22	50547023	50555023	50549498	8000	50551023	-4000	4000	-1525
chr22	37675802	37683802	37679648	8000	37679802	-4000	4000	-154
chr22	42054456	42062456	42060263	8000	42058456	-4000	4000	1807
chr22	45337955	45345955	45340747	8000	45341955	-4000	4000	-1208
chr22	42831412	42839412	42831638	8000	42835412	-4000	4000	-3774
chr22	19432075	19440075	19434816	8000	19436075	-4000	4000	-1259
chr22	20977360	20985360	20979575	8000	20981360	-4000	4000	-1785
chr22	21024718	21032718	21031059	8000	21028718	-4000	4000	2341
chr22	21024718	21032718	21031498	8000	21028718	-4000	4000	2780
chr22	22643898	22651898	22647778	8000	22647898	-4000	4000	-120
chr22	29487390	29495390	29489322	8000	29491390	-4000	4000	-2068
chr22	29766413	29774413	29767506	8000	29770413	-4000	4000	-2907
chr22	32109029	32117029	32110386	8000	32113029	-4000	4000	-2643
chr22	37311341	37319341	37313482	8000	37315341	-4000	4000	-1859
chr22	38988778	38996778	38991540	8000	38992778	-4000	4000	-1238
chr22	40855549	40863549	40861853	8000	40859549	-4000	4000	2304
chr22	43820509	43828509	43826036	8000	43824509	-4000	4000	1527
chr22	50574959	50582959	50576269	8000	50578959	-4000	4000	-2690
chr22	20949747	20957747	20949919	8000	20953747	-4000	4000	-3828
chr22	50729298	50737298	50731773	8000	50733298	-4000	4000	-1525
chr22	36263530	36271530	36265698	8000	36267530	-4000	4000	-1832
chr22	19128622	19136622	19134322	8000	19132622	-4000	4000	1700
chr22	19432075	19440075	19435737	8000	19436075	-4000	4000	-338
chr22	23780316	23788316	23782473	8000	23784316	-4000	4000	-1843
chr22	40406281	40414281	40411867	8000	40410281	-4000	4000	1586
chr22	50618754	50626754	50626231	8000	50622754	-4000	4000	3477
chr22	21447463	21455463	21450628	8000	21451463	-4000	4000	-835
chr22	22480421	22488421	22488138	8000	22484421	-4000	4000	3717
chr22	36136330	36144330	36141383	8000	36140330	-4000	4000	1053
chr22	22480421	22488421	22487949	8000	22484421	-4000	4000	3528
chr22	22543701	22551701	22550203	8000	22547701	-4000	4000	2502
chr22	29487390	29495390	29489323	8000	29491390	-4000	4000	-2067
chr22	39969721	39977721	39970918	8000	39973721	-4000	4000	-2803
chr22	37803432	37811432	37810084	8000	37807432	-4000	4000	2652
chr22	22643898	22651898	22647713	8000	22647898	-4000	4000	-185
chr22	23780316	23788316	23780467	8000	23784316	-4000	4000	-3849
chr22	26027045	26035045	26027583	8000	26031045	-4000	4000	-3462
chr22	32859041	32867041	32859245	8000	32863041	-4000	4000	-3796
chr22	36222209	36230209	36227891	8000	36226209	-4000	4000	1682
chr22	39051972	39059972	39052749	8000	39055972	-4000	4000	-3223
chr22	30903824	30911824	30906283	8000	30907824	-4000	4000	-1541
chr22	40406281	40414281	40410505	8000	40410281	-4000	4000	224
chr22	32494829	32502829	32495519	8000	32498829	-4000	4000	-3310
chr22	50482440	50490440	50483272	8000	50486440	-4000	4000	-3168
chr22	23121032	23129032	23123231	8000	23125032	-4000	4000	-1801
chr22	30903824	30911824	30905885	8000	30907824	-4000	4000	-1939
chr22	38212507	38220507	38219476	8000	38216507	-4000	4000	2969
chr22	39518683	39526683	39522687	8000	39522683	-4000	4000	4
chr22	37025821	37033821	37029412	8000	37029821	-4000	4000	-409
chr22	38681543	38689543	38683777	8000	38685543	-4000	4000	-1766
chr22	26027045	26035045	26027504	8000	26031045	-4000	4000	-3541
chr22	50763501	50771501	50768833	8000	50767501	-4000	4000	1332
chr22	17586995	17594995	17594585	8000	17590995	-4000	4000	3590
chr22	50498949	50506949	50506796	8000	50502949	-4000	4000	3847
chr22	19779223	19787223	19782915	8000	19783223	-4000	4000	-308
chr22	19432075	19440075	19435695	8000	19436075	-4000	4000	-380
chr22	37803432	37811432	37810077	8000	37807432	-4000	4000	2645
chr22	37939050	37947050	37944193	8000	37943050	-4000	4000	1143
chr22	40855549	40863549	40862055	8000	40859549	-4000	4000	2506
chr22	45428509	45436509	45431008	8000	45432509	-4000	4000	-1501
chr22	49923540	49931540	49927374	8000	49927540	-4000	4000	-166
chr22	24438356	24446356	24441758	8000	24442356	-4000	4000	-598
chr22	23780316	23788316	23782336	8000	23784316	-4000	4000	-1980
chr22	40678812	40686812	40681008	8000	40682812	-4000	4000	-1804
chr22	37311341	37319341	37313642	8000	37315341	-4000	4000	-1699
chr22	29487390	29495390	29490074	8000	29491390	-4000	4000	-1316
chr22	40855549	40863549	40857212	8000	40859549	-4000	4000	-2337
chr22	37363960	37371960	37371193	8000	37367960	-4000	4000	3233
chr22	20887214	20895214	20887863	8000	20891214	-4000	4000	-3351
chr22	23780316	23788316	23782155	8000	23784316	-4000	4000	-2161
chr22	30903824	30911824	30906549	8000	30907824	-4000	4000	-1275
chr22	36936439	36944439	36938074	8000	36940439	-4000	4000	-2365
chr22	19326698	19334698	19331183	8000	19330698	-4000	4000	485
chr22	44877162	44885162	44881698	8000	44881162	-4000	4000	536
chr22	44877162	44885162	44882264	8000	44881162	-4000	4000	1102
chr22	49923540	49931540	49927337	8000	49927540	-4000	4000	-203
chr22	41240779	41248779	41246543	8000	41244779	-4000	4000	1764
chrX	65737931	65745931	65738972	8000	65741931	-4000	4000	-2959
chrX	71140103	71148103	71148044	8000	71144103	-4000	4000	3941
chrX	54444032	54452032	54444635	8000	54448032	-4000	4000	-3397
chrX	70501490	70509490	70503778	8000	70505490	-4000	4000	-1712
chrX	78959727	78967727	78961111	8000	78963727	-4000	4000	-2616
chrX	152723484	152731484	152727662	8000	152727484	-4000	4000	178
chrX	78959727	78967727	78960530	8000	78963727	-4000	4000	-3197
chrX	120621674	120629674	120626515	8000	120625674	-4000	4000	841
chrX	17796049	17804049	17801068	8000	17800049	-4000	4000	1019
chrX	70035472	70043472	70041951	8000	70039472	-4000	4000	2479
chrX	71235624	71243624	71242410	8000	71239624	-4000	4000	2786
chrX	78959727	78967727	78961191	8000	78963727	-4000	4000	-2536
chrX	154831788	154839788	154837639	8000	154835788	-4000	4000	1851
chrX	54812015	54820015	54814456	8000	54816015	-4000	4000	-1559
chrX	136043269	136051269	136044536	8000	136047269	-4000	4000	-2733
chrX	17796049	17804049	17800612	8000	17800049	-4000	4000	563
chrX	1306381	1314381	1309445	8000	1310381	-4000	4000	-936
chrX	2930045	2938045	2934921	8000	2934045	-4000	4000	876
chrX	11771772	11779772	11772194	8000	11775772	-4000	4000	-3578
chrX	12919169	12927169	12919464	8000	12923169	-4000	4000	-3705
chrX	14002726	14010726	14009168	8000	14006726	-4000	4000	2442
chrX	47089314	47097314	47092995	8000	47093314	-4000	4000	-319
chrX	53076615	53084615	53077396	8000	53080615	-4000	4000	-3219
chrX	55480616	55488616	55488017	8000	55484616	-4000	4000	3401
chrX	57114551	57122551	57119774	8000	57118551	-4000	4000	1223
chrX	72298926	72306926	72302111	8000	72302926	-4000	4000	-815
chrX	103305346	103313346	103309949	8000	103309346	-4000	4000	603
chrX	103374164	103382164	103377640	8000	103378164	-4000	4000	-524
chrX	153505546	153513546	153508385	8000	153509546	-4000	4000	-1161
chrX	23782210	23790210	23783848	8000	23786210	-4000	4000	-2362
chrX	102600159	102608159	102603512	8000	102604159	-4000	4000	-647
chrX	11119086	11127086	11121823	8000	11123086	-4000	4000	-1263
chrX	17796049	17804049	17800447	8000	17800049	-4000	4000	398
chrX	51486011	51494011	51491553	8000	51490011	-4000	4000	1542
chrX	135578510	135586510	135581615	8000	135582510	-4000	4000	-895
chrX	40644305	40652305	40647031	8000	40648305	-4000	4000	-1274
chrX	121046094	121054094	121047916	8000	121050094	-4000	4000	-2178
chrX	155056304	155064304	155064006	8000	155060304	-4000	4000	3702
chrX	101341661	101349661	101348585	8000	101345661	-4000	4000	2924
chrX	18649629	18657629	18656669	8000	18653629	-4000	4000	3040
chrX	54927431	54935431	54933871	8000	54931431	-4000	4000	2440
chrX	70035472	70043472	70042204	8000	70039472	-4000	4000	2732
chrX	78267468	78275468	78272946	8000	78271468	-4000	4000	1478
chrX	85089315	85097315	85094166	8000	85093315	-4000	4000	851
chrX	40644305	40652305	40647039	8000	40648305	-4000	4000	-1266
chrX	48969720	48977720	48969767	8000	48973720	-4000	4000	-3953
chrX	135029546	135037546	135032977	8000	135033546	-4000	4000	-569
chrX	151921171	151929171	151924469	8000	151925171	-4000	4000	-702
chrX	17731994	17739994	17732445	8000	17735994	-4000	4000	-3549
chrX	124418664	124426664	124422386	8000	124422664	-4000	4000	-278
chrX	116457458	116465458	116459237	8000	116461458	-4000	4000	-2221
chrX	131269506	131277506	131275555	8000	131273506	-4000	4000	2049
chrX	1399139	1407139	1403383	8000	1403139	-4000	4000	244
chrX	101651281	101659281	101655664	8000	101655281	-4000	4000	383
chrX	51898354	51906354	51901820	8000	51902354	-4000	4000	-534
chrX	55449566	55457566	55453106	8000	55453566	-4000	4000	-460
chrX	24999694	25007694	25004639	8000	25003694	-4000	4000	945
chrX	40644305	40652305	40651835	8000	40648305	-4000	4000	3530
chrX	1306381	1314381	1309527	8000	1310381	-4000	4000	-854
chrX	57593477	57601477	57594630	8000	57597477	-4000	4000	-2847
chrX	69156851	69164851	69163218	8000	69160851	-4000	4000	2367
chrX	46878358	46886358	46881545	8000	46882358	-4000	4000	-813
chrX	101550700	101558700	101554245	8000	101554700	-4000	4000	-455
chrX	134765566	134773566	134772210	8000	134769566	-4000	4000	2644
chrX	20145911	20153911	20151088	8000	20149911	-4000	4000	1177
chrX	72298926	72306926	72305311	8000	72302926	-4000	4000	2385
chrX	111289779	111297779	111295127	8000	111293779	-4000	4000	1348
chrX	101651281	101659281	101655967	8000	101655281	-4000	4000	686
chrX	71528374	71536374	71529923	8000	71532374	-4000	4000	-2451
chrX	23782210	23790210	23783865	8000	23786210	-4000	4000	-2345
chrX	47441178	47449178	47447614	8000	47445178	-4000	4000	2436
chrX	149544210	149552210	149546788	8000	149548210	-4000	4000	-1422
chrX	151921171	151929171	151924279	8000	151925171	-4000	4000	-892
chrX	132071943	132079943	132077650	8000	132075943	-4000	4000	1707
chrX	17796049	17804049	17801704	8000	17800049	-4000	4000	1655
chrX	72200657	72208657	72205008	8000	72204657	-4000	4000	351
chrX	119611724	119619724	119618632	8000	119615724	-4000	4000	2908
chrX	153056467	153064467	153058535	8000	153060467	-4000	4000	-1932
chrX	120621674	120629674	120626396	8000	120625674	-4000	4000	722
chrX	46878358	46886358	46881489	8000	46882358	-4000	4000	-869
chrX	76427342	76435342	76430128	8000	76431342	-4000	4000	-1214
chrX	101389273	101397273	101392160	8000	101393273	-4000	4000	-1113
chrX	133531745	133539745	133535784	8000	133535745	-4000	4000	39
chrX	85269362	85277362	85270668	8000	85273362	-4000	4000	-2694
chrX	13766939	13774939	13772815	8000	13770939	-4000	4000	1876
chrX	47441178	47449178	47448751	8000	47445178	-4000	4000	3573
chrX	51742232	51750232	51744801	8000	51746232	-4000	4000	-1431
chrX	102600159	102608159	102603344	8000	102604159	-4000	4000	-815
chrX	135359413	135367413	135359912	8000	135363413	-4000	4000	-3501
chrX	1399139	1407139	1403447	8000	1403139	-4000	4000	308
chrX	142198342	142206342	142203954	8000	142202342	-4000	4000	1612
chrX	81109699	81117699	81114954	8000	81113699	-4000	4000	1255
chrX	101345447	101353447	101353237	8000	101349447	-4000	4000	3790
chrX	101408297	101416297	101413483	8000	101412297	-4000	4000	1186
chrX	154483306	154491306	154487669	8000	154487306	-4000	4000	363
chrX	300529	308529	307460	8000	304529	-4000	4000	2931
chrX	132071943	132079943	132078561	8000	132075943	-4000	4000	2618
chrX	152723484	152731484	152727647	8000	152727484	-4000	4000	163
chrX	106204956	106212956	106206858	8000	106208956	-4000	4000	-2098
chrX	134883632	134891632	134889129	8000	134887632	-4000	4000	1497
chrX	51742232	51750232	51745257	8000	51746232	-4000	4000	-975
chrX	101408297	101416297	101413321	8000	101412297	-4000	4000	1024
chrX	47211128	47219128	47211225	8000	47215128	-4000	4000	-3903
chrX	102600159	102608159	102603440	8000	102604159	-4000	4000	-719
chrX	44143872	44151872	44148819	8000	44147872	-4000	4000	947
chrX	155778459	155786459	155779323	8000	155782459	-4000	4000	-3136
chrX	2899972	2907972	2907340	8000	2903972	-4000	4000	3368
chrX	17731994	17739994	17732326	8000	17735994	-4000	4000	-3668
chrX	17796049	17804049	17801625	8000	17800049	-4000	4000	1576
chrX	47441178	47449178	47447432	8000	47445178	-4000	4000	2254
chrX	47619172	47627172	47619776	8000	47623172	-4000	4000	-3396
chrX	54927431	54935431	54927734	8000	54931431	-4000	4000	-3697
chrX	64911802	64919802	64918920	8000	64915802	-4000	4000	3118
chrX	72200657	72208657	72205625	8000	72204657	-4000	4000	968
chrX	76427342	76435342	76429147	8000	76431342	-4000	4000	-2195
chrX	121046094	121054094	121049458	8000	121050094	-4000	4000	-636
chrX	124418664	124426664	124422516	8000	124422664	-4000	4000	-148
chrX	131085885	131093885	131088765	8000	131089885	-4000	4000	-1120
chrX	153798166	153806166	153803598	8000	153802166	-4000	4000	1432
chrX	12886361	12894361	12887309	8000	12890361	-4000	4000	-3052
chrX	76174314	76182314	76177730	8000	76178314	-4000	4000	-584
chrX	152698347	152706347	152701363	8000	152702347	-4000	4000	-984
chrX	72123110	72131110	72129931	8000	72127110	-4000	4000	2821
chrX	91434584	91442584	91435650	8000	91438584	-4000	4000	-2934
chrX	139722346	139730346	139728825	8000	139726346	-4000	4000	2479
chrX	136207359	136215359	136210075	8000	136211359	-4000	4000	-1284
chrX	102655083	102663083	102657343	8000	102659083	-4000	4000	-1740
chrX	3304565	3312565	3310522	8000	3308565	-4000	4000	1957
chrX	21881423	21889423	21882615	8000	21885423	-4000	4000	-2808
chrX	41693275	41701275	41696007	8000	41697275	-4000	4000	-1268
chrX	46493422	46501422	46500341	8000	46497422	-4000	4000	2919
chrX	49164483	49172483	49165298	8000	49168483	-4000	4000	-3185
chrX	51742232	51750232	51744906	8000	51746232	-4000	4000	-1326
chrX	70282595	70290595	70283574	8000	70286595	-4000	4000	-3021
chrX	78267468	78275468	78273239	8000	78271468	-4000	4000	1771
chrX	78267468	78275468	78273671	8000	78271468	-4000	4000	2203
chrX	131085885	131093885	131088645	8000	131089885	-4000	4000	-1240
chrX	135578510	135586510	135579952	8000	135582510	-4000	4000	-2558
chrX	154446654	154454654	154448494	8000	154450654	-4000	4000	-2160
chrX	153056467	153064467	153058535	8000	153060467	-4000	4000	-1932
chrX	134561838	134569838	134566625	8000	134565838	-4000	4000	787
chrX	1382152	1390152	1389512	8000	1386152	-4000	4000	3360
chrX	21881423	21889423	21882516	8000	21885423	-4000	4000	-2907
chrX	78125748	78133748	78130708	8000	78129748	-4000	4000	960
chrX	49201063	49209063	49205670	8000	49205063	-4000	4000	607
chrX	70501490	70509490	70504517	8000	70505490	-4000	4000	-973
chrX	102136426	102144426	102140500	8000	102140426	-4000	4000	74
chrX	123596561	123604561	123600777	8000	123600561	-4000	4000	216
chrX	150510178	150518178	150512504	8000	150514178	-4000	4000	-1674
chrX	136508346	136516346	136509112	8000	136512346	-4000	4000	-3234
chrX	153647326	153655326	153650147	8000	153651326	-4000	4000	-1179
chrX	77500880	77508880	77507247	8000	77504880	-4000	4000	2367
chrX	47582789	47590789	47583470	8000	47586789	-4000	4000	-3319
chrX	57593477	57601477	57594447	8000	57597477	-4000	4000	-3030
chrX	66591637	66599637	66599628	8000	66595637	-4000	4000	3991
chrX	54927431	54935431	54928643	8000	54931431	-4000	4000	-2788
chrX	102509682	102517682	102513987	8000	102513682	-4000	4000	305
chrX	132071943	132079943	132077650	8000	132075943	-4000	4000	1707
chrX	132622015	132630015	132628489	8000	132626015	-4000	4000	2474
chrX	78267468	78275468	78273042	8000	78271468	-4000	4000	1574
chrX	102655083	102663083	102656062	8000	102659083	-4000	4000	-3021
chrX	103788619	103796619	103789379	8000	103792619	-4000	4000	-3240
chrX	47441178	47449178	47448344	8000	47445178	-4000	4000	3166
chrX	78267468	78275468	78273336	8000	78271468	-4000	4000	1868
chrX	46493422	46501422	46499599	8000	46497422	-4000	4000	2177
chrX	73208299	73216299	73213941	8000	73212299	-4000	4000	1642
chrX	38145336	38153336	38149596	8000	38149336	-4000	4000	260
chrX	102509682	102517682	102514122	8000	102513682	-4000	4000	440
chrX	64911802	64919802	64917186	8000	64915802	-4000	4000	1384
chrX	12919169	12927169	12920856	8000	12923169	-4000	4000	-2313
chrX	51742232	51750232	51744596	8000	51746232	-4000	4000	-1636
chrX	153665733	153673733	153672143	8000	153669733	-4000	4000	2410
chrX	53076615	53084615	53076996	8000	53080615	-4000	4000	-3619
chrX	100595885	100603885	100599790	8000	100599885	-4000	4000	-95
chrX	101341661	101349661	101348786	8000	101345661	-4000	4000	3125
chrX	101611118	101619118	101616491	8000	101615118	-4000	4000	1373
chrX	131085885	131093885	131088656	8000	131089885	-4000	4000	-1229
chrX	152733669	152741669	152737164	8000	152737669	-4000	4000	-505
chrX	153056467	153064467	153057885	8000	153060467	-4000	4000	-2582
chrX	152822994	152830994	152827705	8000	152826994	-4000	4000	711
chrX	153071019	153079019	153073694	8000	153075019	-4000	4000	-1325
chrX	71099532	71107532	71101416	8000	71103532	-4000	4000	-2116
chrX	119587083	119595083	119590271	8000	119591083	-4000	4000	-812
chrX	152698347	152706347	152701953	8000	152702347	-4000	4000	-394
chrX	152762136	152770136	152766530	8000	152766136	-4000	4000	394
chrX	71611916	71619916	71612882	8000	71615916	-4000	4000	-3034
chrX	54744918	54752918	54751276	8000	54748918	-4000	4000	2358
chrX	49109407	49117407	49115925	8000	49113407	-4000	4000	2518
chrX	149544210	149552210	149545845	8000	149548210	-4000	4000	-2365
chrX	23782210	23790210	23785782	8000	23786210	-4000	4000	-428
chrX	76427342	76435342	76429120	8000	76431342	-4000	4000	-2222
chrX	111756649	111764649	111759913	8000	111760649	-4000	4000	-736
chrX	154405168	154413168	154405587	8000	154409168	-4000	4000	-3581
chrX	135046932	135054932	135052047	8000	135050932	-4000	4000	1115
chrX	75047048	75055048	75053488	8000	75051048	-4000	4000	2440
chrX	14002726	14010726	14009014	8000	14006726	-4000	4000	2288
chrX	135029546	135037546	135033462	8000	135033546	-4000	4000	-84
chrX	65737931	65745931	65739837	8000	65741931	-4000	4000	-2094
chrX	3304565	3312565	3309559	8000	3308565	-4000	4000	994
chrX	150986771	150994771	150987846	8000	150990771	-4000	4000	-2925
chrX	153665733	153673733	153671822	8000	153669733	-4000	4000	2089
chrX	112770503	112778503	112778418	8000	112774503	-4000	4000	3915
chrX	121046094	121054094	121048552	8000	121050094	-4000	4000	-1542
chrX	149592556	149600556	149597961	8000	149596556	-4000	4000	1405
chrX	150986771	150994771	150988085	8000	150990771	-4000	4000	-2686
chrX	147947125	147955125	147949344	8000	147951125	-4000	4000	-1781
chrX	142198342	142206342	142202945	8000	142202342	-4000	4000	603
chrX	72123110	72131110	72131035	8000	72127110	-4000	4000	3925
chrX	21650695	21658695	21657474	8000	21654695	-4000	4000	2779
chrX	142198342	142206342	142203770	8000	142202342	-4000	4000	1428
chrX	57593477	57601477	57593657	8000	57597477	-4000	4000	-3820
chrX	72123110	72131110	72129761	8000	72127110	-4000	4000	2651
chrX	3304565	3312565	3310986	8000	3308565	-4000	4000	2421
chrX	108075184	108083184	108077081	8000	108079184	-4000	4000	-2103
chrX	132071943	132079943	132077650	8000	132075943	-4000	4000	1707
chrX	57485193	57493193	57488821	8000	57489193	-4000	4000	-372
chrX	103305346	103313346	103309509	8000	103309346	-4000	4000	163
chrX	85089315	85097315	85093191	8000	85093315	-4000	4000	-124
chrX	47582789	47590789	47585063	8000	47586789	-4000	4000	-1726
chrX	103818327	103826327	103825703	8000	103822327	-4000	4000	3376
chrX	1458581	1466581	1466217	8000	1462581	-4000	4000	3636
chrX	139722346	139730346	139728911	8000	139726346	-4000	4000	2565
chrX	106204956	106212956	106205667	8000	106208956	-4000	4000	-3289
chrX	49201063	49209063	49205664	8000	49205063	-4000	4000	601
chrX	70282595	70290595	70284630	8000	70286595	-4000	4000	-1965
chrX	152733669	152741669	152736849	8000	152737669	-4000	4000	-820
chrX	124418664	124426664	124420490	8000	124422664	-4000	4000	-2174
chrX	108151607	108159607	108159493	8000	108155607	-4000	4000	3886
chrX	102600159	102608159	102603530	8000	102604159	-4000	4000	-629
chrX	103213246	103221246	103216470	8000	103217246	-4000	4000	-776
chrX	72298926	72306926	72301898	8000	72302926	-4000	4000	-1028
chrX	85269362	85277362	85270066	8000	85273362	-4000	4000	-3296
chrX	121046094	121054094	121048882	8000	121050094	-4000	4000	-1212
chrX	142198342	142206342	142203120	8000	142202342	-4000	4000	778
chrX	78267468	78275468	78273399	8000	78271468	-4000	4000	1931
chrX	18649629	18657629	18650583	8000	18653629	-4000	4000	-3046
chrX	103818327	103826327	103825742	8000	103822327	-4000	4000	3415
chrX	13773955	13781955	13777399	8000	13777955	-4000	4000	-556
chrX	112770503	112778503	112776772	8000	112774503	-4000	4000	2269
chrX	71235624	71243624	71241030	8000	71239624	-4000	4000	1406
chrX	73208299	73216299	73213455	8000	73212299	-4000	4000	1156
chrX	10233660	10241660	10235343	8000	10237660	-4000	4000	-2317
chrX	40644305	40652305	40651821	8000	40648305	-4000	4000	3516
chrX	45108779	45116779	45110251	8000	45112779	-4000	4000	-2528
chrX	53076615	53084615	53077768	8000	53080615	-4000	4000	-2847
chrX	49201063	49209063	49208656	8000	49205063	-4000	4000	3593
chrX	71235624	71243624	71242980	8000	71239624	-4000	4000	3356
chrX	54444032	54452032	54444092	8000	54448032	-4000	4000	-3940
chrX	130054071	130062071	130056008	8000	130058071	-4000	4000	-2063
chrX	13773955	13781955	13776247	8000	13777955	-4000	4000	-1708
chrX	119611724	119619724	119618767	8000	119615724	-4000	4000	3043
chrX	46493422	46501422	46500050	8000	46497422	-4000	4000	2628
chrX	46493422	46501422	46500517	8000	46497422	-4000	4000	3095
chrX	107709221	107717221	107714729	8000	107713221	-4000	4000	1508
chrX	140999706	141007706	141002675	8000	141003706	-4000	4000	-1031
chrX	134988473	134996473	134992080	8000	134992473	-4000	4000	-393
chrX	154417726	154425726	154420902	8000	154421726	-4000	4000	-824
chrX	120254650	120262650	120256803	8000	120258650	-4000	4000	-1847
chrX	12886361	12894361	12887523	8000	12890361	-4000	4000	-2838
chrX	57901430	57909430	57908881	8000	57905430	-4000	4000	3451
chrX	79356384	79364384	79361068	8000	79360384	-4000	4000	684
chrX	124418664	124426664	124422460	8000	124422664	-4000	4000	-204
chrX	85857180	85865180	85862421	8000	85861180	-4000	4000	1241
chrX	136661547	136669547	136665835	8000	136665547	-4000	4000	288
chrX	121046094	121054094	121049559	8000	121050094	-4000	4000	-535
chrX	103354462	103362462	103357944	8000	103358462	-4000	4000	-518
chrX	136508346	136516346	136510164	8000	136512346	-4000	4000	-2182
chrX	54744918	54752918	54750107	8000	54748918	-4000	4000	1189
chrX	106204956	106212956	106205865	8000	106208956	-4000	4000	-3091
chrX	131269506	131277506	131275126	8000	131273506	-4000	4000	1620
chrX	48687427	48695427	48688311	8000	48691427	-4000	4000	-3116
chrX	48687427	48695427	48688917	8000	48691427	-4000	4000	-2510
chrX	107709221	107717221	107716730	8000	107713221	-4000	4000	3509
chrX	69156851	69164851	69162704	8000	69160851	-4000	4000	1853
chrX	48687427	48695427	48689433	8000	48691427	-4000	4000	-1994
chrX	153071019	153079019	153074809	8000	153075019	-4000	4000	-210
chrX	108693545	108701545	108696451	8000	108697545	-4000	4000	-1094
chrX	155254235	155262235	155261071	8000	155258235	-4000	4000	2836
chrX	129925761	129933761	129929550	8000	129929761	-4000	4000	-211
chrX	153583925	153591925	153588408	8000	153587925	-4000	4000	483
chrX	13708244	13716244	13716096	8000	13712244	-4000	4000	3852
chrX	64911802	64919802	64917904	8000	64915802	-4000	4000	2102
chrX	71099532	71107532	71101529	8000	71103532	-4000	4000	-2003
chrX	152733669	152741669	152736753	8000	152737669	-4000	4000	-916
chrX	152733669	152741669	152737250	8000	152737669	-4000	4000	-419
chrX	49604538	49612538	49606068	8000	49608538	-4000	4000	-2470
chrX	152762136	152770136	152766608	8000	152766136	-4000	4000	472
chrX	132071943	132079943	132077650	8000	132075943	-4000	4000	1707
chrX	85089315	85097315	85094934	8000	85093315	-4000	4000	1619
chrX	136207359	136215359	136209323	8000	136211359	-4000	4000	-2036
chrX	10233660	10241660	10233760	8000	10237660	-4000	4000	-3900
chrX	17796049	17804049	17801940	8000	17800049	-4000	4000	1891
chrX	93666930	93674930	93671718	8000	93670930	-4000	4000	788
chrX	149927287	149935287	149933770	8000	149931287	-4000	4000	2483
chrX	151921171	151929171	151923818	8000	151925171	-4000	4000	-1353
chrX	153647326	153655326	153650207	8000	153651326	-4000	4000	-1119
chrX	47211128	47219128	47214584	8000	47215128	-4000	4000	-544
chrX	71099532	71107532	71104787	8000	71103532	-4000	4000	1255
chrX	72157750	72165750	72159959	8000	72161750	-4000	4000	-1791
chrX	12886361	12894361	12887910	8000	12890361	-4000	4000	-2451
chrX	102136426	102144426	102141162	8000	102140426	-4000	4000	736
chrX	103213246	103221246	103216855	8000	103217246	-4000	4000	-391
chrX	150986771	150994771	150987302	8000	150990771	-4000	4000	-3469
chrX	131269506	131277506	131275592	8000	131273506	-4000	4000	2086
chrX	149927287	149935287	149932756	8000	149931287	-4000	4000	1469
chrX	47441178	47449178	47448368	8000	47445178	-4000	4000	3190
chrX	51742232	51750232	51745665	8000	51746232	-4000	4000	-567
chrX	101651281	101659281	101655896	8000	101655281	-4000	4000	615
chrX	101651281	101659281	101656544	8000	101655281	-4000	4000	1263
chrX	108150671	108158671	108153806	8000	108154671	-4000	4000	-865
chrX	136661547	136669547	136667892	8000	136665547	-4000	4000	2345
chrX	47211128	47219128	47214809	8000	47215128	-4000	4000	-319
chrX	47441178	47449178	47447620	8000	47445178	-4000	4000	2442
chrX	135046932	135054932	135052061	8000	135050932	-4000	4000	1129
chrX	140999706	141007706	141003705	8000	141003706	-4000	4000	-1
chrX	18235313	18243313	18241093	8000	18239313	-4000	4000	1780
chrX	153979194	153987194	153982631	8000	153983194	-4000	4000	-563
chrX	132622015	132630015	132628914	8000	132626015	-4000	4000	2899
chrX	103213246	103221246	103216559	8000	103217246	-4000	4000	-687
chrX	51742232	51750232	51744680	8000	51746232	-4000	4000	-1552
chrX	152822994	152830994	152827914	8000	152826994	-4000	4000	920
chrX	68721842	68729842	68724478	8000	68725842	-4000	4000	-1364
chrX	91434584	91442584	91436256	8000	91438584	-4000	4000	-2328
chrX	111241099	111249099	111247986	8000	111245099	-4000	4000	2887
chrX	21650695	21658695	21657454	8000	21654695	-4000	4000	2759
chrX	64181117	64189117	64187445	8000	64185117	-4000	4000	2328
chrX	2930045	2938045	2935107	8000	2934045	-4000	4000	1062
chrX	152733669	152741669	152736987	8000	152737669	-4000	4000	-682
chrX	7894247	7902247	7900768	8000	7898247	-4000	4000	2521
chrX	7894247	7902247	7900769	8000	7898247	-4000	4000	2522
chrX	2215506	2223506	2220932	8000	2219506	-4000	4000	1426
chrX	103818327	103826327	103825703	8000	103822327	-4000	4000	3376
chrX	79356384	79364384	79362601	8000	79360384	-4000	4000	2217
chrX	81109699	81117699	81116239	8000	81113699	-4000	4000	2540
chrX	93666930	93674930	93672935	8000	93670930	-4000	4000	2005
chrX	49201063	49209063	49208645	8000	49205063	-4000	4000	3582
chrX	72200657	72208657	72208419	8000	72204657	-4000	4000	3762
chrX	130409656	130417656	130412739	8000	130413656	-4000	4000	-917
chrX	153056467	153064467	153059798	8000	153060467	-4000	4000	-669
chrX	30554809	30562809	30559899	8000	30558809	-4000	4000	1090
chrX	47441178	47449178	47448858	8000	47445178	-4000	4000	3680
chrX	13766939	13774939	13768194	8000	13770939	-4000	4000	-2745
chrX	151921171	151929171	151923722	8000	151925171	-4000	4000	-1449
chrX	47441178	47449178	47447483	8000	47445178	-4000	4000	2305
chrX	49164483	49172483	49165049	8000	49168483	-4000	4000	-3434
chrX	152723484	152731484	152727491	8000	152727484	-4000	4000	7
chrX	136207359	136215359	136208503	8000	136211359	-4000	4000	-2856
chrX	48889447	48897447	48893938	8000	48893447	-4000	4000	491
chrX	101550700	101558700	101552938	8000	101554700	-4000	4000	-1762
chrX	47244328	47252328	47244689	8000	47248328	-4000	4000	-3639
chrX	56563868	56571868	56565577	8000	56567868	-4000	4000	-2291
chrX	101651281	101659281	101656002	8000	101655281	-4000	4000	721
chrX	69156851	69164851	69163068	8000	69160851	-4000	4000	2217
chrX	78959727	78967727	78960830	8000	78963727	-4000	4000	-2897
chrX	116457458	116465458	116461983	8000	116461458	-4000	4000	525
chrX	152733669	152741669	152736242	8000	152737669	-4000	4000	-1427
chrX	153056467	153064467	153057208	8000	153060467	-4000	4000	-3259
chrX	134561838	134569838	134566418	8000	134565838	-4000	4000	580
chrX	71099532	71107532	71104073	8000	71103532	-4000	4000	541
chrX	71099532	71107532	71104392	8000	71103532	-4000	4000	860
chrX	118790535	118798535	118792049	8000	118794535	-4000	4000	-2486
chrX	18235313	18243313	18240733	8000	18239313	-4000	4000	1420
chrX	48918024	48926024	48918610	8000	48922024	-4000	4000	-3414
chrX	71099532	71107532	71103321	8000	71103532	-4000	4000	-211
chrX	45108779	45116779	45111607	8000	45112779	-4000	4000	-1172
chrX	57901430	57909430	57908039	8000	57905430	-4000	4000	2609
chrX	152733669	152741669	152736875	8000	152737669	-4000	4000	-794
chrX	71235624	71243624	71241301	8000	71239624	-4000	4000	1677
chrX	103305346	103313346	103310406	8000	103309346	-4000	4000	1060
chrX	120422148	120430148	120428559	8000	120426148	-4000	4000	2411
chrX	152969481	152977481	152971298	8000	152973481	-4000	4000	-2183
chrX	77963949	77971949	77969502	8000	77967949	-4000	4000	1553
chrX	30727462	30735462	30728769	8000	30731462	-4000	4000	-2693
chrX	55480616	55488616	55487548	8000	55484616	-4000	4000	2932
chrX	85089315	85097315	85094945	8000	85093315	-4000	4000	1630
chrX	91434584	91442584	91435559	8000	91438584	-4000	4000	-3025
chrX	154831788	154839788	154837543	8000	154835788	-4000	4000	1755
chrX	54927431	54935431	54930160	8000	54931431	-4000	4000	-1271
chrX	153583925	153591925	153588187	8000	153587925	-4000	4000	262
chrX	152733669	152741669	152740735	8000	152737669	-4000	4000	3066
chrX	17731994	17739994	17732112	8000	17735994	-4000	4000	-3882
chrX	152762136	152770136	152767066	8000	152766136	-4000	4000	930
chrX	91434584	91442584	91435699	8000	91438584	-4000	4000	-2885
chrX	100671788	100679788	100675929	8000	100675788	-4000	4000	141
chrX	53427258	53435258	53433813	8000	53431258	-4000	4000	2555
chrX	154439467	154447467	154446511	8000	154443467	-4000	4000	3044
chrX	101651281	101659281	101657120	8000	101655281	-4000	4000	1839
chrX	130059955	130067955	130067196	8000	130063955	-4000	4000	3241
chrX	136207359	136215359	136210068	8000	136211359	-4000	4000	-1291
chrX	77903376	77911376	77905227	8000	77907376	-4000	4000	-2149
chrX	153979194	153987194	153981977	8000	153983194	-4000	4000	-1217
chrX	18823921	18831921	18825755	8000	18827921	-4000	4000	-2166
chrX	129588561	129596561	129589000	8000	129592561	-4000	4000	-3561
chrX	78125748	78133748	78126050	8000	78129748	-4000	4000	-3698
chrX	30554809	30562809	30560279	8000	30558809	-4000	4000	1470
chrX	155060034	155068034	155065330	8000	155064034	-4000	4000	1296
chrX	48687427	48695427	48688096	8000	48691427	-4000	4000	-3331
chrX	17796049	17804049	17801514	8000	17800049	-4000	4000	1465
chrX	152733669	152741669	152740971	8000	152737669	-4000	4000	3302
chrX	153798166	153806166	153803572	8000	153802166	-4000	4000	1406
chrX	48516814	48524814	48520412	8000	48520814	-4000	4000	-402
chrX	55449566	55457566	55453020	8000	55453566	-4000	4000	-546
chrX	135029546	135037546	135032656	8000	135033546	-4000	4000	-890
chrX	81109699	81117699	81115090	8000	81113699	-4000	4000	1391
chrX	102600159	102608159	102602578	8000	102604159	-4000	4000	-1581
chrX	102655083	102663083	102657353	8000	102659083	-4000	4000	-1730
chrX	134765566	134773566	134772243	8000	134769566	-4000	4000	2677
chrX	152733669	152741669	152736811	8000	152737669	-4000	4000	-858
chrX	116457458	116465458	116458980	8000	116461458	-4000	4000	-2478
chrX	71099532	71107532	71101659	8000	71103532	-4000	4000	-1873
chrX	78125748	78133748	78129904	8000	78129748	-4000	4000	156
chrX	81294547	81302547	81297280	8000	81298547	-4000	4000	-1267
chrX	130054071	130062071	130056182	8000	130058071	-4000	4000	-1889
chrX	130369361	130377361	130373007	8000	130373361	-4000	4000	-354
chrX	41693275	41701275	41695997	8000	41697275	-4000	4000	-1278
chrX	48909182	48917182	48915095	8000	48913182	-4000	4000	1913
chrX	70035472	70043472	70043199	8000	70039472	-4000	4000	3727
chrX	101408297	101416297	101413231	8000	101412297	-4000	4000	934
chrX	30823442	30831442	30831194	8000	30827442	-4000	4000	3752
chrX	48957378	48965378	48962121	8000	48961378	-4000	4000	743
chrX	101878288	101886288	101883428	8000	101882288	-4000	4000	1140
chrX	79356384	79364384	79361146	8000	79360384	-4000	4000	762
chrX	57593477	57601477	57594951	8000	57597477	-4000	4000	-2526
chrX	103305346	103313346	103309523	8000	103309346	-4000	4000	177
chrX	71611916	71619916	71612515	8000	71615916	-4000	4000	-3401
chrX	132622015	132630015	132628506	8000	132626015	-4000	4000	2491
chrX	72123110	72131110	72130492	8000	72127110	-4000	4000	3382
chrX	102655083	102663083	102656785	8000	102659083	-4000	4000	-2298
chrX	155778459	155786459	155781620	8000	155782459	-4000	4000	-839
chrX	45108779	45116779	45110250	8000	45112779	-4000	4000	-2529
chrX	149544210	149552210	149545677	8000	149548210	-4000	4000	-2533
chrX	12886361	12894361	12888620	8000	12890361	-4000	4000	-1741
chrX	151921171	151929171	151924618	8000	151925171	-4000	4000	-553
chrX	72200657	72208657	72207213	8000	72204657	-4000	4000	2556
chrX	30823442	30831442	30830518	8000	30827442	-4000	4000	3076
chrX	51742232	51750232	51745402	8000	51746232	-4000	4000	-830
chrX	69156851	69164851	69162294	8000	69160851	-4000	4000	1443
chrX	47441178	47449178	47448986	8000	47445178	-4000	4000	3808
chrX	44519639	44527639	44527278	8000	44523639	-4000	4000	3639
chrX	51898354	51906354	51901833	8000	51902354	-4000	4000	-521
chrX	131269506	131277506	131275503	8000	131273506	-4000	4000	1997
chrX	152733669	152741669	152737223	8000	152737669	-4000	4000	-446
chrX	131085885	131093885	131086626	8000	131089885	-4000	4000	-3259
chrX	103818327	103826327	103825759	8000	103822327	-4000	4000	3432
chrX	71099532	71107532	71106011	8000	71103532	-4000	4000	2479
chrX	50095235	50103235	50097438	8000	50099235	-4000	4000	-1797
chrX	74529917	74537917	74531548	8000	74533917	-4000	4000	-2369
chrX	118682163	118690163	118685785	8000	118686163	-4000	4000	-378
chrX	124371903	124379903	124371903	8000	124375903	-4000	4000	-4000
chrX	14002726	14010726	14008987	8000	14006726	-4000	4000	2261
chrX	72200657	72208657	72206184	8000	72204657	-4000	4000	1527
chrX	107601255	107609255	107602555	8000	107605255	-4000	4000	-2700
chrX	16149518	16157518	16152309	8000	16153518	-4000	4000	-1209
chrX	71235624	71243624	71243034	8000	71239624	-4000	4000	3410
chrX	12886361	12894361	12888894	8000	12890361	-4000	4000	-1467
chrX	15821806	15829806	15827229	8000	15825806	-4000	4000	1423
chrX	78267468	78275468	78273035	8000	78271468	-4000	4000	1567
chrX	102655083	102663083	102655269	8000	102659083	-4000	4000	-3814
chrX	119587083	119595083	119590850	8000	119591083	-4000	4000	-233
chrX	135359413	135367413	135361319	8000	135363413	-4000	4000	-2094
chrX	150669143	150677143	150671633	8000	150673143	-4000	4000	-1510
chrX	152733669	152741669	152736662	8000	152737669	-4000	4000	-1007
chrX	71235624	71243624	71242338	8000	71239624	-4000	4000	2714
chrX	21650695	21658695	21656297	8000	21654695	-4000	4000	1602
chrX	101389273	101397273	101391925	8000	101393273	-4000	4000	-1348
chrX	119587083	119595083	119590356	8000	119591083	-4000	4000	-727
chrX	119587083	119595083	119590357	8000	119591083	-4000	4000	-726
chrX	12820222	12828222	12822802	8000	12824222	-4000	4000	-1420
chrX	21650695	21658695	21656238	8000	21654695	-4000	4000	1543
chrX	49070433	49078433	49076692	8000	49074433	-4000	4000	2259
chrX	51742232	51750232	51743468	8000	51746232	-4000	4000	-2764
chrX	57593477	57601477	57593543	8000	57597477	-4000	4000	-3934
chrX	69156851	69164851	69161885	8000	69160851	-4000	4000	1034
chrX	71528374	71536374	71529901	8000	71532374	-4000	4000	-2473
chrX	79356384	79364384	79361350	8000	79360384	-4000	4000	966
chrX	101341661	101349661	101346409	8000	101345661	-4000	4000	748
chrX	101341661	101349661	101348703	8000	101345661	-4000	4000	3042
chrX	150986771	150994771	150987909	8000	150990771	-4000	4000	-2862
chrX	152762136	152770136	152766471	8000	152766136	-4000	4000	335
chrX	153505546	153513546	153508298	8000	153509546	-4000	4000	-1248
chrX	153665733	153673733	153671086	8000	153669733	-4000	4000	1353
chrX	41693275	41701275	41695945	8000	41697275	-4000	4000	-1330
chrX	41693275	41701275	41696452	8000	41697275	-4000	4000	-823
chrX	155778459	155786459	155780572	8000	155782459	-4000	4000	-1887
chrX	65737931	65745931	65739162	8000	65741931	-4000	4000	-2769
chrX	152733669	152741669	152736824	8000	152737669	-4000	4000	-845
chrX	9945443	9953443	9946817	8000	9949443	-4000	4000	-2626
chrX	69156851	69164851	69163214	8000	69160851	-4000	4000	2363
chrX	102655083	102663083	102656369	8000	102659083	-4000	4000	-2714
chrX	37832757	37840757	37840561	8000	37836757	-4000	4000	3804
chrX	51486011	51494011	51491579	8000	51490011	-4000	4000	1568
chrX	155778459	155786459	155780454	8000	155782459	-4000	4000	-2005
chrX	153179880	153187880	153183225	8000	153183880	-4000	4000	-655
chrX	70282595	70290595	70290513	8000	70286595	-4000	4000	3918
chrX	101389273	101397273	101391815	8000	101393273	-4000	4000	-1458
chrX	151921171	151929171	151924758	8000	151925171	-4000	4000	-413
chrX	16149518	16157518	16152906	8000	16153518	-4000	4000	-612
chrX	54812015	54820015	54814737	8000	54816015	-4000	4000	-1278
chrX	103818327	103826327	103825118	8000	103822327	-4000	4000	2791
chrX	3304565	3312565	3310323	8000	3308565	-4000	4000	1758
chrX	53076615	53084615	53077188	8000	53080615	-4000	4000	-3427
chrX	101651281	101659281	101657609	8000	101655281	-4000	4000	2328
chrX	2878820	2886820	2881314	8000	2882820	-4000	4000	-1506
chrX	15380799	15388799	15384040	8000	15384799	-4000	4000	-759
chrX	48454537	48462537	48459002	8000	48458537	-4000	4000	465
chrX	50347914	50355914	50351875	8000	50351914	-4000	4000	-39
chrX	73208299	73216299	73213883	8000	73212299	-4000	4000	1584
chrX	77821747	77829747	77829229	8000	77825747	-4000	4000	3482
chrX	102655083	102663083	102658156	8000	102659083	-4000	4000	-927
chrX	153056467	153064467	153057434	8000	153060467	-4000	4000	-3033
chrX	154774684	154782684	154779214	8000	154778684	-4000	4000	530
chrX	131269506	131277506	131276227	8000	131273506	-4000	4000	2721
chrX	71297522	71305522	71297888	8000	71301522	-4000	4000	-3634
chrX	136656390	136664390	136659417	8000	136660390	-4000	4000	-973
chrX	1382152	1390152	1389626	8000	1386152	-4000	4000	3474
chrX	18649629	18657629	18656650	8000	18653629	-4000	4000	3021
chrX	24212255	24220255	24213317	8000	24216255	-4000	4000	-2938
chrX	30554809	30562809	30559562	8000	30558809	-4000	4000	753
chrX	47057242	47065242	47058924	8000	47061242	-4000	4000	-2318
chrX	47057242	47065242	47060057	8000	47061242	-4000	4000	-1185
chrX	63343228	63351228	63350450	8000	63347228	-4000	4000	3222
chrX	64181117	64189117	64187514	8000	64185117	-4000	4000	2397
chrX	71099532	71107532	71101278	8000	71103532	-4000	4000	-2254
chrX	93666930	93674930	93671718	8000	93670930	-4000	4000	788
chrX	103058651	103066651	103062987	8000	103062651	-4000	4000	336
chrX	119587083	119595083	119590890	8000	119591083	-4000	4000	-193
chrX	135029546	135037546	135033202	8000	135033546	-4000	4000	-344
chrX	152733669	152741669	152737250	8000	152737669	-4000	4000	-419
chrX	154017573	154025573	154023995	8000	154021573	-4000	4000	2422
chrX	47211128	47219128	47214548	8000	47215128	-4000	4000	-580
chrX	51898354	51906354	51901612	8000	51902354	-4000	4000	-742
chrX	49164483	49172483	49164880	8000	49168483	-4000	4000	-3603
chrX	17796049	17804049	17801258	8000	17800049	-4000	4000	1209
chrX	19529977	19537977	19536223	8000	19533977	-4000	4000	2246
chrX	69156851	69164851	69163277	8000	69160851	-4000	4000	2426
chrX	78959727	78967727	78961415	8000	78963727	-4000	4000	-2312
chrX	107057885	107065885	107065633	8000	107061885	-4000	4000	3748
chrX	136508346	136516346	136510176	8000	136512346	-4000	4000	-2170
chrX	149927287	149935287	149933658	8000	149931287	-4000	4000	2371
chrX	153056467	153064467	153057311	8000	153060467	-4000	4000	-3156
chrX	154483306	154491306	154488864	8000	154487306	-4000	4000	1558
chrX	3304565	3312565	3310232	8000	3308565	-4000	4000	1667
chrX	12919169	12927169	12921902	8000	12923169	-4000	4000	-1267
chrX	70501490	70509490	70503910	8000	70505490	-4000	4000	-1580
chrX	119611724	119619724	119618763	8000	119615724	-4000	4000	3039
chrX	101611118	101619118	101616721	8000	101615118	-4000	4000	1603
chrX	134424791	134432791	134425214	8000	134428791	-4000	4000	-3577
chrX	7894247	7902247	7900760	8000	7898247	-4000	4000	2513
chrX	54812015	54820015	54815382	8000	54816015	-4000	4000	-633
chrX	149592556	149600556	149598126	8000	149596556	-4000	4000	1570
chrX	13766939	13774939	13774306	8000	13770939	-4000	4000	3367
chrX	101389273	101397273	101392160	8000	101393273	-4000	4000	-1113
chrX	47619172	47627172	47624361	8000	47623172	-4000	4000	1189
chrX	108150671	108158671	108153695	8000	108154671	-4000	4000	-976
chrX	142198342	142206342	142203247	8000	142202342	-4000	4000	905
chrX	48454537	48462537	48458700	8000	48458537	-4000	4000	163
chrX	1378689	1386689	1378698	8000	1382689	-4000	4000	-3991
chrX	53076615	53084615	53077477	8000	53080615	-4000	4000	-3138
chrX	17796049	17804049	17800619	8000	17800049	-4000	4000	570
chrX	17731994	17739994	17732149	8000	17735994	-4000	4000	-3845
chrX	71099532	71107532	71101196	8000	71103532	-4000	4000	-2336
chrX	119587083	119595083	119589328	8000	119591083	-4000	4000	-1755
chrX	106204956	106212956	106206352	8000	106208956	-4000	4000	-2604
chrX	71297522	71305522	71303473	8000	71301522	-4000	4000	1951
chrX	78125748	78133748	78131722	8000	78129748	-4000	4000	1974
chrX	17731994	17739994	17732680	8000	17735994	-4000	4000	-3314
chrX	153798166	153806166	153804231	8000	153802166	-4000	4000	2065
chrX	300529	308529	304963	8000	304529	-4000	4000	434
chrX	106204956	106212956	106206910	8000	106208956	-4000	4000	-2046
chrX	78125748	78133748	78126031	8000	78129748	-4000	4000	-3717
chrX	76427342	76435342	76430665	8000	76431342	-4000	4000	-677
chrX	71528374	71536374	71530122	8000	71532374	-4000	4000	-2252
chrX	102655083	102663083	102656777	8000	102659083	-4000	4000	-2306
chrX	12886361	12894361	12887972	8000	12890361	-4000	4000	-2389
chrX	48969720	48977720	48970024	8000	48973720	-4000	4000	-3696
chrX	132622015	132630015	132628743	8000	132626015	-4000	4000	2728
chrX	131269506	131277506	131274846	8000	131273506	-4000	4000	1340
chrX	154006506	154014506	154012647	8000	154010506	-4000	4000	2141
chrX	130059955	130067955	130067266	8000	130063955	-4000	4000	3311
chrX	101611118	101619118	101616504	8000	101615118	-4000	4000	1386
chrX	70162324	70170324	70165973	8000	70166324	-4000	4000	-351
chrX	101651281	101659281	101657466	8000	101655281	-4000	4000	2185
chrX	101651281	101659281	101657468	8000	101655281	-4000	4000	2187
chrX	13773955	13781955	13779900	8000	13777955	-4000	4000	1945
chrX	117893813	117901813	117898873	8000	117897813	-4000	4000	1060
chrX	106872150	106880150	106873612	8000	106876150	-4000	4000	-2538
chrX	108150671	108158671	108153878	8000	108154671	-4000	4000	-793
chrX	151921171	151929171	151924469	8000	151925171	-4000	4000	-702
chrX	65737931	65745931	65739798	8000	65741931	-4000	4000	-2133
chrX	72123110	72131110	72130801	8000	72127110	-4000	4000	3691
chrX	154774684	154782684	154779340	8000	154778684	-4000	4000	656
chrX	101878288	101886288	101884511	8000	101882288	-4000	4000	2223
chrX	66017738	66025738	66022661	8000	66021738	-4000	4000	923
chrX	70162324	70170324	70166115	8000	70166324	-4000	4000	-209
chrX	79356384	79364384	79363526	8000	79360384	-4000	4000	3142
chrX	118682163	118690163	118685769	8000	118686163	-4000	4000	-394
chrX	152723484	152731484	152728170	8000	152727484	-4000	4000	686
chrX	2215506	2223506	2220993	8000	2219506	-4000	4000	1487
chrX	81109699	81117699	81116291	8000	81113699	-4000	4000	2592
chrX	134765566	134773566	134772146	8000	134769566	-4000	4000	2580
chrX	154483306	154491306	154487604	8000	154487306	-4000	4000	298
chrX	57593477	57601477	57594267	8000	57597477	-4000	4000	-3210
chrX	49201063	49209063	49207094	8000	49205063	-4000	4000	2031
chrX	101341661	101349661	101346603	8000	101345661	-4000	4000	942
chrX	149927287	149935287	149933657	8000	149931287	-4000	4000	2370
chrX	152733669	152741669	152736432	8000	152737669	-4000	4000	-1237
chrX	78959727	78967727	78960792	8000	78963727	-4000	4000	-2935
chrX	54812015	54820015	54815454	8000	54816015	-4000	4000	-561
chrX	57593477	57601477	57594422	8000	57597477	-4000	4000	-3055
chrX	76174314	76182314	76177686	8000	76178314	-4000	4000	-628
chrX	77963949	77971949	77969456	8000	77967949	-4000	4000	1507
chrX	106204956	106212956	106206764	8000	106208956	-4000	4000	-2192
chrX	152723484	152731484	152728169	8000	152727484	-4000	4000	685
chrX	153505546	153513546	153506020	8000	153509546	-4000	4000	-3526
chrX	131269506	131277506	131274090	8000	131273506	-4000	4000	584
chrX	129588561	129596561	129589926	8000	129592561	-4000	4000	-2635
chrX	134988473	134996473	134991248	8000	134992473	-4000	4000	-1225
chrX	71099532	71107532	71103337	8000	71103532	-4000	4000	-195
chrX	9945443	9953443	9946855	8000	9949443	-4000	4000	-2588
chrX	154483306	154491306	154487575	8000	154487306	-4000	4000	269
chrX	47582789	47590789	47585101	8000	47586789	-4000	4000	-1688
chrX	81294547	81302547	81297226	8000	81298547	-4000	4000	-1321
chrX	103213246	103221246	103216310	8000	103217246	-4000	4000	-936
chrX	47244328	47252328	47245443	8000	47248328	-4000	4000	-2885
chrX	16840519	16848519	16845827	8000	16844519	-4000	4000	1308
chrX	49201063	49209063	49205728	8000	49205063	-4000	4000	665
chrX	55480616	55488616	55487483	8000	55484616	-4000	4000	2867
chrX	53076615	53084615	53083075	8000	53080615	-4000	4000	2460
chrX	57114551	57122551	57119939	8000	57118551	-4000	4000	1388
chrX	142198342	142206342	142203494	8000	142202342	-4000	4000	1152
chrX	11113651	11121651	11118591	8000	11117651	-4000	4000	940
chrX	51742232	51750232	51745761	8000	51746232	-4000	4000	-471
chrX	78125748	78133748	78125897	8000	78129748	-4000	4000	-3851
chrX	132071943	132079943	132073044	8000	132075943	-4000	4000	-2899
chrX	119587083	119595083	119589863	8000	119591083	-4000	4000	-1220
chrX	149927287	149935287	149932351	8000	149931287	-4000	4000	1064
chrX	154446654	154454654	154450232	8000	154450654	-4000	4000	-422
chrX	11113651	11121651	11118554	8000	11117651	-4000	4000	903
chrX	103788619	103796619	103790631	8000	103792619	-4000	4000	-1988
chrX	49183815	49191815	49191335	8000	49187815	-4000	4000	3520
chrX	49164483	49172483	49167231	8000	49168483	-4000	4000	-1252
chrX	81109699	81117699	81115169	8000	81113699	-4000	4000	1470
chrX	149592556	149600556	149598096	8000	149596556	-4000	4000	1540
chrX	135046932	135054932	135051926	8000	135050932	-4000	4000	994
chrX	70416886	70424886	70419760	8000	70420886	-4000	4000	-1126
chrX	1598520	1606520	1599233	8000	1602520	-4000	4000	-3287
chrX	2930045	2938045	2935139	8000	2934045	-4000	4000	1094
chrX	3304565	3312565	3311420	8000	3308565	-4000	4000	2855
chrX	9945443	9953443	9946743	8000	9949443	-4000	4000	-2700
chrX	11771772	11779772	11772622	8000	11775772	-4000	4000	-3150
chrX	13766939	13774939	13769320	8000	13770939	-4000	4000	-1619
chrX	18649629	18657629	18653476	8000	18653629	-4000	4000	-153
chrX	21650695	21658695	21652465	8000	21654695	-4000	4000	-2230
chrX	21990837	21998837	21992612	8000	21994837	-4000	4000	-2225
chrX	46493422	46501422	46499722	8000	46497422	-4000	4000	2300
chrX	47057242	47065242	47058320	8000	47061242	-4000	4000	-2922
chrX	47138071	47146071	47142250	8000	47142071	-4000	4000	179
chrX	51898354	51906354	51901563	8000	51902354	-4000	4000	-791
chrX	53076615	53084615	53083218	8000	53080615	-4000	4000	2603
chrX	53084540	53092540	53087790	8000	53088540	-4000	4000	-750
chrX	55480616	55488616	55487640	8000	55484616	-4000	4000	3024
chrX	57593477	57601477	57594257	8000	57597477	-4000	4000	-3220
chrX	65737931	65745931	65739132	8000	65741931	-4000	4000	-2799
chrX	71099532	71107532	71106103	8000	71103532	-4000	4000	2571
chrX	71221516	71229516	71223961	8000	71225516	-4000	4000	-1555
chrX	93666930	93674930	93672782	8000	93670930	-4000	4000	1852
chrX	101550700	101558700	101553054	8000	101554700	-4000	4000	-1646
chrX	108693545	108701545	108695292	8000	108697545	-4000	4000	-2253
chrX	124418664	124426664	124422395	8000	124422664	-4000	4000	-269
chrX	129925761	129933761	129926244	8000	129929761	-4000	4000	-3517
chrX	130059955	130067955	130066933	8000	130063955	-4000	4000	2978
chrX	130059955	130067955	130067266	8000	130063955	-4000	4000	3311
chrX	130369361	130377361	130371561	8000	130373361	-4000	4000	-1800
chrX	142198342	142206342	142202934	8000	142202342	-4000	4000	592
chrX	142198342	142206342	142203229	8000	142202342	-4000	4000	887
chrX	151921171	151929171	151923674	8000	151925171	-4000	4000	-1497
chrX	152733669	152741669	152736743	8000	152737669	-4000	4000	-926
chrX	152762136	152770136	152766532	8000	152766136	-4000	4000	396
chrX	153443668	153451668	153447693	8000	153447668	-4000	4000	25
chrX	153443668	153451668	153447821	8000	153447668	-4000	4000	153
chrX	153647326	153655326	153650189	8000	153651326	-4000	4000	-1137
chrX	153798166	153806166	153804616	8000	153802166	-4000	4000	2450
chrX	153979194	153987194	153982230	8000	153983194	-4000	4000	-964
chrX	155060034	155068034	155065959	8000	155064034	-4000	4000	1925
chrX	106675439	106683439	106678174	8000	106679439	-4000	4000	-1265
chrX	140999706	141007706	141002726	8000	141003706	-4000	4000	-980
chrX	3304565	3312565	3310200	8000	3308565	-4000	4000	1635
chrX	21881423	21889423	21882659	8000	21885423	-4000	4000	-2764
chrX	81109699	81117699	81116291	8000	81113699	-4000	4000	2592
chrX	119587083	119595083	119590304	8000	119591083	-4000	4000	-779
chrX	132622015	132630015	132628749	8000	132626015	-4000	4000	2734
chrX	1306381	1314381	1309614	8000	1310381	-4000	4000	-767
chrX	49604538	49612538	49606307	8000	49608538	-4000	4000	-2231
chrX	106204956	106212956	106207551	8000	106208956	-4000	4000	-1405
chrX	18888298	18896298	18893607	8000	18892298	-4000	4000	1309
chrX	18985307	18993307	18989911	8000	18989307	-4000	4000	604
chrX	30727462	30735462	30729638	8000	30731462	-4000	4000	-1824
chrX	41232579	41240579	41235450	8000	41236579	-4000	4000	-1129
chrX	51486011	51494011	51491243	8000	51490011	-4000	4000	1232
chrX	72123110	72131110	72130963	8000	72127110	-4000	4000	3853
chrX	74728856	74736856	74736725	8000	74732856	-4000	4000	3869
chrX	101878288	101886288	101884040	8000	101882288	-4000	4000	1752
chrX	103818327	103826327	103825353	8000	103822327	-4000	4000	3026
chrX	129588561	129596561	129590238	8000	129592561	-4000	4000	-2323
chrX	103328326	103336326	103332046	8000	103332326	-4000	4000	-280
chrX	130054071	130062071	130055981	8000	130058071	-4000	4000	-2090
chrX	55480616	55488616	55488057	8000	55484616	-4000	4000	3441
chrX	48687427	48695427	48689371	8000	48691427	-4000	4000	-2056
chrX	102655083	102663083	102657888	8000	102659083	-4000	4000	-1195
chrX	120254650	120262650	120255495	8000	120258650	-4000	4000	-3155
chrX	15380799	15388799	15384873	8000	15384799	-4000	4000	74
chrX	70501490	70509490	70502181	8000	70505490	-4000	4000	-3309
chrX	79356384	79364384	79362785	8000	79360384	-4000	4000	2401
chrX	23782210	23790210	23783216	8000	23786210	-4000	4000	-2994
chrX	47089314	47097314	47092940	8000	47093314	-4000	4000	-374
chrX	48827096	48835096	48829986	8000	48831096	-4000	4000	-1110
chrX	93666930	93674930	93673471	8000	93670930	-4000	4000	2541
chrX	147947125	147955125	147948767	8000	147951125	-4000	4000	-2358
chrX	152762136	152770136	152767347	8000	152766136	-4000	4000	1211
chrX	155056304	155064304	155064027	8000	155060304	-4000	4000	3723
chrX	77963949	77971949	77969242	8000	77967949	-4000	4000	1293
chrX	152698347	152706347	152701546	8000	152702347	-4000	4000	-801
chrX	3304565	3312565	3310143	8000	3308565	-4000	4000	1578
chrX	3304565	3312565	3311331	8000	3308565	-4000	4000	2766
chrX	12886361	12894361	12886718	8000	12890361	-4000	4000	-3643
chrX	12919169	12927169	12919689	8000	12923169	-4000	4000	-3480
chrX	13706504	13714504	13714466	8000	13710504	-4000	4000	3962
chrX	16650670	16658670	16654605	8000	16654670	-4000	4000	-65
chrX	16840519	16848519	16845058	8000	16844519	-4000	4000	539
chrX	18649629	18657629	18653445	8000	18653629	-4000	4000	-184
chrX	19529977	19537977	19536342	8000	19533977	-4000	4000	2365
chrX	24992986	25000986	24995881	8000	24996986	-4000	4000	-1105
chrX	30554809	30562809	30559659	8000	30558809	-4000	4000	850
chrX	40045815	40053815	40052199	8000	40049815	-4000	4000	2384
chrX	41693275	41701275	41695977	8000	41697275	-4000	4000	-1298
chrX	41693275	41701275	41696823	8000	41697275	-4000	4000	-452
chrX	44519639	44527639	44527281	8000	44523639	-4000	4000	3642
chrX	45144373	45152373	45151561	8000	45148373	-4000	4000	3188
chrX	46493422	46501422	46500542	8000	46497422	-4000	4000	3120
chrX	47211128	47219128	47213031	8000	47215128	-4000	4000	-2097
chrX	47211128	47219128	47214339	8000	47215128	-4000	4000	-789
chrX	47441178	47449178	47447607	8000	47445178	-4000	4000	2429
chrX	49109407	49117407	49115796	8000	49113407	-4000	4000	2389
chrX	51486011	51494011	51491509	8000	51490011	-4000	4000	1498
chrX	56563868	56571868	56564937	8000	56567868	-4000	4000	-2931
chrX	66264867	66272867	66266813	8000	66268867	-4000	4000	-2054
chrX	69156851	69164851	69161906	8000	69160851	-4000	4000	1055
chrX	69156851	69164851	69162110	8000	69160851	-4000	4000	1259
chrX	69156851	69164851	69162213	8000	69160851	-4000	4000	1362
chrX	69156851	69164851	69162833	8000	69160851	-4000	4000	1982
chrX	70282595	70290595	70282822	8000	70286595	-4000	4000	-3773
chrX	71235624	71243624	71240845	8000	71239624	-4000	4000	1221
chrX	77963949	77971949	77969416	8000	77967949	-4000	4000	1467
chrX	78125748	78133748	78131466	8000	78129748	-4000	4000	1718
chrX	81109699	81117699	81114596	8000	81113699	-4000	4000	897
chrX	101550700	101558700	101553708	8000	101554700	-4000	4000	-992
chrX	101550700	101558700	101553850	8000	101554700	-4000	4000	-850
chrX	101611118	101619118	101616334	8000	101615118	-4000	4000	1216
chrX	101878288	101886288	101884710	8000	101882288	-4000	4000	2422
chrX	102509682	102517682	102513937	8000	102513682	-4000	4000	255
chrX	102600159	102608159	102603511	8000	102604159	-4000	4000	-648
chrX	103328326	103336326	103331777	8000	103332326	-4000	4000	-549
chrX	103818327	103826327	103825420	8000	103822327	-4000	4000	3093
chrX	103818327	103826327	103825720	8000	103822327	-4000	4000	3393
chrX	108075184	108083184	108076191	8000	108079184	-4000	4000	-2993
chrX	108080207	108088207	108087539	8000	108084207	-4000	4000	3332
chrX	111756649	111764649	111759856	8000	111760649	-4000	4000	-793
chrX	115106616	115114616	115113298	8000	115110616	-4000	4000	2682
chrX	116457458	116465458	116459110	8000	116461458	-4000	4000	-2348
chrX	119240466	119248466	119243170	8000	119244466	-4000	4000	-1296
chrX	120254650	120262650	120255088	8000	120258650	-4000	4000	-3562
chrX	120621674	120629674	120627005	8000	120625674	-4000	4000	1331
chrX	121046094	121054094	121048267	8000	121050094	-4000	4000	-1827
chrX	130059955	130067955	130067008	8000	130063955	-4000	4000	3053
chrX	131269506	131277506	131273827	8000	131273506	-4000	4000	321
chrX	131269506	131277506	131275476	8000	131273506	-4000	4000	1970
chrX	131269506	131277506	131276105	8000	131273506	-4000	4000	2599
chrX	132622015	132630015	132628176	8000	132626015	-4000	4000	2161
chrX	134242207	134250207	134244981	8000	134246207	-4000	4000	-1226
chrX	134424791	134432791	134425452	8000	134428791	-4000	4000	-3339
chrX	134765566	134773566	134771466	8000	134769566	-4000	4000	1900
chrX	135578510	135586510	135580008	8000	135582510	-4000	4000	-2502
chrX	136207359	136215359	136207901	8000	136211359	-4000	4000	-3458
chrX	152698347	152706347	152701945	8000	152702347	-4000	4000	-402
chrX	152723484	152731484	152728119	8000	152727484	-4000	4000	635
chrX	152822994	152830994	152828606	8000	152826994	-4000	4000	1612
chrX	15380799	15388799	15384980	8000	15384799	-4000	4000	181
chrX	23682397	23690397	23686304	8000	23686397	-4000	4000	-93
chrX	63343228	63351228	63350066	8000	63347228	-4000	4000	2838
chrX	64181117	64189117	64186041	8000	64185117	-4000	4000	924
chrX	69156851	69164851	69162658	8000	69160851	-4000	4000	1807
chrX	70416886	70424886	70420264	8000	70420886	-4000	4000	-622
chrX	152733669	152741669	152736488	8000	152737669	-4000	4000	-1181
chrX	16650670	16658670	16654496	8000	16654670	-4000	4000	-174
chrX	66591637	66599637	66599607	8000	66595637	-4000	4000	3970
chrX	153056467	153064467	153058673	8000	153060467	-4000	4000	-1794
chrX	109540698	109548698	109542509	8000	109544698	-4000	4000	-2189
chrX	1598520	1606520	1600659	8000	1602520	-4000	4000	-1861
chrX	48516814	48524814	48523979	8000	48520814	-4000	4000	3165
chrX	69156851	69164851	69161626	8000	69160851	-4000	4000	775
chrX	154774684	154782684	154781688	8000	154778684	-4000	4000	3004
chrX	73208299	73216299	73213398	8000	73212299	-4000	4000	1099
chrX	53427258	53435258	53430617	8000	53431258	-4000	4000	-641
chrX	64911802	64919802	64919223	8000	64915802	-4000	4000	3421
chrX	49164483	49172483	49164810	8000	49168483	-4000	4000	-3673
chrX	70282595	70290595	70289309	8000	70286595	-4000	4000	2714
chrX	72200657	72208657	72205839	8000	72204657	-4000	4000	1182
chrX	107601255	107609255	107601294	8000	107605255	-4000	4000	-3961
chrX	108080207	108088207	108087595	8000	108084207	-4000	4000	3388
chrX	9945443	9953443	9946760	8000	9949443	-4000	4000	-2683
chrX	107709221	107717221	107714723	8000	107713221	-4000	4000	1502
chrX	102655083	102663083	102657490	8000	102659083	-4000	4000	-1593
chrX	70282595	70290595	70290500	8000	70286595	-4000	4000	3905
chrX	153798166	153806166	153804422	8000	153802166	-4000	4000	2256
chrX	52508077	52516077	52512147	8000	52512077	-4000	4000	70
chrX	70416886	70424886	70419697	8000	70420886	-4000	4000	-1189
chrX	156021710	156029710	156025453	8000	156025710	-4000	4000	-257
chrX	81109699	81117699	81116291	8000	81113699	-4000	4000	2592
chrX	48957378	48965378	48962574	8000	48961378	-4000	4000	1196
chrX	136043269	136051269	136045655	8000	136047269	-4000	4000	-1614
chrX	76427342	76435342	76428924	8000	76431342	-4000	4000	-2418
chrX	12919169	12927169	12921158	8000	12923169	-4000	4000	-2011
chrX	121046094	121054094	121048112	8000	121050094	-4000	4000	-1982
chrX	50347914	50355914	50351619	8000	50351914	-4000	4000	-295
chrX	51742232	51750232	51743621	8000	51746232	-4000	4000	-2611
chrX	51742232	51750232	51745418	8000	51746232	-4000	4000	-814
chrX	153056467	153064467	153057109	8000	153060467	-4000	4000	-3358
chrX	136661547	136669547	136668136	8000	136665547	-4000	4000	2589
chrX	152733669	152741669	152736537	8000	152737669	-4000	4000	-1132
chrX	47441178	47449178	47447657	8000	47445178	-4000	4000	2479
chrX	24074810	24082810	24076940	8000	24078810	-4000	4000	-1870
chrX	101878288	101886288	101884193	8000	101882288	-4000	4000	1905
chrX	155056304	155064304	155061898	8000	155060304	-4000	4000	1594
chrX	72200657	72208657	72207144	8000	72204657	-4000	4000	2487
chrX	149544210	149552210	149546788	8000	149548210	-4000	4000	-1422
chrX	73208299	73216299	73213352	8000	73212299	-4000	4000	1053
chrX	50347914	50355914	50351806	8000	50351914	-4000	4000	-108
chrX	50347914	50355914	50351807	8000	50351914	-4000	4000	-107
chrX	85269362	85277362	85271399	8000	85273362	-4000	4000	-1963
chrX	74529917	74537917	74531458	8000	74533917	-4000	4000	-2459
chrX	101651281	101659281	101656438	8000	101655281	-4000	4000	1157
chrX	1306381	1314381	1309522	8000	1310381	-4000	4000	-859
chrX	18888298	18896298	18895135	8000	18892298	-4000	4000	2837
chrX	49164483	49172483	49164655	8000	49168483	-4000	4000	-3828
chrX	51742232	51750232	51745331	8000	51746232	-4000	4000	-901
chrX	53076615	53084615	53076778	8000	53080615	-4000	4000	-3837
chrX	71140103	71148103	71147966	8000	71144103	-4000	4000	3863
chrX	71297522	71305522	71300162	8000	71301522	-4000	4000	-1360
chrX	71297522	71305522	71305277	8000	71301522	-4000	4000	3755
chrX	91434584	91442584	91436599	8000	91438584	-4000	4000	-1985
chrX	102600159	102608159	102603395	8000	102604159	-4000	4000	-764
chrX	102655083	102663083	102656265	8000	102659083	-4000	4000	-2818
chrX	152865729	152873729	152869156	8000	152869729	-4000	4000	-573
chrX	153056467	153064467	153057537	8000	153060467	-4000	4000	-2930
chrX	153665733	153673733	153672189	8000	153669733	-4000	4000	2456
chrX	102600159	102608159	102603475	8000	102604159	-4000	4000	-684
chrX	18888298	18896298	18893584	8000	18892298	-4000	4000	1286
chrX	23782210	23790210	23783952	8000	23786210	-4000	4000	-2258
chrX	134988473	134996473	134991248	8000	134992473	-4000	4000	-1225
chrX	152733669	152741669	152737090	8000	152737669	-4000	4000	-579
chrX	102600159	102608159	102603078	8000	102604159	-4000	4000	-1081
chrX	135046932	135054932	135051322	8000	135050932	-4000	4000	390
chrX	136043269	136051269	136044541	8000	136047269	-4000	4000	-2728
chrX	135956588	135964588	135963882	8000	135960588	-4000	4000	3294
chrX	156021710	156029710	156025584	8000	156025710	-4000	4000	-126
chrX	71235624	71243624	71241239	8000	71239624	-4000	4000	1615
chrX	149927287	149935287	149933774	8000	149931287	-4000	4000	2487
chrX	10233660	10241660	10233871	8000	10237660	-4000	4000	-3789
chrX	51742232	51750232	51743924	8000	51746232	-4000	4000	-2308
chrX	72200657	72208657	72205358	8000	72204657	-4000	4000	701
chrX	135029546	135037546	135033058	8000	135033546	-4000	4000	-488
chrX	155939769	155947769	155943159	8000	155943769	-4000	4000	-610
chrX	47211128	47219128	47212768	8000	47215128	-4000	4000	-2360
chrX	72200657	72208657	72207635	8000	72204657	-4000	4000	2978
chrX	74529917	74537917	74531590	8000	74533917	-4000	4000	-2327
chrX	102655083	102663083	102655456	8000	102659083	-4000	4000	-3627
chrX	121046094	121054094	121048759	8000	121050094	-4000	4000	-1335
chrX	154006506	154014506	154012625	8000	154010506	-4000	4000	2119
chrX	24212255	24220255	24213574	8000	24216255	-4000	4000	-2681
chrX	54927431	54935431	54929349	8000	54931431	-4000	4000	-2082
chrX	81109699	81117699	81113750	8000	81113699	-4000	4000	51
chrX	153665733	153673733	153671879	8000	153669733	-4000	4000	2146
chrX	18985307	18993307	18990849	8000	18989307	-4000	4000	1542
chrX	14918327	14926327	14920118	8000	14922327	-4000	4000	-2209
chrX	119450478	119458478	119454027	8000	119454478	-4000	4000	-451
chrX	64181117	64189117	64186087	8000	64185117	-4000	4000	970
chrX	74529917	74537917	74531712	8000	74533917	-4000	4000	-2205
chrX	66017738	66025738	66025104	8000	66021738	-4000	4000	3366
chrX	47619172	47627172	47626423	8000	47623172	-4000	4000	3251
chrX	65503887	65511887	65505932	8000	65507887	-4000	4000	-1955
chrX	47619172	47627172	47626364	8000	47623172	-4000	4000	3192
chrX	71611916	71619916	71612411	8000	71615916	-4000	4000	-3505
chrX	54927431	54935431	54929774	8000	54931431	-4000	4000	-1657
chrX	64911802	64919802	64917792	8000	64915802	-4000	4000	1990
chrX	69156851	69164851	69162985	8000	69160851	-4000	4000	2134
chrX	53084540	53092540	53087850	8000	53088540	-4000	4000	-690
chrX	152733669	152741669	152740691	8000	152737669	-4000	4000	3022
chrX	47567908	47575908	47575274	8000	47571908	-4000	4000	3366
chrX	43944776	43952776	43949894	8000	43948776	-4000	4000	1118
chrX	13766939	13774939	13767207	8000	13770939	-4000	4000	-3732
chrX	18823921	18831921	18827280	8000	18827921	-4000	4000	-641
chrX	57130530	57138530	57136303	8000	57134530	-4000	4000	1773
chrX	71099532	71107532	71104035	8000	71103532	-4000	4000	503
chrX	71297522	71305522	71304587	8000	71301522	-4000	4000	3065
chrX	77821747	77829747	77829146	8000	77825747	-4000	4000	3399
chrX	45144373	45152373	45151788	8000	45148373	-4000	4000	3415
chrX	85273396	85281396	85279426	8000	85277396	-4000	4000	2030
chrX	53528096	53536096	53535491	8000	53532096	-4000	4000	3395
chrX	18888298	18896298	18893198	8000	18892298	-4000	4000	900
chrX	18985307	18993307	18990669	8000	18989307	-4000	4000	1362
chrX	19357718	19365718	19360804	8000	19361718	-4000	4000	-914
chrX	38265163	38273163	38269403	8000	38269163	-4000	4000	240
chrX	76427342	76435342	76428249	8000	76431342	-4000	4000	-3093
chrX	65503887	65511887	65504092	8000	65507887	-4000	4000	-3795
chrX	71528374	71536374	71529914	8000	71532374	-4000	4000	-2460
chrX	15380799	15388799	15384061	8000	15384799	-4000	4000	-738
chrX	51742232	51750232	51745601	8000	51746232	-4000	4000	-631
chrX	93666930	93674930	93672870	8000	93670930	-4000	4000	1940
chrX	111241099	111249099	111246708	8000	111245099	-4000	4000	1609
chrX	57901430	57909430	57908214	8000	57905430	-4000	4000	2784
chrX	78959727	78967727	78960607	8000	78963727	-4000	4000	-3120
chrX	129442501	129450501	129446931	8000	129446501	-4000	4000	430
chrX	103305346	103313346	103309717	8000	103309346	-4000	4000	371
chrX	119587083	119595083	119589140	8000	119591083	-4000	4000	-1943
chrX	15315452	15323452	15321521	8000	15319452	-4000	4000	2069
chrX	152698347	152706347	152701543	8000	152702347	-4000	4000	-804
chrX	1598520	1606520	1601265	8000	1602520	-4000	4000	-1255
chrX	2215506	2223506	2220961	8000	2219506	-4000	4000	1455
chrX	53427258	53435258	53433881	8000	53431258	-4000	4000	2623
chrX	21650695	21658695	21652573	8000	21654695	-4000	4000	-2122
chrX	17750988	17758988	17753341	8000	17754988	-4000	4000	-1647
chrX	117893813	117901813	117899347	8000	117897813	-4000	4000	1534
chrX	152733669	152741669	152736244	8000	152737669	-4000	4000	-1425
chrX	100671788	100679788	100675929	8000	100675788	-4000	4000	141
chrX	135578510	135586510	135579877	8000	135582510	-4000	4000	-2633
chrX	119240466	119248466	119243228	8000	119244466	-4000	4000	-1238
chrX	101651281	101659281	101657425	8000	101655281	-4000	4000	2144
chrX	100287644	100295644	100294461	8000	100291644	-4000	4000	2817
chrX	135029546	135037546	135033402	8000	135033546	-4000	4000	-144
chrX	65503887	65511887	65507106	8000	65507887	-4000	4000	-781
chrX	47619172	47627172	47626357	8000	47623172	-4000	4000	3185
chrX	76427342	76435342	76428217	8000	76431342	-4000	4000	-3125
chrX	66017738	66025738	66022153	8000	66021738	-4000	4000	415
chrX	43762610	43770610	43767556	8000	43766610	-4000	4000	946
chrX	3304565	3312565	3309532	8000	3308565	-4000	4000	967
chrX	152733669	152741669	152737242	8000	152737669	-4000	4000	-427
chrX	154483306	154491306	154485359	8000	154487306	-4000	4000	-1947
chrX	41693275	41701275	41696040	8000	41697275	-4000	4000	-1235
chrX	149592556	149600556	149594516	8000	149596556	-4000	4000	-2040
chrX	155235841	155243841	155238771	8000	155239841	-4000	4000	-1070
chrX	19357718	19365718	19359938	8000	19361718	-4000	4000	-1780
chrX	55480616	55488616	55488307	8000	55484616	-4000	4000	3691
chrX	69156851	69164851	69162959	8000	69160851	-4000	4000	2108
chrX	72200657	72208657	72206893	8000	72204657	-4000	4000	2236
chrX	1306381	1314381	1309514	8000	1310381	-4000	4000	-867
chrX	119587083	119595083	119592745	8000	119591083	-4000	4000	1662
chrX	153647326	153655326	153650048	8000	153651326	-4000	4000	-1278
chrX	18888298	18896298	18895142	8000	18892298	-4000	4000	2844
chrX	70416886	70424886	70419747	8000	70420886	-4000	4000	-1139
chrX	71297522	71305522	71304584	8000	71301522	-4000	4000	3062
chrX	54927431	54935431	54929266	8000	54931431	-4000	4000	-2165
chrX	152865729	152873729	152867650	8000	152869729	-4000	4000	-2079
chrX	119611724	119619724	119616613	8000	119615724	-4000	4000	889
chrX	117893813	117901813	117898719	8000	117897813	-4000	4000	906
chrX	9737037	9745037	9739593	8000	9741037	-4000	4000	-1444
chrX	55449566	55457566	55452475	8000	55453566	-4000	4000	-1091
chrX	101408297	101416297	101413317	8000	101412297	-4000	4000	1020
chrX	152733669	152741669	152736428	8000	152737669	-4000	4000	-1241
chrX	17796049	17804049	17801562	8000	17800049	-4000	4000	1513
chrX	117893813	117901813	117898273	8000	117897813	-4000	4000	460
chrX	18823921	18831921	18824033	8000	18827921	-4000	4000	-3888
chrX	47057242	47065242	47058218	8000	47061242	-4000	4000	-3024
chrX	47244328	47252328	47245385	8000	47248328	-4000	4000	-2943
chrX	108150671	108158671	108157217	8000	108154671	-4000	4000	2546
chrX	132622015	132630015	132628535	8000	132626015	-4000	4000	2520
chrX	135046932	135054932	135051778	8000	135050932	-4000	4000	846
chrX	10233660	10241660	10233872	8000	10237660	-4000	4000	-3788
chrX	12919169	12927169	12922024	8000	12923169	-4000	4000	-1145
chrX	76427342	76435342	76430742	8000	76431342	-4000	4000	-600
chrX	131269506	131277506	131276084	8000	131273506	-4000	4000	2578
chrX	11119086	11127086	11121948	8000	11123086	-4000	4000	-1138
chrX	12919169	12927169	12921451	8000	12923169	-4000	4000	-1718
chrX	19357718	19365718	19361448	8000	19361718	-4000	4000	-270
chrX	47567908	47575908	47575176	8000	47571908	-4000	4000	3268
chrX	57114551	57122551	57120513	8000	57118551	-4000	4000	1962
chrX	102655083	102663083	102655796	8000	102659083	-4000	4000	-3287
chrX	107601255	107609255	107601772	8000	107605255	-4000	4000	-3483
chrX	136661547	136669547	136667795	8000	136665547	-4000	4000	2248
chrX	147947125	147955125	147951043	8000	147951125	-4000	4000	-82
chrX	117893813	117901813	117899320	8000	117897813	-4000	4000	1507
chrX	72298926	72306926	72305410	8000	72302926	-4000	4000	2484
chrX	153665733	153673733	153671439	8000	153669733	-4000	4000	1706
chrX	54927431	54935431	54930621	8000	54931431	-4000	4000	-810
chrX	132071943	132079943	132077614	8000	132075943	-4000	4000	1671
chrX	3304565	3312565	3311017	8000	3308565	-4000	4000	2452
chrX	49164483	49172483	49166290	8000	49168483	-4000	4000	-2193
chrX	71221516	71229516	71224412	8000	71225516	-4000	4000	-1104
chrX	72200657	72208657	72208376	8000	72204657	-4000	4000	3719
chrX	155778459	155786459	155781677	8000	155782459	-4000	4000	-782
chrX	152698347	152706347	152701250	8000	152702347	-4000	4000	-1097
chrX	57901430	57909430	57909110	8000	57905430	-4000	4000	3680
chrX	11113651	11121651	11117398	8000	11117651	-4000	4000	-253
chrX	106204956	106212956	106207260	8000	106208956	-4000	4000	-1696
