Chr	Start	End	Mutation	Size	Middle	Start_C	End_C	Mutations_C
chr1	186439566	186447566	186443900	8000	186443566	-4000	4000	334
chr1	248345713	248353713	248349077	8000	248349713	-4000	4000	-636
chr1	152149595	152157595	152155595	8000	152153595	-4000	4000	2000
chr1	171634799	171642799	171636268	8000	171638799	-4000	4000	-2531
chr1	149809225	149817225	149812291	8000	149813225	-4000	4000	-934
chr1	151696058	151704058	151698830	8000	151700058	-4000	4000	-1228
chr1	152405243	152413243	152409902	8000	152409243	-4000	4000	659
chr1	152758052	152766052	152760603	8000	152762052	-4000	4000	-1449
chr1	39674648	39682648	39682462	8000	39678648	-4000	4000	3814
chr1	247602515	247610515	247606502	8000	247606515	-4000	4000	-13
chr1	42151820	42159820	42153516	8000	42155820	-4000	4000	-2304
chr1	53463488	53471488	53464813	8000	53467488	-4000	4000	-2675
chr1	149809225	149817225	149813390	8000	149813225	-4000	4000	165
chr1	152716470	152724470	152719689	8000	152720470	-4000	4000	-781
chr1	159947492	159955492	159951799	8000	159951492	-4000	4000	307
chr1	248097103	248105103	248099471	8000	248101103	-4000	4000	-1632
chr1	247707813	247715813	247712381	8000	247711813	-4000	4000	568
chr1	152405243	152413243	152410366	8000	152409243	-4000	4000	1123
chr1	159708289	159716289	159714052	8000	159712289	-4000	4000	1763
chr1	152758052	152766052	152760854	8000	152762052	-4000	4000	-1198
chr1	152881047	152889047	152884592	8000	152885047	-4000	4000	-455
chr1	204186341	204194341	204192813	8000	204190341	-4000	4000	2472
chr1	248451725	248459725	248452797	8000	248455725	-4000	4000	-2928
chr1	152102317	152110317	152110100	8000	152106317	-4000	4000	3783
chr1	247666812	247674812	247672269	8000	247670812	-4000	4000	1457
chr1	158556606	158564606	158562805	8000	158560606	-4000	4000	2199
chr1	31628518	31636518	31633288	8000	31632518	-4000	4000	770
chr1	149883469	149891469	149886521	8000	149887469	-4000	4000	-948
chr1	198519222	198527222	198523313	8000	198523222	-4000	4000	91
chr1	228057271	228065271	228059032	8000	228061271	-4000	4000	-2239
chr1	46925177	46933177	46930203	8000	46929177	-4000	4000	1026
chr1	119419035	119427035	119419512	8000	119423035	-4000	4000	-3523
chr1	152800832	152808832	152805425	8000	152804832	-4000	4000	593
chr1	152800832	152808832	152805427	8000	152804832	-4000	4000	595
chr1	12792628	12800628	12793374	8000	12796628	-4000	4000	-3254
chr1	203163811	203171811	203170314	8000	203167811	-4000	4000	2503
chr1	248319630	248327630	248323712	8000	248323630	-4000	4000	82
chr1	11841709	11849709	11847627	8000	11845709	-4000	4000	1918
chr1	12875212	12883212	12879325	8000	12879212	-4000	4000	113
chr1	158751891	158759891	158754847	8000	158755891	-4000	4000	-1044
chr1	248470307	248478307	248473878	8000	248474307	-4000	4000	-429
chr1	12916482	12924482	12920255	8000	12920482	-4000	4000	-227
chr1	108738749	108746749	108746730	8000	108742749	-4000	4000	3981
chr1	158770222	158778222	158777061	8000	158774222	-4000	4000	2839
chr1	15487395	15495395	15492806	8000	15491395	-4000	4000	1411
chr1	153988685	153996685	153992859	8000	153992685	-4000	4000	174
chr1	31628518	31636518	31633220	8000	31632518	-4000	4000	702
chr1	152561654	152569654	152566134	8000	152565654	-4000	4000	480
chr1	248097103	248105103	248099867	8000	248101103	-4000	4000	-1236
chr1	212826141	212834141	212830151	8000	212830141	-4000	4000	10
chr1	115281904	115289904	115286700	8000	115285904	-4000	4000	796
chr1	146013468	146021468	146018021	8000	146017468	-4000	4000	553
chr1	152758052	152766052	152760708	8000	152762052	-4000	4000	-1344
chr1	241991490	241999490	241998820	8000	241995490	-4000	4000	3330
chr1	248265917	248273917	248273043	8000	248269917	-4000	4000	3126
chr1	12663076	12671076	12666184	8000	12667076	-4000	4000	-892
chr1	162369203	162377203	162373910	8000	162373203	-4000	4000	707
chr1	34758327	34766327	34762130	8000	34762327	-4000	4000	-197
chr1	248569801	248577801	248574629	8000	248573801	-4000	4000	828
chr1	90707539	90715539	90714549	8000	90711539	-4000	4000	3010
chr1	13365067	13373067	13370662	8000	13369067	-4000	4000	1595
chr1	247445118	247453118	247448817	8000	247449118	-4000	4000	-301
chr1	24115771	24123771	24121696	8000	24119771	-4000	4000	1925
chr1	160086563	160094563	160092989	8000	160090563	-4000	4000	2426
chr1	167125165	167133165	167126134	8000	167129165	-4000	4000	-3031
chr1	248142086	248150086	248145832	8000	248146086	-4000	4000	-254
chr1	247735559	247743559	247738656	8000	247739559	-4000	4000	-903
chr1	247962386	247970386	247965464	8000	247966386	-4000	4000	-922
chr1	248319630	248327630	248324373	8000	248323630	-4000	4000	743
chr1	158540550	158548550	158547533	8000	158544550	-4000	4000	2983
chr1	63321128	63329128	63323864	8000	63325128	-4000	4000	-1264
chr1	115281904	115289904	115286799	8000	115285904	-4000	4000	895
chr1	152758052	152766052	152760387	8000	152762052	-4000	4000	-1665
chr1	158606704	158614704	158613842	8000	158610704	-4000	4000	3138
chr1	115832377	115840377	115836514	8000	115836377	-4000	4000	137
chr1	192363285	192371285	192366180	8000	192367285	-4000	4000	-1105
chr1	159439078	159447078	159440152	8000	159443078	-4000	4000	-2926
chr1	248645838	248653838	248650071	8000	248649838	-4000	4000	233
chr1	153066226	153074226	153070589	8000	153070226	-4000	4000	363
chr1	153066226	153074226	153070590	8000	153070226	-4000	4000	364
chr1	158608514	158616514	158615329	8000	158612514	-4000	4000	2815
chr1	248059407	248067407	248061582	8000	248063407	-4000	4000	-1825
chr1	212622775	212630775	212624988	8000	212626775	-4000	4000	-1787
chr1	152080141	152088141	152085532	8000	152084141	-4000	4000	1391
chr1	13337892	13345892	13344486	8000	13341892	-4000	4000	2594
chr1	149883469	149891469	149887265	8000	149887469	-4000	4000	-204
chr1	152208076	152216076	152213577	8000	152212076	-4000	4000	1501
chr1	158606704	158614704	158614305	8000	158610704	-4000	4000	3601
chr1	66775047	66783047	66777512	8000	66779047	-4000	4000	-1535
chr1	241798777	241806777	241801324	8000	241802777	-4000	4000	-1453
chr1	248404020	248412020	248407102	8000	248408020	-4000	4000	-918
chr1	53083179	53091179	53090761	8000	53087179	-4000	4000	3582
chr1	152080141	152088141	152087375	8000	152084141	-4000	4000	3234
chr1	152981500	152989500	152985248	8000	152985500	-4000	4000	-252
chr1	197034741	197042741	197040712	8000	197038741	-4000	4000	1971
chr1	248097103	248105103	248100153	8000	248101103	-4000	4000	-950
chr1	248319630	248327630	248324409	8000	248323630	-4000	4000	779
chr1	247602515	247610515	247606019	8000	247606515	-4000	4000	-496
chr1	248265917	248273917	248273106	8000	248269917	-4000	4000	3189
chr1	152344735	152352735	152351945	8000	152348735	-4000	4000	3210
chr1	183642275	183650275	183648270	8000	183646275	-4000	4000	1995
chr1	212622775	212630775	212625525	8000	212626775	-4000	4000	-1250
chr1	53083179	53091179	53090824	8000	53087179	-4000	4000	3645
chr1	15743982	15751982	15747598	8000	15747982	-4000	4000	-384
chr1	203163811	203171811	203165798	8000	203167811	-4000	4000	-2013
chr1	248470307	248478307	248473842	8000	248474307	-4000	4000	-465
chr1	248569801	248577801	248574266	8000	248573801	-4000	4000	465
chr1	182050570	182058570	182056359	8000	182054570	-4000	4000	1789
chr1	1530778	1538778	1533987	8000	1534778	-4000	4000	-791
chr1	12888896	12896896	12894844	8000	12892896	-4000	4000	1948
chr1	13337892	13345892	13342880	8000	13341892	-4000	4000	988
chr1	15743982	15751982	15747598	8000	15747982	-4000	4000	-384
chr1	115281904	115289904	115286703	8000	115285904	-4000	4000	799
chr1	158574919	158582919	158579068	8000	158578919	-4000	4000	149
chr1	206102936	206110936	206110514	8000	206106936	-4000	4000	3578
chr1	11191981	11199981	11194466	8000	11195981	-4000	4000	-1515
chr1	167048836	167056836	167055080	8000	167052836	-4000	4000	2244
chr1	6575755	6583755	6577030	8000	6579755	-4000	4000	-2725
chr1	158606704	158614704	158614306	8000	158610704	-4000	4000	3602
chr1	159439078	159447078	159439989	8000	159443078	-4000	4000	-3089
chr1	13277035	13285035	13283994	8000	13281035	-4000	4000	2959
chr1	206953965	206961965	206961171	8000	206957965	-4000	4000	3206
chr1	1913296	1921296	1916828	8000	1917296	-4000	4000	-468
chr1	152344735	152352735	152350940	8000	152348735	-4000	4000	2205
chr1	153035732	153043732	153040045	8000	153039732	-4000	4000	313
chr1	247836928	247844928	247841030	8000	247840928	-4000	4000	102
chr1	247836928	247844928	247841354	8000	247840928	-4000	4000	426
chr1	247836928	247844928	247841527	8000	247840928	-4000	4000	599
chr1	32212192	32220192	32216380	8000	32216192	-4000	4000	188
chr1	149809225	149817225	149813683	8000	149813225	-4000	4000	458
chr1	152824097	152832097	152827647	8000	152828097	-4000	4000	-450
chr1	152981500	152989500	152985239	8000	152985500	-4000	4000	-261
chr1	154990315	154998315	154993642	8000	154994315	-4000	4000	-673
chr1	158574919	158582919	158579172	8000	158578919	-4000	4000	253
chr1	158695678	158703678	158700212	8000	158699678	-4000	4000	534
chr1	158712327	158720327	158717691	8000	158716327	-4000	4000	1364
chr1	168578069	168586069	168581087	8000	168582069	-4000	4000	-982
chr1	182050570	182058570	182057268	8000	182054570	-4000	4000	2698
chr1	209609939	209617939	209612048	8000	209613939	-4000	4000	-1891
chr1	248097103	248105103	248099979	8000	248101103	-4000	4000	-1124
chr1	248404020	248412020	248406130	8000	248408020	-4000	4000	-1890
chr1	149883469	149891469	149886301	8000	149887469	-4000	4000	-1168
chr1	240471187	240479187	240472287	8000	240475187	-4000	4000	-2900
chr1	50199772	50207772	50201473	8000	50203772	-4000	4000	-2299
chr1	75914873	75922873	75919032	8000	75918873	-4000	4000	159
chr1	152575381	152583381	152579700	8000	152579381	-4000	4000	319
chr1	155285293	155293293	155287948	8000	155289293	-4000	4000	-1345
chr1	209609939	209617939	209617472	8000	209613939	-4000	4000	3533
chr1	248645838	248653838	248650094	8000	248649838	-4000	4000	256
chr1	248142086	248150086	248146012	8000	248146086	-4000	4000	-74
chr1	247666812	247674812	247672193	8000	247670812	-4000	4000	1381
chr1	248387811	248395811	248387999	8000	248391811	-4000	4000	-3812
chr1	152695442	152703442	152699106	8000	152699442	-4000	4000	-336
chr1	248358627	248366627	248361800	8000	248362627	-4000	4000	-827
chr1	13318598	13326598	13321973	8000	13322598	-4000	4000	-625
chr1	152102317	152110317	152108435	8000	152106317	-4000	4000	2118
chr1	223391465	223399465	223395420	8000	223395465	-4000	4000	-45
chr1	152344735	152352735	152352673	8000	152348735	-4000	4000	3938
chr1	152660659	152668659	152664639	8000	152664659	-4000	4000	-20
chr1	211472522	211480522	211479315	8000	211476522	-4000	4000	2793
chr1	248619557	248627557	248626733	8000	248623557	-4000	4000	3176
chr1	152683397	152691397	152686948	8000	152687397	-4000	4000	-449
chr1	12916482	12924482	12919908	8000	12920482	-4000	4000	-574
chr1	13218705	13226705	13225258	8000	13222705	-4000	4000	2553
chr1	147905269	147913269	147909029	8000	147909269	-4000	4000	-240
chr1	149809225	149817225	149813650	8000	149813225	-4000	4000	425
chr1	159439078	159447078	159439980	8000	159443078	-4000	4000	-3098
chr1	247602515	247610515	247606140	8000	247606515	-4000	4000	-375
chr1	179546539	179554539	179554528	8000	179550539	-4000	4000	3989
chr1	103660554	103668554	103660638	8000	103664554	-4000	4000	-3916
chr1	182895865	182903865	182900208	8000	182899865	-4000	4000	343
chr1	215618891	215626891	215625606	8000	215622891	-4000	4000	2715
chr1	12888896	12896896	12894849	8000	12892896	-4000	4000	1953
chr1	15737392	15745392	15738725	8000	15741392	-4000	4000	-2667
chr1	33860791	33868791	33864426	8000	33864791	-4000	4000	-365
chr1	155939087	155947087	155942473	8000	155943087	-4000	4000	-614
chr1	158323951	158331951	158329857	8000	158327951	-4000	4000	1906
chr1	182050570	182058570	182057605	8000	182054570	-4000	4000	3035
chr1	204150819	204158819	204156305	8000	204154819	-4000	4000	1486
chr1	248097103	248105103	248099508	8000	248101103	-4000	4000	-1595
chr1	149883469	149891469	149887475	8000	149887469	-4000	4000	6
chr1	115281904	115289904	115286394	8000	115285904	-4000	4000	490
chr1	62208328	62216328	62210152	8000	62212328	-4000	4000	-2176
chr1	63321128	63329128	63323738	8000	63325128	-4000	4000	-1390
chr1	26198968	26206968	26202499	8000	26202968	-4000	4000	-469
chr1	237000103	237008103	237004351	8000	237004103	-4000	4000	248
chr1	157741733	157749733	157746699	8000	157745733	-4000	4000	966
chr1	66793740	66801740	66801146	8000	66797740	-4000	4000	3406
chr1	158556606	158564606	158562903	8000	158560606	-4000	4000	2297
chr1	171634799	171642799	171636279	8000	171638799	-4000	4000	-2520
chr1	115281904	115289904	115286558	8000	115285904	-4000	4000	654
chr1	92241813	92249813	92242275	8000	92245813	-4000	4000	-3538
chr1	154544147	154552147	154544407	8000	154548147	-4000	4000	-3740
chr1	158394522	158402522	158398919	8000	158398522	-4000	4000	397
chr1	179546539	179554539	179551383	8000	179550539	-4000	4000	844
chr1	248569801	248577801	248574673	8000	248573801	-4000	4000	872
chr1	212622775	212630775	212626288	8000	212626775	-4000	4000	-487
chr1	119889533	119897533	119895973	8000	119893533	-4000	4000	2440
chr1	183642275	183650275	183647861	8000	183646275	-4000	4000	1586
chr1	247810660	247818660	247815564	8000	247814660	-4000	4000	904
chr1	13337892	13345892	13344568	8000	13341892	-4000	4000	2676
chr1	160368846	160376846	160370945	8000	160372846	-4000	4000	-1901
chr1	63321128	63329128	63323535	8000	63325128	-4000	4000	-1593
chr1	152758052	152766052	152760163	8000	152762052	-4000	4000	-1889
chr1	158695678	158703678	158699703	8000	158699678	-4000	4000	25
chr1	237000103	237008103	237004406	8000	237004103	-4000	4000	303
chr1	247666812	247674812	247672753	8000	247670812	-4000	4000	1941
chr1	240471187	240479187	240472126	8000	240475187	-4000	4000	-3061
chr1	152705434	152713434	152709178	8000	152709434	-4000	4000	-256
chr1	149809225	149817225	149812264	8000	149813225	-4000	4000	-961
chr1	156929094	156937094	156932549	8000	156933094	-4000	4000	-545
chr1	198519222	198527222	198523353	8000	198523222	-4000	4000	131
chr1	3018903	3026903	3022597	8000	3022903	-4000	4000	-306
chr1	13337892	13345892	13342658	8000	13341892	-4000	4000	766
chr1	111316566	111324566	111318028	8000	111320566	-4000	4000	-2538
chr1	247919152	247927152	247921061	8000	247923152	-4000	4000	-2091
chr1	11191981	11199981	11194535	8000	11195981	-4000	4000	-1446
chr1	248038305	248046305	248039059	8000	248042305	-4000	4000	-3246
chr1	182050570	182058570	182056484	8000	182054570	-4000	4000	1914
chr1	13417328	13425328	13420940	8000	13421328	-4000	4000	-388
chr1	43350466	43358466	43352224	8000	43354466	-4000	4000	-2242
chr1	152208076	152216076	152216050	8000	152212076	-4000	4000	3974
chr1	159708289	159716289	159714065	8000	159712289	-4000	4000	1776
chr1	13365067	13373067	13369361	8000	13369067	-4000	4000	294
chr1	248470307	248478307	248474279	8000	248474307	-4000	4000	-28
chr1	203163811	203171811	203171488	8000	203167811	-4000	4000	3677
chr1	13277035	13285035	13281830	8000	13281035	-4000	4000	795
chr1	86576754	86584754	86579449	8000	86580754	-4000	4000	-1305
chr1	240471187	240479187	240472408	8000	240475187	-4000	4000	-2779
chr1	158770222	158778222	158777254	8000	158774222	-4000	4000	3032
chr1	158476936	158484936	158480940	8000	158480936	-4000	4000	4
chr1	159708289	159716289	159713428	8000	159712289	-4000	4000	1139
chr1	44801893	44809893	44803932	8000	44805893	-4000	4000	-1961
chr1	159947492	159955492	159953619	8000	159951492	-4000	4000	2127
chr1	247666812	247674812	247672269	8000	247670812	-4000	4000	1457
chr1	158323951	158331951	158330843	8000	158327951	-4000	4000	2892
chr1	192363285	192371285	192365990	8000	192367285	-4000	4000	-1295
chr1	157790403	157798403	157797790	8000	157794403	-4000	4000	3387
chr1	152344735	152352735	152351071	8000	152348735	-4000	4000	2336
chr1	248345713	248353713	248349667	8000	248349713	-4000	4000	-46
chr1	241991490	241999490	241996309	8000	241995490	-4000	4000	819
chr1	158323951	158331951	158328255	8000	158327951	-4000	4000	304
chr1	247810660	247818660	247815144	8000	247814660	-4000	4000	484
chr1	12663076	12671076	12666560	8000	12667076	-4000	4000	-516
chr1	247945796	247953796	247949648	8000	247949796	-4000	4000	-148
chr1	159531078	159539078	159535654	8000	159535078	-4000	4000	576
chr1	1913296	1921296	1916819	8000	1917296	-4000	4000	-477
chr1	45616044	45624044	45621953	8000	45620044	-4000	4000	1909
chr1	119511054	119519054	119514202	8000	119515054	-4000	4000	-852
chr1	152758052	152766052	152760599	8000	152762052	-4000	4000	-1453
chr1	153201120	153209120	153204755	8000	153205120	-4000	4000	-365
chr1	247707813	247715813	247712483	8000	247711813	-4000	4000	670
chr1	248319630	248327630	248323865	8000	248323630	-4000	4000	235
chr1	84411018	84419018	84414590	8000	84415018	-4000	4000	-428
chr1	158606704	158614704	158612952	8000	158610704	-4000	4000	2248
chr1	19676966	19684966	19683058	8000	19680966	-4000	4000	2092
chr1	70147945	70155945	70148605	8000	70151945	-4000	4000	-3340
chr1	152839983	152847983	152843592	8000	152843983	-4000	4000	-391
chr1	158540550	158548550	158547698	8000	158544550	-4000	4000	3148
chr1	12792628	12800628	12793336	8000	12796628	-4000	4000	-3292
chr1	25326445	25334445	25329079	8000	25330445	-4000	4000	-1366
chr1	54838252	54846252	54841664	8000	54842252	-4000	4000	-588
chr1	67088165	67096165	67093311	8000	67092165	-4000	4000	1146
chr1	152508177	152516177	152515995	8000	152512177	-4000	4000	3818
chr1	247945796	247953796	247949366	8000	247949796	-4000	4000	-430
chr1	248319630	248327630	248324545	8000	248323630	-4000	4000	915
chr1	248645838	248653838	248650791	8000	248649838	-4000	4000	953
chr1	19676966	19684966	19683171	8000	19680966	-4000	4000	2205
chr1	247962386	247970386	247966248	8000	247966386	-4000	4000	-138
chr1	13417328	13425328	13421038	8000	13421328	-4000	4000	-290
chr1	152149595	152157595	152155145	8000	152153595	-4000	4000	1550
chr1	158540550	158548550	158547956	8000	158544550	-4000	4000	3406
chr1	1917951	1925951	1923091	8000	1921951	-4000	4000	1140
chr1	12875212	12883212	12883123	8000	12879212	-4000	4000	3911
chr1	152102317	152110317	152110171	8000	152106317	-4000	4000	3854
chr1	203163811	203171811	203171485	8000	203167811	-4000	4000	3674
chr1	75914873	75922873	75922293	8000	75918873	-4000	4000	3420
chr1	158712327	158720327	158717999	8000	158716327	-4000	4000	1672
chr1	182050570	182058570	182056617	8000	182054570	-4000	4000	2047
chr1	12875212	12883212	12879664	8000	12879212	-4000	4000	452
chr1	248619557	248627557	248626514	8000	248623557	-4000	4000	2957
chr1	182050570	182058570	182056652	8000	182054570	-4000	4000	2082
chr1	201035512	201043512	201039949	8000	201039512	-4000	4000	437
chr1	247585313	247593313	247589082	8000	247589313	-4000	4000	-231
chr1	152800832	152808832	152805437	8000	152804832	-4000	4000	605
chr1	152575381	152583381	152579947	8000	152579381	-4000	4000	566
chr1	248142086	248150086	248145448	8000	248146086	-4000	4000	-638
chr1	248470307	248478307	248473712	8000	248474307	-4000	4000	-595
chr1	12888896	12896896	12892947	8000	12892896	-4000	4000	51
chr1	149809225	149817225	149812029	8000	149813225	-4000	4000	-1196
chr1	149809225	149817225	149812186	8000	149813225	-4000	4000	-1039
chr1	149809225	149817225	149812364	8000	149813225	-4000	4000	-861
chr1	154544147	154552147	154547931	8000	154548147	-4000	4000	-216
chr1	158323951	158331951	158330016	8000	158327951	-4000	4000	2065
chr1	168536768	168544768	168543955	8000	168540768	-4000	4000	3187
chr1	13045476	13053476	13050264	8000	13049476	-4000	4000	788
chr1	149883469	149891469	149887046	8000	149887469	-4000	4000	-423
chr1	153293116	153301116	153299197	8000	153297116	-4000	4000	2081
chr1	162391268	162399268	162397197	8000	162395268	-4000	4000	1929
chr1	247919152	247927152	247921336	8000	247923152	-4000	4000	-1816
chr1	248059407	248067407	248060820	8000	248063407	-4000	4000	-2587
chr1	158414210	158422210	158420498	8000	158418210	-4000	4000	2288
chr1	248569801	248577801	248574378	8000	248573801	-4000	4000	577
chr1	152597086	152605086	152600671	8000	152601086	-4000	4000	-415
chr1	63321128	63329128	63323146	8000	63325128	-4000	4000	-1982
chr1	152102317	152110317	152107726	8000	152106317	-4000	4000	1409
chr1	32212192	32220192	32215836	8000	32216192	-4000	4000	-356
chr1	152809108	152817108	152812928	8000	152813108	-4000	4000	-180
chr1	158574919	158582919	158579093	8000	158578919	-4000	4000	174
chr1	159531078	159539078	159535348	8000	159535078	-4000	4000	270
chr1	198519222	198527222	198523360	8000	198523222	-4000	4000	138
chr1	247602515	247610515	247606087	8000	247606515	-4000	4000	-428
chr1	27391814	27399814	27394609	8000	27395814	-4000	4000	-1205
chr1	149883469	149891469	149887316	8000	149887469	-4000	4000	-153
chr1	155939087	155947087	155942618	8000	155943087	-4000	4000	-469
chr1	228420845	228428845	228424867	8000	228424845	-4000	4000	22
chr1	167048836	167056836	167055044	8000	167052836	-4000	4000	2208
chr1	152405243	152413243	152409836	8000	152409243	-4000	4000	593
chr1	158323951	158331951	158329622	8000	158327951	-4000	4000	1671
chr1	247707813	247715813	247712308	8000	247711813	-4000	4000	495
chr1	248038305	248046305	248039021	8000	248042305	-4000	4000	-3284
chr1	248645838	248653838	248650359	8000	248649838	-4000	4000	521
chr1	151165986	151173986	151170920	8000	151169986	-4000	4000	934
chr1	153201120	153209120	153204712	8000	153205120	-4000	4000	-408
chr1	1917951	1925951	1923780	8000	1921951	-4000	4000	1829
chr1	109599091	109607091	109606045	8000	109603091	-4000	4000	2954
chr1	149883469	149891469	149886455	8000	149887469	-4000	4000	-1014
chr1	182050570	182058570	182056622	8000	182054570	-4000	4000	2052
chr1	223391465	223399465	223394880	8000	223395465	-4000	4000	-585
chr1	47414052	47422052	47416684	8000	47418052	-4000	4000	-1368
chr1	152208076	152216076	152214190	8000	152212076	-4000	4000	2114
chr1	158751891	158759891	158755204	8000	158755891	-4000	4000	-687
chr1	196914713	196922713	196918262	8000	196918713	-4000	4000	-451
chr1	247945796	247953796	247949043	8000	247949796	-4000	4000	-753
chr1	156836063	156844063	156841723	8000	156840063	-4000	4000	1660
chr1	167125165	167133165	167128530	8000	167129165	-4000	4000	-635
chr1	154544147	154552147	154544506	8000	154548147	-4000	4000	-3641
chr1	159708289	159716289	159713937	8000	159712289	-4000	4000	1648
chr1	160368846	160376846	160371317	8000	160372846	-4000	4000	-1529
chr1	200870178	200878178	200873987	8000	200874178	-4000	4000	-191
chr1	42151820	42159820	42155548	8000	42155820	-4000	4000	-272
chr1	145735288	145743288	145738355	8000	145739288	-4000	4000	-933
chr1	12875212	12883212	12879790	8000	12879212	-4000	4000	578
chr1	38039829	38047829	38045687	8000	38043829	-4000	4000	1858
chr1	110453358	110461358	110456300	8000	110457358	-4000	4000	-1058
chr1	152149595	152157595	152156543	8000	152153595	-4000	4000	2948
chr1	173604336	173612336	173609972	8000	173608336	-4000	4000	1636
chr1	248645838	248653838	248650197	8000	248649838	-4000	4000	359
chr1	158323951	158331951	158328045	8000	158327951	-4000	4000	94
chr1	158556606	158564606	158562817	8000	158560606	-4000	4000	2211
chr1	13259314	13267314	13263002	8000	13263314	-4000	4000	-312
chr1	158606704	158614704	158607189	8000	158610704	-4000	4000	-3515
chr1	192656311	192664311	192659335	8000	192660311	-4000	4000	-976
chr1	12857909	12865909	12861292	8000	12861909	-4000	4000	-617
chr1	13318598	13326598	13319826	8000	13322598	-4000	4000	-2772
chr1	151165986	151173986	151171457	8000	151169986	-4000	4000	1471
chr1	248470307	248478307	248474151	8000	248474307	-4000	4000	-156
chr1	248632356	248640356	248638511	8000	248636356	-4000	4000	2155
chr1	248645838	248653838	248650153	8000	248649838	-4000	4000	315
chr1	206953965	206961965	206960943	8000	206957965	-4000	4000	2978
chr1	12857909	12865909	12860210	8000	12861909	-4000	4000	-1699
chr1	152758052	152766052	152760619	8000	152762052	-4000	4000	-1433
chr1	12663076	12671076	12666689	8000	12667076	-4000	4000	-387
chr1	20715731	20723731	20723672	8000	20719731	-4000	4000	3941
chr1	45616044	45624044	45622814	8000	45620044	-4000	4000	2770
chr1	158608514	158616514	158615390	8000	158612514	-4000	4000	2876
chr1	165559957	165567957	165563507	8000	165563957	-4000	4000	-450
chr1	152758052	152766052	152761309	8000	152762052	-4000	4000	-743
chr1	149883469	149891469	149886630	8000	149887469	-4000	4000	-839
chr1	182050570	182058570	182056494	8000	182054570	-4000	4000	1924
chr1	152716470	152724470	152719800	8000	152720470	-4000	4000	-670
chr1	158476936	158484936	158480525	8000	158480936	-4000	4000	-411
chr1	248265917	248273917	248273202	8000	248269917	-4000	4000	3285
chr1	153108121	153116121	153112592	8000	153112121	-4000	4000	471
chr1	248569801	248577801	248574114	8000	248573801	-4000	4000	313
chr1	248097103	248105103	248100082	8000	248101103	-4000	4000	-1021
chr1	228420845	228428845	228424886	8000	228424845	-4000	4000	41
chr1	247735559	247743559	247739555	8000	247739559	-4000	4000	-4
chr1	248345713	248353713	248349485	8000	248349713	-4000	4000	-228
chr1	248059407	248067407	248060967	8000	248063407	-4000	4000	-2440
chr1	158712327	158720327	158717701	8000	158716327	-4000	4000	1374
chr1	158606704	158614704	158613860	8000	158610704	-4000	4000	3156
chr1	158695678	158703678	158700037	8000	158699678	-4000	4000	359
chr1	165197867	165205867	165203820	8000	165201867	-4000	4000	1953
chr1	215618891	215626891	215625806	8000	215622891	-4000	4000	2915
chr1	247585313	247593313	247588797	8000	247589313	-4000	4000	-516
chr1	153433058	153441058	153438312	8000	153437058	-4000	4000	1254
chr1	12820605	12828605	12827599	8000	12824605	-4000	4000	2994
chr1	145735288	145743288	145738155	8000	145739288	-4000	4000	-1133
chr1	158414210	158422210	158419989	8000	158418210	-4000	4000	1779
chr1	67255979	67263979	67258630	8000	67259979	-4000	4000	-1349
chr1	32212192	32220192	32212562	8000	32216192	-4000	4000	-3630
chr1	154321325	154329325	154327817	8000	154325325	-4000	4000	2492
chr1	223391465	223399465	223394597	8000	223395465	-4000	4000	-868
chr1	247602515	247610515	247605662	8000	247606515	-4000	4000	-853
chr1	248569801	248577801	248574470	8000	248573801	-4000	4000	669
chr1	248586487	248594487	248592945	8000	248590487	-4000	4000	2458
chr1	54003298	54011298	54010329	8000	54007298	-4000	4000	3031
chr1	153369711	153377711	153373793	8000	153373711	-4000	4000	82
chr1	159439078	159447078	159440469	8000	159443078	-4000	4000	-2609
chr1	159708289	159716289	159713744	8000	159712289	-4000	4000	1455
chr1	205824025	205832025	205828709	8000	205828025	-4000	4000	684
chr1	159830474	159838474	159835278	8000	159834474	-4000	4000	804
chr1	152800832	152808832	152805443	8000	152804832	-4000	4000	611
chr1	211472522	211480522	211479080	8000	211476522	-4000	4000	2558
chr1	158751891	158759891	158755244	8000	158755891	-4000	4000	-647
chr1	182050570	182058570	182057495	8000	182054570	-4000	4000	2925
chr1	152102317	152110317	152107448	8000	152106317	-4000	4000	1131
chr1	17242007	17250007	17249218	8000	17246007	-4000	4000	3211
chr1	159439078	159447078	159440213	8000	159443078	-4000	4000	-2865
chr1	92241813	92249813	92244365	8000	92245813	-4000	4000	-1448
chr1	13388629	13396629	13389926	8000	13392629	-4000	4000	-2703
chr1	206763602	206771602	206768660	8000	206767602	-4000	4000	1058
chr1	173899800	173907800	173903816	8000	173903800	-4000	4000	16
chr1	206953965	206961965	206961205	8000	206957965	-4000	4000	3240
chr1	158323951	158331951	158329585	8000	158327951	-4000	4000	1634
chr1	248569801	248577801	248574714	8000	248573801	-4000	4000	913
chr1	12888896	12896896	12893360	8000	12892896	-4000	4000	464
chr1	151165986	151173986	151166168	8000	151169986	-4000	4000	-3818
chr1	12820605	12828605	12827750	8000	12824605	-4000	4000	3145
chr1	149883469	149891469	149886215	8000	149887469	-4000	4000	-1254
chr1	10942471	10950471	10948274	8000	10946471	-4000	4000	1803
chr1	10942471	10950471	10948370	8000	10946471	-4000	4000	1899
chr1	158695678	158703678	158700193	8000	158699678	-4000	4000	515
chr1	182050570	182058570	182057383	8000	182054570	-4000	4000	2813
chr1	149883469	149891469	149886087	8000	149887469	-4000	4000	-1382
chr1	152208076	152216076	152215979	8000	152212076	-4000	4000	3903
chr1	248265917	248273917	248272875	8000	248269917	-4000	4000	2958
chr1	158476936	158484936	158479940	8000	158480936	-4000	4000	-996
chr1	11191981	11199981	11194870	8000	11195981	-4000	4000	-1111
chr1	13417328	13425328	13420957	8000	13421328	-4000	4000	-371
chr1	33860791	33868791	33864457	8000	33864791	-4000	4000	-334
chr1	13045476	13053476	13050061	8000	13049476	-4000	4000	585
chr1	247919152	247927152	247921268	8000	247923152	-4000	4000	-1884
chr1	44801893	44809893	44804729	8000	44805893	-4000	4000	-1164
chr1	20715731	20723731	20723689	8000	20719731	-4000	4000	3958
chr1	34758327	34766327	34762613	8000	34762327	-4000	4000	286
chr1	158323951	158331951	158328131	8000	158327951	-4000	4000	180
chr1	169390870	169398870	169395189	8000	169394870	-4000	4000	319
chr1	12916482	12924482	12917884	8000	12920482	-4000	4000	-2598
chr1	248345713	248353713	248349323	8000	248349713	-4000	4000	-390
chr1	167048836	167056836	167055010	8000	167052836	-4000	4000	2174
chr1	13337892	13345892	13342929	8000	13341892	-4000	4000	1037
chr1	70147945	70155945	70155711	8000	70151945	-4000	4000	3766
chr1	158751891	158759891	158755706	8000	158755891	-4000	4000	-185
chr1	247735559	247743559	247738656	8000	247739559	-4000	4000	-903
chr1	12875212	12883212	12882424	8000	12879212	-4000	4000	3212
chr1	248404020	248412020	248406748	8000	248408020	-4000	4000	-1272
chr1	98886245	98894245	98893086	8000	98890245	-4000	4000	2841
chr1	182050570	182058570	182056979	8000	182054570	-4000	4000	2409
chr1	158414210	158422210	158420789	8000	158418210	-4000	4000	2579
chr1	147905269	147913269	147908849	8000	147909269	-4000	4000	-420
chr1	152149595	152157595	152156838	8000	152153595	-4000	4000	3243
chr1	68424822	68432822	68431560	8000	68428822	-4000	4000	2738
chr1	12792628	12800628	12795624	8000	12796628	-4000	4000	-1004
chr1	149809225	149817225	149813574	8000	149813225	-4000	4000	349
chr1	149883469	149891469	149886428	8000	149887469	-4000	4000	-1041
chr1	3018903	3026903	3022696	8000	3022903	-4000	4000	-207
chr1	115832377	115840377	115840238	8000	115836377	-4000	4000	3861
chr1	149883469	149891469	149886569	8000	149887469	-4000	4000	-900
chr1	152102317	152110317	152108305	8000	152106317	-4000	4000	1988
chr1	152102317	152110317	152109454	8000	152106317	-4000	4000	3137
chr1	152618834	152626834	152623023	8000	152622834	-4000	4000	189
chr1	167805386	167813386	167809685	8000	167809386	-4000	4000	299
chr1	247836928	247844928	247841124	8000	247840928	-4000	4000	196
chr1	33860791	33868791	33864329	8000	33864791	-4000	4000	-462
chr1	149883469	149891469	149886378	8000	149887469	-4000	4000	-1091
chr1	158323951	158331951	158331369	8000	158327951	-4000	4000	3418
chr1	158712327	158720327	158717630	8000	158716327	-4000	4000	1303
chr1	173496460	173504460	173503319	8000	173500460	-4000	4000	2859
chr1	182050570	182058570	182056629	8000	182054570	-4000	4000	2059
chr1	247945796	247953796	247949380	8000	247949796	-4000	4000	-416
chr1	248387811	248395811	248388232	8000	248391811	-4000	4000	-3579
chr1	68424822	68432822	68429736	8000	68428822	-4000	4000	914
chr1	247585313	247593313	247588944	8000	247589313	-4000	4000	-369
chr1	228057271	228065271	228059111	8000	228061271	-4000	4000	-2160
chr1	248038305	248046305	248038427	8000	248042305	-4000	4000	-3878
chr1	157826911	157834911	157833363	8000	157830911	-4000	4000	2452
chr1	155285293	155293293	155287200	8000	155289293	-4000	4000	-2093
chr1	12792628	12800628	12795596	8000	12796628	-4000	4000	-1032
chr1	13337892	13345892	13344592	8000	13341892	-4000	4000	2700
chr1	48244644	48252644	48247540	8000	48248644	-4000	4000	-1104
chr1	90707539	90715539	90714663	8000	90711539	-4000	4000	3124
chr1	156877850	156885850	156879192	8000	156881850	-4000	4000	-2658
chr1	170164866	170172866	170167575	8000	170168866	-4000	4000	-1291
chr1	151696058	151704058	151702656	8000	151700058	-4000	4000	2598
chr1	13337892	13345892	13342663	8000	13341892	-4000	4000	771
chr1	12773906	12781906	12775671	8000	12777906	-4000	4000	-2235
chr1	12820605	12828605	12825151	8000	12824605	-4000	4000	546
chr1	152080141	152088141	152085302	8000	152084141	-4000	4000	1161
chr1	26198968	26206968	26201492	8000	26202968	-4000	4000	-1476
chr1	247666812	247674812	247672312	8000	247670812	-4000	4000	1500
chr1	12724760	12732760	12725250	8000	12728760	-4000	4000	-3510
chr1	33860791	33868791	33864453	8000	33864791	-4000	4000	-338
chr1	67255979	67263979	67259344	8000	67259979	-4000	4000	-635
chr1	119419035	119427035	119419512	8000	119423035	-4000	4000	-3523
chr1	152660659	152668659	152664564	8000	152664659	-4000	4000	-95
chr1	248038305	248046305	248038386	8000	248042305	-4000	4000	-3919
chr1	248097103	248105103	248100118	8000	248101103	-4000	4000	-985
chr1	167125165	167133165	167128510	8000	167129165	-4000	4000	-655
chr1	12875212	12883212	12879710	8000	12879212	-4000	4000	498
chr1	12875212	12883212	12881985	8000	12879212	-4000	4000	2773
chr1	15487395	15495395	15491124	8000	15491395	-4000	4000	-271
chr1	26198968	26206968	26201066	8000	26202968	-4000	4000	-1902
chr1	162369203	162377203	162376700	8000	162373203	-4000	4000	3497
chr1	167125165	167133165	167128322	8000	167129165	-4000	4000	-843
chr1	182895865	182903865	182900108	8000	182899865	-4000	4000	243
chr1	206838981	206846981	206841050	8000	206842981	-4000	4000	-1931
chr1	209609939	209617939	209615362	8000	209613939	-4000	4000	1423
chr1	212622775	212630775	212625940	8000	212626775	-4000	4000	-835
chr1	212622775	212630775	212626351	8000	212626775	-4000	4000	-424
chr1	223391465	223399465	223395470	8000	223395465	-4000	4000	5
chr1	248358627	248366627	248362579	8000	248362627	-4000	4000	-48
chr1	248586487	248594487	248593359	8000	248590487	-4000	4000	2872
chr1	247810660	247818660	247815354	8000	247814660	-4000	4000	694
chr1	12792628	12800628	12794014	8000	12796628	-4000	4000	-2614
chr1	34758327	34766327	34761897	8000	34762327	-4000	4000	-430
chr1	44779585	44787585	44784666	8000	44783585	-4000	4000	1081
chr1	153066226	153074226	153070538	8000	153070226	-4000	4000	312
chr1	155285293	155293293	155288471	8000	155289293	-4000	4000	-822
chr1	159531078	159539078	159535322	8000	159535078	-4000	4000	244
chr1	248038305	248046305	248039306	8000	248042305	-4000	4000	-2999
chr1	153293116	153301116	153298005	8000	153297116	-4000	4000	889
chr1	152405243	152413243	152410681	8000	152409243	-4000	4000	1438
chr1	196221779	196229779	196227688	8000	196225779	-4000	4000	1909
chr1	247962386	247970386	247965505	8000	247966386	-4000	4000	-881
chr1	153066226	153074226	153070576	8000	153070226	-4000	4000	350
chr1	192656311	192664311	192658203	8000	192660311	-4000	4000	-2108
chr1	109101951	109109951	109106576	8000	109105951	-4000	4000	625
chr1	155939087	155947087	155942696	8000	155943087	-4000	4000	-391
chr1	18835599	18843599	18840005	8000	18839599	-4000	4000	406
chr1	152758052	152766052	152760400	8000	152762052	-4000	4000	-1652
chr1	152809108	152817108	152813070	8000	152813108	-4000	4000	-38
chr1	153066226	153074226	153070595	8000	153070226	-4000	4000	369
chr1	152208076	152216076	152215813	8000	152212076	-4000	4000	3737
chr1	223391465	223399465	223395126	8000	223395465	-4000	4000	-339
chr1	110513217	110521217	110518687	8000	110517217	-4000	4000	1470
chr1	157826911	157834911	157833304	8000	157830911	-4000	4000	2393
chr1	247945796	247953796	247949110	8000	247949796	-4000	4000	-686
chr1	12792628	12800628	12795903	8000	12796628	-4000	4000	-725
chr1	13304907	13312907	13305985	8000	13308907	-4000	4000	-2922
chr1	32212192	32220192	32216781	8000	32216192	-4000	4000	589
chr1	34758327	34766327	34761905	8000	34762327	-4000	4000	-422
chr1	46925177	46933177	46932758	8000	46929177	-4000	4000	3581
chr1	108738749	108746749	108741799	8000	108742749	-4000	4000	-950
chr1	152080141	152088141	152088045	8000	152084141	-4000	4000	3904
chr1	152102317	152110317	152110144	8000	152106317	-4000	4000	3827
chr1	153433058	153441058	153438198	8000	153437058	-4000	4000	1140
chr1	154990315	154998315	154993959	8000	154994315	-4000	4000	-356
chr1	152758052	152766052	152760711	8000	152762052	-4000	4000	-1341
chr1	158414210	158422210	158420228	8000	158418210	-4000	4000	2018
chr1	228420845	228428845	228425148	8000	228424845	-4000	4000	303
chr1	247945796	247953796	247949709	8000	247949796	-4000	4000	-87
chr1	247962386	247970386	247966137	8000	247966386	-4000	4000	-249
chr1	248451725	248459725	248453322	8000	248455725	-4000	4000	-2403
chr1	248632356	248640356	248638737	8000	248636356	-4000	4000	2381
chr1	2524745	2532745	2526579	8000	2528745	-4000	4000	-2166
chr1	13318598	13326598	13319784	8000	13322598	-4000	4000	-2814
chr1	13470973	13478973	13475745	8000	13474973	-4000	4000	772
chr1	16030050	16038050	16032255	8000	16034050	-4000	4000	-1795
chr1	50413550	50421550	50419567	8000	50417550	-4000	4000	2017
chr1	86496259	86504259	86498642	8000	86500259	-4000	4000	-1617
chr1	90707539	90715539	90712578	8000	90711539	-4000	4000	1039
chr1	110513217	110521217	110518220	8000	110517217	-4000	4000	1003
chr1	149809225	149817225	149813390	8000	149813225	-4000	4000	165
chr1	149883469	149891469	149887097	8000	149887469	-4000	4000	-372
chr1	149883469	149891469	149887749	8000	149887469	-4000	4000	280
chr1	157569747	157577747	157575568	8000	157573747	-4000	4000	1821
chr1	158414210	158422210	158420064	8000	158418210	-4000	4000	1854
chr1	158608514	158616514	158615377	8000	158612514	-4000	4000	2863
chr1	158712327	158720327	158717625	8000	158716327	-4000	4000	1298
chr1	160086563	160094563	160087581	8000	160090563	-4000	4000	-2982
chr1	167125165	167133165	167127464	8000	167129165	-4000	4000	-1701
chr1	170164866	170172866	170166729	8000	170168866	-4000	4000	-2137
chr1	247585313	247593313	247589196	8000	247589313	-4000	4000	-117
chr1	248404020	248412020	248406062	8000	248408020	-4000	4000	-1958
chr1	110513217	110521217	110517770	8000	110517217	-4000	4000	553
chr1	145735288	145743288	145736090	8000	145739288	-4000	4000	-3198
chr1	152102317	152110317	152109639	8000	152106317	-4000	4000	3322
chr1	152575381	152583381	152579744	8000	152579381	-4000	4000	363
chr1	158476936	158484936	158480631	8000	158480936	-4000	4000	-305
chr1	203163811	203171811	203169357	8000	203167811	-4000	4000	1546
chr1	247892531	247900531	247896103	8000	247896531	-4000	4000	-428
chr1	152405243	152413243	152410228	8000	152409243	-4000	4000	985
chr1	247919152	247927152	247921650	8000	247923152	-4000	4000	-1502
chr1	90707539	90715539	90712132	8000	90711539	-4000	4000	593
chr1	156836063	156844063	156843182	8000	156840063	-4000	4000	3119
chr1	248586487	248594487	248593384	8000	248590487	-4000	4000	2897
chr1	152705434	152713434	152709062	8000	152709434	-4000	4000	-372
chr1	152784426	152792426	152787347	8000	152788426	-4000	4000	-1079
chr1	165197867	165205867	165203991	8000	165201867	-4000	4000	2124
chr1	38039829	38047829	38044515	8000	38043829	-4000	4000	686
chr1	115030302	115038302	115034070	8000	115034302	-4000	4000	-232
chr1	156836063	156844063	156843221	8000	156840063	-4000	4000	3158
chr1	13218705	13226705	13224962	8000	13222705	-4000	4000	2257
chr1	12773906	12781906	12775078	8000	12777906	-4000	4000	-2828
chr1	152575381	152583381	152579752	8000	152579381	-4000	4000	371
chr1	152080141	152088141	152086181	8000	152084141	-4000	4000	2040
chr1	247836928	247844928	247841830	8000	247840928	-4000	4000	902
chr1	13417328	13425328	13418663	8000	13421328	-4000	4000	-2665
chr1	26907489	26915489	26913784	8000	26911489	-4000	4000	2295
chr1	158606704	158614704	158612935	8000	158610704	-4000	4000	2231
chr1	44801893	44809893	44805349	8000	44805893	-4000	4000	-544
chr1	44801893	44809893	44805636	8000	44805893	-4000	4000	-257
chr1	247445118	247453118	247451385	8000	247449118	-4000	4000	2267
chr1	247585313	247593313	247588899	8000	247589313	-4000	4000	-414
chr1	158606704	158614704	158612858	8000	158610704	-4000	4000	2154
chr1	149883469	149891469	149887584	8000	149887469	-4000	4000	115
chr1	98886245	98894245	98892972	8000	98890245	-4000	4000	2727
chr1	152102317	152110317	152109916	8000	152106317	-4000	4000	3599
chr1	153533147	153541147	153534797	8000	153537147	-4000	4000	-2350
chr1	155939087	155947087	155942707	8000	155943087	-4000	4000	-380
chr1	158695678	158703678	158700567	8000	158699678	-4000	4000	889
chr1	176841601	176849601	176842392	8000	176845601	-4000	4000	-3209
chr1	248345713	248353713	248349146	8000	248349713	-4000	4000	-567
chr1	248451725	248459725	248453055	8000	248455725	-4000	4000	-2670
chr1	182050570	182058570	182057621	8000	182054570	-4000	4000	3051
chr1	183642275	183650275	183647804	8000	183646275	-4000	4000	1529
chr1	158606704	158614704	158607344	8000	158610704	-4000	4000	-3360
chr1	13417328	13425328	13420984	8000	13421328	-4000	4000	-344
chr1	13417328	13425328	13418138	8000	13421328	-4000	4000	-3190
chr1	158556606	158564606	158562917	8000	158560606	-4000	4000	2311
chr1	159531078	159539078	159535643	8000	159535078	-4000	4000	565
chr1	223391465	223399465	223394180	8000	223395465	-4000	4000	-1285
chr1	248487113	248495113	248488670	8000	248491113	-4000	4000	-2443
chr1	223391465	223399465	223394199	8000	223395465	-4000	4000	-1266
chr1	152758052	152766052	152759824	8000	152762052	-4000	4000	-2228
chr1	159947492	159955492	159953546	8000	159951492	-4000	4000	2054
chr1	248586487	248594487	248593491	8000	248590487	-4000	4000	3004
chr1	13304907	13312907	13306874	8000	13308907	-4000	4000	-2033
chr1	20715731	20723731	20721836	8000	20719731	-4000	4000	2105
chr1	46925177	46933177	46930003	8000	46929177	-4000	4000	826
chr1	152149595	152157595	152156637	8000	152153595	-4000	4000	3042
chr1	156929094	156937094	156932516	8000	156933094	-4000	4000	-578
chr1	215618891	215626891	215625834	8000	215622891	-4000	4000	2943
chr1	206004535	206012535	206010219	8000	206008535	-4000	4000	1684
chr1	12820605	12828605	12827630	8000	12824605	-4000	4000	3025
chr1	160086563	160094563	160093933	8000	160090563	-4000	4000	3370
chr1	247602515	247610515	247605741	8000	247606515	-4000	4000	-774
chr1	146013468	146021468	146019205	8000	146017468	-4000	4000	1737
chr1	147905269	147913269	147909112	8000	147909269	-4000	4000	-157
chr1	152758052	152766052	152761163	8000	152762052	-4000	4000	-889
chr1	119889533	119897533	119895998	8000	119893533	-4000	4000	2465
chr1	152824097	152832097	152827544	8000	152828097	-4000	4000	-553
chr1	223391465	223399465	223394655	8000	223395465	-4000	4000	-810
chr1	152208076	152216076	152213203	8000	152212076	-4000	4000	1127
chr1	13417328	13425328	13421159	8000	13421328	-4000	4000	-169
chr1	158556606	158564606	158563088	8000	158560606	-4000	4000	2482
chr1	153089135	153097135	153093420	8000	153093135	-4000	4000	285
chr1	156877850	156885850	156880037	8000	156881850	-4000	4000	-1813
chr1	158751891	158759891	158755304	8000	158755891	-4000	4000	-587
chr1	155285293	155293293	155291782	8000	155289293	-4000	4000	2489
chr1	159830474	159838474	159835151	8000	159834474	-4000	4000	677
chr1	12875212	12883212	12879653	8000	12879212	-4000	4000	441
chr1	248038305	248046305	248038488	8000	248042305	-4000	4000	-3817
chr1	248177067	248185067	248180373	8000	248181067	-4000	4000	-694
chr1	228420845	228428845	228425051	8000	228424845	-4000	4000	206
chr1	248619557	248627557	248626830	8000	248623557	-4000	4000	3273
chr1	6575755	6583755	6579224	8000	6579755	-4000	4000	-531
chr1	12820605	12828605	12825106	8000	12824605	-4000	4000	501
chr1	62602313	62610313	62602372	8000	62606313	-4000	4000	-3941
chr1	152102317	152110317	152109814	8000	152106317	-4000	4000	3497
chr1	156342995	156350995	156344701	8000	156346995	-4000	4000	-2294
chr1	158606704	158614704	158611310	8000	158610704	-4000	4000	606
chr1	248319630	248327630	248324222	8000	248323630	-4000	4000	592
chr1	12792628	12800628	12795871	8000	12796628	-4000	4000	-757
chr1	12857909	12865909	12861654	8000	12861909	-4000	4000	-255
chr1	152102317	152110317	152109697	8000	152106317	-4000	4000	3380
chr1	157741733	157749733	157746769	8000	157745733	-4000	4000	1036
chr1	179812198	179820198	179813116	8000	179816198	-4000	4000	-3082
chr1	154990315	154998315	154990329	8000	154994315	-4000	4000	-3986
chr1	167125165	167133165	167125837	8000	167129165	-4000	4000	-3328
chr1	168536768	168544768	168540895	8000	168540768	-4000	4000	127
chr1	247945796	247953796	247949714	8000	247949796	-4000	4000	-82
chr1	153145582	153153582	153150063	8000	153149582	-4000	4000	481
chr1	248097103	248105103	248099750	8000	248101103	-4000	4000	-1353
chr1	119511054	119519054	119511513	8000	119515054	-4000	4000	-3541
chr1	155285293	155293293	155293212	8000	155289293	-4000	4000	3919
chr1	196914713	196922713	196918337	8000	196918713	-4000	4000	-376
chr1	152597086	152605086	152600928	8000	152601086	-4000	4000	-158
chr1	165559957	165567957	165563905	8000	165563957	-4000	4000	-52
chr1	86576754	86584754	86580124	8000	86580754	-4000	4000	-630
chr1	158476936	158484936	158479937	8000	158480936	-4000	4000	-999
chr1	182050570	182058570	182056788	8000	182054570	-4000	4000	2218
chr1	244637177	244645177	244639997	8000	244641177	-4000	4000	-1180
chr1	247962386	247970386	247965541	8000	247966386	-4000	4000	-845
chr1	248404020	248412020	248406492	8000	248408020	-4000	4000	-1528
chr1	12934472	12942472	12938852	8000	12938472	-4000	4000	380
chr1	91256766	91264766	91262292	8000	91260766	-4000	4000	1526
chr1	12663076	12671076	12666609	8000	12667076	-4000	4000	-467
chr1	158606704	158614704	158606955	8000	158610704	-4000	4000	-3749
chr1	248345713	248353713	248349046	8000	248349713	-4000	4000	-667
chr1	32212192	32220192	32216568	8000	32216192	-4000	4000	376
chr1	32212192	32220192	32217087	8000	32216192	-4000	4000	895
chr1	248387811	248395811	248387937	8000	248391811	-4000	4000	-3874
chr1	40247684	40255684	40248138	8000	40251684	-4000	4000	-3546
chr1	111316566	111324566	111320453	8000	111320566	-4000	4000	-113
chr1	13318598	13326598	13322032	8000	13322598	-4000	4000	-566
chr1	13218705	13226705	13226029	8000	13222705	-4000	4000	3324
chr1	248177067	248185067	248180294	8000	248181067	-4000	4000	-773
chr1	152149595	152157595	152155566	8000	152153595	-4000	4000	1971
chr1	156836063	156844063	156843011	8000	156840063	-4000	4000	2948
chr1	152800832	152808832	152805125	8000	152804832	-4000	4000	293
chr1	247735559	247743559	247739449	8000	247739559	-4000	4000	-110
chr1	179546539	179554539	179551655	8000	179550539	-4000	4000	1116
chr1	160086563	160094563	160093812	8000	160090563	-4000	4000	3249
chr1	146013468	146021468	146019487	8000	146017468	-4000	4000	2019
chr1	248569801	248577801	248574033	8000	248573801	-4000	4000	232
chr1	153066226	153074226	153070744	8000	153070226	-4000	4000	518
chr1	162369203	162377203	162374105	8000	162373203	-4000	4000	902
chr1	248470307	248478307	248473958	8000	248474307	-4000	4000	-349
chr1	248470307	248478307	248473959	8000	248474307	-4000	4000	-348
chr1	156583719	156591719	156585203	8000	156587719	-4000	4000	-2516
chr1	182050570	182058570	182056638	8000	182054570	-4000	4000	2068
chr1	186439566	186447566	186444340	8000	186443566	-4000	4000	774
chr1	10942471	10950471	10948331	8000	10946471	-4000	4000	1860
chr1	12792628	12800628	12795871	8000	12796628	-4000	4000	-757
chr1	12875212	12883212	12880042	8000	12879212	-4000	4000	830
chr1	13337892	13345892	13345264	8000	13341892	-4000	4000	3372
chr1	13365067	13373067	13369456	8000	13369067	-4000	4000	389
chr1	13388629	13396629	13389819	8000	13392629	-4000	4000	-2810
chr1	15487395	15495395	15491164	8000	15491395	-4000	4000	-231
chr1	15487395	15495395	15493192	8000	15491395	-4000	4000	1797
chr1	16053769	16061769	16058704	8000	16057769	-4000	4000	935
chr1	26198968	26206968	26201403	8000	26202968	-4000	4000	-1565
chr1	31628518	31636518	31635326	8000	31632518	-4000	4000	2808
chr1	32212192	32220192	32214868	8000	32216192	-4000	4000	-1324
chr1	34758327	34766327	34761653	8000	34762327	-4000	4000	-674
chr1	34758327	34766327	34761936	8000	34762327	-4000	4000	-391
chr1	44801893	44809893	44808816	8000	44805893	-4000	4000	2923
chr1	47145727	47153727	47146201	8000	47149727	-4000	4000	-3526
chr1	53083179	53091179	53090884	8000	53087179	-4000	4000	3705
chr1	53502237	53510237	53506740	8000	53506237	-4000	4000	503
chr1	59983269	59991269	59990537	8000	59987269	-4000	4000	3268
chr1	86496259	86504259	86500082	8000	86500259	-4000	4000	-177
chr1	108811898	108819898	108817145	8000	108815898	-4000	4000	1247
chr1	115030302	115038302	115034207	8000	115034302	-4000	4000	-95
chr1	147905269	147913269	147908345	8000	147909269	-4000	4000	-924
chr1	149809225	149817225	149811694	8000	149813225	-4000	4000	-1531
chr1	149809225	149817225	149812114	8000	149813225	-4000	4000	-1111
chr1	149883469	149891469	149886228	8000	149887469	-4000	4000	-1241
chr1	149883469	149891469	149886593	8000	149887469	-4000	4000	-876
chr1	152080141	152088141	152086304	8000	152084141	-4000	4000	2163
chr1	152149595	152157595	152156543	8000	152153595	-4000	4000	2948
chr1	152208076	152216076	152214877	8000	152212076	-4000	4000	2801
chr1	152344735	152352735	152350869	8000	152348735	-4000	4000	2134
chr1	152610098	152618098	152613992	8000	152614098	-4000	4000	-106
chr1	152672569	152680569	152676159	8000	152676569	-4000	4000	-410
chr1	152809108	152817108	152812518	8000	152813108	-4000	4000	-590
chr1	152881047	152889047	152884845	8000	152885047	-4000	4000	-202
chr1	153066226	153074226	153070538	8000	153070226	-4000	4000	312
chr1	154321325	154329325	154323264	8000	154325325	-4000	4000	-2061
chr1	156929094	156937094	156930613	8000	156933094	-4000	4000	-2481
chr1	156929094	156937094	156932633	8000	156933094	-4000	4000	-461
chr1	157826911	157834911	157831848	8000	157830911	-4000	4000	937
chr1	157826911	157834911	157834431	8000	157830911	-4000	4000	3520
chr1	159531078	159539078	159535448	8000	159535078	-4000	4000	370
chr1	159708289	159716289	159714015	8000	159712289	-4000	4000	1726
chr1	160872540	160880540	160879391	8000	160876540	-4000	4000	2851
chr1	196221779	196229779	196228336	8000	196225779	-4000	4000	2557
chr1	211472522	211480522	211479245	8000	211476522	-4000	4000	2723
chr1	244637177	244645177	244640123	8000	244641177	-4000	4000	-1054
chr1	247602515	247610515	247605649	8000	247606515	-4000	4000	-866
chr1	247666812	247674812	247672208	8000	247670812	-4000	4000	1396
chr1	247810660	247818660	247814863	8000	247814660	-4000	4000	203
chr1	247836928	247844928	247841237	8000	247840928	-4000	4000	309
chr1	248142086	248150086	248145822	8000	248146086	-4000	4000	-264
chr1	248345713	248353713	248349323	8000	248349713	-4000	4000	-390
chr1	248586487	248594487	248593391	8000	248590487	-4000	4000	2904
chr1	248586487	248594487	248593715	8000	248590487	-4000	4000	3228
chr1	154321325	154329325	154323318	8000	154325325	-4000	4000	-2007
chr1	247810660	247818660	247815624	8000	247814660	-4000	4000	964
chr1	248038305	248046305	248038694	8000	248042305	-4000	4000	-3611
chr1	248038305	248046305	248039060	8000	248042305	-4000	4000	-3245
chr1	147905269	147913269	147908754	8000	147909269	-4000	4000	-515
chr1	160826160	160834160	160832703	8000	160830160	-4000	4000	2543
chr1	237000103	237008103	237004280	8000	237004103	-4000	4000	177
chr1	31628518	31636518	31630750	8000	31632518	-4000	4000	-1768
chr1	153201120	153209120	153204988	8000	153205120	-4000	4000	-132
chr1	167125165	167133165	167126395	8000	167129165	-4000	4000	-2770
chr1	25326445	25334445	25329087	8000	25330445	-4000	4000	-1358
chr1	197474455	197482455	197477722	8000	197478455	-4000	4000	-733
chr1	248097103	248105103	248099600	8000	248101103	-4000	4000	-1503
chr1	149883469	149891469	149887226	8000	149887469	-4000	4000	-243
chr1	247945796	247953796	247948890	8000	247949796	-4000	4000	-906
chr1	17242007	17250007	17249112	8000	17246007	-4000	4000	3105
chr1	149883469	149891469	149886419	8000	149887469	-4000	4000	-1050
chr1	152102317	152110317	152108932	8000	152106317	-4000	4000	2615
chr1	158712327	158720327	158717352	8000	158716327	-4000	4000	1025
chr1	171060765	171068765	171064238	8000	171064765	-4000	4000	-527
chr1	111316566	111324566	111318635	8000	111320566	-4000	4000	-1931
chr1	149809225	149817225	149813418	8000	149813225	-4000	4000	193
chr1	152800832	152808832	152805411	8000	152804832	-4000	4000	579
chr1	158394522	158402522	158399137	8000	158398522	-4000	4000	615
chr1	158712327	158720327	158717370	8000	158716327	-4000	4000	1043
chr1	212622775	212630775	212625708	8000	212626775	-4000	4000	-1067
chr1	12934472	12942472	12938984	8000	12938472	-4000	4000	512
chr1	153066226	153074226	153070698	8000	153070226	-4000	4000	472
chr1	201224952	201232952	201227085	8000	201228952	-4000	4000	-1867
chr1	103660554	103668554	103660600	8000	103664554	-4000	4000	-3954
chr1	67585	75585	69767	8000	71585	-4000	4000	-1818
chr1	6575755	6583755	6576613	8000	6579755	-4000	4000	-3142
chr1	13318598	13326598	13321749	8000	13322598	-4000	4000	-849
chr1	13318598	13326598	13322096	8000	13322598	-4000	4000	-502
chr1	26198968	26206968	26200959	8000	26202968	-4000	4000	-2009
chr1	47414052	47422052	47416702	8000	47418052	-4000	4000	-1350
chr1	50199772	50207772	50201055	8000	50203772	-4000	4000	-2717
chr1	53083179	53091179	53088212	8000	53087179	-4000	4000	1033
chr1	62208328	62216328	62211118	8000	62212328	-4000	4000	-1210
chr1	67088165	67096165	67093556	8000	67092165	-4000	4000	1391
chr1	67088165	67096165	67095374	8000	67092165	-4000	4000	3209
chr1	91256766	91264766	91261194	8000	91260766	-4000	4000	428
chr1	98886245	98894245	98892974	8000	98890245	-4000	4000	2729
chr1	103621780	103629780	103623968	8000	103625780	-4000	4000	-1812
chr1	108811898	108819898	108817062	8000	108815898	-4000	4000	1164
chr1	110513217	110521217	110517341	8000	110517217	-4000	4000	124
chr1	110513217	110521217	110517983	8000	110517217	-4000	4000	766
chr1	114669090	114677090	114675598	8000	114673090	-4000	4000	2508
chr1	146013468	146021468	146018314	8000	146017468	-4000	4000	846
chr1	147905269	147913269	147908943	8000	147909269	-4000	4000	-326
chr1	149809225	149817225	149813294	8000	149813225	-4000	4000	69
chr1	152149595	152157595	152155725	8000	152153595	-4000	4000	2130
chr1	152149595	152157595	152156919	8000	152153595	-4000	4000	3324
chr1	152405243	152413243	152412198	8000	152409243	-4000	4000	2955
chr1	153066226	153074226	153070740	8000	153070226	-4000	4000	514
chr1	153089135	153097135	153093370	8000	153093135	-4000	4000	235
chr1	154544147	154552147	154547585	8000	154548147	-4000	4000	-562
chr1	156583719	156591719	156585170	8000	156587719	-4000	4000	-2549
chr1	158414210	158422210	158420160	8000	158418210	-4000	4000	1950
chr1	158476936	158484936	158480052	8000	158480936	-4000	4000	-884
chr1	159439078	159447078	159440023	8000	159443078	-4000	4000	-3055
chr1	159439078	159447078	159440552	8000	159443078	-4000	4000	-2526
chr1	159531078	159539078	159535225	8000	159535078	-4000	4000	147
chr1	159830474	159838474	159832940	8000	159834474	-4000	4000	-1534
chr1	160941025	160949025	160948012	8000	160945025	-4000	4000	2987
chr1	178544602	178552602	178545762	8000	178548602	-4000	4000	-2840
chr1	182895865	182903865	182903110	8000	182899865	-4000	4000	3245
chr1	192656311	192664311	192659546	8000	192660311	-4000	4000	-765
chr1	196221779	196229779	196228325	8000	196225779	-4000	4000	2546
chr1	196791407	196799407	196793507	8000	196795407	-4000	4000	-1900
chr1	196914713	196922713	196918279	8000	196918713	-4000	4000	-434
chr1	197005678	197013678	197008636	8000	197009678	-4000	4000	-1042
chr1	201035512	201043512	201043330	8000	201039512	-4000	4000	3818
chr1	247836928	247844928	247841035	8000	247840928	-4000	4000	107
chr1	248038305	248046305	248038343	8000	248042305	-4000	4000	-3962
chr1	248059407	248067407	248061237	8000	248063407	-4000	4000	-2170
chr1	248451725	248459725	248453088	8000	248455725	-4000	4000	-2637
chr1	248586487	248594487	248593260	8000	248590487	-4000	4000	2773
chr1	32212192	32220192	32216387	8000	32216192	-4000	4000	195
chr1	152080141	152088141	152088045	8000	152084141	-4000	4000	3904
chr1	156583719	156591719	156585807	8000	156587719	-4000	4000	-1912
chr1	159830474	159838474	159835151	8000	159834474	-4000	4000	677
chr1	159947492	159955492	159951829	8000	159951492	-4000	4000	337
chr1	176841601	176849601	176842514	8000	176845601	-4000	4000	-3087
chr1	198519222	198527222	198523541	8000	198523222	-4000	4000	319
chr1	203163811	203171811	203165656	8000	203167811	-4000	4000	-2155
chr1	206953965	206961965	206960683	8000	206957965	-4000	4000	2718
chr1	212622775	212630775	212625765	8000	212626775	-4000	4000	-1010
chr1	215618891	215626891	215619260	8000	215622891	-4000	4000	-3631
chr1	247892531	247900531	247895637	8000	247896531	-4000	4000	-894
chr1	168578069	168586069	168580076	8000	168582069	-4000	4000	-1993
chr1	209609939	209617939	209612910	8000	209613939	-4000	4000	-1029
chr1	247602515	247610515	247605882	8000	247606515	-4000	4000	-633
chr1	167125165	167133165	167128295	8000	167129165	-4000	4000	-870
chr1	203163811	203171811	203165249	8000	203167811	-4000	4000	-2562
chr1	158695678	158703678	158699918	8000	158699678	-4000	4000	240
chr1	247836928	247844928	247841770	8000	247840928	-4000	4000	842
chr1	160086563	160094563	160093933	8000	160090563	-4000	4000	3370
chr1	204150819	204158819	204156260	8000	204154819	-4000	4000	1441
chr1	227842470	227850470	227846078	8000	227846470	-4000	4000	-392
chr1	204150819	204158819	204156791	8000	204154819	-4000	4000	1972
chr1	152575381	152583381	152579508	8000	152579381	-4000	4000	127
chr1	32212192	32220192	32214621	8000	32216192	-4000	4000	-1571
chr1	44801893	44809893	44802805	8000	44805893	-4000	4000	-3088
chr1	156929094	156937094	156935855	8000	156933094	-4000	4000	2761
chr1	167125165	167133165	167126331	8000	167129165	-4000	4000	-2834
chr1	158606704	158614704	158613776	8000	158610704	-4000	4000	3072
chr1	196221779	196229779	196228101	8000	196225779	-4000	4000	2322
chr1	212622775	212630775	212625427	8000	212626775	-4000	4000	-1348
chr1	40247684	40255684	40251622	8000	40251684	-4000	4000	-62
chr1	152080141	152088141	152086979	8000	152084141	-4000	4000	2838
chr1	47145727	47153727	47145900	8000	47149727	-4000	4000	-3827
chr1	115281904	115289904	115286435	8000	115285904	-4000	4000	531
chr1	155285293	155293293	155285743	8000	155289293	-4000	4000	-3550
chr1	160086563	160094563	160093893	8000	160090563	-4000	4000	3330
chr1	247666812	247674812	247672291	8000	247670812	-4000	4000	1479
chr1	3018903	3026903	3022445	8000	3022903	-4000	4000	-458
chr1	91256766	91264766	91262250	8000	91260766	-4000	4000	1484
chr1	6575755	6583755	6580703	8000	6579755	-4000	4000	948
chr1	248404020	248412020	248406515	8000	248408020	-4000	4000	-1505
chr1	241991490	241999490	241996060	8000	241995490	-4000	4000	570
chr1	12773906	12781906	12777340	8000	12777906	-4000	4000	-566
chr1	248097103	248105103	248099632	8000	248101103	-4000	4000	-1471
chr1	13388629	13396629	13390462	8000	13392629	-4000	4000	-2167
chr1	247445118	247453118	247451271	8000	247449118	-4000	4000	2153
chr1	13337892	13345892	13344599	8000	13341892	-4000	4000	2707
chr1	247962386	247970386	247965464	8000	247966386	-4000	4000	-922
chr1	159584865	159592865	159587959	8000	159588865	-4000	4000	-906
chr1	157826911	157834911	157833464	8000	157830911	-4000	4000	2553
chr1	209609939	209617939	209617542	8000	209613939	-4000	4000	3603
chr1	34861436	34869436	34867567	8000	34865436	-4000	4000	2131
chr1	158394522	158402522	158398573	8000	158398522	-4000	4000	51
chr1	66775047	66783047	66777659	8000	66779047	-4000	4000	-1388
chr1	66775047	66783047	66777660	8000	66779047	-4000	4000	-1387
chr1	247573690	247581690	247574247	8000	247577690	-4000	4000	-3443
chr1	247602515	247610515	247605650	8000	247606515	-4000	4000	-865
chr1	248586487	248594487	248593469	8000	248590487	-4000	4000	2982
chr1	158414210	158422210	158420557	8000	158418210	-4000	4000	2347
chr1	196914713	196922713	196915097	8000	196918713	-4000	4000	-3616
chr1	27391814	27399814	27394765	8000	27395814	-4000	4000	-1049
chr1	46925177	46933177	46932821	8000	46929177	-4000	4000	3644
chr1	110513217	110521217	110517225	8000	110517217	-4000	4000	8
chr1	115281904	115289904	115285953	8000	115285904	-4000	4000	49
chr1	147905269	147913269	147908288	8000	147909269	-4000	4000	-981
chr1	149883469	149891469	149886247	8000	149887469	-4000	4000	-1222
chr1	152672569	152680569	152676008	8000	152676569	-4000	4000	-561
chr1	247602515	247610515	247606356	8000	247606515	-4000	4000	-159
chr1	248345713	248353713	248349630	8000	248349713	-4000	4000	-83
chr1	165396922	165404922	165401329	8000	165400922	-4000	4000	407
chr1	247810660	247818660	247815024	8000	247814660	-4000	4000	364
chr1	12857909	12865909	12859773	8000	12861909	-4000	4000	-2136
chr1	13277035	13285035	13281662	8000	13281035	-4000	4000	627
chr1	152784426	152792426	152787421	8000	152788426	-4000	4000	-1005
chr1	12916482	12924482	12917834	8000	12920482	-4000	4000	-2648
chr1	13337892	13345892	13342617	8000	13341892	-4000	4000	725
chr1	158540550	158548550	158547897	8000	158544550	-4000	4000	3347
chr1	196914713	196922713	196918371	8000	196918713	-4000	4000	-342
chr1	248487113	248495113	248488850	8000	248491113	-4000	4000	-2263
chr1	152208076	152216076	152213312	8000	152212076	-4000	4000	1236
chr1	248059407	248067407	248061003	8000	248063407	-4000	4000	-2404
chr1	162369203	162377203	162373751	8000	162373203	-4000	4000	548
chr1	19676966	19684966	19682530	8000	19680966	-4000	4000	1564
chr1	19810029	19818029	19814795	8000	19814029	-4000	4000	766
chr1	167125165	167133165	167127328	8000	167129165	-4000	4000	-1837
chr1	247585313	247593313	247588902	8000	247589313	-4000	4000	-411
chr1	158770222	158778222	158777005	8000	158774222	-4000	4000	2783
chr1	68424822	68432822	68429829	8000	68428822	-4000	4000	1007
chr1	153988685	153996685	153991226	8000	153992685	-4000	4000	-1459
chr1	158556606	158564606	158562789	8000	158560606	-4000	4000	2183
chr1	158751891	158759891	158754818	8000	158755891	-4000	4000	-1073
chr1	152683397	152691397	152686892	8000	152687397	-4000	4000	-505
chr1	247919152	247927152	247921113	8000	247923152	-4000	4000	-2039
chr1	3018903	3026903	3021531	8000	3022903	-4000	4000	-1372
chr1	119419035	119427035	119422220	8000	119423035	-4000	4000	-815
chr1	13259314	13267314	13260504	8000	13263314	-4000	4000	-2810
chr1	152344735	152352735	152352516	8000	152348735	-4000	4000	3781
chr1	119419035	119427035	119419573	8000	119423035	-4000	4000	-3462
chr1	154544147	154552147	154544931	8000	154548147	-4000	4000	-3216
chr1	89384160	89392160	89385335	8000	89388160	-4000	4000	-2825
chr1	159439078	159447078	159440039	8000	159443078	-4000	4000	-3039
chr1	152881047	152889047	152884684	8000	152885047	-4000	4000	-363
chr1	12857909	12865909	12860056	8000	12861909	-4000	4000	-1853
chr1	168578069	168586069	168581118	8000	168582069	-4000	4000	-951
chr1	119419035	119427035	119422558	8000	119423035	-4000	4000	-477
chr1	182050570	182058570	182056428	8000	182054570	-4000	4000	1858
chr1	247892531	247900531	247895688	8000	247896531	-4000	4000	-843
chr1	45616044	45624044	45622606	8000	45620044	-4000	4000	2562
chr1	6097787	6105787	6098600	8000	6101787	-4000	4000	-3187
chr1	46925177	46933177	46930049	8000	46929177	-4000	4000	872
chr1	66793740	66801740	66798108	8000	66797740	-4000	4000	368
chr1	167048836	167056836	167055758	8000	167052836	-4000	4000	2922
chr1	248358627	248366627	248362046	8000	248362627	-4000	4000	-581
chr1	119889533	119897533	119895991	8000	119893533	-4000	4000	2458
chr1	158606704	158614704	158611255	8000	158610704	-4000	4000	551
chr1	159830474	159838474	159833001	8000	159834474	-4000	4000	-1473
chr1	160872540	160880540	160876634	8000	160876540	-4000	4000	94
chr1	171634799	171642799	171636125	8000	171638799	-4000	4000	-2674
chr1	147905269	147913269	147909119	8000	147909269	-4000	4000	-150
chr1	152660659	152668659	152664341	8000	152664659	-4000	4000	-318
chr1	20551020	20559020	20553094	8000	20555020	-4000	4000	-1926
chr1	66775047	66783047	66777383	8000	66779047	-4000	4000	-1664
chr1	152149595	152157595	152156527	8000	152153595	-4000	4000	2932
chr1	156929094	156937094	156932005	8000	156933094	-4000	4000	-1089
chr1	158394522	158402522	158399319	8000	158398522	-4000	4000	797
chr1	152149595	152157595	152156123	8000	152153595	-4000	4000	2528
chr1	159584865	159592865	159588521	8000	159588865	-4000	4000	-344
chr1	152149595	152157595	152154971	8000	152153595	-4000	4000	1376
chr1	158476936	158484936	158480047	8000	158480936	-4000	4000	-889
chr1	158606704	158614704	158607000	8000	158610704	-4000	4000	-3704
chr1	152149595	152157595	152154515	8000	152153595	-4000	4000	920
chr1	114991370	114999370	114995058	8000	114995370	-4000	4000	-312
chr1	223391465	223399465	223395119	8000	223395465	-4000	4000	-346
chr1	248569801	248577801	248574683	8000	248573801	-4000	4000	882
chr1	6575755	6583755	6580741	8000	6579755	-4000	4000	986
chr1	15737392	15745392	15743152	8000	15741392	-4000	4000	1760
chr1	42729093	42737093	42735132	8000	42733093	-4000	4000	2039
chr1	157826911	157834911	157834632	8000	157830911	-4000	4000	3721
chr1	248177067	248185067	248180557	8000	248181067	-4000	4000	-510
chr1	149883469	149891469	149887261	8000	149887469	-4000	4000	-208
chr1	154544147	154552147	154551807	8000	154548147	-4000	4000	3660
chr1	193174730	193182730	193181205	8000	193178730	-4000	4000	2475
chr1	206102936	206110936	206110247	8000	206106936	-4000	4000	3311
chr1	206953965	206961965	206960571	8000	206957965	-4000	4000	2606
chr1	209609939	209617939	209611479	8000	209613939	-4000	4000	-2460
chr1	158414210	158422210	158420212	8000	158418210	-4000	4000	2002
chr1	149809225	149817225	149813312	8000	149813225	-4000	4000	87
chr1	149809225	149817225	149813313	8000	149813225	-4000	4000	88
chr1	152208076	152216076	152213081	8000	152212076	-4000	4000	1005
chr1	158556606	158564606	158563187	8000	158560606	-4000	4000	2581
chr1	114669090	114677090	114674772	8000	114673090	-4000	4000	1682
chr1	147905269	147913269	147908573	8000	147909269	-4000	4000	-696
chr1	19916009	19924009	19923541	8000	19920009	-4000	4000	3532
chr1	66775047	66783047	66777253	8000	66779047	-4000	4000	-1794
chr1	153035732	153043732	153040321	8000	153039732	-4000	4000	589
chr1	45616044	45624044	45622793	8000	45620044	-4000	4000	2749
chr1	160086563	160094563	160092313	8000	160090563	-4000	4000	1750
chr1	178544602	178552602	178545848	8000	178548602	-4000	4000	-2754
chr1	89384160	89392160	89384229	8000	89388160	-4000	4000	-3931
chr1	247445118	247453118	247451945	8000	247449118	-4000	4000	2827
chr1	153326120	153334120	153330717	8000	153330120	-4000	4000	597
chr1	247810660	247818660	247815630	8000	247814660	-4000	4000	970
chr1	157826911	157834911	157834727	8000	157830911	-4000	4000	3816
chr1	248404020	248412020	248406139	8000	248408020	-4000	4000	-1881
chr1	152149595	152157595	152156764	8000	152153595	-4000	4000	3169
chr1	152575381	152583381	152579622	8000	152579381	-4000	4000	241
chr1	17397699	17405699	17401461	8000	17401699	-4000	4000	-238
chr1	158394522	158402522	158399046	8000	158398522	-4000	4000	524
chr1	12857909	12865909	12861256	8000	12861909	-4000	4000	-653
chr1	171634799	171642799	171635859	8000	171638799	-4000	4000	-2940
chr1	13304907	13312907	13306873	8000	13308907	-4000	4000	-2034
chr1	247810660	247818660	247815478	8000	247814660	-4000	4000	818
chr1	152102317	152110317	152109832	8000	152106317	-4000	4000	3515
chr1	152405243	152413243	152409688	8000	152409243	-4000	4000	445
chr1	114669090	114677090	114673963	8000	114673090	-4000	4000	873
chr1	156583719	156591719	156585770	8000	156587719	-4000	4000	-1949
chr1	160826160	160834160	160831361	8000	160830160	-4000	4000	1201
chr1	248470307	248478307	248473564	8000	248474307	-4000	4000	-743
chr1	152672569	152680569	152676052	8000	152676569	-4000	4000	-517
chr1	149883469	149891469	149887004	8000	149887469	-4000	4000	-465
chr1	152149595	152157595	152155632	8000	152153595	-4000	4000	2037
chr1	31628518	31636518	31633252	8000	31632518	-4000	4000	734
chr1	152080141	152088141	152086088	8000	152084141	-4000	4000	1947
chr1	248619557	248627557	248626480	8000	248623557	-4000	4000	2923
chr1	92241813	92249813	92245759	8000	92245813	-4000	4000	-54
chr1	152102317	152110317	152107693	8000	152106317	-4000	4000	1376
chr1	152102317	152110317	152108131	8000	152106317	-4000	4000	1814
chr1	152344735	152352735	152352096	8000	152348735	-4000	4000	3361
chr1	159439078	159447078	159440709	8000	159443078	-4000	4000	-2369
chr1	179546539	179554539	179551367	8000	179550539	-4000	4000	828
chr1	212622775	212630775	212625412	8000	212626775	-4000	4000	-1363
chr1	248097103	248105103	248099903	8000	248101103	-4000	4000	-1200
chr1	155285293	155293293	155287215	8000	155289293	-4000	4000	-2078
chr1	248387811	248395811	248388289	8000	248391811	-4000	4000	-3522
chr1	12857909	12865909	12859132	8000	12861909	-4000	4000	-2777
chr1	12875212	12883212	12883201	8000	12879212	-4000	4000	3989
chr1	13218705	13226705	13225901	8000	13222705	-4000	4000	3196
chr1	63321128	63329128	63323502	8000	63325128	-4000	4000	-1626
chr1	115281904	115289904	115286682	8000	115285904	-4000	4000	778
chr1	147905269	147913269	147908135	8000	147909269	-4000	4000	-1134
chr1	152405243	152413243	152409382	8000	152409243	-4000	4000	139
chr1	154990315	154998315	154992746	8000	154994315	-4000	4000	-1569
chr1	154990315	154998315	154993659	8000	154994315	-4000	4000	-656
chr1	162369203	162377203	162374496	8000	162373203	-4000	4000	1293
chr1	33860791	33868791	33864733	8000	33864791	-4000	4000	-58
chr1	149883469	149891469	149886147	8000	149887469	-4000	4000	-1322
chr1	156929094	156937094	156935921	8000	156933094	-4000	4000	2827
chr1	149809225	149817225	149812366	8000	149813225	-4000	4000	-859
chr1	152683397	152691397	152687193	8000	152687397	-4000	4000	-204
chr1	159531078	159539078	159535906	8000	159535078	-4000	4000	828
chr1	12857909	12865909	12859706	8000	12861909	-4000	4000	-2203
chr1	44801893	44809893	44805698	8000	44805893	-4000	4000	-195
chr1	152405243	152413243	152409631	8000	152409243	-4000	4000	388
chr1	152758052	152766052	152760698	8000	152762052	-4000	4000	-1354
chr1	160368846	160376846	160372643	8000	160372846	-4000	4000	-203
chr1	167125165	167133165	167128096	8000	167129165	-4000	4000	-1069
chr1	248038305	248046305	248038883	8000	248042305	-4000	4000	-3422
chr1	119419035	119427035	119422171	8000	119423035	-4000	4000	-864
chr1	178544602	178552602	178545843	8000	178548602	-4000	4000	-2759
chr1	44801893	44809893	44805941	8000	44805893	-4000	4000	48
chr2	31169056	31177056	31174657	8000	31173056	-4000	4000	1601
chr2	98394601	98402601	98397126	8000	98398601	-4000	4000	-1475
chr2	184935492	184943492	184937401	8000	184939492	-4000	4000	-2091
chr2	111116610	111124610	111123896	8000	111120610	-4000	4000	3286
chr2	26452711	26460711	26453345	8000	26456711	-4000	4000	-3366
chr2	88109384	88117384	88110450	8000	88113384	-4000	4000	-2934
chr2	216098783	216106783	216099989	8000	216102783	-4000	4000	-2794
chr2	26575532	26583532	26582830	8000	26579532	-4000	4000	3298
chr2	165083526	165091526	165090431	8000	165087526	-4000	4000	2905
chr2	73813147	73821147	73813769	8000	73817147	-4000	4000	-3378
chr2	108009994	108017994	108010904	8000	108013994	-4000	4000	-3090
chr2	167255753	167263753	167259207	8000	167259753	-4000	4000	-546
chr2	31169056	31177056	31174621	8000	31173056	-4000	4000	1565
chr2	80644861	80652861	80647802	8000	80648861	-4000	4000	-1059
chr2	218364099	218372099	218367483	8000	218368099	-4000	4000	-616
chr2	96108876	96116876	96113902	8000	96112876	-4000	4000	1026
chr2	104854574	104862574	104856879	8000	104858574	-4000	4000	-1695
chr2	79081023	79089023	79085140	8000	79085023	-4000	4000	117
chr2	218133251	218141251	218135734	8000	218137251	-4000	4000	-1517
chr2	96700887	96708887	96707222	8000	96704887	-4000	4000	2335
chr2	240025491	240033491	240029284	8000	240029491	-4000	4000	-207
chr2	73286929	73294929	73291880	8000	73290929	-4000	4000	951
chr2	218958155	218966155	218961963	8000	218962155	-4000	4000	-192
chr2	115841780	115849780	115844169	8000	115845780	-4000	4000	-1611
chr2	88109384	88117384	88110480	8000	88113384	-4000	4000	-2904
chr2	127648639	127656639	127651168	8000	127652639	-4000	4000	-1471
chr2	219534772	219542772	219535261	8000	219538772	-4000	4000	-3511
chr2	127648639	127656639	127654566	8000	127652639	-4000	4000	1927
chr2	167255753	167263753	167258440	8000	167259753	-4000	4000	-1313
chr2	79119409	79127409	79121942	8000	79123409	-4000	4000	-1467
chr2	20997429	21005429	21001975	8000	21001429	-4000	4000	546
chr2	208117607	208125607	208121743	8000	208121607	-4000	4000	136
chr2	79119409	79127409	79123356	8000	79123409	-4000	4000	-53
chr2	218998846	219006846	219006196	8000	219002846	-4000	4000	3350
chr2	127425242	127433242	127428776	8000	127429242	-4000	4000	-466
chr2	232761802	232769802	232768623	8000	232765802	-4000	4000	2821
chr2	238148947	238156947	238149006	8000	238152947	-4000	4000	-3941
chr2	111116610	111124610	111117739	8000	111120610	-4000	4000	-2871
chr2	42438017	42446017	42444341	8000	42442017	-4000	4000	2324
chr2	218158841	218166841	218164894	8000	218162841	-4000	4000	2053
chr2	3698671	3706671	3701595	8000	3702671	-4000	4000	-1076
chr2	219323407	219331407	219327416	8000	219327407	-4000	4000	9
chr2	113061382	113069382	113062150	8000	113065382	-4000	4000	-3232
chr2	48958157	48966157	48963378	8000	48962157	-4000	4000	1221
chr2	79153003	79161003	79157280	8000	79157003	-4000	4000	277
chr2	68941232	68949232	68946222	8000	68945232	-4000	4000	990
chr2	79081023	79089023	79086470	8000	79085023	-4000	4000	1447
chr2	96108876	96116876	96115101	8000	96112876	-4000	4000	2225
chr2	119435843	119443843	119437275	8000	119439843	-4000	4000	-2568
chr2	54249178	54257178	54256011	8000	54253178	-4000	4000	2833
chr2	169641425	169649425	169649278	8000	169645425	-4000	4000	3853
chr2	241869823	241877823	241869828	8000	241873823	-4000	4000	-3995
chr2	233031057	233039057	233034587	8000	233035057	-4000	4000	-470
chr2	20997429	21005429	21003275	8000	21001429	-4000	4000	1846
chr2	219534772	219542772	219538034	8000	219538772	-4000	4000	-738
chr2	79119409	79127409	79122912	8000	79123409	-4000	4000	-497
chr2	222195887	222203887	222201934	8000	222199887	-4000	4000	2047
chr2	26304173	26312173	26310911	8000	26308173	-4000	4000	2738
chr2	26304173	26312173	26311307	8000	26308173	-4000	4000	3134
chr2	201284271	201292271	201285224	8000	201288271	-4000	4000	-3047
chr2	25156853	25164853	25161252	8000	25160853	-4000	4000	399
chr2	240135026	240143026	240140081	8000	240139026	-4000	4000	1055
chr2	26304173	26312173	26311750	8000	26308173	-4000	4000	3577
chr2	208156740	208164740	208160905	8000	208160740	-4000	4000	165
chr2	29188774	29196774	29193455	8000	29192774	-4000	4000	681
chr2	79024505	79032505	79027903	8000	79028505	-4000	4000	-602
chr2	208156740	208164740	208161045	8000	208160740	-4000	4000	305
chr2	158132154	158140154	158134835	8000	158136154	-4000	4000	-1319
chr2	43808472	43816472	43813130	8000	43812472	-4000	4000	658
chr2	112914882	112922882	112917656	8000	112918882	-4000	4000	-1226
chr2	127648639	127656639	127651480	8000	127652639	-4000	4000	-1159
chr2	208124137	208132137	208129641	8000	208128137	-4000	4000	1504
chr2	80644861	80652861	80647872	8000	80648861	-4000	4000	-989
chr2	105239467	105247467	105242918	8000	105243467	-4000	4000	-549
chr2	275558	283558	283135	8000	279558	-4000	4000	3577
chr2	219050424	219058424	219057605	8000	219054424	-4000	4000	3181
chr2	184935492	184943492	184938981	8000	184939492	-4000	4000	-511
chr2	73208513	73216513	73210809	8000	73212513	-4000	4000	-1704
chr2	95595778	95603778	95596225	8000	95599778	-4000	4000	-3553
chr2	130764134	130772134	130765851	8000	130768134	-4000	4000	-2283
chr2	20997429	21005429	21002399	8000	21001429	-4000	4000	970
chr2	240041077	240049077	240045802	8000	240045077	-4000	4000	725
chr2	100479280	100487280	100481147	8000	100483280	-4000	4000	-2133
chr2	108890471	108898471	108897208	8000	108894471	-4000	4000	2737
chr2	26452711	26460711	26455171	8000	26456711	-4000	4000	-1540
chr2	27132848	27140848	27137950	8000	27136848	-4000	4000	1102
chr2	208117607	208125607	208124118	8000	208121607	-4000	4000	2511
chr2	31518480	31526480	31526088	8000	31522480	-4000	4000	3608
chr2	127633729	127641729	127640893	8000	127637729	-4000	4000	3164
chr2	218158841	218166841	218164376	8000	218162841	-4000	4000	1535
chr2	127425242	127433242	127428419	8000	127429242	-4000	4000	-823
chr2	3640644	3648644	3643873	8000	3644644	-4000	4000	-771
chr2	158132154	158140154	158134773	8000	158136154	-4000	4000	-1381
chr2	240041077	240049077	240042910	8000	240045077	-4000	4000	-2167
chr2	98394601	98402601	98397032	8000	98398601	-4000	4000	-1569
chr2	238164900	238172900	238170650	8000	238168900	-4000	4000	1750
chr2	238164900	238172900	238170651	8000	238168900	-4000	4000	1751
chr2	73813147	73821147	73816685	8000	73817147	-4000	4000	-462
chr2	88118982	88126982	88126189	8000	88122982	-4000	4000	3207
chr2	73208513	73216513	73210875	8000	73212513	-4000	4000	-1638
chr2	88525585	88533585	88526488	8000	88529585	-4000	4000	-3097
chr2	232456753	232464753	232458288	8000	232460753	-4000	4000	-2465
chr2	112914882	112922882	112918564	8000	112918882	-4000	4000	-318
chr2	73286929	73294929	73292301	8000	73290929	-4000	4000	1372
chr2	48958157	48966157	48962933	8000	48962157	-4000	4000	776
chr2	74513148	74521148	74515659	8000	74517148	-4000	4000	-1489
chr2	241800287	241808287	241804056	8000	241804287	-4000	4000	-231
chr2	186823475	186831475	186828626	8000	186827475	-4000	4000	1151
chr2	27303439	27311439	27309974	8000	27307439	-4000	4000	2535
chr2	88525585	88533585	88529260	8000	88529585	-4000	4000	-325
chr2	218364099	218372099	218364728	8000	218368099	-4000	4000	-3371
chr2	138665157	138673157	138670812	8000	138669157	-4000	4000	1655
chr2	218158841	218166841	218164447	8000	218162841	-4000	4000	1606
chr2	218158841	218166841	218164448	8000	218162841	-4000	4000	1607
chr2	218998846	219006846	219004299	8000	219002846	-4000	4000	1453
chr2	73286929	73294929	73292188	8000	73290929	-4000	4000	1259
chr2	96108876	96116876	96115763	8000	96112876	-4000	4000	2887
chr2	153473338	153481338	153478163	8000	153477338	-4000	4000	825
chr2	26304173	26312173	26311637	8000	26308173	-4000	4000	3464
chr2	218977087	218985087	218985031	8000	218981087	-4000	4000	3944
chr2	26575532	26583532	26579422	8000	26579532	-4000	4000	-110
chr2	79081023	79089023	79086734	8000	79085023	-4000	4000	1711
chr2	119435843	119443843	119437050	8000	119439843	-4000	4000	-2793
chr2	25156853	25164853	25164728	8000	25160853	-4000	4000	3875
chr2	127648639	127656639	127654525	8000	127652639	-4000	4000	1886
chr2	98394601	98402601	98396724	8000	98398601	-4000	4000	-1877
chr2	208124137	208132137	208128283	8000	208128137	-4000	4000	146
chr2	79119409	79127409	79121649	8000	79123409	-4000	4000	-1760
chr2	184935492	184943492	184938630	8000	184939492	-4000	4000	-862
chr2	232378889	232386889	232380275	8000	232382889	-4000	4000	-2614
chr2	232406714	232414714	232408356	8000	232410714	-4000	4000	-2358
chr2	201284271	201292271	201285251	8000	201288271	-4000	4000	-3020
chr2	236161236	236169236	236166385	8000	236165236	-4000	4000	1149
chr2	115841780	115849780	115844038	8000	115845780	-4000	4000	-1742
chr2	184935492	184943492	184936062	8000	184939492	-4000	4000	-3430
chr2	201284271	201292271	201285182	8000	201288271	-4000	4000	-3089
chr2	218158841	218166841	218164214	8000	218162841	-4000	4000	1373
chr2	240025491	240033491	240029992	8000	240029491	-4000	4000	501
chr2	70804643	70812643	70809040	8000	70808643	-4000	4000	397
chr2	99238246	99246246	99242355	8000	99242246	-4000	4000	109
chr2	169641425	169649425	169645983	8000	169645425	-4000	4000	558
chr2	176091944	176099944	176095519	8000	176095944	-4000	4000	-425
chr2	201284271	201292271	201285028	8000	201288271	-4000	4000	-3243
chr2	216855458	216863458	216859517	8000	216859458	-4000	4000	59
chr2	219323407	219331407	219329166	8000	219327407	-4000	4000	1759
chr2	26304173	26312173	26311963	8000	26308173	-4000	4000	3790
chr2	96700887	96708887	96702722	8000	96704887	-4000	4000	-2165
chr2	96700887	96708887	96703209	8000	96704887	-4000	4000	-1678
chr2	127648639	127656639	127654669	8000	127652639	-4000	4000	2030
chr2	201284271	201292271	201284842	8000	201288271	-4000	4000	-3429
chr2	127633729	127641729	127639127	8000	127637729	-4000	4000	1398
chr2	232378889	232386889	232379891	8000	232382889	-4000	4000	-2998
chr2	238164900	238172900	238167377	8000	238168900	-4000	4000	-1523
chr2	227920344	227928344	227921544	8000	227924344	-4000	4000	-2800
chr2	98309299	98317299	98311872	8000	98313299	-4000	4000	-1427
chr2	241869823	241877823	241872918	8000	241873823	-4000	4000	-905
chr2	127633729	127641729	127637398	8000	127637729	-4000	4000	-331
chr2	127633729	127641729	127637399	8000	127637729	-4000	4000	-330
chr2	167255753	167263753	167258485	8000	167259753	-4000	4000	-1268
chr2	11654178	11662178	11658542	8000	11658178	-4000	4000	364
chr2	26452711	26460711	26460105	8000	26456711	-4000	4000	3394
chr2	27132848	27140848	27133296	8000	27136848	-4000	4000	-3552
chr2	108009994	108017994	108011024	8000	108013994	-4000	4000	-2970
chr2	108890471	108898471	108897157	8000	108894471	-4000	4000	2686
chr2	135783850	135791850	135788169	8000	135787850	-4000	4000	319
chr2	210183126	210191126	210188699	8000	210187126	-4000	4000	1573
chr2	218259861	218267861	218263286	8000	218263861	-4000	4000	-575
chr2	26304173	26312173	26308855	8000	26308173	-4000	4000	682
chr2	201284271	201292271	201284960	8000	201288271	-4000	4000	-3311
chr2	11654178	11662178	11662009	8000	11658178	-4000	4000	3831
chr2	96700887	96708887	96704491	8000	96704887	-4000	4000	-396
chr2	219534772	219542772	219541675	8000	219538772	-4000	4000	2903
chr2	232521716	232529716	232528901	8000	232525716	-4000	4000	3185
chr2	238148947	238156947	238150838	8000	238152947	-4000	4000	-2109
chr2	208117607	208125607	208121701	8000	208121607	-4000	4000	94
chr2	101393359	101401359	101397683	8000	101397359	-4000	4000	324
chr2	73286929	73294929	73291496	8000	73290929	-4000	4000	567
chr2	73813147	73821147	73816181	8000	73817147	-4000	4000	-966
chr2	79081023	79089023	79087589	8000	79085023	-4000	4000	2566
chr2	208117607	208125607	208121735	8000	208121607	-4000	4000	128
chr2	25156853	25164853	25161562	8000	25160853	-4000	4000	709
chr2	26453203	26461203	26460855	8000	26457203	-4000	4000	3652
chr2	68976980	68984980	68977690	8000	68980980	-4000	4000	-3290
chr2	100479280	100487280	100481164	8000	100483280	-4000	4000	-2116
chr2	104854574	104862574	104856663	8000	104858574	-4000	4000	-1911
chr2	130726336	130734336	130729217	8000	130730336	-4000	4000	-1119
chr2	135783850	135791850	135784600	8000	135787850	-4000	4000	-3250
chr2	184935492	184943492	184938928	8000	184939492	-4000	4000	-564
chr2	201284271	201292271	201285129	8000	201288271	-4000	4000	-3142
chr2	201483421	201491421	201491361	8000	201487421	-4000	4000	3940
chr2	230903318	230911318	230911057	8000	230907318	-4000	4000	3739
chr2	165083526	165091526	165090741	8000	165087526	-4000	4000	3215
chr2	79119409	79127409	79120860	8000	79123409	-4000	4000	-2549
chr2	227358038	227366038	227363631	8000	227362038	-4000	4000	1593
chr2	165083526	165091526	165090929	8000	165087526	-4000	4000	3403
chr2	112914882	112922882	112918595	8000	112918882	-4000	4000	-287
chr2	11654178	11662178	11658507	8000	11658178	-4000	4000	329
chr2	79081023	79089023	79085798	8000	79085023	-4000	4000	775
chr2	208124137	208132137	208129613	8000	208128137	-4000	4000	1476
chr2	218158841	218166841	218164885	8000	218162841	-4000	4000	2044
chr2	68941232	68949232	68945345	8000	68945232	-4000	4000	113
chr2	20997429	21005429	21002896	8000	21001429	-4000	4000	1467
chr2	227920344	227928344	227923974	8000	227924344	-4000	4000	-370
chr2	218818383	218826383	218824283	8000	218822383	-4000	4000	1900
chr2	26304173	26312173	26308826	8000	26308173	-4000	4000	653
chr2	3640644	3648644	3643527	8000	3644644	-4000	4000	-1117
chr2	184935492	184943492	184939256	8000	184939492	-4000	4000	-236
chr2	240041077	240049077	240045443	8000	240045077	-4000	4000	366
chr2	96108876	96116876	96115607	8000	96112876	-4000	4000	2731
chr2	232532667	232540667	232534318	8000	232536667	-4000	4000	-2349
chr2	219323407	219331407	219329174	8000	219327407	-4000	4000	1767
chr2	108009994	108017994	108010352	8000	108013994	-4000	4000	-3642
chr2	135783850	135791850	135788242	8000	135787850	-4000	4000	392
chr2	218158841	218166841	218164124	8000	218162841	-4000	4000	1283
chr2	79081023	79089023	79087596	8000	79085023	-4000	4000	2573
chr2	218818383	218826383	218823827	8000	218822383	-4000	4000	1444
chr2	73813147	73821147	73815712	8000	73817147	-4000	4000	-1435
chr2	238148947	238156947	238149044	8000	238152947	-4000	4000	-3903
chr2	201284271	201292271	201285026	8000	201288271	-4000	4000	-3245
chr2	112914882	112922882	112917777	8000	112918882	-4000	4000	-1105
chr2	210183126	210191126	210189036	8000	210187126	-4000	4000	1910
chr2	210183126	210191126	210189037	8000	210187126	-4000	4000	1911
chr2	127648639	127656639	127651121	8000	127652639	-4000	4000	-1518
chr2	127648639	127656639	127651252	8000	127652639	-4000	4000	-1387
chr2	167255753	167263753	167258848	8000	167259753	-4000	4000	-905
chr2	99238246	99246246	99244027	8000	99242246	-4000	4000	1781
chr2	206965474	206973474	206968338	8000	206969474	-4000	4000	-1136
chr2	227975955	227983955	227981749	8000	227979955	-4000	4000	1794
chr2	27519684	27527684	27523384	8000	27523684	-4000	4000	-300
chr2	201284271	201292271	201285178	8000	201288271	-4000	4000	-3093
chr2	79119409	79127409	79123158	8000	79123409	-4000	4000	-251
chr2	111116610	111124610	111123929	8000	111120610	-4000	4000	3319
chr2	104854574	104862574	104856966	8000	104858574	-4000	4000	-1608
chr2	70981499	70989499	70984748	8000	70985499	-4000	4000	-751
chr2	232532667	232540667	232535187	8000	232536667	-4000	4000	-1480
chr2	68941232	68949232	68946057	8000	68945232	-4000	4000	825
chr2	218133251	218141251	218135699	8000	218137251	-4000	4000	-1552
chr2	218958155	218966155	218961804	8000	218962155	-4000	4000	-351
chr2	73636723	73644723	73641547	8000	73640723	-4000	4000	824
chr2	27132848	27140848	27137088	8000	27136848	-4000	4000	240
chr2	232406714	232414714	232409936	8000	232410714	-4000	4000	-778
chr2	68941232	68949232	68946086	8000	68945232	-4000	4000	854
chr2	236161236	236169236	236166192	8000	236165236	-4000	4000	956
chr2	79119409	79127409	79122124	8000	79123409	-4000	4000	-1285
chr2	70804643	70812643	70809815	8000	70808643	-4000	4000	1172
chr2	225650018	225658018	225651993	8000	225654018	-4000	4000	-2025
chr2	24196849	24204849	24204378	8000	24200849	-4000	4000	3529
chr2	27132848	27140848	27133200	8000	27136848	-4000	4000	-3648
chr2	27249684	27257684	27256403	8000	27253684	-4000	4000	2719
chr2	27277499	27285499	27277997	8000	27281499	-4000	4000	-3502
chr2	27303439	27311439	27305034	8000	27307439	-4000	4000	-2405
chr2	27303439	27311439	27309931	8000	27307439	-4000	4000	2492
chr2	43671151	43679151	43675693	8000	43675151	-4000	4000	542
chr2	74513148	74521148	74515651	8000	74517148	-4000	4000	-1497
chr2	79081023	79089023	79085734	8000	79085023	-4000	4000	711
chr2	88118982	88126982	88123136	8000	88122982	-4000	4000	154
chr2	94872823	94880823	94873517	8000	94876823	-4000	4000	-3306
chr2	96700887	96708887	96704293	8000	96704887	-4000	4000	-594
chr2	113497155	113505155	113499655	8000	113501155	-4000	4000	-1500
chr2	130764134	130772134	130764445	8000	130768134	-4000	4000	-3689
chr2	153473338	153481338	153478328	8000	153477338	-4000	4000	990
chr2	162367407	162375407	162371995	8000	162371407	-4000	4000	588
chr2	184935492	184943492	184938325	8000	184939492	-4000	4000	-1167
chr2	208138573	208146573	208145974	8000	208142573	-4000	4000	3401
chr2	218977087	218985087	218982164	8000	218981087	-4000	4000	1077
chr2	219050424	219058424	219057465	8000	219054424	-4000	4000	3041
chr2	231519187	231527187	231525077	8000	231523187	-4000	4000	1890
chr2	232532667	232540667	232539733	8000	232536667	-4000	4000	3066
chr2	233343055	233351055	233346924	8000	233347055	-4000	4000	-131
chr2	43671151	43679151	43675589	8000	43675151	-4000	4000	438
chr2	135783850	135791850	135788385	8000	135787850	-4000	4000	535
chr2	201640870	201648870	201647716	8000	201644870	-4000	4000	2846
chr2	216098783	216106783	216100934	8000	216102783	-4000	4000	-1849
chr2	79081023	79089023	79085562	8000	79085023	-4000	4000	539
chr2	135783850	135791850	135790788	8000	135787850	-4000	4000	2938
chr2	3640644	3648644	3644017	8000	3644644	-4000	4000	-627
chr2	165083526	165091526	165090683	8000	165087526	-4000	4000	3157
chr2	79153003	79161003	79157257	8000	79157003	-4000	4000	254
chr2	11654178	11662178	11660120	8000	11658178	-4000	4000	1942
chr2	20997429	21005429	21005181	8000	21001429	-4000	4000	3752
chr2	31169056	31177056	31174475	8000	31173056	-4000	4000	1419
chr2	70981499	70989499	70984199	8000	70985499	-4000	4000	-1300
chr2	73636723	73644723	73641045	8000	73640723	-4000	4000	322
chr2	73813147	73821147	73816173	8000	73817147	-4000	4000	-974
chr2	88525585	88533585	88529169	8000	88529585	-4000	4000	-416
chr2	98309299	98317299	98311868	8000	98313299	-4000	4000	-1431
chr2	112738879	112746879	112742622	8000	112742879	-4000	4000	-257
chr2	112914882	112922882	112915230	8000	112918882	-4000	4000	-3652
chr2	112914882	112922882	112917697	8000	112918882	-4000	4000	-1185
chr2	135783850	135791850	135788361	8000	135787850	-4000	4000	511
chr2	138665157	138673157	138671316	8000	138669157	-4000	4000	2159
chr2	166191185	166199185	166199103	8000	166195185	-4000	4000	3918
chr2	184935492	184943492	184937555	8000	184939492	-4000	4000	-1937
chr2	184935492	184943492	184937875	8000	184939492	-4000	4000	-1617
chr2	186823475	186831475	186828616	8000	186827475	-4000	4000	1141
chr2	201483421	201491421	201487706	8000	201487421	-4000	4000	285
chr2	216098783	216106783	216100182	8000	216102783	-4000	4000	-2601
chr2	216855458	216863458	216860030	8000	216859458	-4000	4000	572
chr2	219534772	219542772	219540994	8000	219538772	-4000	4000	2222
chr2	227310792	227318792	227311972	8000	227314792	-4000	4000	-2820
chr2	227975955	227983955	227981857	8000	227979955	-4000	4000	1902
chr2	232544115	232552115	232549674	8000	232548115	-4000	4000	1559
chr2	232761802	232769802	232768215	8000	232765802	-4000	4000	2413
chr2	240041077	240049077	240041984	8000	240045077	-4000	4000	-3093
chr2	208124137	208132137	208129787	8000	208128137	-4000	4000	1650
chr2	227358038	227366038	227363611	8000	227362038	-4000	4000	1573
chr2	219534772	219542772	219539815	8000	219538772	-4000	4000	1043
chr2	80644861	80652861	80648154	8000	80648861	-4000	4000	-707
chr2	176091944	176099944	176093603	8000	176095944	-4000	4000	-2341
chr2	184935492	184943492	184938102	8000	184939492	-4000	4000	-1390
chr2	73813147	73821147	73816377	8000	73817147	-4000	4000	-770
chr2	216098783	216106783	216100115	8000	216102783	-4000	4000	-2668
chr2	208124137	208132137	208128271	8000	208128137	-4000	4000	134
chr2	162138882	162146882	162145610	8000	162142882	-4000	4000	2728
chr2	232532667	232540667	232540066	8000	232536667	-4000	4000	3399
chr2	232456753	232464753	232458953	8000	232460753	-4000	4000	-1800
chr2	240135026	240143026	240139173	8000	240139026	-4000	4000	147
chr2	218818383	218826383	218823719	8000	218822383	-4000	4000	1336
chr2	201640870	201648870	201645370	8000	201644870	-4000	4000	500
chr2	79119409	79127409	79120817	8000	79123409	-4000	4000	-2592
chr2	233031057	233039057	233034940	8000	233035057	-4000	4000	-117
chr2	79081023	79089023	79085649	8000	79085023	-4000	4000	626
chr2	219534772	219542772	219541058	8000	219538772	-4000	4000	2286
chr2	115841780	115849780	115844266	8000	115845780	-4000	4000	-1514
chr2	219534772	219542772	219537078	8000	219538772	-4000	4000	-1694
chr2	79153003	79161003	79157626	8000	79157003	-4000	4000	623
chr2	54249178	54257178	54255796	8000	54253178	-4000	4000	2618
chr2	70981499	70989499	70984811	8000	70985499	-4000	4000	-688
chr2	73813147	73821147	73813499	8000	73817147	-4000	4000	-3648
chr2	115841780	115849780	115842294	8000	115845780	-4000	4000	-3486
chr2	230903318	230911318	230910519	8000	230907318	-4000	4000	3201
chr2	233031057	233039057	233034571	8000	233035057	-4000	4000	-486
chr2	240041077	240049077	240045564	8000	240045077	-4000	4000	487
chr2	99238246	99246246	99244062	8000	99242246	-4000	4000	1816
chr2	11654178	11662178	11658595	8000	11658178	-4000	4000	417
chr2	230903318	230911318	230910533	8000	230907318	-4000	4000	3215
chr2	232406714	232414714	232407136	8000	232410714	-4000	4000	-3578
chr2	201640870	201648870	201645392	8000	201644870	-4000	4000	522
chr2	26577205	26585205	26583796	8000	26581205	-4000	4000	2591
chr2	20997429	21005429	21005266	8000	21001429	-4000	4000	3837
chr2	162138882	162146882	162143369	8000	162142882	-4000	4000	487
chr2	219268197	219276197	219271597	8000	219272197	-4000	4000	-600
chr2	1785113	1793113	1791932	8000	1789113	-4000	4000	2819
chr2	231519187	231527187	231525342	8000	231523187	-4000	4000	2155
chr2	222195887	222203887	222201216	8000	222199887	-4000	4000	1329
chr2	3640644	3648644	3643820	8000	3644644	-4000	4000	-824
chr2	48958157	48966157	48962783	8000	48962157	-4000	4000	626
chr2	99238246	99246246	99242426	8000	99242246	-4000	4000	180
chr2	113497155	113505155	113499651	8000	113501155	-4000	4000	-1504
chr2	73813147	73821147	73813904	8000	73817147	-4000	4000	-3243
chr2	99238246	99246246	99245382	8000	99242246	-4000	4000	3136
chr2	167255753	167263753	167259340	8000	167259753	-4000	4000	-413
chr2	169641425	169649425	169645721	8000	169645425	-4000	4000	296
chr2	70804643	70812643	70809790	8000	70808643	-4000	4000	1147
chr2	138665157	138673157	138671647	8000	138669157	-4000	4000	2490
chr2	25156853	25164853	25160982	8000	25160853	-4000	4000	129
chr2	231590276	231598276	231593042	8000	231594276	-4000	4000	-1234
chr2	31518480	31526480	31526076	8000	31522480	-4000	4000	3596
chr2	79024505	79032505	79026747	8000	79028505	-4000	4000	-1758
chr2	38971454	38979454	38971920	8000	38975454	-4000	4000	-3534
chr2	214574976	214582976	214575758	8000	214578976	-4000	4000	-3218
chr2	11654178	11662178	11660084	8000	11658178	-4000	4000	1906
chr2	275558	283558	279771	8000	279558	-4000	4000	213
chr2	20997429	21005429	21001876	8000	21001429	-4000	4000	447
chr2	238164900	238172900	238170459	8000	238168900	-4000	4000	1559
chr2	80644861	80652861	80647802	8000	80648861	-4000	4000	-1059
chr2	186823475	186831475	186828675	8000	186827475	-4000	4000	1200
chr2	88525585	88533585	88529542	8000	88529585	-4000	4000	-43
chr2	127648639	127656639	127651632	8000	127652639	-4000	4000	-1007
chr2	240025491	240033491	240030159	8000	240029491	-4000	4000	668
chr2	218158841	218166841	218164301	8000	218162841	-4000	4000	1460
chr2	230903318	230911318	230910910	8000	230907318	-4000	4000	3592
chr2	219050424	219058424	219055681	8000	219054424	-4000	4000	1257
chr2	98394601	98402601	98397126	8000	98398601	-4000	4000	-1475
chr2	127648639	127656639	127651367	8000	127652639	-4000	4000	-1272
chr2	222195887	222203887	222201230	8000	222199887	-4000	4000	1343
chr2	98394601	98402601	98396940	8000	98398601	-4000	4000	-1661
chr2	127648639	127656639	127650051	8000	127652639	-4000	4000	-2588
chr2	79024505	79032505	79026771	8000	79028505	-4000	4000	-1734
chr2	79024505	79032505	79026772	8000	79028505	-4000	4000	-1733
chr2	68941232	68949232	68947203	8000	68945232	-4000	4000	1971
chr2	113004044	113012044	113005992	8000	113008044	-4000	4000	-2052
chr2	115841780	115849780	115842316	8000	115845780	-4000	4000	-3464
chr2	176186907	176194907	176190684	8000	176190907	-4000	4000	-223
chr2	113071843	113079843	113075251	8000	113075843	-4000	4000	-592
chr2	127648639	127656639	127651695	8000	127652639	-4000	4000	-944
chr2	233343055	233351055	233346855	8000	233347055	-4000	4000	-200
chr2	240025491	240033491	240029875	8000	240029491	-4000	4000	384
chr2	222195887	222203887	222201138	8000	222199887	-4000	4000	1251
chr3	46511385	46519385	46519054	8000	46515385	-4000	4000	3669
chr3	13812258	13820258	13819294	8000	13816258	-4000	4000	3036
chr3	38544057	38552057	38551545	8000	38548057	-4000	4000	3488
chr3	57193838	57201838	57198473	8000	57197838	-4000	4000	635
chr3	69102065	69110065	69108878	8000	69106065	-4000	4000	2813
chr3	169833773	169841773	169839987	8000	169837773	-4000	4000	2214
chr3	165182720	165190720	165188383	8000	165186720	-4000	4000	1663
chr3	172885357	172893357	172889619	8000	172889357	-4000	4000	262
chr3	98387631	98395631	98391062	8000	98391631	-4000	4000	-569
chr3	98530681	98538681	98532977	8000	98534681	-4000	4000	-1704
chr3	186617318	186625318	186620726	8000	186621318	-4000	4000	-592
chr3	186674234	186682234	186677649	8000	186678234	-4000	4000	-585
chr3	191263168	191271168	191268257	8000	191267168	-4000	4000	1089
chr3	38314575	38322575	38316407	8000	38318575	-4000	4000	-2168
chr3	13812258	13820258	13819288	8000	13816258	-4000	4000	3030
chr3	167235843	167243843	167240908	8000	167239843	-4000	4000	1065
chr3	36708421	36716421	36715426	8000	36712421	-4000	4000	3005
chr3	184102995	184110995	184105791	8000	184106995	-4000	4000	-1204
chr3	49173634	49181634	49174942	8000	49177634	-4000	4000	-2692
chr3	186674234	186682234	186677599	8000	186678234	-4000	4000	-635
chr3	151824488	151832488	151827868	8000	151828488	-4000	4000	-620
chr3	13812258	13820258	13819072	8000	13816258	-4000	4000	2814
chr3	62365681	62373681	62369766	8000	62369681	-4000	4000	85
chr3	126539291	126547291	126542555	8000	126543291	-4000	4000	-736
chr3	38544057	38552057	38550236	8000	38548057	-4000	4000	2179
chr3	38841764	38849764	38847558	8000	38845764	-4000	4000	1794
chr3	118896557	118904557	118902892	8000	118900557	-4000	4000	2335
chr3	130480844	130488844	130484037	8000	130484844	-4000	4000	-807
chr3	98280070	98288070	98283434	8000	98284070	-4000	4000	-636
chr3	10281666	10289666	10287051	8000	10285666	-4000	4000	1385
chr3	194335768	194343768	194342110	8000	194339768	-4000	4000	2342
chr3	178840429	178848429	178842890	8000	178844429	-4000	4000	-1539
chr3	38314575	38322575	38318202	8000	38318575	-4000	4000	-373
chr3	49853988	49861988	49859274	8000	49857988	-4000	4000	1286
chr3	187664912	187672912	187669060	8000	187668912	-4000	4000	148
chr3	98280070	98288070	98283171	8000	98284070	-4000	4000	-899
chr3	129547467	129555467	129549196	8000	129551467	-4000	4000	-2271
chr3	194335768	194343768	194342577	8000	194339768	-4000	4000	2809
chr3	13812258	13820258	13819295	8000	13816258	-4000	4000	3037
chr3	42253825	42261825	42258208	8000	42257825	-4000	4000	383
chr3	187664912	187672912	187669243	8000	187668912	-4000	4000	331
chr3	98280070	98288070	98283352	8000	98284070	-4000	4000	-718
chr3	112009887	112017887	112011815	8000	112013887	-4000	4000	-2072
chr3	115717490	115725490	115720829	8000	115721490	-4000	4000	-661
chr3	51714613	51722613	51715260	8000	51718613	-4000	4000	-3353
chr3	73059337	73067337	73065426	8000	73063337	-4000	4000	2089
chr3	196502879	196510879	196503222	8000	196506879	-4000	4000	-3657
chr3	184035369	184043369	184038616	8000	184039369	-4000	4000	-753
chr3	48616759	48624759	48621492	8000	48620759	-4000	4000	733
chr3	128458437	128466437	128462640	8000	128462437	-4000	4000	203
chr3	134595923	134603923	134603857	8000	134599923	-4000	4000	3934
chr3	51953499	51961499	51958937	8000	51957499	-4000	4000	1438
chr3	62365681	62373681	62371314	8000	62369681	-4000	4000	1633
chr3	187197462	187205462	187199618	8000	187201462	-4000	4000	-1844
chr3	138940224	138948224	138946516	8000	138944224	-4000	4000	2292
chr3	51890876	51898876	51895252	8000	51894876	-4000	4000	376
chr3	161499942	161507942	161503600	8000	161503942	-4000	4000	-342
chr3	42688544	42696544	42691928	8000	42692544	-4000	4000	-616
chr3	51953499	51961499	51955721	8000	51957499	-4000	4000	-1778
chr3	52805009	52813009	52807005	8000	52809009	-4000	4000	-2004
chr3	98261356	98269356	98265029	8000	98265356	-4000	4000	-327
chr3	46831111	46839111	46833740	8000	46835111	-4000	4000	-1371
chr3	129531344	129539344	129532728	8000	129535344	-4000	4000	-2616
chr3	107374635	107382635	107377665	8000	107378635	-4000	4000	-970
chr3	94010365	94018365	94014669	8000	94014365	-4000	4000	304
chr3	184056673	184064673	184060488	8000	184060673	-4000	4000	-185
chr3	121626295	121634295	121631842	8000	121630295	-4000	4000	1547
chr3	46496950	46504950	46498111	8000	46500950	-4000	4000	-2839
chr3	186740410	186748410	186742089	8000	186744410	-4000	4000	-2321
chr3	154330943	154338943	154337964	8000	154334943	-4000	4000	3021
chr3	165182720	165190720	165190297	8000	165186720	-4000	4000	3577
chr3	186674234	186682234	186677764	8000	186678234	-4000	4000	-470
chr3	159992019	160000019	159993063	8000	159996019	-4000	4000	-2956
chr3	7737533	7745533	7740986	8000	7741533	-4000	4000	-547
chr3	45899174	45907174	45902690	8000	45903174	-4000	4000	-484
chr3	48397259	48405259	48404446	8000	48401259	-4000	4000	3187
chr3	178840429	178848429	178843271	8000	178844429	-4000	4000	-1158
chr3	128458437	128466437	128462995	8000	128462437	-4000	4000	558
chr3	98261356	98269356	98264792	8000	98265356	-4000	4000	-564
chr3	137762334	137770334	137765468	8000	137766334	-4000	4000	-866
chr3	128458437	128466437	128462906	8000	128462437	-4000	4000	469
chr3	194335768	194343768	194341207	8000	194339768	-4000	4000	1439
chr3	134595923	134603923	134603558	8000	134599923	-4000	4000	3635
chr3	139015031	139023031	139020256	8000	139019031	-4000	4000	1225
chr3	98387631	98395631	98391582	8000	98391631	-4000	4000	-49
chr3	108374285	108382285	108375785	8000	108378285	-4000	4000	-2500
chr3	9494361	9502361	9502179	8000	9498361	-4000	4000	3818
chr3	38544057	38552057	38551157	8000	38548057	-4000	4000	3100
chr3	126432556	126440556	126439696	8000	126436556	-4000	4000	3140
chr3	184102995	184110995	184104791	8000	184106995	-4000	4000	-2204
chr3	30722197	30730197	30728316	8000	30726197	-4000	4000	2119
chr3	114230631	114238631	114237078	8000	114234631	-4000	4000	2447
chr3	165182720	165190720	165187580	8000	165186720	-4000	4000	860
chr3	112811709	112819709	112815739	8000	112815709	-4000	4000	30
chr3	49853988	49861988	49861601	8000	49857988	-4000	4000	3613
chr3	49786732	49794732	49791736	8000	49790732	-4000	4000	1004
chr3	186740410	186748410	186742066	8000	186744410	-4000	4000	-2344
chr3	170992347	171000347	170997942	8000	170996347	-4000	4000	1595
chr3	38544057	38552057	38551286	8000	38548057	-4000	4000	3229
chr3	114230631	114238631	114236919	8000	114234631	-4000	4000	2288
chr3	57289699	57297699	57296396	8000	57293699	-4000	4000	2697
chr3	87989839	87997839	87990825	8000	87993839	-4000	4000	-3014
chr3	165182720	165190720	165189015	8000	165186720	-4000	4000	2295
chr3	98494631	98502631	98498283	8000	98498631	-4000	4000	-348
chr3	184035369	184043369	184038038	8000	184039369	-4000	4000	-1331
chr3	42688544	42696544	42689004	8000	42692544	-4000	4000	-3540
chr3	1400217	1408217	1403343	8000	1404217	-4000	4000	-874
chr3	118896557	118904557	118902473	8000	118900557	-4000	4000	1916
chr3	194335768	194343768	194341881	8000	194339768	-4000	4000	2113
chr3	178840429	178848429	178842923	8000	178844429	-4000	4000	-1506
chr3	49786732	49794732	49793714	8000	49790732	-4000	4000	2982
chr3	98494631	98502631	98498184	8000	98498631	-4000	4000	-447
chr3	137762334	137770334	137765110	8000	137766334	-4000	4000	-1224
chr3	98084102	98092102	98087874	8000	98088102	-4000	4000	-228
chr3	138029655	138037655	138031287	8000	138033655	-4000	4000	-2368
chr3	100691479	100699479	100694853	8000	100695479	-4000	4000	-626
chr3	138257437	138265437	138264192	8000	138261437	-4000	4000	2755
chr3	194390821	194398821	194397698	8000	194394821	-4000	4000	2877
chr3	186617318	186625318	186620701	8000	186621318	-4000	4000	-617
chr3	128458437	128466437	128462532	8000	128462437	-4000	4000	95
chr3	191263168	191271168	191268413	8000	191267168	-4000	4000	1245
chr3	75663220	75671220	75665623	8000	75667220	-4000	4000	-1597
chr3	87255404	87263404	87259925	8000	87259404	-4000	4000	521
chr3	44328098	44336098	44331841	8000	44332098	-4000	4000	-257
chr3	164974898	164982898	164982286	8000	164978898	-4000	4000	3388
chr3	159992019	160000019	159993038	8000	159996019	-4000	4000	-2981
chr3	191263168	191271168	191268391	8000	191267168	-4000	4000	1223
chr3	46831111	46839111	46831974	8000	46835111	-4000	4000	-3137
chr3	98350819	98358819	98354029	8000	98354819	-4000	4000	-790
chr3	75663220	75671220	75665984	8000	75667220	-4000	4000	-1236
chr3	194390821	194398821	194397690	8000	194394821	-4000	4000	2869
chr3	191263168	191271168	191268256	8000	191267168	-4000	4000	1088
chr3	98165774	98173774	98169602	8000	98169774	-4000	4000	-172
chr3	164974898	164982898	164979222	8000	164978898	-4000	4000	324
chr3	9494361	9502361	9501127	8000	9498361	-4000	4000	2766
chr3	62365681	62373681	62370310	8000	62369681	-4000	4000	629
chr3	108903792	108911792	108908032	8000	108907792	-4000	4000	240
chr3	49853988	49861988	49861527	8000	49857988	-4000	4000	3539
chr3	129531344	129539344	129533715	8000	129535344	-4000	4000	-1629
chr3	46262706	46270706	46265537	8000	46266706	-4000	4000	-1169
chr3	49254106	49262106	49256987	8000	49258106	-4000	4000	-1119
chr3	112009887	112017887	112013459	8000	112013887	-4000	4000	-428
chr3	150655885	150663885	150660068	8000	150659885	-4000	4000	183
chr3	184056673	184064673	184059550	8000	184060673	-4000	4000	-1123
chr3	194335768	194343768	194342684	8000	194339768	-4000	4000	2916
chr3	75663220	75671220	75666025	8000	75667220	-4000	4000	-1195
chr3	108954248	108962248	108959096	8000	108958248	-4000	4000	848
chr3	108954248	108962248	108959097	8000	108958248	-4000	4000	849
chr3	165182720	165190720	165190085	8000	165186720	-4000	4000	3365
chr3	69102065	69110065	69108562	8000	69106065	-4000	4000	2497
chr3	87255404	87263404	87260046	8000	87259404	-4000	4000	642
chr3	165182720	165190720	165190618	8000	165186720	-4000	4000	3898
chr3	186740410	186748410	186743831	8000	186744410	-4000	4000	-579
chr3	165182720	165190720	165187981	8000	165186720	-4000	4000	1261
chr3	35790496	35798496	35792422	8000	35794496	-4000	4000	-2074
chr3	51890876	51898876	51894925	8000	51894876	-4000	4000	49
chr3	38274757	38282757	38276074	8000	38278757	-4000	4000	-2683
chr3	52805009	52813009	52808572	8000	52809009	-4000	4000	-437
chr3	108903792	108911792	108908017	8000	108907792	-4000	4000	225
chr3	19875472	19883472	19882701	8000	19879472	-4000	4000	3229
chr3	38841764	38849764	38847530	8000	38845764	-4000	4000	1766
chr3	75663220	75671220	75664485	8000	75667220	-4000	4000	-2735
chr3	108903792	108911792	108907875	8000	108907792	-4000	4000	83
chr3	186740410	186748410	186742218	8000	186744410	-4000	4000	-2192
chr3	154330943	154338943	154337827	8000	154334943	-4000	4000	2884
chr3	38544057	38552057	38550521	8000	38548057	-4000	4000	2464
chr3	38692802	38700802	38698439	8000	38696802	-4000	4000	1637
chr3	51953499	51961499	51961158	8000	51957499	-4000	4000	3659
chr3	75663220	75671220	75666035	8000	75667220	-4000	4000	-1185
chr3	137762334	137770334	137765105	8000	137766334	-4000	4000	-1229
chr3	19531642	19539642	19534175	8000	19535642	-4000	4000	-1467
chr3	75663220	75671220	75665776	8000	75667220	-4000	4000	-1444
chr3	184102995	184110995	184106206	8000	184106995	-4000	4000	-789
chr3	49786732	49794732	49791948	8000	49790732	-4000	4000	1216
chr3	75663220	75671220	75665732	8000	75667220	-4000	4000	-1488
chr3	118896557	118904557	118902448	8000	118900557	-4000	4000	1891
chr3	129531344	129539344	129532625	8000	129535344	-4000	4000	-2719
chr3	138949990	138957990	138950542	8000	138953990	-4000	4000	-3448
chr3	42688544	42696544	42688701	8000	42692544	-4000	4000	-3843
chr3	51859424	51867424	51863200	8000	51863424	-4000	4000	-224
chr3	126432556	126440556	126434280	8000	126436556	-4000	4000	-2276
chr3	107374635	107382635	107377427	8000	107378635	-4000	4000	-1208
chr3	165182720	165190720	165189653	8000	165186720	-4000	4000	2933
chr3	54914231	54922231	54918755	8000	54918231	-4000	4000	524
chr3	112077269	112085269	112078803	8000	112081269	-4000	4000	-2466
chr3	139038102	139046102	139044217	8000	139042102	-4000	4000	2115
chr3	38314575	38322575	38316384	8000	38318575	-4000	4000	-2191
chr3	38314575	38322575	38318216	8000	38318575	-4000	4000	-359
chr3	138119713	138127713	138124872	8000	138123713	-4000	4000	1159
chr3	38692802	38700802	38697926	8000	38696802	-4000	4000	1124
chr3	184035369	184043369	184038141	8000	184039369	-4000	4000	-1228
chr3	186674234	186682234	186677209	8000	186678234	-4000	4000	-1025
chr3	87255404	87263404	87259911	8000	87259404	-4000	4000	507
chr3	98468924	98476924	98470198	8000	98472924	-4000	4000	-2726
chr3	165182720	165190720	165188017	8000	165186720	-4000	4000	1297
chr3	48616759	48624759	48620972	8000	48620759	-4000	4000	213
chr3	114230631	114238631	114236668	8000	114234631	-4000	4000	2037
chr3	45899174	45907174	45901765	8000	45903174	-4000	4000	-1409
chr3	98350819	98358819	98354768	8000	98354819	-4000	4000	-51
chr3	75663220	75671220	75665732	8000	75667220	-4000	4000	-1488
chr3	87989839	87997839	87990843	8000	87993839	-4000	4000	-2996
chr3	112811709	112819709	112815806	8000	112815709	-4000	4000	97
chr3	30722197	30730197	30728211	8000	30726197	-4000	4000	2014
chr3	151824488	151832488	151828122	8000	151828488	-4000	4000	-366
chr3	184102995	184110995	184106203	8000	184106995	-4000	4000	-792
chr3	19531642	19539642	19534462	8000	19535642	-4000	4000	-1180
chr3	194335768	194343768	194341326	8000	194339768	-4000	4000	1558
chr3	98165774	98173774	98169388	8000	98169774	-4000	4000	-386
chr3	165182720	165190720	165188345	8000	165186720	-4000	4000	1625
chr3	44328098	44336098	44328298	8000	44332098	-4000	4000	-3800
chr3	98494631	98502631	98497762	8000	98498631	-4000	4000	-869
chr3	196502879	196510879	196508059	8000	196506879	-4000	4000	1180
chr3	3062324	3070324	3070185	8000	3066324	-4000	4000	3861
chr3	46831111	46839111	46833659	8000	46835111	-4000	4000	-1452
chr3	51859424	51867424	51861669	8000	51863424	-4000	4000	-1755
chr3	62365681	62373681	62370001	8000	62369681	-4000	4000	320
chr3	62365681	62373681	62372113	8000	62369681	-4000	4000	2432
chr3	68541621	68549621	68544496	8000	68545621	-4000	4000	-1125
chr3	73059337	73067337	73063698	8000	73063337	-4000	4000	361
chr3	73059337	73067337	73065060	8000	73063337	-4000	4000	1723
chr3	73059337	73067337	73065675	8000	73063337	-4000	4000	2338
chr3	75663220	75671220	75666098	8000	75667220	-4000	4000	-1122
chr3	98261356	98269356	98265103	8000	98265356	-4000	4000	-253
chr3	98530681	98538681	98532143	8000	98534681	-4000	4000	-2538
chr3	100691479	100699479	100694966	8000	100695479	-4000	4000	-513
chr3	108903792	108911792	108908079	8000	108907792	-4000	4000	287
chr3	118896557	118904557	118902831	8000	118900557	-4000	4000	2274
chr3	165182720	165190720	165190099	8000	165186720	-4000	4000	3379
chr3	167235843	167243843	167242611	8000	167239843	-4000	4000	2768
chr3	172439291	172447291	172445442	8000	172443291	-4000	4000	2151
chr3	186674234	186682234	186677185	8000	186678234	-4000	4000	-1049
chr3	190848737	190856737	190855664	8000	190852737	-4000	4000	2927
chr3	194390821	194398821	194396631	8000	194394821	-4000	4000	1810
chr3	52788068	52796068	52788287	8000	52792068	-4000	4000	-3781
chr3	19531642	19539642	19534457	8000	19535642	-4000	4000	-1185
chr3	62365681	62373681	62371322	8000	62369681	-4000	4000	1641
chr3	98494631	98502631	98498304	8000	98498631	-4000	4000	-327
chr3	141144611	141152611	141147229	8000	141148611	-4000	4000	-1382
chr3	141144611	141152611	141147230	8000	141148611	-4000	4000	-1381
chr3	98494631	98502631	98498462	8000	98498631	-4000	4000	-169
chr3	57289699	57297699	57292080	8000	57293699	-4000	4000	-1619
chr3	138119713	138127713	138124816	8000	138123713	-4000	4000	1103
chr3	184056673	184064673	184059597	8000	184060673	-4000	4000	-1076
chr3	191457456	191465456	191461249	8000	191461456	-4000	4000	-207
chr3	38841764	38849764	38846993	8000	38845764	-4000	4000	1229
chr3	196502879	196510879	196503333	8000	196506879	-4000	4000	-3546
chr3	126539291	126547291	126542466	8000	126543291	-4000	4000	-825
chr3	13812258	13820258	13819010	8000	13816258	-4000	4000	2752
chr3	19875472	19883472	19879600	8000	19879472	-4000	4000	128
chr3	46511385	46519385	46518962	8000	46515385	-4000	4000	3577
chr3	51869721	51877721	51873839	8000	51873721	-4000	4000	118
chr3	51890876	51898876	51895337	8000	51894876	-4000	4000	461
chr3	57193838	57201838	57198110	8000	57197838	-4000	4000	272
chr3	57193838	57201838	57198267	8000	57197838	-4000	4000	429
chr3	73059337	73067337	73062332	8000	73063337	-4000	4000	-1005
chr3	73059337	73067337	73062533	8000	73063337	-4000	4000	-804
chr3	87255404	87263404	87259828	8000	87259404	-4000	4000	424
chr3	87989839	87997839	87990746	8000	87993839	-4000	4000	-3093
chr3	98084102	98092102	98088056	8000	98088102	-4000	4000	-46
chr3	98165774	98173774	98169577	8000	98169774	-4000	4000	-197
chr3	98261356	98269356	98264705	8000	98265356	-4000	4000	-651
chr3	112077269	112085269	112080942	8000	112081269	-4000	4000	-327
chr3	127194185	127202185	127196656	8000	127198185	-4000	4000	-1529
chr3	133471222	133479222	133475029	8000	133475222	-4000	4000	-193
chr3	138999962	139007962	139006041	8000	139003962	-4000	4000	2079
chr3	139015031	139023031	139020405	8000	139019031	-4000	4000	1374
chr3	149499394	149507394	149502781	8000	149503394	-4000	4000	-613
chr3	151824488	151832488	151827852	8000	151828488	-4000	4000	-636
chr3	161499942	161507942	161503713	8000	161503942	-4000	4000	-229
chr3	165182720	165190720	165187839	8000	165186720	-4000	4000	1119
chr3	165182720	165190720	165187929	8000	165186720	-4000	4000	1209
chr3	165182720	165190720	165188784	8000	165186720	-4000	4000	2064
chr3	165182720	165190720	165190489	8000	165186720	-4000	4000	3769
chr3	169833773	169841773	169840068	8000	169837773	-4000	4000	2295
chr3	172885357	172893357	172889413	8000	172889357	-4000	4000	56
chr3	178840429	178848429	178842677	8000	178844429	-4000	4000	-1752
chr3	190848737	190856737	190855846	8000	190852737	-4000	4000	3109
chr3	196502879	196510879	196507956	8000	196506879	-4000	4000	1077
chr3	159992019	160000019	159995415	8000	159996019	-4000	4000	-604
chr3	190408138	190416138	190408311	8000	190412138	-4000	4000	-3827
chr3	107374635	107382635	107378507	8000	107378635	-4000	4000	-128
chr3	49254106	49262106	49257537	8000	49258106	-4000	4000	-569
chr3	73059337	73067337	73065809	8000	73063337	-4000	4000	2472
chr3	138029655	138037655	138029886	8000	138033655	-4000	4000	-3769
chr3	75663220	75671220	75665138	8000	75667220	-4000	4000	-2082
chr3	75663220	75671220	75665667	8000	75667220	-4000	4000	-1553
chr3	49173634	49181634	49174268	8000	49177634	-4000	4000	-3366
chr3	52788068	52796068	52788242	8000	52792068	-4000	4000	-3826
chr3	194335768	194343768	194342322	8000	194339768	-4000	4000	2554
chr3	38692802	38700802	38698217	8000	38696802	-4000	4000	1415
chr3	98387631	98395631	98391397	8000	98391631	-4000	4000	-234
chr3	137762334	137770334	137764959	8000	137766334	-4000	4000	-1375
chr3	165182720	165190720	165189403	8000	165186720	-4000	4000	2683
chr3	57193838	57201838	57198075	8000	57197838	-4000	4000	237
chr3	100691479	100699479	100695012	8000	100695479	-4000	4000	-467
chr3	126432556	126440556	126438334	8000	126436556	-4000	4000	1778
chr3	138257437	138265437	138264165	8000	138261437	-4000	4000	2728
chr3	49853988	49861988	49859563	8000	49857988	-4000	4000	1575
chr3	38841764	38849764	38847597	8000	38845764	-4000	4000	1833
chr3	73059337	73067337	73062842	8000	73063337	-4000	4000	-495
chr3	38544057	38552057	38550846	8000	38548057	-4000	4000	2789
chr3	138949990	138957990	138950459	8000	138953990	-4000	4000	-3531
chr3	49786732	49794732	49791771	8000	49790732	-4000	4000	1039
chr3	139015031	139023031	139020275	8000	139019031	-4000	4000	1244
chr3	187694259	187702259	187698936	8000	187698259	-4000	4000	677
chr3	75663220	75671220	75665679	8000	75667220	-4000	4000	-1541
chr3	19531642	19539642	19533559	8000	19535642	-4000	4000	-2083
chr3	190424655	190432655	190429530	8000	190428655	-4000	4000	875
chr3	139015031	139023031	139020076	8000	139019031	-4000	4000	1045
chr3	194335768	194343768	194341332	8000	194339768	-4000	4000	1564
chr3	196502879	196510879	196507709	8000	196506879	-4000	4000	830
chr3	121626295	121634295	121633148	8000	121630295	-4000	4000	2853
chr3	178840429	178848429	178844135	8000	178844429	-4000	4000	-294
chr3	98468924	98476924	98469838	8000	98472924	-4000	4000	-3086
chr3	186649141	186657141	186652630	8000	186653141	-4000	4000	-511
chr3	54914231	54922231	54918749	8000	54918231	-4000	4000	518
chr3	71767655	71775655	71772830	8000	71771655	-4000	4000	1175
chr3	108954248	108962248	108958920	8000	108958248	-4000	4000	672
chr3	151824488	151832488	151828269	8000	151828488	-4000	4000	-219
chr3	46262706	46270706	46266238	8000	46266706	-4000	4000	-468
chr3	98494631	98502631	98497819	8000	98498631	-4000	4000	-812
chr3	94010365	94018365	94014933	8000	94014365	-4000	4000	568
chr3	184102995	184110995	184106139	8000	184106995	-4000	4000	-856
chr3	165182720	165190720	165188204	8000	165186720	-4000	4000	1484
chr3	98468924	98476924	98469583	8000	98472924	-4000	4000	-3341
chr3	46511385	46519385	46518848	8000	46515385	-4000	4000	3463
chr3	3062324	3070324	3070264	8000	3066324	-4000	4000	3940
chr3	75663220	75671220	75664487	8000	75667220	-4000	4000	-2733
chr3	139038102	139046102	139044060	8000	139042102	-4000	4000	1958
chr3	98084102	98092102	98087413	8000	98088102	-4000	4000	-689
chr3	73059337	73067337	73065755	8000	73063337	-4000	4000	2418
chr3	139015031	139023031	139020003	8000	139019031	-4000	4000	972
chr3	9725908	9733908	9726697	8000	9729908	-4000	4000	-3211
chr3	1400217	1408217	1403487	8000	1404217	-4000	4000	-730
chr3	52805009	52813009	52806937	8000	52809009	-4000	4000	-2072
chr3	138257437	138265437	138262497	8000	138261437	-4000	4000	1060
chr3	98261356	98269356	98265242	8000	98265356	-4000	4000	-114
chr3	154330943	154338943	154337937	8000	154334943	-4000	4000	2994
chr3	13812258	13820258	13819073	8000	13816258	-4000	4000	2815
chr3	98280070	98288070	98283123	8000	98284070	-4000	4000	-947
chr3	48397259	48405259	48404500	8000	48401259	-4000	4000	3241
chr3	98280070	98288070	98283602	8000	98284070	-4000	4000	-468
chr3	98530681	98538681	98532234	8000	98534681	-4000	4000	-2447
chr3	73059337	73067337	73065117	8000	73063337	-4000	4000	1780
chr3	138999962	139007962	139005988	8000	139003962	-4000	4000	2026
chr3	160674448	160682448	160677933	8000	160678448	-4000	4000	-515
chr3	167474684	167482684	167478765	8000	167478684	-4000	4000	81
chr3	194335768	194343768	194342494	8000	194339768	-4000	4000	2726
chr3	1400217	1408217	1402329	8000	1404217	-4000	4000	-1888
chr3	98280070	98288070	98283157	8000	98284070	-4000	4000	-913
chr3	42688544	42696544	42691958	8000	42692544	-4000	4000	-586
chr3	10281666	10289666	10285455	8000	10285666	-4000	4000	-211
chr4	73850483	73858483	73853894	8000	73854483	-4000	4000	-589
chr4	174974180	174982180	174978150	8000	174978180	-4000	4000	-30
chr4	174974180	174982180	174976364	8000	174978180	-4000	4000	-1816
chr4	165037749	165045749	165040345	8000	165041749	-4000	4000	-1404
chr4	188143743	188151743	188147036	8000	188147743	-4000	4000	-707
chr4	188001046	188009046	188002733	8000	188005046	-4000	4000	-2313
chr4	93826964	93834964	93829918	8000	93830964	-4000	4000	-1046
chr4	146638474	146646474	146640659	8000	146642474	-4000	4000	-1815
chr4	174974180	174982180	174975625	8000	174978180	-4000	4000	-2555
chr4	188143743	188151743	188147078	8000	188147743	-4000	4000	-665
chr4	80959750	80967750	80963566	8000	80963750	-4000	4000	-184
chr4	51989652	51997652	51995047	8000	51993652	-4000	4000	1395
chr4	56805860	56813860	56810086	8000	56809860	-4000	4000	226
chr4	56805860	56813860	56810087	8000	56809860	-4000	4000	227
chr4	68049198	68057198	68053492	8000	68053198	-4000	4000	294
chr4	79402361	79410361	79406561	8000	79406361	-4000	4000	200
chr4	188143743	188151743	188146870	8000	188147743	-4000	4000	-873
chr4	190020367	190028367	190027138	8000	190024367	-4000	4000	2771
chr4	165037749	165045749	165040327	8000	165041749	-4000	4000	-1422
chr4	70032538	70040538	70033172	8000	70036538	-4000	4000	-3366
chr4	41740082	41748082	41746248	8000	41744082	-4000	4000	2166
chr4	188001046	188009046	188003706	8000	188005046	-4000	4000	-1340
chr4	87612873	87620873	87614177	8000	87616873	-4000	4000	-2696
chr4	122447470	122455470	122451718	8000	122451470	-4000	4000	248
chr4	188143743	188151743	188146826	8000	188147743	-4000	4000	-917
chr4	183317764	183325764	183319758	8000	183321764	-4000	4000	-2006
chr4	127770292	127778292	127773470	8000	127774292	-4000	4000	-822
chr4	69108987	69116987	69112771	8000	69112987	-4000	4000	-216
chr4	70603288	70611288	70606263	8000	70607288	-4000	4000	-1025
chr4	7426285	7434285	7433586	8000	7430285	-4000	4000	3301
chr4	79402361	79410361	79408182	8000	79406361	-4000	4000	1821
chr4	44169903	44177903	44174183	8000	44173903	-4000	4000	280
chr4	174974180	174982180	174977051	8000	174978180	-4000	4000	-1129
chr4	87612873	87620873	87612976	8000	87616873	-4000	4000	-3897
chr4	186285681	186293681	186285764	8000	186289681	-4000	4000	-3917
chr4	174974180	174982180	174977705	8000	174978180	-4000	4000	-475
chr4	146638474	146646474	146640148	8000	146642474	-4000	4000	-2326
chr4	70333116	70341116	70335874	8000	70337116	-4000	4000	-1242
chr4	44169903	44177903	44174707	8000	44173903	-4000	4000	804
chr4	37445463	37453463	37447164	8000	37449463	-4000	4000	-2299
chr4	41740082	41748082	41747372	8000	41744082	-4000	4000	3290
chr4	70603288	70611288	70603890	8000	70607288	-4000	4000	-3398
chr4	176209673	176217673	176216877	8000	176213673	-4000	4000	3204
chr4	163467095	163475095	163471934	8000	163471095	-4000	4000	839
chr4	51989652	51997652	51995732	8000	51993652	-4000	4000	2080
chr4	75561871	75569871	75564412	8000	75565871	-4000	4000	-1459
chr4	146638474	146646474	146641421	8000	146642474	-4000	4000	-1053
chr4	174974180	174982180	174976688	8000	174978180	-4000	4000	-1492
chr4	9780009	9788009	9783174	8000	9784009	-4000	4000	-835
chr4	46730827	46738827	46734938	8000	46734827	-4000	4000	111
chr4	93826964	93834964	93829497	8000	93830964	-4000	4000	-1467
chr4	9780009	9788009	9782986	8000	9784009	-4000	4000	-1023
chr4	47422447	47430447	47426188	8000	47426447	-4000	4000	-259
chr4	70603288	70611288	70606420	8000	70607288	-4000	4000	-868
chr4	146702617	146710617	146707050	8000	146706617	-4000	4000	433
chr4	164950446	164958446	164957172	8000	164954446	-4000	4000	2726
chr4	41740082	41748082	41744488	8000	41744082	-4000	4000	406
chr4	163467095	163475095	163472900	8000	163471095	-4000	4000	1805
chr4	185016953	185024953	185020512	8000	185020953	-4000	4000	-441
chr4	144105303	144113303	144111146	8000	144109303	-4000	4000	1843
chr4	165037749	165045749	165041006	8000	165041749	-4000	4000	-743
chr4	152765354	152773354	152771014	8000	152769354	-4000	4000	1660
chr4	36343511	36351511	36343815	8000	36347511	-4000	4000	-3696
chr4	266675	274675	272318	8000	270675	-4000	4000	1643
chr4	164950446	164958446	164957444	8000	164954446	-4000	4000	2998
chr4	48490389	48498389	48494141	8000	48494389	-4000	4000	-248
chr4	183317764	183325764	183318561	8000	183321764	-4000	4000	-3203
chr4	174974180	174982180	174976557	8000	174978180	-4000	4000	-1623
chr4	87612873	87620873	87616450	8000	87616873	-4000	4000	-423
chr4	121754881	121762881	121761653	8000	121758881	-4000	4000	2772
chr4	174974180	174982180	174977934	8000	174978180	-4000	4000	-246
chr4	163467095	163475095	163472672	8000	163471095	-4000	4000	1577
chr4	73500001	73508001	73500096	8000	73504001	-4000	4000	-3905
chr4	79402361	79410361	79407009	8000	79406361	-4000	4000	648
chr4	37445463	37453463	37446470	8000	37449463	-4000	4000	-2993
chr4	146638474	146646474	146640364	8000	146642474	-4000	4000	-2110
chr4	154824813	154832813	154828069	8000	154828813	-4000	4000	-744
chr4	87842814	87850814	87846745	8000	87846814	-4000	4000	-69
chr4	7426285	7434285	7433978	8000	7430285	-4000	4000	3693
chr4	165037749	165045749	165040539	8000	165041749	-4000	4000	-1210
chr4	87612873	87620873	87613288	8000	87616873	-4000	4000	-3585
chr4	174974180	174982180	174976198	8000	174978180	-4000	4000	-1982
chr4	9780009	9788009	9782681	8000	9784009	-4000	4000	-1328
chr4	155825729	155833729	155829888	8000	155829729	-4000	4000	159
chr4	10482395	10490395	10490341	8000	10486395	-4000	4000	3946
chr4	79402361	79410361	79406791	8000	79406361	-4000	4000	430
chr4	185016953	185024953	185018951	8000	185020953	-4000	4000	-2002
chr4	165037749	165045749	165041006	8000	165041749	-4000	4000	-743
chr4	43026658	43034658	43030452	8000	43030658	-4000	4000	-206
chr4	79402361	79410361	79408006	8000	79406361	-4000	4000	1645
chr4	69108987	69116987	69112811	8000	69112987	-4000	4000	-176
chr4	161379897	161387897	161385943	8000	161383897	-4000	4000	2046
chr4	163467095	163475095	163471674	8000	163471095	-4000	4000	579
chr4	56805860	56813860	56811743	8000	56809860	-4000	4000	1883
chr4	70603288	70611288	70606214	8000	70607288	-4000	4000	-1074
chr4	43026658	43034658	43030438	8000	43030658	-4000	4000	-220
chr4	70333116	70341116	70335180	8000	70337116	-4000	4000	-1936
chr4	51989652	51997652	51995609	8000	51993652	-4000	4000	1957
chr4	150580693	150588693	150583320	8000	150584693	-4000	4000	-1373
chr4	68828023	68836023	68830642	8000	68832023	-4000	4000	-1381
chr4	41740082	41748082	41747536	8000	41744082	-4000	4000	3454
chr4	67816876	67824876	67822194	8000	67820876	-4000	4000	1318
chr4	47422447	47430447	47426110	8000	47426447	-4000	4000	-337
chr4	48490389	48498389	48492851	8000	48494389	-4000	4000	-1538
chr4	48490389	48498389	48494201	8000	48494389	-4000	4000	-188
chr4	74032589	74040589	74037004	8000	74036589	-4000	4000	415
chr4	93826964	93834964	93828931	8000	93830964	-4000	4000	-2033
chr4	266675	274675	271224	8000	270675	-4000	4000	549
chr4	266675	274675	271736	8000	270675	-4000	4000	1061
chr4	86819468	86827468	86825454	8000	86823468	-4000	4000	1986
chr4	146638474	146646474	146640063	8000	146642474	-4000	4000	-2411
chr4	37445463	37453463	37445548	8000	37449463	-4000	4000	-3915
chr4	46730827	46738827	46735147	8000	46734827	-4000	4000	320
chr4	37445463	37453463	37445913	8000	37449463	-4000	4000	-3550
chr4	44618088	44626088	44624638	8000	44622088	-4000	4000	2550
chr4	161379897	161387897	161385877	8000	161383897	-4000	4000	1980
chr4	37445463	37453463	37445569	8000	37449463	-4000	4000	-3894
chr4	37445463	37453463	37446804	8000	37449463	-4000	4000	-2659
chr4	72144305	72152305	72147747	8000	72148305	-4000	4000	-558
chr4	99198638	99206638	99204995	8000	99202638	-4000	4000	2357
chr4	174974180	174982180	174975617	8000	174978180	-4000	4000	-2563
chr4	9232046	9240046	9239944	8000	9236046	-4000	4000	3898
chr4	41740082	41748082	41744734	8000	41744082	-4000	4000	652
chr4	121754881	121762881	121761658	8000	121758881	-4000	4000	2777
chr4	73850483	73858483	73854082	8000	73854483	-4000	4000	-401
chr4	68828023	68836023	68830629	8000	68832023	-4000	4000	-1394
chr4	68924463	68932463	68929929	8000	68928463	-4000	4000	1466
chr4	75855864	75863864	75860889	8000	75859864	-4000	4000	1025
chr4	163467095	163475095	163472087	8000	163471095	-4000	4000	992
chr4	163467095	163475095	163473290	8000	163471095	-4000	4000	2195
chr4	47422447	47430447	47425881	8000	47426447	-4000	4000	-566
chr4	95837464	95845464	95840932	8000	95841464	-4000	4000	-532
chr4	79402361	79410361	79407874	8000	79406361	-4000	4000	1513
chr4	122447470	122455470	122453822	8000	122451470	-4000	4000	2352
chr4	87660361	87668361	87662931	8000	87664361	-4000	4000	-1430
chr4	266675	274675	272406	8000	270675	-4000	4000	1731
chr4	72144305	72152305	72147431	8000	72148305	-4000	4000	-874
chr4	118254634	118262634	118255634	8000	118258634	-4000	4000	-3000
chr4	165037749	165045749	165040437	8000	165041749	-4000	4000	-1312
chr4	17523104	17531104	17526837	8000	17527104	-4000	4000	-267
chr4	150580693	150588693	150583629	8000	150584693	-4000	4000	-1064
chr4	72144305	72152305	72147705	8000	72148305	-4000	4000	-600
chr4	168183736	168191736	168187438	8000	168187736	-4000	4000	-298
chr4	42398487	42406487	42401127	8000	42402487	-4000	4000	-1360
chr4	145767032	145775032	145774612	8000	145771032	-4000	4000	3580
chr4	168183736	168191736	168184648	8000	168187736	-4000	4000	-3088
chr4	70333116	70341116	70335384	8000	70337116	-4000	4000	-1732
chr4	99198638	99206638	99204036	8000	99202638	-4000	4000	1398
chr4	152765354	152773354	152770564	8000	152769354	-4000	4000	1210
chr4	176209673	176217673	176215560	8000	176213673	-4000	4000	1887
chr4	42398487	42406487	42401348	8000	42402487	-4000	4000	-1139
chr4	87842814	87850814	87846238	8000	87846814	-4000	4000	-576
chr4	3445486	3453486	3447961	8000	3449486	-4000	4000	-1525
chr4	44618088	44626088	44624666	8000	44622088	-4000	4000	2578
chr4	70333116	70341116	70336291	8000	70337116	-4000	4000	-825
chr4	70333116	70341116	70335880	8000	70337116	-4000	4000	-1236
chr4	44618088	44626088	44624739	8000	44622088	-4000	4000	2651
chr4	68222653	68230653	68228775	8000	68226653	-4000	4000	2122
chr4	41740082	41748082	41744413	8000	41744082	-4000	4000	331
chr4	48490389	48498389	48494278	8000	48494389	-4000	4000	-111
chr4	86819468	86827468	86823706	8000	86823468	-4000	4000	238
chr4	185445826	185453826	185449610	8000	185449826	-4000	4000	-216
chr4	67733118	67741118	67740129	8000	67737118	-4000	4000	3011
chr4	9780009	9788009	9782710	8000	9784009	-4000	4000	-1299
chr4	9780009	9788009	9783491	8000	9784009	-4000	4000	-518
chr4	37445463	37453463	37446621	8000	37449463	-4000	4000	-2842
chr4	48485526	48493526	48488936	8000	48489526	-4000	4000	-590
chr4	51989652	51997652	51995861	8000	51993652	-4000	4000	2209
chr4	69998570	70006570	69999680	8000	70002570	-4000	4000	-2890
chr4	163467095	163475095	163473519	8000	163471095	-4000	4000	2424
chr4	174974180	174982180	174975570	8000	174978180	-4000	4000	-2610
chr4	48485526	48493526	48488803	8000	48489526	-4000	4000	-723
chr4	70333116	70341116	70335007	8000	70337116	-4000	4000	-2109
chr4	146638474	146646474	146641106	8000	146642474	-4000	4000	-1368
chr4	174974180	174982180	174977165	8000	174978180	-4000	4000	-1015
chr4	93826964	93834964	93829692	8000	93830964	-4000	4000	-1272
chr4	146638474	146646474	146640335	8000	146642474	-4000	4000	-2139
chr4	51989652	51997652	51994202	8000	51993652	-4000	4000	550
chr4	266675	274675	271734	8000	270675	-4000	4000	1059
chr4	266675	274675	272048	8000	270675	-4000	4000	1373
chr4	266675	274675	272475	8000	270675	-4000	4000	1800
chr4	43026658	43034658	43030452	8000	43030658	-4000	4000	-206
chr4	47422447	47430447	47425676	8000	47426447	-4000	4000	-771
chr4	55552519	55560519	55556669	8000	55556519	-4000	4000	150
chr4	67905395	67913395	67911430	8000	67909395	-4000	4000	2035
chr4	69998570	70006570	70000934	8000	70002570	-4000	4000	-1636
chr4	87612873	87620873	87613851	8000	87616873	-4000	4000	-3022
chr4	87660361	87668361	87662646	8000	87664361	-4000	4000	-1715
chr4	87842814	87850814	87845441	8000	87846814	-4000	4000	-1373
chr4	109868315	109876315	109870217	8000	109872315	-4000	4000	-2098
chr4	146638474	146646474	146639907	8000	146642474	-4000	4000	-2567
chr4	146638474	146646474	146640572	8000	146642474	-4000	4000	-1902
chr4	150580693	150588693	150583700	8000	150584693	-4000	4000	-993
chr4	150580693	150588693	150588104	8000	150584693	-4000	4000	3411
chr4	152765354	152773354	152770402	8000	152769354	-4000	4000	1048
chr4	155825729	155833729	155831847	8000	155829729	-4000	4000	2118
chr4	158649372	158657372	158651849	8000	158653372	-4000	4000	-1523
chr4	161379897	161387897	161386062	8000	161383897	-4000	4000	2165
chr4	176180579	176188579	176184670	8000	176184579	-4000	4000	91
chr4	186285681	186293681	186286499	8000	186289681	-4000	4000	-3182
chr4	186285681	186293681	186288751	8000	186289681	-4000	4000	-930
chr4	188001046	188009046	188003226	8000	188005046	-4000	4000	-1820
chr4	48062393	48070393	48067467	8000	48066393	-4000	4000	1074
chr4	87612873	87620873	87613028	8000	87616873	-4000	4000	-3845
chr4	109868315	109876315	109870211	8000	109872315	-4000	4000	-2104
chr4	70528743	70536743	70531036	8000	70532743	-4000	4000	-1707
chr4	152765354	152773354	152769790	8000	152769354	-4000	4000	436
chr4	146638474	146646474	146640684	8000	146642474	-4000	4000	-1790
chr4	87842814	87850814	87845642	8000	87846814	-4000	4000	-1172
chr4	155825729	155833729	155831915	8000	155829729	-4000	4000	2186
chr4	86819468	86827468	86825549	8000	86823468	-4000	4000	2081
chr4	87612873	87620873	87616197	8000	87616873	-4000	4000	-676
chr4	51989652	51997652	51995642	8000	51993652	-4000	4000	1990
chr4	173037559	173045559	173040055	8000	173041559	-4000	4000	-1504
chr4	95837464	95845464	95840833	8000	95841464	-4000	4000	-631
chr4	163467095	163475095	163473557	8000	163471095	-4000	4000	2462
chr4	121754881	121762881	121761565	8000	121758881	-4000	4000	2684
chr4	69108987	69116987	69112941	8000	69112987	-4000	4000	-46
chr4	69108987	69116987	69112943	8000	69112987	-4000	4000	-44
chr4	143992104	144000104	143997616	8000	143996104	-4000	4000	1512
chr4	164950446	164958446	164957173	8000	164954446	-4000	4000	2727
chr4	9780009	9788009	9783329	8000	9784009	-4000	4000	-680
chr4	72144305	72152305	72147297	8000	72148305	-4000	4000	-1008
chr4	95837464	95845464	95841237	8000	95841464	-4000	4000	-227
chr4	146638474	146646474	146640356	8000	146642474	-4000	4000	-2118
chr4	168183736	168191736	168187471	8000	168187736	-4000	4000	-265
chr4	183317764	183325764	183319606	8000	183321764	-4000	4000	-2158
chr4	99538303	99546303	99539351	8000	99542303	-4000	4000	-2952
chr4	174974180	174982180	174975712	8000	174978180	-4000	4000	-2468
chr4	99619997	99627997	99622762	8000	99623997	-4000	4000	-1235
chr4	3445486	3453486	3449321	8000	3449486	-4000	4000	-165
chr4	174974180	174982180	174976162	8000	174978180	-4000	4000	-2018
chr4	51989652	51997652	51994899	8000	51993652	-4000	4000	1247
chr4	69584417	69592417	69589596	8000	69588417	-4000	4000	1179
chr4	150580693	150588693	150583551	8000	150584693	-4000	4000	-1142
chr4	150580693	150588693	150583784	8000	150584693	-4000	4000	-909
chr4	87612873	87620873	87613096	8000	87616873	-4000	4000	-3777
chr4	165037749	165045749	165041364	8000	165041749	-4000	4000	-385
chr4	48490389	48498389	48494260	8000	48494389	-4000	4000	-129
chr4	163467095	163475095	163472784	8000	163471095	-4000	4000	1689
chr4	73845064	73853064	73847941	8000	73849064	-4000	4000	-1123
chr4	87612873	87620873	87613288	8000	87616873	-4000	4000	-3585
chr4	158649372	158657372	158651995	8000	158653372	-4000	4000	-1377
chr4	188143743	188151743	188147081	8000	188147743	-4000	4000	-662
chr4	112509516	112517516	112515139	8000	112513516	-4000	4000	1623
chr4	93826964	93834964	93829877	8000	93830964	-4000	4000	-1087
chr4	188143743	188151743	188147302	8000	188147743	-4000	4000	-441
chr4	5010586	5018586	5014986	8000	5014586	-4000	4000	400
chr4	17523104	17531104	17527028	8000	17527104	-4000	4000	-76
chr4	75561871	75569871	75564447	8000	75565871	-4000	4000	-1424
chr4	87612873	87620873	87614822	8000	87616873	-4000	4000	-2051
chr4	99538303	99546303	99540429	8000	99542303	-4000	4000	-1874
chr4	72144305	72152305	72147205	8000	72148305	-4000	4000	-1100
chr4	73850483	73858483	73854084	8000	73854483	-4000	4000	-399
chr4	86819468	86827468	86825532	8000	86823468	-4000	4000	2064
chr4	121324642	121332642	121329323	8000	121328642	-4000	4000	681
chr4	146638474	146646474	146640067	8000	146642474	-4000	4000	-2407
chr4	161379897	161387897	161386538	8000	161383897	-4000	4000	2641
chr4	56805860	56813860	56810061	8000	56809860	-4000	4000	201
chr4	168183736	168191736	168187371	8000	168187736	-4000	4000	-365
chr5	56095680	56103680	56100248	8000	56099680	-4000	4000	568
chr5	177988235	177996235	177992415	8000	177992235	-4000	4000	180
chr5	180735123	180743123	180739899	8000	180739123	-4000	4000	776
chr5	146509144	146517144	146515736	8000	146513144	-4000	4000	2592
chr5	116023619	116031619	116026282	8000	116027619	-4000	4000	-1337
chr5	147878191	147886191	147882171	8000	147882191	-4000	4000	-20
chr5	175436036	175444036	175442486	8000	175440036	-4000	4000	2450
chr5	150215491	150223491	150222685	8000	150219491	-4000	4000	3194
chr5	151310972	151318972	151317032	8000	151314972	-4000	4000	2060
chr5	33934918	33942918	33936923	8000	33938918	-4000	4000	-1995
chr5	148311922	148319922	148315764	8000	148315922	-4000	4000	-158
chr5	157676158	157684158	157679856	8000	157680158	-4000	4000	-302
chr5	157025413	157033413	157029752	8000	157029413	-4000	4000	339
chr5	141241861	141249861	141242004	8000	141245861	-4000	4000	-3857
chr5	138088365	138096365	138091147	8000	138092365	-4000	4000	-1218
chr5	1221111	1229111	1221819	8000	1225111	-4000	4000	-3292
chr5	154470972	154478972	154475562	8000	154474972	-4000	4000	590
chr5	180946906	180954906	180947624	8000	180950906	-4000	4000	-3282
chr5	43276850	43284850	43277176	8000	43280850	-4000	4000	-3674
chr5	132537445	132545445	132541812	8000	132541445	-4000	4000	367
chr5	145854521	145862521	145859759	8000	145858521	-4000	4000	1238
chr5	180735123	180743123	180739207	8000	180739123	-4000	4000	84
chr5	24483100	24491100	24488105	8000	24487100	-4000	4000	1005
chr5	95618142	95626142	95621526	8000	95622142	-4000	4000	-616
chr5	150896736	150904736	150898469	8000	150900736	-4000	4000	-2267
chr5	151310972	151318972	151317020	8000	151314972	-4000	4000	2048
chr5	180735123	180743123	180739345	8000	180739123	-4000	4000	222
chr5	21746673	21754673	21752075	8000	21750673	-4000	4000	1402
chr5	26876597	26884597	26881453	8000	26880597	-4000	4000	856
chr5	73127809	73135809	73128401	8000	73131809	-4000	4000	-3408
chr5	145854521	145862521	145859903	8000	145858521	-4000	4000	1382
chr5	97087867	97095867	97094892	8000	97091867	-4000	4000	3025
chr5	9623347	9631347	9629564	8000	9627347	-4000	4000	2217
chr5	138088365	138096365	138090692	8000	138092365	-4000	4000	-1673
chr5	157621679	157629679	157626410	8000	157625679	-4000	4000	731
chr5	26876597	26884597	26881296	8000	26880597	-4000	4000	699
chr5	127654630	127662630	127657763	8000	127658630	-4000	4000	-867
chr5	95446454	95454454	95448378	8000	95450454	-4000	4000	-2076
chr5	54452377	54460377	54455794	8000	54456377	-4000	4000	-583
chr5	121848833	121856833	121852119	8000	121852833	-4000	4000	-714
chr5	177988235	177996235	177995974	8000	177992235	-4000	4000	3739
chr5	63953874	63961874	63960723	8000	63957874	-4000	4000	2849
chr5	148335852	148343852	148339726	8000	148339852	-4000	4000	-126
chr5	176591974	176599974	176599311	8000	176595974	-4000	4000	3337
chr5	80552755	80560755	80557156	8000	80556755	-4000	4000	401
chr5	160234735	160242735	160234855	8000	160238735	-4000	4000	-3880
chr5	151310972	151318972	151316943	8000	151314972	-4000	4000	1971
chr5	26876597	26884597	26880727	8000	26880597	-4000	4000	130
chr5	149367324	149375324	149368052	8000	149371324	-4000	4000	-3272
chr5	114492500	114500500	114496127	8000	114496500	-4000	4000	-373
chr5	139840466	139848466	139847858	8000	139844466	-4000	4000	3392
chr5	121848833	121856833	121852147	8000	121852833	-4000	4000	-686
chr5	63953874	63961874	63960810	8000	63957874	-4000	4000	2936
chr5	139840466	139848466	139842341	8000	139844466	-4000	4000	-2125
chr5	114492500	114500500	114496166	8000	114496500	-4000	4000	-334
chr5	141241861	141249861	141245591	8000	141245861	-4000	4000	-270
chr5	180735123	180743123	180739997	8000	180739123	-4000	4000	874
chr5	141241861	141249861	141246863	8000	141245861	-4000	4000	1002
chr5	180946906	180954906	180950494	8000	180950906	-4000	4000	-412
chr5	177988235	177996235	177994243	8000	177992235	-4000	4000	2008
chr5	26876597	26884597	26881295	8000	26880597	-4000	4000	698
chr5	26876597	26884597	26881214	8000	26880597	-4000	4000	617
chr5	80317842	80325842	80321780	8000	80321842	-4000	4000	-62
chr5	148282255	148290255	148286049	8000	148286255	-4000	4000	-206
chr5	33934918	33942918	33937417	8000	33938918	-4000	4000	-1501
chr5	33934918	33942918	33936981	8000	33938918	-4000	4000	-1937
chr5	148171619	148179619	148174263	8000	148175619	-4000	4000	-1356
chr5	180735123	180743123	180739708	8000	180739123	-4000	4000	585
chr5	143816716	143824716	143820485	8000	143820716	-4000	4000	-231
chr5	80552755	80560755	80559288	8000	80556755	-4000	4000	2533
chr5	176616082	176624082	176621276	8000	176620082	-4000	4000	1194
chr5	111074026	111082026	111075969	8000	111078026	-4000	4000	-2057
chr5	73171143	73179143	73173839	8000	73175143	-4000	4000	-1304
chr5	33934918	33942918	33937100	8000	33938918	-4000	4000	-1818
chr5	160559120	160567120	160565793	8000	160563120	-4000	4000	2673
chr5	26876597	26884597	26881044	8000	26880597	-4000	4000	447
chr5	24483100	24491100	24487897	8000	24487100	-4000	4000	797
chr5	102229986	102237986	102236901	8000	102233986	-4000	4000	2915
chr5	23524093	23532093	23526644	8000	23528093	-4000	4000	-1449
chr5	57476018	57484018	57481725	8000	57480018	-4000	4000	1707
chr5	57476018	57484018	57481727	8000	57480018	-4000	4000	1709
chr5	157157846	157165846	157162505	8000	157161846	-4000	4000	659
chr5	1388794	1396794	1394555	8000	1392794	-4000	4000	1761
chr5	9623347	9631347	9629615	8000	9627347	-4000	4000	2268
chr5	157157846	157165846	157163204	8000	157161846	-4000	4000	1358
chr5	54452377	54460377	54456153	8000	54456377	-4000	4000	-224
chr5	180735123	180743123	180739248	8000	180739123	-4000	4000	125
chr5	192334	200334	195161	8000	196334	-4000	4000	-1173
chr5	21746673	21754673	21751216	8000	21750673	-4000	4000	543
chr5	80317842	80325842	80320498	8000	80321842	-4000	4000	-1344
chr5	24483100	24491100	24487304	8000	24487100	-4000	4000	204
chr5	177988235	177996235	177993031	8000	177992235	-4000	4000	796
chr5	192334	200334	195029	8000	196334	-4000	4000	-1305
chr5	80552755	80560755	80558322	8000	80556755	-4000	4000	1567
chr5	146509144	146517144	146510487	8000	146513144	-4000	4000	-2657
chr5	157157846	157165846	157163300	8000	157161846	-4000	4000	1454
chr5	135888246	135896246	135895735	8000	135892246	-4000	4000	3489
chr5	157025413	157033413	157029813	8000	157029413	-4000	4000	400
chr5	80552755	80560755	80559962	8000	80556755	-4000	4000	3207
chr5	135530282	135538282	135535513	8000	135534282	-4000	4000	1231
chr5	157470722	157478722	157472531	8000	157474722	-4000	4000	-2191
chr5	173228109	173236109	173233087	8000	173232109	-4000	4000	978
chr5	180096795	180104795	180101345	8000	180100795	-4000	4000	550
chr5	23524093	23532093	23527438	8000	23528093	-4000	4000	-655
chr5	80317842	80325842	80320291	8000	80321842	-4000	4000	-1551
chr5	180735123	180743123	180739594	8000	180739123	-4000	4000	471
chr5	21746673	21754673	21751967	8000	21750673	-4000	4000	1294
chr5	102229986	102237986	102236987	8000	102233986	-4000	4000	3001
chr5	141241861	141249861	141246883	8000	141245861	-4000	4000	1022
chr5	9623347	9631347	9629276	8000	9627347	-4000	4000	1929
chr5	24483100	24491100	24487938	8000	24487100	-4000	4000	838
chr5	57476018	57484018	57481975	8000	57480018	-4000	4000	1957
chr5	64608319	64616319	64609286	8000	64612319	-4000	4000	-3033
chr5	141241861	141249861	141247865	8000	141245861	-4000	4000	2004
chr5	143816716	143824716	143820485	8000	143820716	-4000	4000	-231
chr5	157157846	157165846	157162738	8000	157161846	-4000	4000	892
chr5	63953874	63961874	63961427	8000	63957874	-4000	4000	3553
chr5	137883851	137891851	137890482	8000	137887851	-4000	4000	2631
chr5	97087867	97095867	97094921	8000	97091867	-4000	4000	3054
chr5	21746673	21754673	21751883	8000	21750673	-4000	4000	1210
chr5	175436036	175444036	175441552	8000	175440036	-4000	4000	1516
chr5	141241861	141249861	141247142	8000	141245861	-4000	4000	1281
chr5	19467296	19475296	19473597	8000	19471296	-4000	4000	2301
chr5	151272358	151280358	151277406	8000	151276358	-4000	4000	1048
chr5	95648181	95656181	95652466	8000	95652181	-4000	4000	285
chr5	141241861	141249861	141242080	8000	141245861	-4000	4000	-3781
chr5	63953874	63961874	63961186	8000	63957874	-4000	4000	3312
chr5	181155285	181163285	181155416	8000	181159285	-4000	4000	-3869
chr5	180946906	180954906	180950233	8000	180950906	-4000	4000	-673
chr5	21746673	21754673	21752000	8000	21750673	-4000	4000	1327
chr5	63953874	63961874	63961070	8000	63957874	-4000	4000	3196
chr5	63953874	63961874	63961576	8000	63957874	-4000	4000	3702
chr5	75677773	75685773	75677937	8000	75681773	-4000	4000	-3836
chr5	80552755	80560755	80559740	8000	80556755	-4000	4000	2985
chr5	146080313	146088313	146084401	8000	146084313	-4000	4000	88
chr5	176591974	176599974	176598910	8000	176595974	-4000	4000	2936
chr5	80552755	80560755	80558474	8000	80556755	-4000	4000	1719
chr5	160559120	160567120	160565845	8000	160563120	-4000	4000	2725
chr5	1249147	1257147	1255341	8000	1253147	-4000	4000	2194
chr5	95446454	95454454	95448341	8000	95450454	-4000	4000	-2113
chr5	9623347	9631347	9629847	8000	9627347	-4000	4000	2500
chr5	54452377	54460377	54455901	8000	54456377	-4000	4000	-476
chr5	141241861	141249861	141245792	8000	141245861	-4000	4000	-69
chr5	23524093	23532093	23527632	8000	23528093	-4000	4000	-461
chr5	23524093	23532093	23527765	8000	23528093	-4000	4000	-328
chr5	140371141	140379141	140372746	8000	140375141	-4000	4000	-2395
chr5	141241861	141249861	141242095	8000	141245861	-4000	4000	-3766
chr5	143816716	143824716	143820683	8000	143820716	-4000	4000	-33
chr5	152387546	152395546	152392422	8000	152391546	-4000	4000	876
chr5	154470972	154478972	154475830	8000	154474972	-4000	4000	858
chr5	159310780	159318780	159316772	8000	159314780	-4000	4000	1992
chr5	178962433	178970433	178965174	8000	178966433	-4000	4000	-1259
chr5	178962433	178970433	178965437	8000	178966433	-4000	4000	-996
chr5	180096795	180104795	180102117	8000	180100795	-4000	4000	1322
chr5	180946906	180954906	180947509	8000	180950906	-4000	4000	-3397
chr5	180096795	180104795	180101463	8000	180100795	-4000	4000	668
chr5	80317842	80325842	80320131	8000	80321842	-4000	4000	-1711
chr5	157470722	157478722	157472854	8000	157474722	-4000	4000	-1868
chr5	9623347	9631347	9629869	8000	9627347	-4000	4000	2522
chr5	26876597	26884597	26881260	8000	26880597	-4000	4000	663
chr5	34994101	35002101	34998763	8000	34998101	-4000	4000	662
chr5	43276850	43284850	43280232	8000	43280850	-4000	4000	-618
chr5	43276850	43284850	43280481	8000	43280850	-4000	4000	-369
chr5	51390730	51398730	51391399	8000	51394730	-4000	4000	-3331
chr5	79128288	79136288	79131120	8000	79132288	-4000	4000	-1168
chr5	80552755	80560755	80558935	8000	80556755	-4000	4000	2180
chr5	80552755	80560755	80559794	8000	80556755	-4000	4000	3039
chr5	116023619	116031619	116026052	8000	116027619	-4000	4000	-1567
chr5	140371141	140379141	140372775	8000	140375141	-4000	4000	-2366
chr5	141241861	141249861	141247095	8000	141245861	-4000	4000	1234
chr5	146509144	146517144	146515288	8000	146513144	-4000	4000	2144
chr5	147878191	147886191	147881524	8000	147882191	-4000	4000	-667
chr5	148282255	148290255	148286164	8000	148286255	-4000	4000	-91
chr5	151818513	151826513	151822931	8000	151822513	-4000	4000	418
chr5	157470722	157478722	157472879	8000	157474722	-4000	4000	-1843
chr5	157621679	157629679	157626305	8000	157625679	-4000	4000	626
chr5	170732632	170740632	170735939	8000	170736632	-4000	4000	-693
chr5	178962433	178970433	178964714	8000	178966433	-4000	4000	-1719
chr5	178962433	178970433	178965531	8000	178966433	-4000	4000	-902
chr5	180946906	180954906	180950039	8000	180950906	-4000	4000	-867
chr5	181002727	181010727	181005613	8000	181006727	-4000	4000	-1114
chr5	139840466	139848466	139842326	8000	139844466	-4000	4000	-2140
chr5	157470722	157478722	157472378	8000	157474722	-4000	4000	-2344
chr5	178962433	178970433	178965050	8000	178966433	-4000	4000	-1383
chr5	51390730	51398730	51391428	8000	51394730	-4000	4000	-3302
chr5	1221111	1229111	1225439	8000	1225111	-4000	4000	328
chr5	24483100	24491100	24487407	8000	24487100	-4000	4000	307
chr5	135888246	135896246	135888284	8000	135892246	-4000	4000	-3962
chr5	102229986	102237986	102236714	8000	102233986	-4000	4000	2728
chr5	102229986	102237986	102236855	8000	102233986	-4000	4000	2869
chr5	152387546	152395546	152392231	8000	152391546	-4000	4000	685
chr5	24483100	24491100	24487891	8000	24487100	-4000	4000	791
chr5	178962433	178970433	178965206	8000	178966433	-4000	4000	-1227
chr5	79128288	79136288	79131120	8000	79132288	-4000	4000	-1168
chr5	64608319	64616319	64609171	8000	64612319	-4000	4000	-3148
chr5	79128288	79136288	79131378	8000	79132288	-4000	4000	-910
chr5	149367324	149375324	149368730	8000	149371324	-4000	4000	-2594
chr5	150896736	150904736	150898518	8000	150900736	-4000	4000	-2218
chr5	157157846	157165846	157162945	8000	157161846	-4000	4000	1099
chr5	180946906	180954906	180950573	8000	180950906	-4000	4000	-333
chr5	111074026	111082026	111076006	8000	111078026	-4000	4000	-2020
chr5	102229986	102237986	102236959	8000	102233986	-4000	4000	2973
chr5	80317842	80325842	80321199	8000	80321842	-4000	4000	-643
chr5	51390730	51398730	51393557	8000	51394730	-4000	4000	-1173
chr5	33934918	33942918	33936581	8000	33938918	-4000	4000	-2337
chr5	80552755	80560755	80559212	8000	80556755	-4000	4000	2457
chr5	157157846	157165846	157162486	8000	157161846	-4000	4000	640
chr5	178962433	178970433	178965798	8000	178966433	-4000	4000	-635
chr5	146509144	146517144	146509174	8000	146513144	-4000	4000	-3970
chr5	135530282	135538282	135535148	8000	135534282	-4000	4000	866
chr5	157470722	157478722	157472728	8000	157474722	-4000	4000	-1994
chr5	55813157	55821157	55816687	8000	55817157	-4000	4000	-470
chr5	181119122	181127122	181124841	8000	181123122	-4000	4000	1719
chr5	136208745	136216745	136213453	8000	136212745	-4000	4000	708
chr5	137883851	137891851	137889471	8000	137887851	-4000	4000	1620
chr5	146509144	146517144	146515819	8000	146513144	-4000	4000	2675
chr5	9623347	9631347	9630057	8000	9627347	-4000	4000	2710
chr5	95648181	95656181	95652263	8000	95652181	-4000	4000	82
chr5	181002727	181010727	181004758	8000	181006727	-4000	4000	-1969
chr5	192334	200334	195038	8000	196334	-4000	4000	-1296
chr5	57476018	57484018	57481747	8000	57480018	-4000	4000	1729
chr5	57476018	57484018	57482011	8000	57480018	-4000	4000	1993
chr5	73171143	73179143	73173537	8000	73175143	-4000	4000	-1606
chr5	132059204	132067204	132062693	8000	132063204	-4000	4000	-511
chr5	136208745	136216745	136216225	8000	136212745	-4000	4000	3480
chr5	181002727	181010727	181005814	8000	181006727	-4000	4000	-913
chr5	40994017	41002017	40998636	8000	40998017	-4000	4000	619
chr5	177394848	177402848	177402561	8000	177398848	-4000	4000	3713
chr5	157157846	157165846	157165812	8000	157161846	-4000	4000	3966
chr5	180946906	180954906	180950136	8000	180950906	-4000	4000	-770
chr5	57476018	57484018	57482065	8000	57480018	-4000	4000	2047
chr5	43276850	43284850	43280435	8000	43280850	-4000	4000	-415
chr6	26236793	26244793	26240436	8000	26240793	-4000	4000	-357
chr6	28256958	28264958	28259819	8000	28260958	-4000	4000	-1139
chr6	28427930	28435930	28434803	8000	28431930	-4000	4000	2873
chr6	83521704	83529704	83523925	8000	83525704	-4000	4000	-1779
chr6	83521704	83529704	83523586	8000	83525704	-4000	4000	-2118
chr6	168041091	168049091	168044826	8000	168045091	-4000	4000	-265
chr6	27907185	27915185	27911821	8000	27911185	-4000	4000	636
chr6	29482697	29490697	29487207	8000	29486697	-4000	4000	510
chr6	31526232	31534232	31531101	8000	31530232	-4000	4000	869
chr6	42921838	42929838	42923203	8000	42925838	-4000	4000	-2635
chr6	52232681	52240681	52238886	8000	52236681	-4000	4000	2205
chr6	55398493	55406493	55399407	8000	55402493	-4000	4000	-3086
chr6	88062838	88070838	88066489	8000	88066838	-4000	4000	-349
chr6	132639312	132647312	132645060	8000	132643312	-4000	4000	1748
chr6	132567359	132575359	132570319	8000	132571359	-4000	4000	-1040
chr6	26016958	26024958	26020958	8000	26020958	-4000	4000	0
chr6	26029092	26037092	26031821	8000	26033092	-4000	4000	-1271
chr6	26029092	26037092	26033205	8000	26033092	-4000	4000	113
chr6	27861798	27869798	27867086	8000	27865798	-4000	4000	1288
chr6	132613022	132621022	132617699	8000	132617022	-4000	4000	677
chr6	114051596	114059596	114057325	8000	114055596	-4000	4000	1729
chr6	29436977	29444977	29440199	8000	29440977	-4000	4000	-778
chr6	27833880	27841880	27838771	8000	27837880	-4000	4000	891
chr6	41060891	41068891	41061334	8000	41064891	-4000	4000	-3557
chr6	27861798	27869798	27866966	8000	27865798	-4000	4000	1168
chr6	44274734	44282734	44275587	8000	44278734	-4000	4000	-3147
chr6	134913393	134921393	134918751	8000	134917393	-4000	4000	1358
chr6	26029092	26037092	26031843	8000	26033092	-4000	4000	-1249
chr6	42177338	42185338	42178361	8000	42181338	-4000	4000	-2977
chr6	146433601	146441601	146434348	8000	146437601	-4000	4000	-3253
chr6	27954182	27962182	27957987	8000	27958182	-4000	4000	-195
chr6	114051596	114059596	114057712	8000	114055596	-4000	4000	2116
chr6	39026792	39034792	39030371	8000	39030792	-4000	4000	-421
chr6	116557127	116565127	116558108	8000	116561127	-4000	4000	-3019
chr6	27811489	27819489	27814470	8000	27815489	-4000	4000	-1019
chr6	49964677	49972677	49968849	8000	49968677	-4000	4000	172
chr6	40387591	40395591	40392722	8000	40391591	-4000	4000	1131
chr6	137488199	137496199	137492744	8000	137492199	-4000	4000	545
chr6	35745079	35753079	35748636	8000	35749079	-4000	4000	-443
chr6	98835458	98843458	98836138	8000	98839458	-4000	4000	-3320
chr6	28530955	28538955	28531876	8000	28534955	-4000	4000	-3079
chr6	29349749	29357749	29355545	8000	29353749	-4000	4000	1796
chr6	26246142	26254142	26251719	8000	26250142	-4000	4000	1577
chr6	132584592	132592592	132588888	8000	132588592	-4000	4000	296
chr6	27811489	27819489	27814720	8000	27815489	-4000	4000	-769
chr6	29668372	29676372	29672587	8000	29672372	-4000	4000	215
chr6	26242611	26250611	26250391	8000	26246611	-4000	4000	3780
chr6	26269412	26277412	26273044	8000	26273412	-4000	4000	-368
chr6	27907185	27915185	27911653	8000	27911185	-4000	4000	468
chr6	30950221	30958221	30951015	8000	30954221	-4000	4000	-3206
chr6	133891553	133899553	133891749	8000	133895553	-4000	4000	-3804
chr6	167151247	167159247	167157447	8000	167155247	-4000	4000	2200
chr6	27811489	27819489	27814571	8000	27815489	-4000	4000	-918
chr6	26029092	26037092	26031667	8000	26033092	-4000	4000	-1425
chr6	132535336	132543336	132538558	8000	132539336	-4000	4000	-778
chr6	134913393	134921393	134918456	8000	134917393	-4000	4000	1063
chr6	27143562	27151562	27147488	8000	27147562	-4000	4000	-74
chr6	77456924	77464924	77462684	8000	77460924	-4000	4000	1760
chr6	132613022	132621022	132617898	8000	132617022	-4000	4000	876
chr6	26029092	26037092	26031824	8000	26033092	-4000	4000	-1268
chr6	30147943	30155943	30153516	8000	30151943	-4000	4000	1573
chr6	26246142	26254142	26251998	8000	26250142	-4000	4000	1856
chr6	73360171	73368171	73363604	8000	73364171	-4000	4000	-567
chr6	73413566	73421566	73416197	8000	73417566	-4000	4000	-1369
chr6	116748197	116756197	116752456	8000	116752197	-4000	4000	259
chr6	26100337	26108337	26104250	8000	26104337	-4000	4000	-87
chr6	27861798	27869798	27865582	8000	27865798	-4000	4000	-216
chr6	26039227	26047227	26043444	8000	26043227	-4000	4000	217
chr6	27867845	27875845	27873470	8000	27871845	-4000	4000	1625
chr6	31570324	31578324	31573834	8000	31574324	-4000	4000	-490
chr6	87278980	87286980	87284412	8000	87282980	-4000	4000	1432
chr6	132549721	132557721	132553145	8000	132553721	-4000	4000	-576
chr6	26269412	26277412	26272225	8000	26273412	-4000	4000	-1187
chr6	26029092	26037092	26031709	8000	26033092	-4000	4000	-1383
chr6	29482697	29490697	29486895	8000	29486697	-4000	4000	198
chr6	52186638	52194638	52189387	8000	52190638	-4000	4000	-1251
chr6	26029092	26037092	26033292	8000	26033092	-4000	4000	200
chr6	28499296	28507296	28504426	8000	28503296	-4000	4000	1130
chr6	26029092	26037092	26031739	8000	26033092	-4000	4000	-1353
chr6	123212339	123220339	123218709	8000	123216339	-4000	4000	2370
chr6	41346889	41354889	41350699	8000	41350889	-4000	4000	-190
chr6	25908754	25916754	25913211	8000	25912754	-4000	4000	457
chr6	87012679	87020679	87015849	8000	87016679	-4000	4000	-830
chr6	31713918	31721918	31719001	8000	31717918	-4000	4000	1083
chr6	83853515	83861515	83857257	8000	83857515	-4000	4000	-258
chr6	132567359	132575359	132571098	8000	132571359	-4000	4000	-261
chr6	27889891	27897891	27892868	8000	27893891	-4000	4000	-1023
chr6	26246142	26254142	26251879	8000	26250142	-4000	4000	1737
chr6	27143562	27151562	27147405	8000	27147562	-4000	4000	-157
chr6	27811489	27819489	27815306	8000	27815489	-4000	4000	-183
chr6	43301538	43309538	43307715	8000	43305538	-4000	4000	2177
chr6	27867845	27875845	27871965	8000	27871845	-4000	4000	120
chr6	28256958	28264958	28259967	8000	28260958	-4000	4000	-991
chr6	30950221	30958221	30951759	8000	30954221	-4000	4000	-2462
chr6	31133534	31141534	31138675	8000	31137534	-4000	4000	1141
chr6	27143562	27151562	27146555	8000	27147562	-4000	4000	-1007
chr6	31160337	31168337	31165666	8000	31164337	-4000	4000	1329
chr6	109976720	109984720	109979133	8000	109980720	-4000	4000	-1587
chr6	27811489	27819489	27814467	8000	27815489	-4000	4000	-1022
chr6	30950221	30958221	30951929	8000	30954221	-4000	4000	-2292
chr6	35114071	35122071	35120509	8000	35118071	-4000	4000	2438
chr6	28530955	28538955	28533965	8000	28534955	-4000	4000	-990
chr6	73364555	73372555	73368818	8000	73368555	-4000	4000	263
chr6	166153656	166161656	166158354	8000	166157656	-4000	4000	698
chr6	27954182	27962182	27957386	8000	27958182	-4000	4000	-796
chr6	49781660	49789660	49786116	8000	49785660	-4000	4000	456
chr6	26242611	26250611	26250277	8000	26246611	-4000	4000	3666
chr6	29436977	29444977	29440172	8000	29440977	-4000	4000	-805
chr6	83521704	83529704	83524401	8000	83525704	-4000	4000	-1303
chr6	165275664	165283664	165280018	8000	165279664	-4000	4000	354
chr6	26029092	26037092	26031769	8000	26033092	-4000	4000	-1323
chr6	39310698	39318698	39310915	8000	39314698	-4000	4000	-3783
chr6	49781660	49789660	49786461	8000	49785660	-4000	4000	801
chr6	73413566	73421566	73413684	8000	73417566	-4000	4000	-3882
chr6	26029092	26037092	26031745	8000	26033092	-4000	4000	-1347
chr6	26100337	26108337	26104016	8000	26104337	-4000	4000	-321
chr6	26246142	26254142	26251855	8000	26250142	-4000	4000	1713
chr6	33717662	33725662	33723135	8000	33721662	-4000	4000	1473
chr6	26242611	26250611	26250290	8000	26246611	-4000	4000	3679
chr6	28256958	28264958	28259678	8000	28260958	-4000	4000	-1280
chr6	87012679	87020679	87015976	8000	87016679	-4000	4000	-703
chr6	28165594	28173594	28166761	8000	28169594	-4000	4000	-2833
chr6	146433601	146441601	146435193	8000	146437601	-4000	4000	-2408
chr6	26269412	26277412	26273332	8000	26273412	-4000	4000	-80
chr6	49781660	49789660	49786132	8000	49785660	-4000	4000	472
chr6	33717662	33725662	33725576	8000	33721662	-4000	4000	3914
chr6	99914519	99922519	99921100	8000	99918519	-4000	4000	2581
chr6	132567359	132575359	132570437	8000	132571359	-4000	4000	-922
chr6	99914519	99922519	99921175	8000	99918519	-4000	4000	2656
chr6	26029092	26037092	26031841	8000	26033092	-4000	4000	-1251
chr6	26039227	26047227	26043263	8000	26043227	-4000	4000	36
chr6	30985903	30993903	30987621	8000	30989903	-4000	4000	-2282
chr6	155272548	155280548	155275998	8000	155276548	-4000	4000	-550
chr6	27889891	27897891	27890710	8000	27893891	-4000	4000	-3181
chr6	41040337	41048337	41043983	8000	41044337	-4000	4000	-354
chr6	49781660	49789660	49787005	8000	49785660	-4000	4000	1345
chr6	29082208	29090208	29086856	8000	29086208	-4000	4000	648
chr6	35114071	35122071	35118445	8000	35118071	-4000	4000	374
chr6	109976720	109984720	109980185	8000	109980720	-4000	4000	-535
chr6	27907185	27915185	27911689	8000	27911185	-4000	4000	504
chr6	134913393	134921393	134918507	8000	134917393	-4000	4000	1114
chr6	88062838	88070838	88064162	8000	88066838	-4000	4000	-2676
chr6	105079332	105087332	105082213	8000	105083332	-4000	4000	-1119
chr6	27867845	27875845	27872322	8000	27871845	-4000	4000	477
chr6	132535336	132543336	132538383	8000	132539336	-4000	4000	-953
chr6	26100337	26108337	26108020	8000	26104337	-4000	4000	3683
chr6	27833880	27841880	27838335	8000	27837880	-4000	4000	455
chr6	136921660	136929660	136924119	8000	136925660	-4000	4000	-1541
chr6	61675961	61683961	61681014	8000	61679961	-4000	4000	1053
chr6	114051596	114059596	114057513	8000	114055596	-4000	4000	1917
chr6	26029092	26037092	26031817	8000	26033092	-4000	4000	-1275
chr6	88062838	88070838	88066350	8000	88066838	-4000	4000	-488
chr6	25722063	25730063	25726074	8000	25726063	-4000	4000	11
chr6	25722063	25730063	25726164	8000	25726063	-4000	4000	101
chr6	28165594	28173594	28167059	8000	28169594	-4000	4000	-2535
chr6	52746087	52754087	52750398	8000	52750087	-4000	4000	311
chr6	43284258	43292258	43287434	8000	43288258	-4000	4000	-824
chr6	26016958	26024958	26017540	8000	26020958	-4000	4000	-3418
chr6	27811489	27819489	27815435	8000	27815489	-4000	4000	-54
chr6	54386142	54394142	54389824	8000	54390142	-4000	4000	-318
chr6	27889891	27897891	27892792	8000	27893891	-4000	4000	-1099
chr6	29436977	29444977	29440486	8000	29440977	-4000	4000	-491
chr6	99914519	99922519	99921186	8000	99918519	-4000	4000	2667
chr6	27867845	27875845	27873404	8000	27871845	-4000	4000	1559
chr6	30950221	30958221	30951916	8000	30954221	-4000	4000	-2305
chr6	28530955	28538955	28534224	8000	28534955	-4000	4000	-731
chr6	22567666	22575666	22569587	8000	22571666	-4000	4000	-2079
chr6	29082208	29090208	29087239	8000	29086208	-4000	4000	1031
chr6	31713918	31721918	31717719	8000	31717918	-4000	4000	-199
chr6	116928161	116936161	116928796	8000	116932161	-4000	4000	-3365
chr6	26236793	26244793	26240503	8000	26240793	-4000	4000	-290
chr6	31570324	31578324	31574010	8000	31574324	-4000	4000	-314
chr6	73413566	73421566	73416112	8000	73417566	-4000	4000	-1454
chr6	77456924	77464924	77462516	8000	77460924	-4000	4000	1592
chr6	73364555	73372555	73369757	8000	73368555	-4000	4000	1202
chr6	29349749	29357749	29355545	8000	29353749	-4000	4000	1796
chr6	166153656	166161656	166158365	8000	166157656	-4000	4000	709
chr6	167151247	167159247	167156994	8000	167155247	-4000	4000	1747
chr6	26016958	26024958	26020500	8000	26020958	-4000	4000	-458
chr6	26039227	26047227	26043295	8000	26043227	-4000	4000	68
chr6	26039227	26047227	26043376	8000	26043227	-4000	4000	149
chr6	26100337	26108337	26108090	8000	26104337	-4000	4000	3753
chr6	27867845	27875845	27872278	8000	27871845	-4000	4000	433
chr6	131695644	131703644	131701197	8000	131699644	-4000	4000	1553
chr6	11098489	11106489	11104061	8000	11102489	-4000	4000	1572
chr6	55278617	55286617	55282432	8000	55282617	-4000	4000	-185
chr6	83521704	83529704	83524426	8000	83525704	-4000	4000	-1278
chr6	26242611	26250611	26250438	8000	26246611	-4000	4000	3827
chr6	132613022	132621022	132617693	8000	132617022	-4000	4000	671
chr6	47718021	47726021	47718426	8000	47722021	-4000	4000	-3595
chr6	54386142	54394142	54389943	8000	54390142	-4000	4000	-199
chr6	42921838	42929838	42929618	8000	42925838	-4000	4000	3780
chr6	29394008	29402008	29397415	8000	29398008	-4000	4000	-593
chr6	27867845	27875845	27872240	8000	27871845	-4000	4000	395
chr6	97136754	97144754	97139454	8000	97140754	-4000	4000	-1300
chr6	27833880	27841880	27838123	8000	27837880	-4000	4000	243
chr6	10869223	10877223	10874237	8000	10873223	-4000	4000	1014
chr6	28256958	28264958	28260369	8000	28260958	-4000	4000	-589
chr6	132639312	132647312	132644988	8000	132643312	-4000	4000	1676
chr6	27803479	27811479	27807515	8000	27807479	-4000	4000	36
chr6	29482697	29490697	29486967	8000	29486697	-4000	4000	270
chr6	29482697	29490697	29487555	8000	29486697	-4000	4000	858
chr6	31570324	31578324	31573325	8000	31574324	-4000	4000	-999
chr6	152755765	152763765	152756193	8000	152759765	-4000	4000	-3572
chr6	28256958	28264958	28259356	8000	28260958	-4000	4000	-1602
chr6	75917114	75925114	75921679	8000	75921114	-4000	4000	565
chr6	116788085	116796085	116792886	8000	116792085	-4000	4000	801
chr6	35493874	35501874	35498299	8000	35497874	-4000	4000	425
chr6	52746087	52754087	52751636	8000	52750087	-4000	4000	1549
chr6	105153900	105161900	105161495	8000	105157900	-4000	4000	3595
chr6	105153900	105161900	105161873	8000	105157900	-4000	4000	3973
chr6	44274734	44282734	44282516	8000	44278734	-4000	4000	3782
chr6	116748197	116756197	116752496	8000	116752197	-4000	4000	299
chr6	114051596	114059596	114058011	8000	114055596	-4000	4000	2415
chr6	50769033	50777033	50772830	8000	50773033	-4000	4000	-203
chr6	105153900	105161900	105158377	8000	105157900	-4000	4000	477
chr6	41040337	41048337	41042678	8000	41044337	-4000	4000	-1659
chr6	27811489	27819489	27815152	8000	27815489	-4000	4000	-337
chr6	109976720	109984720	109980176	8000	109980720	-4000	4000	-544
chr6	29171811	29179811	29173844	8000	29175811	-4000	4000	-1967
chr6	52892639	52900639	52897846	8000	52896639	-4000	4000	1207
chr6	53122961	53130961	53128915	8000	53126961	-4000	4000	1954
chr6	110239940	110247940	110245971	8000	110243940	-4000	4000	2031
chr6	114051596	114059596	114057185	8000	114055596	-4000	4000	1589
chr6	114051596	114059596	114057511	8000	114055596	-4000	4000	1915
chr6	123212339	123220339	123218717	8000	123216339	-4000	4000	2378
chr6	131580332	131588332	131587666	8000	131584332	-4000	4000	3334
chr6	167312014	167320014	167315673	8000	167316014	-4000	4000	-341
chr6	10869223	10877223	10874372	8000	10873223	-4000	4000	1149
chr6	27143562	27151562	27146681	8000	27147562	-4000	4000	-881
chr6	39310698	39318698	39315300	8000	39314698	-4000	4000	602
chr6	27143562	27151562	27146802	8000	27147562	-4000	4000	-760
chr6	28165594	28173594	28166765	8000	28169594	-4000	4000	-2829
chr6	28427930	28435930	28434813	8000	28431930	-4000	4000	2883
chr6	29482697	29490697	29486958	8000	29486697	-4000	4000	261
chr6	11098489	11106489	11103746	8000	11102489	-4000	4000	1257
chr6	27803479	27811479	27807867	8000	27807479	-4000	4000	388
chr6	49601175	49609175	49605747	8000	49605175	-4000	4000	572
chr6	11098489	11106489	11104603	8000	11102489	-4000	4000	2114
chr6	41346889	41354889	41350758	8000	41350889	-4000	4000	-131
chr6	30950221	30958221	30951613	8000	30954221	-4000	4000	-2608
chr6	25722063	25730063	25726359	8000	25726063	-4000	4000	296
chr6	26184710	26192710	26188959	8000	26188710	-4000	4000	249
chr6	29482697	29490697	29487201	8000	29486697	-4000	4000	504
chr6	42921838	42929838	42923260	8000	42925838	-4000	4000	-2578
chr6	52827655	52835655	52831874	8000	52831655	-4000	4000	219
chr6	4045434	4053434	4049068	8000	4049434	-4000	4000	-366
chr6	42921838	42929838	42925505	8000	42925838	-4000	4000	-333
chr6	26039227	26047227	26043342	8000	26043227	-4000	4000	115
chr6	28256958	28264958	28259516	8000	28260958	-4000	4000	-1442
chr6	26029092	26037092	26031841	8000	26033092	-4000	4000	-1251
chr6	27833880	27841880	27838112	8000	27837880	-4000	4000	232
chr6	27861798	27869798	27865787	8000	27865798	-4000	4000	-11
chr6	28427930	28435930	28435469	8000	28431930	-4000	4000	3539
chr6	29586500	29594500	29588056	8000	29590500	-4000	4000	-2444
chr6	39310698	39318698	39316360	8000	39314698	-4000	4000	1662
chr6	146433601	146441601	146434593	8000	146437601	-4000	4000	-3008
chr6	25722063	25730063	25727222	8000	25726063	-4000	4000	1159
chr6	27861798	27869798	27865358	8000	27865798	-4000	4000	-440
chr6	27867845	27875845	27873203	8000	27871845	-4000	4000	1358
chr6	29082208	29090208	29087213	8000	29086208	-4000	4000	1005
chr6	29482697	29490697	29487407	8000	29486697	-4000	4000	710
chr6	167312014	167320014	167315455	8000	167316014	-4000	4000	-559
chr6	26269412	26277412	26271160	8000	26273412	-4000	4000	-2252
chr6	28256958	28264958	28259401	8000	28260958	-4000	4000	-1557
chr6	83521704	83529704	83523732	8000	83525704	-4000	4000	-1972
chr6	26269412	26277412	26271347	8000	26273412	-4000	4000	-2065
chr6	31526232	31534232	31532822	8000	31530232	-4000	4000	2590
chr6	50038099	50046099	50043635	8000	50042099	-4000	4000	1536
chr6	27803479	27811479	27807811	8000	27807479	-4000	4000	332
chr6	29394008	29402008	29396887	8000	29398008	-4000	4000	-1121
chr6	30950221	30958221	30951587	8000	30954221	-4000	4000	-2634
chr6	26242611	26250611	26246846	8000	26246611	-4000	4000	235
chr6	27954182	27962182	27957502	8000	27958182	-4000	4000	-680
chr6	27143562	27151562	27147262	8000	27147562	-4000	4000	-300
chr6	131580332	131588332	131582641	8000	131584332	-4000	4000	-1691
chr6	116928161	116936161	116928913	8000	116932161	-4000	4000	-3248
chr6	52827655	52835655	52831961	8000	52831655	-4000	4000	306
chr6	41060891	41068891	41067302	8000	41064891	-4000	4000	2411
chr6	61675961	61683961	61680182	8000	61679961	-4000	4000	221
chr6	26029092	26037092	26033212	8000	26033092	-4000	4000	120
chr6	27143562	27151562	27147138	8000	27147562	-4000	4000	-424
chr6	27143562	27151562	27147341	8000	27147562	-4000	4000	-221
chr6	117269565	117277565	117272464	8000	117273565	-4000	4000	-1101
chr6	29349749	29357749	29355668	8000	29353749	-4000	4000	1919
chr6	52186638	52194638	52189166	8000	52190638	-4000	4000	-1472
chr6	27833880	27841880	27838306	8000	27837880	-4000	4000	426
chr6	39310698	39318698	39314714	8000	39314698	-4000	4000	16
chr6	123212339	123220339	123218444	8000	123216339	-4000	4000	2105
chr6	27889891	27897891	27893026	8000	27893891	-4000	4000	-865
chr6	26039227	26047227	26043367	8000	26043227	-4000	4000	140
chr6	28256958	28264958	28259592	8000	28260958	-4000	4000	-1366
chr6	25722063	25730063	25726294	8000	25726063	-4000	4000	231
chr6	55278617	55286617	55282311	8000	55282617	-4000	4000	-306
chr6	41060891	41068891	41061755	8000	41064891	-4000	4000	-3136
chr6	26029092	26037092	26031908	8000	26033092	-4000	4000	-1184
chr6	132567359	132575359	132571317	8000	132571359	-4000	4000	-42
chr6	167151247	167159247	167157387	8000	167155247	-4000	4000	2140
chr6	26100337	26108337	26107621	8000	26104337	-4000	4000	3284
chr6	26269412	26277412	26271254	8000	26273412	-4000	4000	-2158
chr6	30985903	30993903	30986841	8000	30989903	-4000	4000	-3062
chr6	27803479	27811479	27807897	8000	27807479	-4000	4000	418
chr6	33790673	33798673	33794773	8000	33794673	-4000	4000	100
chr6	105079332	105087332	105082061	8000	105083332	-4000	4000	-1271
chr6	27833880	27841880	27838745	8000	27837880	-4000	4000	865
chr6	11098489	11106489	11105371	8000	11102489	-4000	4000	2882
chr6	42177338	42185338	42178809	8000	42181338	-4000	4000	-2529
chr6	73360171	73368171	73363253	8000	73364171	-4000	4000	-918
chr6	27803479	27811479	27808591	8000	27807479	-4000	4000	1112
chr6	132584592	132592592	132588896	8000	132588592	-4000	4000	304
chr6	29171811	29179811	29174343	8000	29175811	-4000	4000	-1468
chr6	27954182	27962182	27957795	8000	27958182	-4000	4000	-387
chr6	4045434	4053434	4047185	8000	4049434	-4000	4000	-2249
chr6	25722063	25730063	25726116	8000	25726063	-4000	4000	53
chr6	26016958	26024958	26022039	8000	26020958	-4000	4000	1081
chr6	26022896	26030896	26027030	8000	26026896	-4000	4000	134
chr6	26039227	26047227	26045417	8000	26043227	-4000	4000	2190
chr6	26242611	26250611	26250287	8000	26246611	-4000	4000	3676
chr6	26246142	26254142	26251879	8000	26250142	-4000	4000	1737
chr6	27143562	27151562	27147225	8000	27147562	-4000	4000	-337
chr6	27803479	27811479	27810226	8000	27807479	-4000	4000	2747
chr6	27811489	27819489	27814343	8000	27815489	-4000	4000	-1146
chr6	27889891	27897891	27893616	8000	27893891	-4000	4000	-275
chr6	29171811	29179811	29173994	8000	29175811	-4000	4000	-1817
chr6	29482697	29490697	29487220	8000	29486697	-4000	4000	523
chr6	30950221	30958221	30951032	8000	30954221	-4000	4000	-3189
chr6	33717662	33725662	33722905	8000	33721662	-4000	4000	1243
chr6	44274734	44282734	44282526	8000	44278734	-4000	4000	3792
chr6	87012679	87020679	87016145	8000	87016679	-4000	4000	-534
chr6	131580332	131588332	131587608	8000	131584332	-4000	4000	3276
chr6	132639312	132647312	132645083	8000	132643312	-4000	4000	1771
chr6	137488199	137496199	137493701	8000	137492199	-4000	4000	1502
chr6	132639312	132647312	132645048	8000	132643312	-4000	4000	1736
chr6	27907185	27915185	27911610	8000	27911185	-4000	4000	425
chr6	26236793	26244793	26240571	8000	26240793	-4000	4000	-222
chr6	132567359	132575359	132571239	8000	132571359	-4000	4000	-120
chr6	83853515	83861515	83859848	8000	83857515	-4000	4000	2333
chr6	52232681	52240681	52238911	8000	52236681	-4000	4000	2230
chr6	27954182	27962182	27957336	8000	27958182	-4000	4000	-846
chr6	132535336	132543336	132538497	8000	132539336	-4000	4000	-839
chr6	167312014	167320014	167315532	8000	167316014	-4000	4000	-482
chr6	25722063	25730063	25727082	8000	25726063	-4000	4000	1019
chr6	25777199	25785199	25779196	8000	25781199	-4000	4000	-2003
chr6	28499296	28507296	28505718	8000	28503296	-4000	4000	2422
chr6	29436977	29444977	29440063	8000	29440977	-4000	4000	-914
chr6	30950221	30958221	30951912	8000	30954221	-4000	4000	-2309
chr6	36311761	36319761	36319393	8000	36315761	-4000	4000	3632
chr6	40387591	40395591	40392054	8000	40391591	-4000	4000	463
chr6	41185749	41193749	41192832	8000	41189749	-4000	4000	3083
chr6	50038099	50046099	50043739	8000	50042099	-4000	4000	1640
chr6	52232681	52240681	52236897	8000	52236681	-4000	4000	216
chr6	53122961	53130961	53128250	8000	53126961	-4000	4000	1289
chr6	53122961	53130961	53128344	8000	53126961	-4000	4000	1383
chr6	83521704	83529704	83524629	8000	83525704	-4000	4000	-1075
chr6	105153900	105161900	105161769	8000	105157900	-4000	4000	3869
chr6	108184805	108192805	108187603	8000	108188805	-4000	4000	-1202
chr6	114051596	114059596	114057529	8000	114055596	-4000	4000	1933
chr6	116748197	116756197	116752592	8000	116752197	-4000	4000	395
chr6	127587820	127595820	127590223	8000	127591820	-4000	4000	-1597
chr6	131580332	131588332	131583374	8000	131584332	-4000	4000	-958
chr6	132613022	132621022	132617161	8000	132617022	-4000	4000	139
chr6	132613022	132621022	132617996	8000	132617022	-4000	4000	974
chr6	132639312	132647312	132645602	8000	132643312	-4000	4000	2290
chr6	137488199	137496199	137493688	8000	137492199	-4000	4000	1489
chr6	28256958	28264958	28260448	8000	28260958	-4000	4000	-510
chr6	31160337	31168337	31166025	8000	31164337	-4000	4000	1688
chr6	41346889	41354889	41350797	8000	41350889	-4000	4000	-92
chr6	42177338	42185338	42184760	8000	42181338	-4000	4000	3422
chr6	27143562	27151562	27146837	8000	27147562	-4000	4000	-725
chr6	42177338	42185338	42179312	8000	42181338	-4000	4000	-2026
chr6	118313676	118321676	118314085	8000	118317676	-4000	4000	-3591
chr6	49964677	49972677	49968804	8000	49968677	-4000	4000	127
chr6	10869223	10877223	10874319	8000	10873223	-4000	4000	1096
chr6	27861798	27869798	27867101	8000	27865798	-4000	4000	1303
chr6	27889891	27897891	27893732	8000	27893891	-4000	4000	-159
chr6	27833880	27841880	27837976	8000	27837880	-4000	4000	96
chr6	52232681	52240681	52236930	8000	52236681	-4000	4000	249
chr6	26029092	26037092	26031841	8000	26033092	-4000	4000	-1251
chr6	44274734	44282734	44282416	8000	44278734	-4000	4000	3682
chr6	26039227	26047227	26045498	8000	26043227	-4000	4000	2271
chr6	10869223	10877223	10874475	8000	10873223	-4000	4000	1252
chr6	29082208	29090208	29086325	8000	29086208	-4000	4000	117
chr6	167312014	167320014	167315297	8000	167316014	-4000	4000	-717
chr6	138900070	138908070	138900945	8000	138904070	-4000	4000	-3125
chr6	28530955	28538955	28533990	8000	28534955	-4000	4000	-965
chr6	26242611	26250611	26250433	8000	26246611	-4000	4000	3822
chr6	50038099	50046099	50043667	8000	50042099	-4000	4000	1568
chr6	116928161	116936161	116931372	8000	116932161	-4000	4000	-789
chr6	27143562	27151562	27147470	8000	27147562	-4000	4000	-92
chr6	10869223	10877223	10876510	8000	10873223	-4000	4000	3287
chr6	49956249	49964249	49960423	8000	49960249	-4000	4000	174
chr6	35790982	35798982	35797238	8000	35794982	-4000	4000	2256
chr6	89250464	89258464	89257921	8000	89254464	-4000	4000	3457
chr6	49964677	49972677	49969620	8000	49968677	-4000	4000	943
chr6	28499296	28507296	28504247	8000	28503296	-4000	4000	951
chr6	36386551	36394551	36387566	8000	36390551	-4000	4000	-2985
chr6	43301538	43309538	43302331	8000	43305538	-4000	4000	-3207
chr6	43301538	43309538	43302332	8000	43305538	-4000	4000	-3206
chr6	26029092	26037092	26031751	8000	26033092	-4000	4000	-1341
chr6	27861798	27869798	27865668	8000	27865798	-4000	4000	-130
chr6	29082208	29090208	29087288	8000	29086208	-4000	4000	1080
chr6	31584895	31592895	31587308	8000	31588895	-4000	4000	-1587
chr6	31713918	31721918	31720182	8000	31717918	-4000	4000	2264
chr6	39310698	39318698	39316876	8000	39314698	-4000	4000	2178
chr6	87012679	87020679	87015945	8000	87016679	-4000	4000	-734
chr6	97136754	97144754	97139481	8000	97140754	-4000	4000	-1273
chr6	132535336	132543336	132538487	8000	132539336	-4000	4000	-849
chr6	137488199	137496199	137493850	8000	137492199	-4000	4000	1651
chr6	27867845	27875845	27871866	8000	27871845	-4000	4000	21
chr6	29436977	29444977	29440648	8000	29440977	-4000	4000	-329
chr6	26022896	26030896	26027096	8000	26026896	-4000	4000	200
chr6	131695644	131703644	131700573	8000	131699644	-4000	4000	929
chr6	116928161	116936161	116931723	8000	116932161	-4000	4000	-438
chr6	55278617	55286617	55280432	8000	55282617	-4000	4000	-2185
chr6	32389339	32397339	32394882	8000	32393339	-4000	4000	1543
chr6	30950221	30958221	30951021	8000	30954221	-4000	4000	-3200
chr6	11098489	11106489	11104234	8000	11102489	-4000	4000	1745
chr6	26236793	26244793	26240622	8000	26240793	-4000	4000	-171
chr6	73360171	73368171	73362871	8000	73364171	-4000	4000	-1300
chr6	27889891	27897891	27893024	8000	27893891	-4000	4000	-867
chr6	77456924	77464924	77462600	8000	77460924	-4000	4000	1676
chr6	31722714	31730714	31723649	8000	31726714	-4000	4000	-3065
chr6	35745079	35753079	35747307	8000	35749079	-4000	4000	-1772
chr6	26100337	26108337	26104007	8000	26104337	-4000	4000	-330
chr6	124821640	124829640	124824976	8000	124825640	-4000	4000	-664
chr6	27811489	27819489	27814609	8000	27815489	-4000	4000	-880
chr6	132584592	132592592	132589161	8000	132588592	-4000	4000	569
chr6	27861798	27869798	27867416	8000	27865798	-4000	4000	1618
chr6	131695644	131703644	131700988	8000	131699644	-4000	4000	1344
chr6	99914519	99922519	99920896	8000	99918519	-4000	4000	2377
chr6	27833880	27841880	27837957	8000	27837880	-4000	4000	77
chr6	55278617	55286617	55282503	8000	55282617	-4000	4000	-114
chr6	132613022	132621022	132618014	8000	132617022	-4000	4000	992
chr6	52232681	52240681	52236745	8000	52236681	-4000	4000	64
chr6	29668372	29676372	29673306	8000	29672372	-4000	4000	934
chr6	83853515	83861515	83859733	8000	83857515	-4000	4000	2218
chr6	35114071	35122071	35118291	8000	35118071	-4000	4000	220
chr6	132549721	132557721	132553486	8000	132553721	-4000	4000	-235
chr6	132567359	132575359	132570712	8000	132571359	-4000	4000	-647
chr6	42921838	42929838	42924255	8000	42925838	-4000	4000	-1583
chr6	123212339	123220339	123218710	8000	123216339	-4000	4000	2371
chr6	109976720	109984720	109979627	8000	109980720	-4000	4000	-1093
chr6	10869223	10877223	10874750	8000	10873223	-4000	4000	1527
chr6	73360171	73368171	73362681	8000	73364171	-4000	4000	-1490
chr6	27803479	27811479	27808542	8000	27807479	-4000	4000	1063
chr6	131580332	131588332	131587798	8000	131584332	-4000	4000	3466
chr6	29482697	29490697	29487270	8000	29486697	-4000	4000	573
chr6	29482697	29490697	29487416	8000	29486697	-4000	4000	719
chr6	46835778	46843778	46839091	8000	46839778	-4000	4000	-687
chr6	49781660	49789660	49787275	8000	49785660	-4000	4000	1615
chr6	114051596	114059596	114057845	8000	114055596	-4000	4000	2249
chr6	105153900	105161900	105161527	8000	105157900	-4000	4000	3627
chr6	36309955	36317955	36317310	8000	36313955	-4000	4000	3355
chr6	26269412	26277412	26270991	8000	26273412	-4000	4000	-2421
chr6	52232681	52240681	52236945	8000	52236681	-4000	4000	264
chr6	30985903	30993903	30986757	8000	30989903	-4000	4000	-3146
chr6	42692598	42700598	42698397	8000	42696598	-4000	4000	1799
chr6	26269412	26277412	26273059	8000	26273412	-4000	4000	-353
chr6	27867845	27875845	27873256	8000	27871845	-4000	4000	1411
chr6	36386551	36394551	36391740	8000	36390551	-4000	4000	1189
chr6	77456924	77464924	77462870	8000	77460924	-4000	4000	1946
chr6	160154718	160162718	160158653	8000	160158718	-4000	4000	-65
chr6	49524078	49532078	49526701	8000	49528078	-4000	4000	-1377
chr6	43301538	43309538	43301640	8000	43305538	-4000	4000	-3898
chr6	149912878	149920878	149918197	8000	149916878	-4000	4000	1319
chr6	22567666	22575666	22569774	8000	22571666	-4000	4000	-1892
chr6	26029092	26037092	26031728	8000	26033092	-4000	4000	-1364
chr6	26039227	26047227	26043441	8000	26043227	-4000	4000	214
chr6	26100337	26108337	26107621	8000	26104337	-4000	4000	3284
chr6	27803479	27811479	27808438	8000	27807479	-4000	4000	959
chr6	30950221	30958221	30953313	8000	30954221	-4000	4000	-908
chr6	40387591	40395591	40392862	8000	40391591	-4000	4000	1271
chr6	77456924	77464924	77462892	8000	77460924	-4000	4000	1968
chr6	99611578	99619578	99613052	8000	99615578	-4000	4000	-2526
chr6	109976720	109984720	109980276	8000	109980720	-4000	4000	-444
chr6	132613022	132621022	132617570	8000	132617022	-4000	4000	548
chr6	30985903	30993903	30986574	8000	30989903	-4000	4000	-3329
chr6	27143562	27151562	27146792	8000	27147562	-4000	4000	-770
chr6	26029092	26037092	26031887	8000	26033092	-4000	4000	-1205
chr6	27143562	27151562	27146601	8000	27147562	-4000	4000	-961
chr6	27833880	27841880	27838278	8000	27837880	-4000	4000	398
chr6	33717662	33725662	33723156	8000	33721662	-4000	4000	1494
chr6	35790982	35798982	35795147	8000	35794982	-4000	4000	165
chr6	105153900	105161900	105159752	8000	105157900	-4000	4000	1852
chr6	105153900	105161900	105161834	8000	105157900	-4000	4000	3934
chr6	117269565	117277565	117272549	8000	117273565	-4000	4000	-1016
chr6	27833880	27841880	27838154	8000	27837880	-4000	4000	274
chr7	122990704	122998704	122994804	8000	122994704	-4000	4000	100
chr7	48923454	48931454	48925007	8000	48927454	-4000	4000	-2447
chr7	141832300	141840300	141837998	8000	141836300	-4000	4000	1698
chr7	53032925	53040925	53036147	8000	53036925	-4000	4000	-778
chr7	98211457	98219457	98218028	8000	98215457	-4000	4000	2571
chr7	15196317	15204317	15201188	8000	15200317	-4000	4000	871
chr7	14141049	14149049	14148367	8000	14145049	-4000	4000	3318
chr7	73861890	73869890	73865318	8000	73865890	-4000	4000	-572
chr7	144004793	144012793	144004845	8000	144008793	-4000	4000	-3948
chr7	25220570	25228570	25225076	8000	25224570	-4000	4000	506
chr7	93907265	93915265	93911026	8000	93911265	-4000	4000	-239
chr7	143474796	143482796	143478098	8000	143478796	-4000	4000	-698
chr7	100597117	100605117	100600661	8000	100601117	-4000	4000	-456
chr7	122990704	122998704	122995599	8000	122994704	-4000	4000	895
chr7	144106539	144114539	144110245	8000	144110539	-4000	4000	-294
chr7	15196317	15204317	15201155	8000	15200317	-4000	4000	838
chr7	44006124	44014124	44007200	8000	44010124	-4000	4000	-2924
chr7	86860879	86868879	86864306	8000	86864879	-4000	4000	-573
chr7	89334528	89342528	89335529	8000	89338528	-4000	4000	-2999
chr7	31704455	31712455	31707414	8000	31708455	-4000	4000	-1041
chr7	20778279	20786279	20784695	8000	20782279	-4000	4000	2416
chr7	101191007	101199007	101196060	8000	101195007	-4000	4000	1053
chr7	88790106	88798106	88794284	8000	88794106	-4000	4000	178
chr7	101191007	101199007	101198292	8000	101195007	-4000	4000	3285
chr7	20778279	20786279	20784662	8000	20782279	-4000	4000	2383
chr7	48923454	48931454	48925877	8000	48927454	-4000	4000	-1577
chr7	123109531	123117531	123117513	8000	123113531	-4000	4000	3982
chr7	113872777	113880777	113878040	8000	113876777	-4000	4000	1263
chr7	107471684	107479684	107474808	8000	107475684	-4000	4000	-876
chr7	73861890	73869890	73865598	8000	73865890	-4000	4000	-292
chr7	113872777	113880777	113879151	8000	113876777	-4000	4000	2374
chr7	99752960	99760960	99760864	8000	99756960	-4000	4000	3904
chr7	113872777	113880777	113879652	8000	113876777	-4000	4000	2875
chr7	113872777	113880777	113879956	8000	113876777	-4000	4000	3179
chr7	113872777	113880777	113880027	8000	113876777	-4000	4000	3250
chr7	73861890	73869890	73865806	8000	73865890	-4000	4000	-84
chr7	48923454	48931454	48925160	8000	48927454	-4000	4000	-2294
chr7	31333465	31341465	31339038	8000	31337465	-4000	4000	1573
chr7	143932186	143940186	143936003	8000	143936186	-4000	4000	-183
chr7	64262931	64270931	64266189	8000	64266931	-4000	4000	-742
chr7	4901989	4909989	4909977	8000	4905989	-4000	4000	3988
chr7	100639097	100647097	100646801	8000	100643097	-4000	4000	3704
chr7	123660290	123668290	123662289	8000	123664290	-4000	4000	-2001
chr7	18022770	18030770	18027637	8000	18026770	-4000	4000	867
chr7	53032925	53040925	53036419	8000	53036925	-4000	4000	-506
chr7	75500316	75508316	75503126	8000	75504316	-4000	4000	-1190
chr7	143049282	143057282	143053257	8000	143053282	-4000	4000	-25
chr7	143932186	143940186	143935640	8000	143936186	-4000	4000	-546
chr7	77046391	77054391	77052981	8000	77050391	-4000	4000	2590
chr7	44139213	44147213	44145765	8000	44143213	-4000	4000	2552
chr7	128768485	128776485	128774616	8000	128772485	-4000	4000	2131
chr7	123873481	123881481	123877274	8000	123877481	-4000	4000	-207
chr7	4901989	4909989	4907307	8000	4905989	-4000	4000	1318
chr7	97007040	97015040	97007699	8000	97011040	-4000	4000	-3341
chr7	142936868	142944868	142944394	8000	142940868	-4000	4000	3526
chr7	124472955	124480955	124476711	8000	124476955	-4000	4000	-244
chr7	30647942	30655942	30655716	8000	30651942	-4000	4000	3774
chr7	101191007	101199007	101195927	8000	101195007	-4000	4000	920
chr7	144393240	144401240	144400265	8000	144397240	-4000	4000	3025
chr7	152015929	152023929	152019661	8000	152019929	-4000	4000	-268
chr7	100639097	100647097	100640975	8000	100643097	-4000	4000	-2122
chr7	142248143	142256143	142255630	8000	142252143	-4000	4000	3487
chr7	73861890	73869890	73865172	8000	73865890	-4000	4000	-718
chr7	19715315	19723315	19722096	8000	19719315	-4000	4000	2781
chr7	27096354	27104354	27100847	8000	27100354	-4000	4000	493
chr7	88790106	88798106	88794327	8000	88794106	-4000	4000	221
chr7	1233326	1241326	1235864	8000	1237326	-4000	4000	-1462
chr7	130384114	130392114	130385903	8000	130388114	-4000	4000	-2211
chr7	53032925	53040925	53035791	8000	53036925	-4000	4000	-1134
chr7	123635481	123643481	123637423	8000	123639481	-4000	4000	-2058
chr7	86860879	86868879	86864286	8000	86864879	-4000	4000	-593
chr7	95293676	95301676	95298807	8000	95297676	-4000	4000	1131
chr7	48923454	48931454	48925208	8000	48927454	-4000	4000	-2246
chr7	48923454	48931454	48925547	8000	48927454	-4000	4000	-1907
chr7	92464380	92472380	92470317	8000	92468380	-4000	4000	1937
chr7	123660290	123668290	123663032	8000	123664290	-4000	4000	-1258
chr7	127606292	127614292	127613829	8000	127610292	-4000	4000	3537
chr7	113872777	113880777	113877592	8000	113876777	-4000	4000	815
chr7	30647942	30655942	30653367	8000	30651942	-4000	4000	1425
chr7	141787367	141795367	141791291	8000	141791367	-4000	4000	-76
chr7	19140782	19148782	19145320	8000	19144782	-4000	4000	538
chr7	48923454	48931454	48924911	8000	48927454	-4000	4000	-2543
chr7	124472955	124480955	124476376	8000	124476955	-4000	4000	-579
chr7	123660290	123668290	123663842	8000	123664290	-4000	4000	-448
chr7	27088993	27096993	27095724	8000	27092993	-4000	4000	2731
chr7	27189503	27197503	27196970	8000	27193503	-4000	4000	3467
chr7	100597117	100605117	100603943	8000	100601117	-4000	4000	2826
chr7	144127188	144135188	144129157	8000	144131188	-4000	4000	-2031
chr7	75500316	75508316	75501384	8000	75504316	-4000	4000	-2932
chr7	86860879	86868879	86864615	8000	86864879	-4000	4000	-264
chr7	100639097	100647097	100641483	8000	100643097	-4000	4000	-1614
chr7	57113676	57121676	57119968	8000	57117676	-4000	4000	2292
chr7	1233326	1241326	1233633	8000	1237326	-4000	4000	-3693
chr7	57469559	57477559	57470415	8000	57473559	-4000	4000	-3144
chr7	101054859	101062859	101058031	8000	101058859	-4000	4000	-828
chr7	128768485	128776485	128775459	8000	128772485	-4000	4000	2974
chr7	92464380	92472380	92468892	8000	92468380	-4000	4000	512
chr7	31333465	31341465	31339141	8000	31337465	-4000	4000	1676
chr7	31333465	31341465	31339285	8000	31337465	-4000	4000	1820
chr7	143219079	143227079	143222214	8000	143223079	-4000	4000	-865
chr7	144094953	144102953	144096016	8000	144098953	-4000	4000	-2937
chr7	122990704	122998704	122994995	8000	122994704	-4000	4000	291
chr7	101014939	101022939	101018635	8000	101018939	-4000	4000	-304
chr7	73861890	73869890	73865262	8000	73865890	-4000	4000	-628
chr7	141968631	141976631	141973390	8000	141972631	-4000	4000	759
chr7	143474796	143482796	143478580	8000	143478796	-4000	4000	-216
chr7	152015929	152023929	152019701	8000	152019929	-4000	4000	-228
chr7	93907265	93915265	93909648	8000	93911265	-4000	4000	-1617
chr7	27088993	27096993	27095330	8000	27092993	-4000	4000	2337
chr7	50155256	50163256	50159186	8000	50159256	-4000	4000	-70
chr7	88790106	88798106	88794855	8000	88794106	-4000	4000	749
chr7	154890285	154898285	154892812	8000	154894285	-4000	4000	-1473
chr7	128346325	128354325	128350903	8000	128350325	-4000	4000	578
chr7	53032925	53040925	53036530	8000	53036925	-4000	4000	-395
chr7	35198430	35206430	35202642	8000	35202430	-4000	4000	212
chr7	31333465	31341465	31338553	8000	31337465	-4000	4000	1088
chr7	44006124	44014124	44007742	8000	44010124	-4000	4000	-2382
chr7	122990704	122998704	122994953	8000	122994704	-4000	4000	249
chr7	144106539	144114539	144109752	8000	144110539	-4000	4000	-787
chr7	35198430	35206430	35202690	8000	35202430	-4000	4000	260
chr7	48923454	48931454	48924975	8000	48927454	-4000	4000	-2479
chr7	18022770	18030770	18027659	8000	18026770	-4000	4000	889
chr7	123873481	123881481	123876790	8000	123877481	-4000	4000	-691
chr7	130726697	130734697	130732961	8000	130730697	-4000	4000	2264
chr7	124026921	124034921	124032773	8000	124030921	-4000	4000	1852
chr7	31333465	31341465	31339045	8000	31337465	-4000	4000	1580
chr7	101166496	101174496	101174428	8000	101170496	-4000	4000	3932
chr7	75806825	75814825	75813338	8000	75810825	-4000	4000	2513
chr7	89334528	89342528	89335619	8000	89338528	-4000	4000	-2909
chr7	130212844	130220844	130216379	8000	130216844	-4000	4000	-465
chr7	130384114	130392114	130387858	8000	130388114	-4000	4000	-256
chr7	142904101	142912101	142908627	8000	142908101	-4000	4000	526
chr7	100597117	100605117	100600800	8000	100601117	-4000	4000	-317
chr7	2470728	2478728	2475680	8000	2474728	-4000	4000	952
chr7	31333465	31341465	31338307	8000	31337465	-4000	4000	842
chr7	73861890	73869890	73865250	8000	73865890	-4000	4000	-640
chr7	141727271	141735271	141727342	8000	141731271	-4000	4000	-3929
chr7	141832300	141840300	141838068	8000	141836300	-4000	4000	1768
chr7	44139213	44147213	44145565	8000	44143213	-4000	4000	2352
chr7	142663718	142671718	142671199	8000	142667718	-4000	4000	3481
chr7	127606292	127614292	127613778	8000	127610292	-4000	4000	3486
chr7	14141049	14149049	14148318	8000	14145049	-4000	4000	3269
chr7	101191007	101199007	101195962	8000	101195007	-4000	4000	955
chr7	144393240	144401240	144400234	8000	144397240	-4000	4000	2994
chr7	88790106	88798106	88794266	8000	88794106	-4000	4000	160
chr7	144094953	144102953	144095537	8000	144098953	-4000	4000	-3416
chr7	48923454	48931454	48924887	8000	48927454	-4000	4000	-2567
chr7	18022770	18030770	18027324	8000	18026770	-4000	4000	554
chr7	113872777	113880777	113877723	8000	113876777	-4000	4000	946
chr7	144071870	144079870	144074795	8000	144075870	-4000	4000	-1075
chr7	31333465	31341465	31337482	8000	31337465	-4000	4000	17
chr7	44139213	44147213	44145090	8000	44143213	-4000	4000	1877
chr7	100793797	100801797	100797739	8000	100797797	-4000	4000	-58
chr7	143022200	143030200	143026856	8000	143026200	-4000	4000	656
chr7	124472955	124480955	124476433	8000	124476955	-4000	4000	-522
chr7	25220570	25228570	25225052	8000	25224570	-4000	4000	482
chr7	31333465	31341465	31339201	8000	31337465	-4000	4000	1736
chr7	93907265	93915265	93910763	8000	93911265	-4000	4000	-502
chr7	89334528	89342528	89335903	8000	89338528	-4000	4000	-2625
chr7	27096354	27104354	27102120	8000	27100354	-4000	4000	1766
chr7	113872777	113880777	113879051	8000	113876777	-4000	4000	2274
chr7	144094953	144102953	144095328	8000	144098953	-4000	4000	-3625
chr7	155083392	155091392	155084601	8000	155087392	-4000	4000	-2791
chr7	144127188	144135188	144129830	8000	144131188	-4000	4000	-1358
chr7	122990704	122998704	122994783	8000	122994704	-4000	4000	79
chr7	130384114	130392114	130385882	8000	130388114	-4000	4000	-2232
chr7	143440409	143448409	143444304	8000	143444409	-4000	4000	-105
chr7	100639097	100647097	100641209	8000	100643097	-4000	4000	-1888
chr7	128768485	128776485	128769217	8000	128772485	-4000	4000	-3268
chr7	126434598	126442598	126439126	8000	126438598	-4000	4000	528
chr7	57113676	57121676	57119862	8000	57117676	-4000	4000	2186
chr7	19140782	19148782	19145038	8000	19144782	-4000	4000	256
chr7	89334528	89342528	89336307	8000	89338528	-4000	4000	-2221
chr7	97980684	97988684	97987082	8000	97984684	-4000	4000	2398
chr7	985640	993640	988630	8000	989640	-4000	4000	-1010
chr7	128768485	128776485	128775083	8000	128772485	-4000	4000	2598
chr7	1233326	1241326	1233651	8000	1237326	-4000	4000	-3675
chr7	1233326	1241326	1233652	8000	1237326	-4000	4000	-3674
chr7	73308536	73316536	73313147	8000	73312536	-4000	4000	611
chr7	6032552	6040552	6037525	8000	6036552	-4000	4000	973
chr7	88790106	88798106	88794718	8000	88794106	-4000	4000	612
chr7	107471684	107479684	107474044	8000	107475684	-4000	4000	-1640
chr7	44006124	44014124	44007648	8000	44010124	-4000	4000	-2476
chr7	93420486	93428486	93426216	8000	93424486	-4000	4000	1730
chr7	108019548	108027548	108023840	8000	108023548	-4000	4000	292
chr7	95293676	95301676	95298939	8000	95297676	-4000	4000	1263
chr7	44139213	44147213	44140739	8000	44143213	-4000	4000	-2474
chr7	89334528	89342528	89335312	8000	89338528	-4000	4000	-3216
chr7	113872777	113880777	113879588	8000	113876777	-4000	4000	2811
chr7	141787367	141795367	141790569	8000	141791367	-4000	4000	-798
chr7	57113676	57121676	57120612	8000	57117676	-4000	4000	2936
chr7	141832300	141840300	141838040	8000	141836300	-4000	4000	1740
chr7	124026921	124034921	124032158	8000	124030921	-4000	4000	1237
chr7	142904101	142912101	142908496	8000	142908101	-4000	4000	395
chr7	6492778	6500778	6498174	8000	6496778	-4000	4000	1396
chr7	27159535	27167535	27164938	8000	27163535	-4000	4000	1403
chr7	31333465	31341465	31338616	8000	31337465	-4000	4000	1151
chr7	48923454	48931454	48925480	8000	48927454	-4000	4000	-1974
chr7	57113676	57121676	57120420	8000	57117676	-4000	4000	2744
chr7	64262931	64270931	64266253	8000	64266931	-4000	4000	-678
chr7	93420486	93428486	93426502	8000	93424486	-4000	4000	2016
chr7	104904561	104912561	104906249	8000	104908561	-4000	4000	-2312
chr7	107471684	107479684	107474987	8000	107475684	-4000	4000	-697
chr7	113872777	113880777	113879315	8000	113876777	-4000	4000	2538
chr7	122990704	122998704	122995468	8000	122994704	-4000	4000	764
chr7	130726697	130734697	130733404	8000	130730697	-4000	4000	2707
chr7	141787367	141795367	141790880	8000	141791367	-4000	4000	-487
chr7	142936868	142944868	142941216	8000	142940868	-4000	4000	348
chr7	143049282	143057282	143052637	8000	143053282	-4000	4000	-645
chr7	143219079	143227079	143222332	8000	143223079	-4000	4000	-747
chr7	144094953	144102953	144095707	8000	144098953	-4000	4000	-3246
chr7	107471684	107479684	107474408	8000	107475684	-4000	4000	-1276
chr7	141832300	141840300	141837189	8000	141836300	-4000	4000	889
chr7	4901989	4909989	4907384	8000	4905989	-4000	4000	1395
chr7	47983148	47991148	47987235	8000	47987148	-4000	4000	87
chr7	97980684	97988684	97984884	8000	97984684	-4000	4000	200
chr7	142248143	142256143	142252170	8000	142252143	-4000	4000	27
chr7	130212844	130220844	130216318	8000	130216844	-4000	4000	-526
chr7	75765533	75773533	75769624	8000	75769533	-4000	4000	91
chr7	141787367	141795367	141790497	8000	141791367	-4000	4000	-870
chr7	5882363	5890363	5886095	8000	5886363	-4000	4000	-268
chr7	19715315	19723315	19722072	8000	19719315	-4000	4000	2757
chr7	72955485	72963485	72960203	8000	72959485	-4000	4000	718
chr7	75765533	75773533	75771981	8000	75769533	-4000	4000	2448
chr7	121337104	121345104	121339219	8000	121341104	-4000	4000	-1885
chr7	142663718	142671718	142670986	8000	142667718	-4000	4000	3268
chr7	143022200	143030200	143026971	8000	143026200	-4000	4000	771
chr7	144393240	144401240	144400260	8000	144397240	-4000	4000	3020
chr7	100639097	100647097	100641558	8000	100643097	-4000	4000	-1539
chr7	100719700	100727700	100723052	8000	100723700	-4000	4000	-648
chr7	128768485	128776485	128775718	8000	128772485	-4000	4000	3233
chr7	72955485	72963485	72960135	8000	72959485	-4000	4000	650
chr7	57113676	57121676	57121054	8000	57117676	-4000	4000	3378
chr7	57469559	57477559	57469660	8000	57473559	-4000	4000	-3899
chr7	141832300	141840300	141836304	8000	141836300	-4000	4000	4
chr7	141968631	141976631	141973270	8000	141972631	-4000	4000	639
chr7	143049282	143057282	143052685	8000	143053282	-4000	4000	-597
chr7	108019548	108027548	108023952	8000	108023548	-4000	4000	404
chr7	142248143	142256143	142252491	8000	142252143	-4000	4000	348
chr7	97007040	97015040	97009891	8000	97011040	-4000	4000	-1149
chr7	50155256	50163256	50159251	8000	50159256	-4000	4000	-5
chr7	19140782	19148782	19145516	8000	19144782	-4000	4000	734
chr7	127606292	127614292	127611132	8000	127610292	-4000	4000	840
chr7	122990704	122998704	122994793	8000	122994704	-4000	4000	89
chr7	100639097	100647097	100643215	8000	100643097	-4000	4000	118
chr7	27096354	27104354	27100803	8000	27100354	-4000	4000	449
chr7	101191007	101199007	101198733	8000	101195007	-4000	4000	3726
chr7	27088993	27096993	27095331	8000	27092993	-4000	4000	2338
chr7	144106539	144114539	144110195	8000	144110539	-4000	4000	-344
chr7	19140782	19148782	19145084	8000	19144782	-4000	4000	302
chr7	138114305	138122305	138116737	8000	138118305	-4000	4000	-1568
chr7	97007040	97015040	97009959	8000	97011040	-4000	4000	-1081
chr7	144393240	144401240	144399032	8000	144397240	-4000	4000	1792
chr7	19140782	19148782	19145162	8000	19144782	-4000	4000	380
chr7	24287862	24295862	24291664	8000	24291862	-4000	4000	-198
chr7	128768485	128776485	128775458	8000	128772485	-4000	4000	2973
chr7	4901989	4909989	4907501	8000	4905989	-4000	4000	1512
chr7	44139213	44147213	44145135	8000	44143213	-4000	4000	1922
chr7	6032552	6040552	6038563	8000	6036552	-4000	4000	2011
chr7	100597117	100605117	100603910	8000	100601117	-4000	4000	2793
chr7	117359222	117367222	117363712	8000	117363222	-4000	4000	490
chr7	151144009	151152009	151149117	8000	151148009	-4000	4000	1108
chr7	75806825	75814825	75813320	8000	75810825	-4000	4000	2495
chr7	57113676	57121676	57119945	8000	57117676	-4000	4000	2269
chr7	142936868	142944868	142939738	8000	142940868	-4000	4000	-1130
chr7	155460831	155468831	155462660	8000	155464831	-4000	4000	-2171
chr7	93907265	93915265	93910785	8000	93911265	-4000	4000	-480
chr7	113872777	113880777	113877717	8000	113876777	-4000	4000	940
chr7	152015929	152023929	152019775	8000	152019929	-4000	4000	-154
chr8	10602349	10610349	10609094	8000	10606349	-4000	4000	2745
chr8	22044809	22052809	22046182	8000	22048809	-4000	4000	-2627
chr8	81689631	81697631	81694541	8000	81693631	-4000	4000	910
chr8	144348219	144356219	144355625	8000	144352219	-4000	4000	3406
chr8	142912506	142920506	142915070	8000	142916506	-4000	4000	-1436
chr8	72934349	72942349	72936241	8000	72938349	-4000	4000	-2108
chr8	87866747	87874747	87873014	8000	87870747	-4000	4000	2267
chr8	87866747	87874747	87873859	8000	87870747	-4000	4000	3112
chr8	142868356	142876356	142875848	8000	142872356	-4000	4000	3492
chr8	81520981	81528981	81525082	8000	81524981	-4000	4000	101
chr8	142868356	142876356	142875076	8000	142872356	-4000	4000	2720
chr8	81436326	81444326	81443356	8000	81440326	-4000	4000	3030
chr8	86210063	86218063	86217695	8000	86214063	-4000	4000	3632
chr8	40012397	40020397	40015256	8000	40016397	-4000	4000	-1141
chr8	81689631	81697631	81694053	8000	81693631	-4000	4000	422
chr8	98428853	98436853	98429234	8000	98432853	-4000	4000	-3619
chr8	85323608	85331608	85329701	8000	85327608	-4000	4000	2093
chr8	142906559	142914559	142912660	8000	142910559	-4000	4000	2101
chr8	20140855	20148855	20145681	8000	20144855	-4000	4000	826
chr8	36932125	36940125	36935742	8000	36936125	-4000	4000	-383
chr8	10696590	10704590	10700456	8000	10700590	-4000	4000	-134
chr8	72934349	72942349	72937239	8000	72938349	-4000	4000	-1110
chr8	10602349	10610349	10607555	8000	10606349	-4000	4000	1206
chr8	10696590	10704590	10697721	8000	10700590	-4000	4000	-2869
chr8	87866747	87874747	87873675	8000	87870747	-4000	4000	2928
chr8	27455756	27463756	27463312	8000	27459756	-4000	4000	3556
chr8	72934349	72942349	72936120	8000	72938349	-4000	4000	-2229
chr8	10892045	10900045	10898037	8000	10896045	-4000	4000	1992
chr8	10602349	10610349	10609250	8000	10606349	-4000	4000	2901
chr8	142868356	142876356	142876355	8000	142872356	-4000	4000	3999
chr8	142912506	142920506	142914847	8000	142916506	-4000	4000	-1659
chr8	30127671	30135671	30132779	8000	30131671	-4000	4000	1108
chr8	142912506	142920506	142917195	8000	142916506	-4000	4000	689
chr8	22142830	22150830	22148847	8000	22146830	-4000	4000	2017
chr8	38138700	38146700	38138845	8000	38142700	-4000	4000	-3855
chr8	18397218	18405218	18400099	8000	18401218	-4000	4000	-1119
chr8	27455756	27463756	27458350	8000	27459756	-4000	4000	-1406
chr8	23697740	23705740	23702737	8000	23701740	-4000	4000	997
chr8	10602349	10610349	10608710	8000	10606349	-4000	4000	2361
chr8	10602349	10610349	10608790	8000	10606349	-4000	4000	2441
chr8	124116061	124124061	124119609	8000	124120061	-4000	4000	-452
chr8	144326565	144334565	144332666	8000	144330565	-4000	4000	2101
chr8	56108942	56116942	56113565	8000	56112942	-4000	4000	623
chr8	142906559	142914559	142912693	8000	142910559	-4000	4000	2134
chr8	106755483	106763483	106761130	8000	106759483	-4000	4000	1647
chr8	6804517	6812517	6811406	8000	6808517	-4000	4000	2889
chr8	72934349	72942349	72937348	8000	72938349	-4000	4000	-1001
chr8	10602349	10610349	10609775	8000	10606349	-4000	4000	3426
chr8	87866747	87874747	87872714	8000	87870747	-4000	4000	1967
chr8	10602349	10610349	10610269	8000	10606349	-4000	4000	3920
chr8	24915098	24923098	24917299	8000	24919098	-4000	4000	-1799
chr8	86043109	86051109	86048607	8000	86047109	-4000	4000	1498
chr8	40012397	40020397	40015368	8000	40016397	-4000	4000	-1029
chr8	87866747	87874747	87872992	8000	87870747	-4000	4000	2245
chr8	142906559	142914559	142912054	8000	142910559	-4000	4000	1495
chr8	20140855	20148855	20147678	8000	20144855	-4000	4000	2823
chr8	38138700	38146700	38144357	8000	38142700	-4000	4000	1657
chr8	106755483	106763483	106761001	8000	106759483	-4000	4000	1518
chr8	10602349	10610349	10608288	8000	10606349	-4000	4000	1939
chr8	143153914	143161914	143158428	8000	143157914	-4000	4000	514
chr8	24915098	24923098	24917353	8000	24919098	-4000	4000	-1745
chr8	6931820	6939820	6936796	8000	6935820	-4000	4000	976
chr8	96138333	96146333	96142608	8000	96142333	-4000	4000	275
chr8	86210063	86218063	86214407	8000	86214063	-4000	4000	344
chr8	10696590	10704590	10697616	8000	10700590	-4000	4000	-2974
chr8	66171485	66179485	66176750	8000	66175485	-4000	4000	1265
chr8	124116061	124124061	124119816	8000	124120061	-4000	4000	-245
chr8	72934349	72942349	72937048	8000	72938349	-4000	4000	-1301
chr8	42370063	42378063	42376982	8000	42374063	-4000	4000	2919
chr8	58486178	58494178	58491476	8000	58490178	-4000	4000	1298
chr8	141352470	141360470	141357853	8000	141356470	-4000	4000	1383
chr8	16988181	16996181	16992935	8000	16992181	-4000	4000	754
chr8	141352470	141360470	141357696	8000	141356470	-4000	4000	1226
chr8	72934349	72942349	72936132	8000	72938349	-4000	4000	-2217
chr8	142906559	142914559	142913429	8000	142910559	-4000	4000	2870
chr8	87866747	87874747	87873431	8000	87870747	-4000	4000	2684
chr8	52106838	52114838	52111796	8000	52110838	-4000	4000	958
chr8	24946955	24954955	24954196	8000	24950955	-4000	4000	3241
chr8	10602349	10610349	10607520	8000	10606349	-4000	4000	1171
chr8	40012397	40020397	40013637	8000	40016397	-4000	4000	-2760
chr8	143702694	143710694	143706818	8000	143706694	-4000	4000	124
chr8	72934349	72942349	72936936	8000	72938349	-4000	4000	-1413
chr8	109117565	109125565	109119411	8000	109121565	-4000	4000	-2154
chr8	86549977	86557977	86556168	8000	86553977	-4000	4000	2191
chr8	35792550	35800550	35793699	8000	35796550	-4000	4000	-2851
chr8	24946955	24954955	24952898	8000	24950955	-4000	4000	1943
chr8	30127671	30135671	30132343	8000	30131671	-4000	4000	672
chr8	130776301	130784301	130780429	8000	130780301	-4000	4000	128
chr8	142906559	142914559	142912574	8000	142910559	-4000	4000	2015
chr8	109117565	109125565	109119494	8000	109121565	-4000	4000	-2071
chr8	72934349	72942349	72937322	8000	72938349	-4000	4000	-1027
chr8	90054608	90062608	90060682	8000	90058608	-4000	4000	2074
chr8	81436326	81444326	81442283	8000	81440326	-4000	4000	1957
chr8	130776301	130784301	130780746	8000	130780301	-4000	4000	445
chr8	12132435	12140435	12137651	8000	12136435	-4000	4000	1216
chr8	96138333	96146333	96142803	8000	96142333	-4000	4000	470
chr8	96138333	96146333	96143570	8000	96142333	-4000	4000	1237
chr8	162086	170086	166434	8000	166086	-4000	4000	348
chr8	6804517	6812517	6811845	8000	6808517	-4000	4000	3328
chr8	7892716	7900716	7894701	8000	7896716	-4000	4000	-2015
chr8	81454253	81462253	81459220	8000	81458253	-4000	4000	967
chr8	56108942	56116942	56113550	8000	56112942	-4000	4000	608
chr8	84917844	84925844	84921056	8000	84921844	-4000	4000	-788
chr8	119104455	119112455	119106138	8000	119108455	-4000	4000	-2317
chr8	143702694	143710694	143707857	8000	143706694	-4000	4000	1163
chr8	22142830	22150830	22148755	8000	22146830	-4000	4000	1925
chr8	33587330	33595330	33593708	8000	33591330	-4000	4000	2378
chr8	87866747	87874747	87873385	8000	87870747	-4000	4000	2638
chr8	142912506	142920506	142915174	8000	142916506	-4000	4000	-1332
chr8	87866747	87874747	87873609	8000	87870747	-4000	4000	2862
chr8	81454253	81462253	81459181	8000	81458253	-4000	4000	928
chr8	6931820	6939820	6936093	8000	6935820	-4000	4000	273
chr8	96138333	96146333	96144493	8000	96142333	-4000	4000	2160
chr8	84917844	84925844	84920908	8000	84921844	-4000	4000	-936
chr8	10892045	10900045	10898156	8000	10896045	-4000	4000	2111
chr8	11969937	11977937	11973968	8000	11973937	-4000	4000	31
chr8	102557018	102565018	102560591	8000	102561018	-4000	4000	-427
chr8	104352689	104360689	104355139	8000	104356689	-4000	4000	-1550
chr8	20140855	20148855	20145682	8000	20144855	-4000	4000	827
chr8	104352689	104360689	104355155	8000	104356689	-4000	4000	-1534
chr8	81436326	81444326	81443427	8000	81440326	-4000	4000	3101
chr8	42370063	42378063	42371601	8000	42374063	-4000	4000	-2462
chr8	42370063	42378063	42374762	8000	42374063	-4000	4000	699
chr8	42748620	42756620	42756137	8000	42752620	-4000	4000	3517
chr8	87866747	87874747	87872987	8000	87870747	-4000	4000	2240
chr8	10892045	10900045	10898569	8000	10896045	-4000	4000	2524
chr8	130776301	130784301	130780848	8000	130780301	-4000	4000	547
chr8	81689631	81697631	81693896	8000	81693631	-4000	4000	265
chr8	6804517	6812517	6811403	8000	6808517	-4000	4000	2886
chr8	10892045	10900045	10897931	8000	10896045	-4000	4000	1886
chr8	42370063	42378063	42374197	8000	42374063	-4000	4000	134
chr8	106755483	106763483	106761182	8000	106759483	-4000	4000	1699
chr8	107895316	107903316	107901165	8000	107899316	-4000	4000	1849
chr8	142868356	142876356	142875231	8000	142872356	-4000	4000	2875
chr8	53221724	53229724	53229587	8000	53225724	-4000	4000	3863
chr8	10892045	10900045	10898107	8000	10896045	-4000	4000	2062
chr8	42748620	42756620	42756400	8000	42752620	-4000	4000	3780
chr8	38138700	38146700	38145262	8000	38142700	-4000	4000	2562
chr8	142912506	142920506	142917193	8000	142916506	-4000	4000	687
chr8	66171485	66179485	66176824	8000	66175485	-4000	4000	1339
chr8	130776301	130784301	130780698	8000	130780301	-4000	4000	397
chr8	16988181	16996181	16993150	8000	16992181	-4000	4000	969
chr8	24915098	24923098	24917060	8000	24919098	-4000	4000	-2038
chr8	24946955	24954955	24952611	8000	24950955	-4000	4000	1656
chr8	27231308	27239308	27236893	8000	27235308	-4000	4000	1585
chr8	27455756	27463756	27458452	8000	27459756	-4000	4000	-1304
chr8	30991802	30999802	30996583	8000	30995802	-4000	4000	781
chr8	33587330	33595330	33593555	8000	33591330	-4000	4000	2225
chr8	42370063	42378063	42375770	8000	42374063	-4000	4000	1707
chr8	42733407	42741407	42736813	8000	42737407	-4000	4000	-594
chr8	81436326	81444326	81443258	8000	81440326	-4000	4000	2932
chr8	81520981	81528981	81527064	8000	81524981	-4000	4000	2083
chr8	85323608	85331608	85329686	8000	85327608	-4000	4000	2078
chr8	86210063	86218063	86217716	8000	86214063	-4000	4000	3653
chr8	142868356	142876356	142875784	8000	142872356	-4000	4000	3428
chr8	142906559	142914559	142914308	8000	142910559	-4000	4000	3749
chr8	38138700	38146700	38139033	8000	38142700	-4000	4000	-3667
chr8	33587330	33595330	33593677	8000	33591330	-4000	4000	2347
chr8	40012397	40020397	40015283	8000	40016397	-4000	4000	-1114
chr8	53221724	53229724	53229685	8000	53225724	-4000	4000	3961
chr8	87866747	87874747	87872983	8000	87870747	-4000	4000	2236
chr8	87866747	87874747	87873263	8000	87870747	-4000	4000	2516
chr8	10892045	10900045	10898240	8000	10896045	-4000	4000	2195
chr8	30127671	30135671	30132193	8000	30131671	-4000	4000	522
chr8	42748620	42756620	42756316	8000	42752620	-4000	4000	3696
chr8	10602349	10610349	10607133	8000	10606349	-4000	4000	784
chr8	96138333	96146333	96144782	8000	96142333	-4000	4000	2449
chr8	72934349	72942349	72936047	8000	72938349	-4000	4000	-2302
chr8	66171485	66179485	66174683	8000	66175485	-4000	4000	-802
chr8	10602349	10610349	10610307	8000	10606349	-4000	4000	3958
chr8	11328360	11336360	11331684	8000	11332360	-4000	4000	-676
chr8	81689631	81697631	81694314	8000	81693631	-4000	4000	683
chr8	6804517	6812517	6811377	8000	6808517	-4000	4000	2860
chr8	30991802	30999802	30996434	8000	30995802	-4000	4000	632
chr8	56108942	56116942	56113721	8000	56112942	-4000	4000	779
chr8	70047651	70055651	70052233	8000	70051651	-4000	4000	582
chr8	141352470	141360470	141357026	8000	141356470	-4000	4000	556
chr8	142906559	142914559	142912060	8000	142910559	-4000	4000	1501
chr8	81689631	81697631	81694280	8000	81693631	-4000	4000	649
chr8	123676794	123684794	123681350	8000	123680794	-4000	4000	556
chr8	30127671	30135671	30132558	8000	30131671	-4000	4000	887
chr8	49072093	49080093	49075417	8000	49076093	-4000	4000	-676
chr8	87866747	87874747	87873212	8000	87870747	-4000	4000	2465
chr8	10602349	10610349	10607794	8000	10606349	-4000	4000	1445
chr8	33587330	33595330	33592208	8000	33591330	-4000	4000	878
chr8	10696590	10704590	10697914	8000	10700590	-4000	4000	-2676
chr8	24915098	24923098	24917614	8000	24919098	-4000	4000	-1484
chr8	85323608	85331608	85329819	8000	85327608	-4000	4000	2211
chr8	72934349	72942349	72936047	8000	72938349	-4000	4000	-2302
chr8	86549977	86557977	86556285	8000	86553977	-4000	4000	2308
chr8	72934349	72942349	72937786	8000	72938349	-4000	4000	-563
chr8	142906559	142914559	142913310	8000	142910559	-4000	4000	2751
chr8	87866747	87874747	87873256	8000	87870747	-4000	4000	2509
chr8	49072093	49080093	49075285	8000	49076093	-4000	4000	-808
chr8	87866747	87874747	87873746	8000	87870747	-4000	4000	2999
chr8	23697740	23705740	23702842	8000	23701740	-4000	4000	1102
chr8	56108942	56116942	56113223	8000	56112942	-4000	4000	281
chr8	72934349	72942349	72937308	8000	72938349	-4000	4000	-1041
chr8	142906559	142914559	142912674	8000	142910559	-4000	4000	2115
chr8	49072093	49080093	49075283	8000	49076093	-4000	4000	-810
chr8	50792692	50800692	50792763	8000	50796692	-4000	4000	-3929
chr8	58486178	58494178	58492485	8000	58490178	-4000	4000	2307
chr8	53221724	53229724	53229171	8000	53225724	-4000	4000	3447
chr9	32785201	32793201	32786436	8000	32789201	-4000	4000	-2765
chr9	37742904	37750904	37746482	8000	37746904	-4000	4000	-422
chr9	104522253	104530253	104526758	8000	104526253	-4000	4000	505
chr9	27944078	27952078	27950325	8000	27948078	-4000	4000	2247
chr9	27944078	27952078	27950143	8000	27948078	-4000	4000	2065
chr9	104522253	104530253	104526684	8000	104526253	-4000	4000	431
chr9	34657880	34665880	34660533	8000	34661880	-4000	4000	-1347
chr9	34657880	34665880	34660534	8000	34661880	-4000	4000	-1346
chr9	21161637	21169637	21166205	8000	21165637	-4000	4000	568
chr9	21197469	21205469	21201727	8000	21201469	-4000	4000	258
chr9	65734784	65742784	65737154	8000	65738784	-4000	4000	-1630
chr9	88125305	88133305	88132493	8000	88129305	-4000	4000	3188
chr9	101321135	101329135	101324207	8000	101325135	-4000	4000	-928
chr9	133510586	133518586	133514776	8000	133514586	-4000	4000	190
chr9	35953108	35961108	35957987	8000	35957108	-4000	4000	879
chr9	81946093	81954093	81949702	8000	81950093	-4000	4000	-391
chr9	122563117	122571117	122568038	8000	122567117	-4000	4000	921
chr9	81991253	81999253	81993432	8000	81995253	-4000	4000	-1821
chr9	122472958	122480958	122477152	8000	122476958	-4000	4000	194
chr9	987732	995732	990144	8000	991732	-4000	4000	-1588
chr9	104691462	104699462	104694848	8000	104695462	-4000	4000	-614
chr9	122522358	122530358	122526561	8000	122526358	-4000	4000	203
chr9	97852717	97860717	97856102	8000	97856717	-4000	4000	-615
chr9	26989136	26997136	26993536	8000	26993136	-4000	4000	400
chr9	88125305	88133305	88129538	8000	88129305	-4000	4000	233
chr9	135619648	135627648	135624030	8000	135623648	-4000	4000	382
chr9	133573081	133581081	133580182	8000	133577081	-4000	4000	3101
chr9	74718495	74726495	74724732	8000	74722495	-4000	4000	2237
chr9	21300326	21308326	21304987	8000	21304326	-4000	4000	661
chr9	81946093	81954093	81947672	8000	81950093	-4000	4000	-2421
chr9	42185887	42193887	42186336	8000	42189887	-4000	4000	-3551
chr9	136734167	136742167	136739951	8000	136738167	-4000	4000	1784
chr9	88125305	88133305	88132106	8000	88129305	-4000	4000	2801
chr9	101416560	101424560	101421891	8000	101420560	-4000	4000	1331
chr9	122522358	122530358	122526943	8000	122526358	-4000	4000	585
chr9	6327891	6335891	6330045	8000	6331891	-4000	4000	-1846
chr9	21380255	21388255	21384883	8000	21384255	-4000	4000	628
chr9	36167334	36175334	36170438	8000	36171334	-4000	4000	-896
chr9	66982304	66990304	66987247	8000	66986304	-4000	4000	943
chr9	94314198	94322198	94320217	8000	94318198	-4000	4000	2019
chr9	122746783	122754783	122750436	8000	122750783	-4000	4000	-347
chr9	34617074	34625074	34623973	8000	34621074	-4000	4000	2899
chr9	27944078	27952078	27950485	8000	27948078	-4000	4000	2407
chr9	104522253	104530253	104526329	8000	104526253	-4000	4000	76
chr9	33795231	33803231	33798610	8000	33799231	-4000	4000	-621
chr9	35557831	35565831	35563033	8000	35561831	-4000	4000	1202
chr9	81991253	81999253	81992837	8000	81995253	-4000	4000	-2416
chr9	88125305	88133305	88130776	8000	88129305	-4000	4000	1471
chr9	129608225	129616225	129615523	8000	129612225	-4000	4000	3298
chr9	136734167	136742167	136739411	8000	136738167	-4000	4000	1244
chr9	104501222	104509222	104504764	8000	104505222	-4000	4000	-458
chr9	104531749	104539749	104536257	8000	104535749	-4000	4000	508
chr9	104566130	104574130	104570101	8000	104570130	-4000	4000	-29
chr9	108850588	108858588	108855031	8000	108854588	-4000	4000	443
chr9	35041986	35049986	35043033	8000	35045986	-4000	4000	-2953
chr9	34617074	34625074	34623466	8000	34621074	-4000	4000	2392
chr9	65278101	65286101	65283967	8000	65282101	-4000	4000	1866
chr9	65734784	65742784	65737556	8000	65738784	-4000	4000	-1228
chr9	35041986	35049986	35043845	8000	35045986	-4000	4000	-2141
chr9	81930998	81938998	81932710	8000	81934998	-4000	4000	-2288
chr9	81930998	81938998	81932933	8000	81934998	-4000	4000	-2065
chr9	6327891	6335891	6329975	8000	6331891	-4000	4000	-1916
chr9	81991253	81999253	81992872	8000	81995253	-4000	4000	-2381
chr9	104594457	104602457	104598785	8000	104598457	-4000	4000	328
chr9	21136632	21144632	21141049	8000	21140632	-4000	4000	417
chr9	21223243	21231243	21227651	8000	21227243	-4000	4000	408
chr9	21223243	21231243	21228015	8000	21227243	-4000	4000	772
chr9	94314198	94322198	94320414	8000	94318198	-4000	4000	2216
chr9	108850588	108858588	108854892	8000	108854588	-4000	4000	304
chr9	133510586	133518586	133515602	8000	133514586	-4000	4000	1016
chr9	37742904	37750904	37744940	8000	37746904	-4000	4000	-1964
chr9	81946093	81954093	81947903	8000	81950093	-4000	4000	-2190
chr9	81991253	81999253	81993325	8000	81995253	-4000	4000	-1928
chr9	87884903	87892903	87888072	8000	87888903	-4000	4000	-831
chr9	87884903	87892903	87888623	8000	87888903	-4000	4000	-280
chr9	94314198	94322198	94318707	8000	94318198	-4000	4000	509
chr9	108859756	108867756	108863299	8000	108863756	-4000	4000	-457
chr9	21235002	21243002	21239925	8000	21239002	-4000	4000	923
chr9	81991253	81999253	81994501	8000	81995253	-4000	4000	-752
chr9	21073104	21081104	21077757	8000	21077104	-4000	4000	653
chr9	87884903	87892903	87888136	8000	87888903	-4000	4000	-767
chr9	21235002	21243002	21239902	8000	21239002	-4000	4000	900
chr9	34617074	34625074	34622416	8000	34621074	-4000	4000	1342
chr9	108850588	108858588	108855972	8000	108854588	-4000	4000	1384
chr9	61192280	61200280	61192549	8000	61196280	-4000	4000	-3731
chr9	41122435	41130435	41127246	8000	41126435	-4000	4000	811
chr9	81991253	81999253	81993342	8000	81995253	-4000	4000	-1911
chr9	96936253	96944253	96936528	8000	96940253	-4000	4000	-3725
chr9	35557831	35565831	35558486	8000	35561831	-4000	4000	-3345
chr9	37742904	37750904	37745159	8000	37746904	-4000	4000	-1745
chr9	122563117	122571117	122567572	8000	122567117	-4000	4000	455
chr9	122611682	122619682	122614962	8000	122615682	-4000	4000	-720
chr9	110299476	110307476	110303631	8000	110303476	-4000	4000	155
chr9	39357962	39365962	39360985	8000	39361962	-4000	4000	-977
chr9	35041986	35049986	35044017	8000	35045986	-4000	4000	-1969
chr9	39357962	39365962	39358744	8000	39361962	-4000	4000	-3218
chr9	122672104	122680104	122675941	8000	122676104	-4000	4000	-163
chr9	122507743	122515743	122511356	8000	122511743	-4000	4000	-387
chr9	81991253	81999253	81991554	8000	81995253	-4000	4000	-3699
chr9	104501222	104509222	104504560	8000	104505222	-4000	4000	-662
chr9	111682171	111690171	111686731	8000	111686171	-4000	4000	560
chr9	61192280	61200280	61193138	8000	61196280	-4000	4000	-3142
chr9	987732	995732	990838	8000	991732	-4000	4000	-894
chr9	81991253	81999253	81993812	8000	81995253	-4000	4000	-1441
chr9	69008504	69016504	69013892	8000	69012504	-4000	4000	1388
chr9	97922791	97930791	97927426	8000	97926791	-4000	4000	635
chr9	21182694	21190694	21187339	8000	21186694	-4000	4000	645
chr9	5330930	5338930	5335559	8000	5334930	-4000	4000	629
chr9	42185887	42193887	42186033	8000	42189887	-4000	4000	-3854
chr9	41122435	41130435	41127360	8000	41126435	-4000	4000	925
chr9	65278101	65286101	65283354	8000	65282101	-4000	4000	1253
chr9	87884903	87892903	87886515	8000	87888903	-4000	4000	-2388
chr9	14715724	14723724	14719821	8000	14719724	-4000	4000	97
chr9	27944078	27952078	27950446	8000	27948078	-4000	4000	2368
chr9	36167334	36175334	36170530	8000	36171334	-4000	4000	-804
chr9	81991253	81999253	81992724	8000	81995253	-4000	4000	-2529
chr9	27944078	27952078	27949371	8000	27948078	-4000	4000	1293
chr9	90605832	90613832	90613611	8000	90609832	-4000	4000	3779
chr9	68301084	68309084	68302973	8000	68305084	-4000	4000	-2111
chr9	104522253	104530253	104526888	8000	104526253	-4000	4000	635
chr9	132987687	132995687	132991024	8000	132991687	-4000	4000	-663
chr9	35557831	35565831	35562548	8000	35561831	-4000	4000	717
chr9	37742904	37750904	37745144	8000	37746904	-4000	4000	-1760
chr9	104600671	104608671	104605014	8000	104604671	-4000	4000	343
chr9	21363424	21371424	21367944	8000	21367424	-4000	4000	520
chr9	94314198	94322198	94318847	8000	94318198	-4000	4000	649
chr9	104531749	104539749	104536346	8000	104535749	-4000	4000	597
chr9	122785895	122793895	122789275	8000	122789895	-4000	4000	-620
chr9	136192250	136200250	136196678	8000	136196250	-4000	4000	428
chr9	81991253	81999253	81992611	8000	81995253	-4000	4000	-2642
chr9	105659124	105667124	105662478	8000	105663124	-4000	4000	-646
chr9	136734167	136742167	136740989	8000	136738167	-4000	4000	2822
chr9	35865463	35873463	35870178	8000	35869463	-4000	4000	715
chr9	94314198	94322198	94320502	8000	94318198	-4000	4000	2304
chr9	104613248	104621248	104617394	8000	104617248	-4000	4000	146
chr9	110299476	110307476	110304507	8000	110303476	-4000	4000	1031
chr9	104531749	104539749	104535966	8000	104535749	-4000	4000	217
chr9	40262845	40270845	40265460	8000	40266845	-4000	4000	-1385
chr9	133573081	133581081	133573984	8000	133577081	-4000	4000	-3097
chr9	35557831	35565831	35560530	8000	35561831	-4000	4000	-1301
chr9	2726037	2734037	2729625	8000	2730037	-4000	4000	-412
chr9	87884903	87892903	87887746	8000	87888903	-4000	4000	-1157
chr9	81991253	81999253	81993269	8000	81995253	-4000	4000	-1984
chr9	21380255	21388255	21385236	8000	21384255	-4000	4000	981
chr9	21223243	21231243	21228029	8000	21227243	-4000	4000	786
chr9	21380255	21388255	21384862	8000	21384255	-4000	4000	607
chr9	104566130	104574130	104569972	8000	104570130	-4000	4000	-158
chr9	122611682	122619682	122615331	8000	122615682	-4000	4000	-351
chr9	110299476	110307476	110304512	8000	110303476	-4000	4000	1036
chr9	14715724	14723724	14720006	8000	14719724	-4000	4000	282
chr9	21363424	21371424	21367849	8000	21367424	-4000	4000	425
chr9	122624579	122632579	122628839	8000	122628579	-4000	4000	260
chr9	112231	120231	116959	8000	116231	-4000	4000	728
chr9	81946093	81954093	81948029	8000	81950093	-4000	4000	-2064
chr9	21363424	21371424	21367502	8000	21367424	-4000	4000	78
chr9	122196088	122204088	122199961	8000	122200088	-4000	4000	-127
chr9	69008504	69016504	69013789	8000	69012504	-4000	4000	1285
chr9	34657880	34665880	34661487	8000	34661880	-4000	4000	-393
chr9	34719053	34727053	34723332	8000	34723053	-4000	4000	279
chr9	21161637	21169637	21166407	8000	21165637	-4000	4000	770
chr9	122720925	122728925	122724262	8000	122724925	-4000	4000	-663
chr9	137225640	137233640	137232131	8000	137229640	-4000	4000	2491
chr9	21073104	21081104	21077644	8000	21077104	-4000	4000	540
chr9	81930998	81938998	81933102	8000	81934998	-4000	4000	-1896
chr9	35865463	35873463	35870124	8000	35869463	-4000	4000	661
chr9	21182694	21190694	21186956	8000	21186694	-4000	4000	262
chr9	34719053	34727053	34723406	8000	34723053	-4000	4000	353
chr9	66982304	66990304	66987458	8000	66986304	-4000	4000	1154
chr9	69902227	69910227	69906067	8000	69906227	-4000	4000	-160
chr9	108859756	108867756	108863093	8000	108863756	-4000	4000	-663
chr9	122551173	122559173	122553271	8000	122555173	-4000	4000	-1902
chr9	134883523	134891523	134885282	8000	134887523	-4000	4000	-2241
chr9	122507743	122515743	122511718	8000	122511743	-4000	4000	-25
chr9	21073104	21081104	21077515	8000	21077104	-4000	4000	411
chr9	35865463	35873463	35869721	8000	35869463	-4000	4000	258
chr9	122720925	122728925	122724469	8000	122724925	-4000	4000	-456
chr9	69008504	69016504	69013395	8000	69012504	-4000	4000	891
chr9	104613248	104621248	104617401	8000	104617248	-4000	4000	153
chr9	136750386	136758386	136754464	8000	136754386	-4000	4000	78
chr9	37742904	37750904	37745277	8000	37746904	-4000	4000	-1627
chr9	81991253	81999253	81994212	8000	81995253	-4000	4000	-1041
chr9	108850588	108858588	108855251	8000	108854588	-4000	4000	663
chr9	21202181	21210181	21207103	8000	21206181	-4000	4000	922
chr9	37742904	37750904	37746360	8000	37746904	-4000	4000	-544
chr9	122785895	122793895	122789003	8000	122789895	-4000	4000	-892
chr9	135522540	135530540	135524862	8000	135526540	-4000	4000	-1678
chr9	6327891	6335891	6331219	8000	6331891	-4000	4000	-672
chr9	21476839	21484839	21481400	8000	21480839	-4000	4000	561
chr9	122472958	122480958	122477893	8000	122476958	-4000	4000	935
chr9	21202181	21210181	21206845	8000	21206181	-4000	4000	664
chr9	66982304	66990304	66988475	8000	66986304	-4000	4000	2171
chr9	90605832	90613832	90610372	8000	90609832	-4000	4000	540
chr9	101565352	101573352	101570405	8000	101569352	-4000	4000	1053
chr9	122785895	122793895	122789668	8000	122789895	-4000	4000	-227
chr9	124474589	124482589	124476690	8000	124478589	-4000	4000	-1899
chr9	61192280	61200280	61192474	8000	61196280	-4000	4000	-3806
chr9	34719053	34727053	34723921	8000	34723053	-4000	4000	868
chr9	133655329	133663329	133657238	8000	133659329	-4000	4000	-2091
chr9	122746783	122754783	122750665	8000	122750783	-4000	4000	-118
chr9	21223243	21231243	21227496	8000	21227243	-4000	4000	253
chr9	21223243	21231243	21227708	8000	21227243	-4000	4000	465
chr9	21300326	21308326	21304749	8000	21304326	-4000	4000	423
chr9	21345835	21353835	21350380	8000	21349835	-4000	4000	545
chr9	21406185	21414185	21409747	8000	21410185	-4000	4000	-438
chr9	81991253	81999253	81993859	8000	81995253	-4000	4000	-1394
chr9	94314198	94322198	94321156	8000	94318198	-4000	4000	2958
chr9	69008504	69016504	69013946	8000	69012504	-4000	4000	1442
chr9	94314198	94322198	94318685	8000	94318198	-4000	4000	487
chr9	21363424	21371424	21367457	8000	21367424	-4000	4000	33
chr9	32785201	32793201	32787357	8000	32789201	-4000	4000	-1844
chr9	35041986	35049986	35042873	8000	35045986	-4000	4000	-3113
chr9	35041986	35049986	35043270	8000	35045986	-4000	4000	-2716
chr9	35041986	35049986	35043368	8000	35045986	-4000	4000	-2618
chr9	35041986	35049986	35045606	8000	35045986	-4000	4000	-380
chr9	35953108	35961108	35957374	8000	35957108	-4000	4000	266
chr9	36167334	36175334	36169688	8000	36171334	-4000	4000	-1646
chr9	42185887	42193887	42188966	8000	42189887	-4000	4000	-921
chr9	66982304	66990304	66988244	8000	66986304	-4000	4000	1940
chr9	81946093	81954093	81947578	8000	81950093	-4000	4000	-2515
chr9	137249483	137257483	137252513	8000	137253483	-4000	4000	-970
chr9	36167334	36175334	36170595	8000	36171334	-4000	4000	-739
chr9	65734784	65742784	65737408	8000	65738784	-4000	4000	-1376
chr9	122522358	122530358	122526652	8000	122526358	-4000	4000	294
chr9	111323229	111331229	111327789	8000	111327229	-4000	4000	560
chr9	21073104	21081104	21077626	8000	21077104	-4000	4000	522
chr9	21202181	21210181	21206601	8000	21206181	-4000	4000	420
chr9	35041986	35049986	35043980	8000	35045986	-4000	4000	-2006
chr9	2726037	2734037	2729631	8000	2730037	-4000	4000	-406
chr9	122196088	122204088	122199952	8000	122200088	-4000	4000	-136
chr9	104600671	104608671	104605328	8000	104604671	-4000	4000	657
chr9	77016953	77024953	77020049	8000	77020953	-4000	4000	-904
chr9	81946093	81954093	81947599	8000	81950093	-4000	4000	-2494
chr9	108850588	108858588	108855667	8000	108854588	-4000	4000	1079
chr9	21202181	21210181	21206600	8000	21206181	-4000	4000	419
chr9	122516082	122524082	122519531	8000	122520082	-4000	4000	-551
chr9	64409142	64417142	64412066	8000	64413142	-4000	4000	-1076
chr9	101416560	101424560	101421861	8000	101420560	-4000	4000	1301
chr9	21073104	21081104	21077876	8000	21077104	-4000	4000	772
chr9	122522358	122530358	122526562	8000	122526358	-4000	4000	204
chr9	26989136	26997136	26996422	8000	26993136	-4000	4000	3286
chr9	27944078	27952078	27948863	8000	27948078	-4000	4000	785
chr9	88125305	88133305	88131077	8000	88129305	-4000	4000	1772
chr9	14715724	14723724	14722328	8000	14719724	-4000	4000	2604
chr9	104566130	104574130	104569805	8000	104570130	-4000	4000	-325
chr9	21223243	21231243	21227805	8000	21227243	-4000	4000	562
chr9	6327891	6335891	6330991	8000	6331891	-4000	4000	-900
chr9	21476839	21484839	21481514	8000	21480839	-4000	4000	675
chr9	34719053	34727053	34726879	8000	34723053	-4000	4000	3826
chr9	136942975	136950975	136946650	8000	136946975	-4000	4000	-325
chr9	135562955	135570955	135564247	8000	135566955	-4000	4000	-2708
chr9	104594457	104602457	104598509	8000	104598457	-4000	4000	52
chr9	68301084	68309084	68303913	8000	68305084	-4000	4000	-1171
chr9	90605832	90613832	90613712	8000	90609832	-4000	4000	3880
chr9	27522498	27530498	27524615	8000	27526498	-4000	4000	-1883
chr9	68301084	68309084	68303897	8000	68305084	-4000	4000	-1187
chr9	21212373	21220373	21217073	8000	21216373	-4000	4000	700
chr9	100584389	100592389	100586129	8000	100588389	-4000	4000	-2260
chr9	104613248	104621248	104617803	8000	104617248	-4000	4000	555
chr9	1053552	1061552	1057000	8000	1057552	-4000	4000	-552
chr9	2726037	2734037	2729706	8000	2730037	-4000	4000	-331
chr9	6327891	6335891	6330070	8000	6331891	-4000	4000	-1821
chr9	14715724	14723724	14722629	8000	14719724	-4000	4000	2905
chr9	21073104	21081104	21077166	8000	21077104	-4000	4000	62
chr9	21212373	21220373	21217192	8000	21216373	-4000	4000	819
chr9	21223243	21231243	21227956	8000	21227243	-4000	4000	713
chr9	21223243	21231243	21228098	8000	21227243	-4000	4000	855
chr9	34719053	34727053	34724773	8000	34723053	-4000	4000	1720
chr9	35041986	35049986	35044907	8000	35045986	-4000	4000	-1079
chr9	36167334	36175334	36169866	8000	36171334	-4000	4000	-1468
chr9	42185887	42193887	42189204	8000	42189887	-4000	4000	-683
chr9	68532580	68540580	68537416	8000	68536580	-4000	4000	836
chr9	69008504	69016504	69013998	8000	69012504	-4000	4000	1494
chr9	72047376	72055376	72052225	8000	72051376	-4000	4000	849
chr9	81991253	81999253	81991982	8000	81995253	-4000	4000	-3271
chr9	87884903	87892903	87886424	8000	87888903	-4000	4000	-2479
chr9	88125305	88133305	88132621	8000	88129305	-4000	4000	3316
chr9	94314198	94322198	94318809	8000	94318198	-4000	4000	611
chr9	104600671	104608671	104604912	8000	104604671	-4000	4000	241
chr9	104613248	104621248	104618180	8000	104617248	-4000	4000	932
chr9	104691462	104699462	104694557	8000	104695462	-4000	4000	-905
chr9	104691462	104699462	104695211	8000	104695462	-4000	4000	-251
chr9	108850588	108858588	108855819	8000	108854588	-4000	4000	1231
chr9	111323229	111331229	111327643	8000	111327229	-4000	4000	414
chr9	122472958	122480958	122477117	8000	122476958	-4000	4000	159
chr9	129608225	129616225	129613547	8000	129612225	-4000	4000	1322
chr9	135791508	135799508	135792089	8000	135795508	-4000	4000	-3419
chr9	35557831	35565831	35558282	8000	35561831	-4000	4000	-3549
chr9	39357962	39365962	39361723	8000	39361962	-4000	4000	-239
chr9	122611682	122619682	122615552	8000	122615682	-4000	4000	-130
chr9	81930998	81938998	81933078	8000	81934998	-4000	4000	-1920
chr9	81991253	81999253	81994440	8000	81995253	-4000	4000	-813
chr9	96936253	96944253	96937261	8000	96940253	-4000	4000	-2992
chr9	21476839	21484839	21481119	8000	21480839	-4000	4000	280
chr9	104566130	104574130	104569991	8000	104570130	-4000	4000	-139
chr9	104566130	104574130	104570103	8000	104570130	-4000	4000	-27
chr9	104566130	104574130	104570104	8000	104570130	-4000	4000	-26
chr9	1053552	1061552	1056030	8000	1057552	-4000	4000	-1522
chr9	1053552	1061552	1056555	8000	1057552	-4000	4000	-997
chr9	21437316	21445316	21440442	8000	21441316	-4000	4000	-874
chr9	21437316	21445316	21441212	8000	21441316	-4000	4000	-104
chr9	26989136	26997136	26996333	8000	26993136	-4000	4000	3197
chr9	27944078	27952078	27949967	8000	27948078	-4000	4000	1889
chr9	34375019	34383019	34381420	8000	34379019	-4000	4000	2401
chr9	34657880	34665880	34662040	8000	34661880	-4000	4000	160
chr9	64409142	64417142	64411219	8000	64413142	-4000	4000	-1923
chr9	65734784	65742784	65737227	8000	65738784	-4000	4000	-1557
chr9	69008504	69016504	69008649	8000	69012504	-4000	4000	-3855
chr9	81946093	81954093	81947865	8000	81950093	-4000	4000	-2228
chr9	81946093	81954093	81948029	8000	81950093	-4000	4000	-2064
chr9	81991253	81999253	81992261	8000	81995253	-4000	4000	-2992
chr9	81991253	81999253	81993267	8000	81995253	-4000	4000	-1986
chr9	81991253	81999253	81995143	8000	81995253	-4000	4000	-110
chr9	88125305	88133305	88130168	8000	88129305	-4000	4000	863
chr9	100584389	100592389	100586170	8000	100588389	-4000	4000	-2219
chr9	111323229	111331229	111327757	8000	111327229	-4000	4000	528
chr9	111323229	111331229	111328355	8000	111327229	-4000	4000	1126
chr9	122624579	122632579	122629227	8000	122628579	-4000	4000	648
chr9	122672104	122680104	122675180	8000	122676104	-4000	4000	-924
chr9	2726037	2734037	2729535	8000	2730037	-4000	4000	-502
chr9	104501222	104509222	104504546	8000	104505222	-4000	4000	-676
chr9	81930998	81938998	81933076	8000	81934998	-4000	4000	-1922
chr9	132586252	132594252	132589984	8000	132590252	-4000	4000	-268
chr9	14715724	14723724	14722338	8000	14719724	-4000	4000	2614
chr9	27944078	27952078	27950417	8000	27948078	-4000	4000	2339
chr9	35041986	35049986	35043677	8000	35045986	-4000	4000	-2309
chr9	108859756	108867756	108863049	8000	108863756	-4000	4000	-707
chr9	104600671	104608671	104605322	8000	104604671	-4000	4000	651
chr9	27944078	27952078	27950345	8000	27948078	-4000	4000	2267
chr9	122746783	122754783	122750215	8000	122750783	-4000	4000	-568
chr9	69008504	69016504	69013883	8000	69012504	-4000	4000	1379
chr9	122522358	122530358	122526616	8000	122526358	-4000	4000	258
chr9	21197469	21205469	21202188	8000	21201469	-4000	4000	719
chr9	101565352	101573352	101573241	8000	101569352	-4000	4000	3889
chr9	81991253	81999253	81992192	8000	81995253	-4000	4000	-3061
chr9	21406185	21414185	21409273	8000	21410185	-4000	4000	-912
chr9	36167334	36175334	36169594	8000	36171334	-4000	4000	-1740
chr9	39357962	39365962	39360190	8000	39361962	-4000	4000	-1772
chr9	42185887	42193887	42189635	8000	42189887	-4000	4000	-252
chr9	130888707	130896707	130893471	8000	130892707	-4000	4000	764
chr9	136750386	136758386	136757058	8000	136754386	-4000	4000	2672
chr9	81946093	81954093	81949899	8000	81950093	-4000	4000	-194
chr9	104566130	104574130	104569378	8000	104570130	-4000	4000	-752
chr9	21161637	21169637	21166062	8000	21165637	-4000	4000	425
chr9	42185887	42193887	42188956	8000	42189887	-4000	4000	-931
chr9	77016953	77024953	77019698	8000	77020953	-4000	4000	-1255
chr9	81991253	81999253	81992897	8000	81995253	-4000	4000	-2356
chr9	124029301	124037301	124032556	8000	124033301	-4000	4000	-745
chr9	987732	995732	991183	8000	991732	-4000	4000	-549
chr9	104522253	104530253	104526850	8000	104526253	-4000	4000	597
chr9	81930998	81938998	81933055	8000	81934998	-4000	4000	-1943
chr9	21235002	21243002	21239567	8000	21239002	-4000	4000	565
chr9	21212373	21220373	21216923	8000	21216373	-4000	4000	550
chr9	122563117	122571117	122567707	8000	122567117	-4000	4000	590
chr9	5231304	5239304	5233728	8000	5235304	-4000	4000	-1576
chr9	21380255	21388255	21385029	8000	21384255	-4000	4000	774
chr9	27944078	27952078	27950283	8000	27948078	-4000	4000	2205
chr9	65734784	65742784	65737143	8000	65738784	-4000	4000	-1641
chr9	135689407	135697407	135694319	8000	135693407	-4000	4000	912
chr9	94314198	94322198	94320429	8000	94318198	-4000	4000	2231
chr9	122522358	122530358	122526919	8000	122526358	-4000	4000	561
chr9	96936253	96944253	96938896	8000	96940253	-4000	4000	-1357
chr9	17793124	17801124	17795654	8000	17797124	-4000	4000	-1470
chr9	21363424	21371424	21367457	8000	21367424	-4000	4000	33
chr9	21161637	21169637	21166508	8000	21165637	-4000	4000	871
chr9	21197469	21205469	21201827	8000	21201469	-4000	4000	358
chr9	34657880	34665880	34662020	8000	34661880	-4000	4000	140
chr9	27944078	27952078	27949806	8000	27948078	-4000	4000	1728
chr9	21182694	21190694	21186889	8000	21186694	-4000	4000	195
chr9	27522498	27530498	27524399	8000	27526498	-4000	4000	-2099
chr9	39357962	39365962	39358850	8000	39361962	-4000	4000	-3112
chr9	105659124	105667124	105662908	8000	105663124	-4000	4000	-216
chr9	14715724	14723724	14719982	8000	14719724	-4000	4000	258
chr9	14715724	14723724	14720355	8000	14719724	-4000	4000	631
chr9	122746783	122754783	122750116	8000	122750783	-4000	4000	-667
chr9	108859756	108867756	108863517	8000	108863756	-4000	4000	-239
chr9	27944078	27952078	27949220	8000	27948078	-4000	4000	1142
chr9	35041986	35049986	35044470	8000	35045986	-4000	4000	-1516
chr9	122797073	122805073	122800271	8000	122801073	-4000	4000	-802
chr9	39357962	39365962	39361276	8000	39361962	-4000	4000	-686
chr9	21437316	21445316	21441025	8000	21441316	-4000	4000	-291
chr9	81930998	81938998	81933145	8000	81934998	-4000	4000	-1853
chr9	987732	995732	990339	8000	991732	-4000	4000	-1393
chr9	5330930	5338930	5335409	8000	5334930	-4000	4000	479
chr9	112874920	112882920	112879717	8000	112878920	-4000	4000	797
chr9	27944078	27952078	27950340	8000	27948078	-4000	4000	2262
chr9	37742904	37750904	37746253	8000	37746904	-4000	4000	-651
chr9	35865463	35873463	35870159	8000	35869463	-4000	4000	696
chr9	21380255	21388255	21385065	8000	21384255	-4000	4000	810
chr9	39357962	39365962	39361521	8000	39361962	-4000	4000	-441
chr9	6327891	6335891	6330015	8000	6331891	-4000	4000	-1876
chr9	108859756	108867756	108863339	8000	108863756	-4000	4000	-417
chr9	133573081	133581081	133573879	8000	133577081	-4000	4000	-3202
chr9	122507743	122515743	122511314	8000	122511743	-4000	4000	-429
chr9	122196088	122204088	122200028	8000	122200088	-4000	4000	-60
chr9	122472958	122480958	122477822	8000	122476958	-4000	4000	864
chr9	122785895	122793895	122789482	8000	122789895	-4000	4000	-413
chr9	137232555	137240555	137236003	8000	137236555	-4000	4000	-552
chr9	90605832	90613832	90613611	8000	90609832	-4000	4000	3779
chr9	1053552	1061552	1057202	8000	1057552	-4000	4000	-350
chr9	34719053	34727053	34725694	8000	34723053	-4000	4000	2641
chr9	94554720	94562720	94558905	8000	94558720	-4000	4000	185
chr10	79611455	79619455	79612415	8000	79615455	-4000	4000	-3040
chr10	100479744	100487744	100487655	8000	100483744	-4000	4000	3911
chr10	50007654	50015654	50009704	8000	50011654	-4000	4000	-1950
chr10	113584714	113592714	113588837	8000	113588714	-4000	4000	123
chr10	71707701	71715701	71712835	8000	71711701	-4000	4000	1134
chr10	113584714	113592714	113589695	8000	113588714	-4000	4000	981
chr10	70427936	70435936	70432730	8000	70431936	-4000	4000	794
chr10	88602976	88610976	88605645	8000	88606976	-4000	4000	-1331
chr10	80332105	80340105	80338475	8000	80336105	-4000	4000	2370
chr10	67097551	67105551	67097704	8000	67101551	-4000	4000	-3847
chr10	75090432	75098432	75097885	8000	75094432	-4000	4000	3453
chr10	117206299	117214299	117209534	8000	117210299	-4000	4000	-765
chr10	100479744	100487744	100482431	8000	100483744	-4000	4000	-1313
chr10	133619895	133627895	133626676	8000	133623895	-4000	4000	2781
chr10	42888	50888	47147	8000	46888	-4000	4000	259
chr10	88674814	88682814	88678740	8000	88678814	-4000	4000	-74
chr10	123135423	123143423	123137378	8000	123139423	-4000	4000	-2045
chr10	15069853	15077853	15073161	8000	15073853	-4000	4000	-692
chr10	50007654	50015654	50009994	8000	50011654	-4000	4000	-1660
chr10	70427936	70435936	70435629	8000	70431936	-4000	4000	3693
chr10	75090432	75098432	75095767	8000	75094432	-4000	4000	1335
chr10	101766109	101774109	101770481	8000	101770109	-4000	4000	372
chr10	88602976	88610976	88606691	8000	88606976	-4000	4000	-285
chr10	97579884	97587884	97583693	8000	97583884	-4000	4000	-191
chr10	101766109	101774109	101770388	8000	101770109	-4000	4000	279
chr10	117124521	117132521	117132219	8000	117128521	-4000	4000	3698
chr10	127873841	127881841	127878313	8000	127877841	-4000	4000	472
chr10	84227520	84235520	84234173	8000	84231520	-4000	4000	2653
chr10	49323492	49331492	49324129	8000	49327492	-4000	4000	-3363
chr10	49323492	49331492	49327115	8000	49327492	-4000	4000	-377
chr10	116473957	116481957	116476655	8000	116477957	-4000	4000	-1302
chr10	49323492	49331492	49324515	8000	49327492	-4000	4000	-2977
chr10	42888	50888	48649	8000	46888	-4000	4000	1761
chr10	15069853	15077853	15073243	8000	15073853	-4000	4000	-610
chr10	103449240	103457240	103449361	8000	103453240	-4000	4000	-3879
chr10	47353881	47361881	47355375	8000	47357881	-4000	4000	-2506
chr10	113584714	113592714	113589020	8000	113588714	-4000	4000	306
chr10	75090432	75098432	75094561	8000	75094432	-4000	4000	129
chr10	49127154	49135154	49132150	8000	49131154	-4000	4000	996
chr10	49323492	49331492	49325876	8000	49327492	-4000	4000	-1616
chr10	122693709	122701709	122698207	8000	122697709	-4000	4000	498
chr10	42888	50888	47164	8000	46888	-4000	4000	276
chr10	133127675	133135675	133129327	8000	133131675	-4000	4000	-2348
chr10	88775626	88783626	88778199	8000	88779626	-4000	4000	-1427
chr10	23190245	23198245	23193947	8000	23194245	-4000	4000	-298
chr10	127873841	127881841	127878163	8000	127877841	-4000	4000	322
chr10	47323588	47331588	47325503	8000	47327588	-4000	4000	-2085
chr10	102826531	102834531	102830766	8000	102830531	-4000	4000	235
chr10	90908096	90916096	90912908	8000	90912096	-4000	4000	812
chr10	127737183	127745183	127738601	8000	127741183	-4000	4000	-2582
chr10	131088391	131096391	131092533	8000	131092391	-4000	4000	142
chr10	45298298	45306298	45304074	8000	45302298	-4000	4000	1776
chr10	100479744	100487744	100479955	8000	100483744	-4000	4000	-3789
chr10	75033472	75041472	75038057	8000	75037472	-4000	4000	585
chr10	122693709	122701709	122697853	8000	122697709	-4000	4000	144
chr10	94986091	94994091	94986105	8000	94990091	-4000	4000	-3986
chr10	93662010	93670010	93663067	8000	93666010	-4000	4000	-2943
chr10	48905483	48913483	48910034	8000	48909483	-4000	4000	551
chr10	84227520	84235520	84234346	8000	84231520	-4000	4000	2826
chr10	117206299	117214299	117209831	8000	117210299	-4000	4000	-468
chr10	89381205	89389205	89383685	8000	89385205	-4000	4000	-1520
chr10	30607779	30615779	30611959	8000	30611779	-4000	4000	180
chr10	116473957	116481957	116476713	8000	116477957	-4000	4000	-1244
chr10	103449240	103457240	103455643	8000	103453240	-4000	4000	2403
chr10	101766109	101774109	101770551	8000	101770109	-4000	4000	442
chr10	15069853	15077853	15073238	8000	15073853	-4000	4000	-615
chr10	95224928	95232928	95228901	8000	95228928	-4000	4000	-27
chr10	103468804	103476804	103473537	8000	103472804	-4000	4000	733
chr10	102226186	102234186	102229004	8000	102230186	-4000	4000	-1182
chr10	122909111	122917111	122912951	8000	122913111	-4000	4000	-160
chr10	43372335	43380335	43373650	8000	43376335	-4000	4000	-2685
chr10	48905483	48913483	48910220	8000	48909483	-4000	4000	737
chr10	52761380	52769380	52768268	8000	52765380	-4000	4000	2888
chr10	84216571	84224571	84222257	8000	84220571	-4000	4000	1686
chr10	94986091	94994091	94988927	8000	94990091	-4000	4000	-1164
chr10	79611455	79619455	79613962	8000	79615455	-4000	4000	-1493
chr10	69567698	69575698	69573000	8000	69571698	-4000	4000	1302
chr10	116605175	116613175	116609091	8000	116609175	-4000	4000	-84
chr10	47361496	47369496	47368256	8000	47365496	-4000	4000	2760
chr10	102226186	102234186	102230230	8000	102230186	-4000	4000	44
chr10	102226186	102234186	102226488	8000	102230186	-4000	4000	-3698
chr10	45298298	45306298	45303768	8000	45302298	-4000	4000	1470
chr10	46457099	46465099	46462654	8000	46461099	-4000	4000	1555
chr10	100479744	100487744	100479912	8000	100483744	-4000	4000	-3832
chr10	105261242	105269242	105263559	8000	105265242	-4000	4000	-1683
chr10	75090432	75098432	75094765	8000	75094432	-4000	4000	333
chr10	113584714	113592714	113592211	8000	113588714	-4000	4000	3497
chr10	113584714	113592714	113592212	8000	113588714	-4000	4000	3498
chr10	48149088	48157088	48157074	8000	48153088	-4000	4000	3986
chr10	95224928	95232928	95228923	8000	95228928	-4000	4000	-5
chr10	49323492	49331492	49324265	8000	49327492	-4000	4000	-3227
chr10	70427936	70435936	70435786	8000	70431936	-4000	4000	3850
chr10	68226595	68234595	68231345	8000	68230595	-4000	4000	750
chr10	117206299	117214299	117209907	8000	117210299	-4000	4000	-392
chr10	122693709	122701709	122699643	8000	122697709	-4000	4000	1934
chr10	35604935	35612935	35607720	8000	35608935	-4000	4000	-1215
chr10	16509734	16517734	16512809	8000	16513734	-4000	4000	-925
chr10	94986091	94994091	94989033	8000	94990091	-4000	4000	-1058
chr10	101222994	101230994	101227771	8000	101226994	-4000	4000	777
chr10	102226186	102234186	102230492	8000	102230186	-4000	4000	306
chr10	102226186	102234186	102230671	8000	102230186	-4000	4000	485
chr10	102226186	102234186	102230872	8000	102230186	-4000	4000	686
chr10	102226186	102234186	102231024	8000	102230186	-4000	4000	838
chr10	53798771	53806771	53806745	8000	53802771	-4000	4000	3974
chr10	103449240	103457240	103455553	8000	103453240	-4000	4000	2313
chr10	49706261	49714261	49708621	8000	49710261	-4000	4000	-1640
chr10	49127154	49135154	49133834	8000	49131154	-4000	4000	2680
chr10	80642560	80650560	80646306	8000	80646560	-4000	4000	-254
chr10	87020730	87028730	87024638	8000	87024730	-4000	4000	-92
chr10	90908096	90916096	90915575	8000	90912096	-4000	4000	3479
chr10	88748776	88756776	88752600	8000	88752776	-4000	4000	-176
chr10	49127154	49135154	49131957	8000	49131154	-4000	4000	803
chr10	127873841	127881841	127878359	8000	127877841	-4000	4000	518
chr10	42888	50888	47210	8000	46888	-4000	4000	322
chr10	117206299	117214299	117209890	8000	117210299	-4000	4000	-409
chr10	93662010	93670010	93662098	8000	93666010	-4000	4000	-3912
chr10	47323588	47331588	47325788	8000	47327588	-4000	4000	-1800
chr10	35604935	35612935	35605595	8000	35608935	-4000	4000	-3340
chr10	68208017	68216017	68210655	8000	68212017	-4000	4000	-1362
chr10	70767238	70775238	70771384	8000	70771238	-4000	4000	146
chr10	82983179	82991179	82985232	8000	82987179	-4000	4000	-1947
chr10	90908096	90916096	90912885	8000	90912096	-4000	4000	789
chr10	95224928	95232928	95228749	8000	95228928	-4000	4000	-179
chr10	96339221	96347221	96345830	8000	96343221	-4000	4000	2609
chr10	102826531	102834531	102832618	8000	102830531	-4000	4000	2087
chr10	117124521	117132521	117132183	8000	117128521	-4000	4000	3662
chr10	122693709	122701709	122699739	8000	122697709	-4000	4000	2030
chr10	84255960	84263960	84258559	8000	84259960	-4000	4000	-1401
chr10	102226186	102234186	102227663	8000	102230186	-4000	4000	-2523
chr10	122909111	122917111	122911712	8000	122913111	-4000	4000	-1399
chr10	104451102	104459102	104454487	8000	104455102	-4000	4000	-615
chr10	46457099	46465099	46462595	8000	46461099	-4000	4000	1496
chr10	49323492	49331492	49323822	8000	49327492	-4000	4000	-3670
chr10	49323492	49331492	49324151	8000	49327492	-4000	4000	-3341
chr10	100284149	100292149	100290084	8000	100288149	-4000	4000	1935
chr10	102226186	102234186	102226608	8000	102230186	-4000	4000	-3578
chr10	122334159	122342159	122334897	8000	122338159	-4000	4000	-3262
chr10	70427936	70435936	70432765	8000	70431936	-4000	4000	829
chr10	80642560	80650560	80644155	8000	80646560	-4000	4000	-2405
chr10	82983179	82991179	82985518	8000	82987179	-4000	4000	-1661
chr10	70427936	70435936	70435507	8000	70431936	-4000	4000	3571
chr10	84181294	84189294	84184681	8000	84185294	-4000	4000	-613
chr10	49706261	49714261	49708784	8000	49710261	-4000	4000	-1477
chr10	100284149	100292149	100290067	8000	100288149	-4000	4000	1918
chr10	116376029	116384029	116379529	8000	116380029	-4000	4000	-500
chr10	49706261	49714261	49708421	8000	49710261	-4000	4000	-1840
chr10	82983179	82991179	82985207	8000	82987179	-4000	4000	-1972
chr10	84227520	84235520	84232433	8000	84231520	-4000	4000	913
chr10	69567698	69575698	69572880	8000	69571698	-4000	4000	1182
chr10	47361496	47369496	47368143	8000	47365496	-4000	4000	2647
chr10	69567698	69575698	69572806	8000	69571698	-4000	4000	1108
chr10	79611455	79619455	79615060	8000	79615455	-4000	4000	-395
chr10	79611455	79619455	79613247	8000	79615455	-4000	4000	-2208
chr10	45298298	45306298	45304316	8000	45302298	-4000	4000	2018
chr10	24977979	24985979	24984816	8000	24981979	-4000	4000	2837
chr10	49127154	49135154	49132091	8000	49131154	-4000	4000	937
chr10	47323588	47331588	47325643	8000	47327588	-4000	4000	-1945
chr10	26300558	26308558	26300941	8000	26304558	-4000	4000	-3617
chr10	72930762	72938762	72932559	8000	72934762	-4000	4000	-2203
chr10	94849073	94857073	94850013	8000	94853073	-4000	4000	-3060
chr10	122693709	122701709	122698090	8000	122697709	-4000	4000	381
chr10	72930762	72938762	72932471	8000	72934762	-4000	4000	-2291
chr10	90736823	90744823	90742248	8000	90740823	-4000	4000	1425
chr10	102226186	102234186	102230351	8000	102230186	-4000	4000	165
chr10	42888	50888	48714	8000	46888	-4000	4000	1826
chr10	97762751	97770751	97767693	8000	97766751	-4000	4000	942
chr10	84255960	84263960	84258703	8000	84259960	-4000	4000	-1257
chr10	102226186	102234186	102229216	8000	102230186	-4000	4000	-970
chr10	126420997	126428997	126425843	8000	126424997	-4000	4000	846
chr10	70767238	70775238	70771502	8000	70771238	-4000	4000	264
chr10	116376029	116384029	116378490	8000	116380029	-4000	4000	-1539
chr10	100284149	100292149	100286145	8000	100288149	-4000	4000	-2004
chr10	49323492	49331492	49324219	8000	49327492	-4000	4000	-3273
chr10	117206299	117214299	117209918	8000	117210299	-4000	4000	-381
chr10	49706261	49714261	49708616	8000	49710261	-4000	4000	-1645
chr10	46457099	46465099	46462338	8000	46461099	-4000	4000	1239
chr10	99532524	99540524	99535016	8000	99536524	-4000	4000	-1508
chr10	117124521	117132521	117132233	8000	117128521	-4000	4000	3712
chr10	50007654	50015654	50009894	8000	50011654	-4000	4000	-1760
chr10	84255960	84263960	84258642	8000	84259960	-4000	4000	-1318
chr10	88775626	88783626	88778099	8000	88779626	-4000	4000	-1527
chr10	94849073	94857073	94852880	8000	94853073	-4000	4000	-193
chr10	117124521	117132521	117132201	8000	117128521	-4000	4000	3680
chr11	92981066	92989066	92981726	8000	92985066	-4000	4000	-3340
chr11	7953537	7961537	7959977	8000	7957537	-4000	4000	2440
chr11	94304146	94312146	94306634	8000	94308146	-4000	4000	-1512
chr11	5995445	6003445	6002681	8000	5999445	-4000	4000	3236
chr11	7087148	7095148	7090251	8000	7091148	-4000	4000	-897
chr11	67514912	67522912	67518990	8000	67518912	-4000	4000	78
chr11	92981066	92989066	92981694	8000	92985066	-4000	4000	-3372
chr11	4676171	4684171	4681939	8000	4680171	-4000	4000	1768
chr11	66422707	66430707	66423875	8000	66426707	-4000	4000	-2832
chr11	54703902	54711902	54707054	8000	54707902	-4000	4000	-848
chr11	116829072	116837072	116835925	8000	116833072	-4000	4000	2853
chr11	6165355	6173355	6170149	8000	6169355	-4000	4000	794
chr11	612577	620577	613081	8000	616577	-4000	4000	-3496
chr11	6165355	6173355	6169366	8000	6169355	-4000	4000	11
chr11	36571574	36579574	36578482	8000	36575574	-4000	4000	2908
chr11	124019948	124027948	124023705	8000	124023948	-4000	4000	-243
chr11	7087148	7095148	7089234	8000	7091148	-4000	4000	-1914
chr11	54599069	54607069	54603129	8000	54603069	-4000	4000	60
chr11	55551419	55559419	55554516	8000	55555419	-4000	4000	-903
chr11	30231261	30239261	30233690	8000	30235261	-4000	4000	-1571
chr11	46379789	46387789	46386513	8000	46383789	-4000	4000	2724
chr11	55364918	55372918	55368016	8000	55368918	-4000	4000	-902
chr11	55662195	55670195	55665186	8000	55666195	-4000	4000	-1009
chr11	57368396	57376396	57368400	8000	57372396	-4000	4000	-3996
chr11	57739514	57747514	57744396	8000	57743514	-4000	4000	882
chr11	77212558	77220558	77212960	8000	77216558	-4000	4000	-3598
chr11	94304146	94312146	94305776	8000	94308146	-4000	4000	-2370
chr11	112244153	112252153	112248929	8000	112248153	-4000	4000	776
chr11	66422707	66430707	66424673	8000	66426707	-4000	4000	-2034
chr11	19050455	19058455	19055655	8000	19054455	-4000	4000	1200
chr11	111533043	111541043	111536727	8000	111537043	-4000	4000	-316
chr11	2400515	2408515	2403557	8000	2404515	-4000	4000	-958
chr11	6787558	6795558	6795005	8000	6791558	-4000	4000	3447
chr11	36571574	36579574	36575783	8000	36575574	-4000	4000	209
chr11	55887810	55895810	55889990	8000	55891810	-4000	4000	-1820
chr11	61247444	61255444	61249666	8000	61251444	-4000	4000	-1778
chr11	66422707	66430707	66424709	8000	66426707	-4000	4000	-1998
chr11	5043461	5051461	5046985	8000	5047461	-4000	4000	-476
chr11	58212084	58220084	58215206	8000	58216084	-4000	4000	-878
chr11	56272819	56280819	56276105	8000	56276819	-4000	4000	-714
chr11	57546272	57554272	57546547	8000	57550272	-4000	4000	-3725
chr11	6842636	6850636	6846399	8000	6846636	-4000	4000	-237
chr11	56103658	56111658	56105462	8000	56107658	-4000	4000	-2196
chr11	59453905	59461905	59457560	8000	59457905	-4000	4000	-345
chr11	56413258	56421258	56417860	8000	56417258	-4000	4000	602
chr11	90038025	90046025	90041276	8000	90042025	-4000	4000	-749
chr11	54703902	54711902	54707116	8000	54707902	-4000	4000	-786
chr11	55364918	55372918	55367922	8000	55368918	-4000	4000	-996
chr11	30005730	30013730	30012176	8000	30009730	-4000	4000	2446
chr11	56227282	56235282	56233123	8000	56231282	-4000	4000	1841
chr11	56284462	56292462	56290990	8000	56288462	-4000	4000	2528
chr11	58177616	58185616	58180086	8000	58181616	-4000	4000	-1530
chr11	5995445	6003445	6002554	8000	5999445	-4000	4000	3109
chr11	48213739	48221739	48217489	8000	48217739	-4000	4000	-250
chr11	59500511	59508511	59504092	8000	59504511	-4000	4000	-419
chr11	104035196	104043196	104036887	8000	104039196	-4000	4000	-2309
chr11	108304519	108312519	108310284	8000	108308519	-4000	4000	1765
chr11	124014732	124022732	124015988	8000	124018732	-4000	4000	-2744
chr11	20152155	20160155	20159206	8000	20156155	-4000	4000	3051
chr11	125787600	125795600	125789422	8000	125791600	-4000	4000	-2178
chr11	30005730	30013730	30011770	8000	30009730	-4000	4000	2040
chr11	55835738	55843738	55839548	8000	55839738	-4000	4000	-190
chr11	71577855	71585855	71582340	8000	71581855	-4000	4000	485
chr11	5485749	5493749	5489170	8000	5489749	-4000	4000	-579
chr11	56249222	56257222	56253174	8000	56253222	-4000	4000	-48
chr11	5947347	5955347	5947946	8000	5951347	-4000	4000	-3401
chr11	59453905	59461905	59457417	8000	59457905	-4000	4000	-488
chr11	66422707	66430707	66424914	8000	66426707	-4000	4000	-1793
chr11	5782471	5790471	5788670	8000	5786471	-4000	4000	2199
chr11	126419358	126427358	126424782	8000	126423358	-4000	4000	1424
chr11	58354124	58362124	58358135	8000	58358124	-4000	4000	11
chr11	116785367	116793367	116787047	8000	116789367	-4000	4000	-2320
chr11	47327406	47335406	47328682	8000	47331406	-4000	4000	-2724
chr11	64115173	64123173	64116390	8000	64119173	-4000	4000	-2783
chr11	107959482	107967482	107962334	8000	107963482	-4000	4000	-1148
chr11	56413258	56421258	56417563	8000	56417258	-4000	4000	305
chr11	55551419	55559419	55554459	8000	55555419	-4000	4000	-960
chr11	56272819	56280819	56275754	8000	56276819	-4000	4000	-1065
chr11	102707796	102715796	102714647	8000	102711796	-4000	4000	2851
chr11	4988431	4996431	4989741	8000	4992431	-4000	4000	-2690
chr11	5195735	5203735	5200057	8000	5199735	-4000	4000	322
chr11	47433764	47441764	47441730	8000	47437764	-4000	4000	3966
chr11	56272819	56280819	56276316	8000	56276819	-4000	4000	-503
chr11	7953537	7961537	7960624	8000	7957537	-4000	4000	3087
chr11	55824154	55832154	55827628	8000	55828154	-4000	4000	-526
chr11	622309	630309	626464	8000	626309	-4000	4000	155
chr11	5348446	5356446	5351819	8000	5352446	-4000	4000	-627
chr11	128832315	128840315	128839347	8000	128836315	-4000	4000	3032
chr11	123972661	123980661	123976903	8000	123976661	-4000	4000	242
chr11	5817483	5825483	5821174	8000	5821483	-4000	4000	-309
chr11	64115173	64123173	64117422	8000	64119173	-4000	4000	-1751
chr11	55569060	55577060	55572345	8000	55573060	-4000	4000	-715
chr11	60392596	60400596	60397951	8000	60396596	-4000	4000	1355
chr11	124032013	124040013	124038950	8000	124036013	-4000	4000	2937
chr11	114517645	114525645	114522195	8000	114521645	-4000	4000	550
chr11	124535635	124543635	124542771	8000	124539635	-4000	4000	3136
chr11	294200	302200	299462	8000	298200	-4000	4000	1262
chr11	36571574	36579574	36575671	8000	36575574	-4000	4000	97
chr11	59453905	59461905	59457606	8000	59457905	-4000	4000	-299
chr11	88500576	88508576	88508424	8000	88504576	-4000	4000	3848
chr11	56538340	56546340	56542916	8000	56542340	-4000	4000	576
chr11	622309	630309	624855	8000	626309	-4000	4000	-1454
chr11	124032013	124040013	124038740	8000	124036013	-4000	4000	2727
chr11	30005730	30013730	30012653	8000	30009730	-4000	4000	2923
chr11	58262792	58270792	58267896	8000	58266792	-4000	4000	1104
chr11	64930471	64938471	64931759	8000	64934471	-4000	4000	-2712
chr11	64930471	64938471	64931760	8000	64934471	-4000	4000	-2711
chr11	56272819	56280819	56275657	8000	56276819	-4000	4000	-1162
chr11	64930471	64938471	64932887	8000	64934471	-4000	4000	-1584
chr11	124433445	124441445	124440570	8000	124437445	-4000	4000	3125
chr11	4950772	4958772	4955453	8000	4954772	-4000	4000	681
chr11	5883079	5891079	5884577	8000	5887079	-4000	4000	-2502
chr11	783115	791115	788469	8000	787115	-4000	4000	1354
chr11	6207135	6215135	6211531	8000	6211135	-4000	4000	396
chr11	55909650	55917650	55913938	8000	55913650	-4000	4000	288
chr11	60044044	60052044	60047032	8000	60048044	-4000	4000	-1012
chr11	72235077	72243077	72238372	8000	72239077	-4000	4000	-705
chr11	113683547	113691547	113688048	8000	113687547	-4000	4000	501
chr11	5195735	5203735	5200596	8000	5199735	-4000	4000	861
chr11	7791974	7799974	7796409	8000	7795974	-4000	4000	435
chr11	30005730	30013730	30012263	8000	30009730	-4000	4000	2533
chr11	47585194	47593194	47589947	8000	47589194	-4000	4000	753
chr11	56173556	56181556	56177353	8000	56177556	-4000	4000	-203
chr11	124535635	124543635	124543148	8000	124539635	-4000	4000	3513
chr11	612577	620577	619328	8000	616577	-4000	4000	2751
chr11	5817483	5825483	5821095	8000	5821483	-4000	4000	-388
chr11	7820818	7828818	7825161	8000	7824818	-4000	4000	343
chr11	20152155	20160155	20156346	8000	20156155	-4000	4000	191
chr11	55364918	55372918	55368481	8000	55368918	-4000	4000	-437
chr11	56103658	56111658	56105379	8000	56107658	-4000	4000	-2279
chr11	56284462	56292462	56290299	8000	56288462	-4000	4000	1837
chr11	56284462	56292462	56290867	8000	56288462	-4000	4000	2405
chr11	56342998	56350998	56346534	8000	56346998	-4000	4000	-464
chr11	56538340	56546340	56543171	8000	56542340	-4000	4000	831
chr11	61247444	61255444	61250000	8000	61251444	-4000	4000	-1444
chr11	64296031	64304031	64297228	8000	64300031	-4000	4000	-2803
chr11	71545608	71553608	71548869	8000	71549608	-4000	4000	-739
chr11	124026634	124034634	124029631	8000	124030634	-4000	4000	-1003
chr11	14962668	14970668	14967761	8000	14966668	-4000	4000	1093
chr11	6268127	6276127	6270300	8000	6272127	-4000	4000	-1827
chr11	69805968	69813968	69810515	8000	69809968	-4000	4000	547
chr11	71545608	71553608	71548647	8000	71549608	-4000	4000	-961
chr11	56699884	56707884	56700682	8000	56703884	-4000	4000	-3202
chr11	58199202	58207202	58203593	8000	58203202	-4000	4000	391
chr11	61254286	61262286	61258974	8000	61258286	-4000	4000	688
chr11	5124776	5132776	5131959	8000	5128776	-4000	4000	3183
chr11	48242015	48250015	48245918	8000	48246015	-4000	4000	-97
chr11	4639060	4647060	4640243	8000	4643060	-4000	4000	-2817
chr11	4764979	4772979	4769289	8000	4768979	-4000	4000	310
chr11	6207135	6215135	6214862	8000	6211135	-4000	4000	3727
chr11	18929499	18937499	18934652	8000	18933499	-4000	4000	1153
chr11	48485722	48493722	48489455	8000	48489722	-4000	4000	-267
chr11	55551419	55559419	55554845	8000	55555419	-4000	4000	-574
chr11	124433445	124441445	124440152	8000	124437445	-4000	4000	2707
chr11	18723928	18731928	18728807	8000	18727928	-4000	4000	879
chr11	58190053	58198053	58191057	8000	58194053	-4000	4000	-2996
chr11	58398464	58406464	58402894	8000	58402464	-4000	4000	430
chr11	95023596	95031596	95025536	8000	95027596	-4000	4000	-2060
chr11	66422707	66430707	66424448	8000	66426707	-4000	4000	-2259
chr11	7087148	7095148	7090285	8000	7091148	-4000	4000	-863
chr11	56372553	56380553	56376216	8000	56376553	-4000	4000	-337
chr11	56605236	56613236	56613017	8000	56609236	-4000	4000	3781
chr11	4938831	4946831	4946569	8000	4942831	-4000	4000	3738
chr11	55598360	55606360	55603975	8000	55602360	-4000	4000	1615
chr11	56699884	56707884	56700528	8000	56703884	-4000	4000	-3356
chr11	30005730	30013730	30012170	8000	30009730	-4000	4000	2440
chr11	55364918	55372918	55368200	8000	55368918	-4000	4000	-718
chr11	5250392	5258392	5254373	8000	5254392	-4000	4000	-19
chr11	55662195	55670195	55665509	8000	55666195	-4000	4000	-686
chr11	1616958	1624958	1621829	8000	1620958	-4000	4000	871
chr11	95047338	95055338	95049982	8000	95051338	-4000	4000	-1356
chr11	46379789	46387789	46385355	8000	46383789	-4000	4000	1566
chr11	64296031	64304031	64300733	8000	64300031	-4000	4000	702
chr11	64300770	64308770	64304566	8000	64304770	-4000	4000	-204
chr11	60871693	60879693	60875196	8000	60875693	-4000	4000	-497
chr11	57368396	57376396	57369901	8000	57372396	-4000	4000	-2495
chr11	59475361	59483361	59478015	8000	59479361	-4000	4000	-1346
chr11	59825273	59833273	59829463	8000	59829273	-4000	4000	190
chr11	77212558	77220558	77217230	8000	77216558	-4000	4000	672
chr11	124026634	124034634	124030357	8000	124030634	-4000	4000	-277
chr11	58417238	58425238	58423099	8000	58421238	-4000	4000	1861
chr11	3634512	3642512	3638737	8000	3638512	-4000	4000	225
chr11	4988431	4996431	4990595	8000	4992431	-4000	4000	-1836
chr11	56699884	56707884	56700719	8000	56703884	-4000	4000	-3165
chr11	59475361	59483361	59477587	8000	59479361	-4000	4000	-1774
chr11	116829072	116837072	116836282	8000	116833072	-4000	4000	3210
chr11	7791974	7799974	7796045	8000	7795974	-4000	4000	71
chr11	116816700	116824700	116821686	8000	116820700	-4000	4000	986
chr11	4639060	4647060	4640554	8000	4643060	-4000	4000	-2506
chr11	19050455	19058455	19055508	8000	19054455	-4000	4000	1053
chr11	56572774	56580774	56577363	8000	56576774	-4000	4000	589
chr11	49949419	49957419	49953029	8000	49953419	-4000	4000	-390
chr11	56090240	56098240	56093774	8000	56094240	-4000	4000	-466
chr11	55808476	55816476	55812361	8000	55812476	-4000	4000	-115
chr11	57546272	57554272	57550119	8000	57550272	-4000	4000	-153
chr11	57546272	57554272	57550120	8000	57550272	-4000	4000	-152
chr11	55931456	55939456	55935959	8000	55935456	-4000	4000	503
chr11	55931456	55939456	55935632	8000	55935456	-4000	4000	176
chr11	5124776	5132776	5132066	8000	5128776	-4000	4000	3290
chr11	48242015	48250015	48245413	8000	48246015	-4000	4000	-602
chr11	14962668	14970668	14970076	8000	14966668	-4000	4000	3408
chr11	104035196	104043196	104037604	8000	104039196	-4000	4000	-1592
chr11	55598360	55606360	55603982	8000	55602360	-4000	4000	1622
chr11	60871693	60879693	60875553	8000	60875693	-4000	4000	-140
chr11	101886674	101894674	101891354	8000	101890674	-4000	4000	680
chr11	85679848	85687848	85686135	8000	85683848	-4000	4000	2287
chr11	58354124	58362124	58358504	8000	58358124	-4000	4000	380
chr11	4446361	4454361	4449621	8000	4450361	-4000	4000	-740
chr11	7791974	7799974	7796722	8000	7795974	-4000	4000	748
chr11	3634512	3642512	3641887	8000	3638512	-4000	4000	3375
chr11	4542144	4550144	4545693	8000	4546144	-4000	4000	-451
chr11	30005730	30013730	30012521	8000	30009730	-4000	4000	2791
chr11	56342998	56350998	56346554	8000	56346998	-4000	4000	-444
chr11	6917994	6925994	6921639	8000	6921994	-4000	4000	-355
chr11	4908588	4916588	4915252	8000	4912588	-4000	4000	2664
chr11	55648854	55656854	55651572	8000	55652854	-4000	4000	-1282
chr11	55808476	55816476	55811975	8000	55812476	-4000	4000	-501
chr11	14962668	14970668	14968639	8000	14966668	-4000	4000	1971
chr11	30231261	30239261	30233925	8000	30235261	-4000	4000	-1336
chr11	66422707	66430707	66422742	8000	66426707	-4000	4000	-3965
chr11	48242015	48250015	48245919	8000	48246015	-4000	4000	-96
chr11	6761626	6769626	6768358	8000	6765626	-4000	4000	2732
chr11	56413258	56421258	56417334	8000	56417258	-4000	4000	76
chr11	66422707	66430707	66424382	8000	66426707	-4000	4000	-2325
chr11	18929499	18937499	18934393	8000	18933499	-4000	4000	894
chr11	56284462	56292462	56290869	8000	56288462	-4000	4000	2407
chr11	18170280	18178280	18174021	8000	18174280	-4000	4000	-259
chr11	5348446	5356446	5352088	8000	5352446	-4000	4000	-358
chr11	18929499	18937499	18934608	8000	18933499	-4000	4000	1109
chr11	123749580	123757580	123753855	8000	123753580	-4000	4000	275
chr11	4844237	4852237	4848528	8000	4848237	-4000	4000	291
chr11	55835738	55843738	55838862	8000	55839738	-4000	4000	-876
chr11	6240479	6248479	6240692	8000	6244479	-4000	4000	-3787
chr11	55551419	55559419	55555042	8000	55555419	-4000	4000	-377
chr11	77212558	77220558	77217269	8000	77216558	-4000	4000	711
chr11	105133714	105141714	105138932	8000	105137714	-4000	4000	1218
chr11	123905229	123913229	123906501	8000	123909229	-4000	4000	-2728
chr11	5419206	5427206	5422670	8000	5423206	-4000	4000	-536
chr11	58223882	58231882	58228283	8000	58227882	-4000	4000	401
chr11	6787558	6795558	6794637	8000	6791558	-4000	4000	3079
chr11	56372553	56380553	56376149	8000	56376553	-4000	4000	-404
chr11	102687487	102695487	102693995	8000	102691487	-4000	4000	2508
chr11	124019948	124027948	124023881	8000	124023948	-4000	4000	-67
chr11	6887574	6895574	6892330	8000	6891574	-4000	4000	756
chr11	64598353	64606353	64600861	8000	64602353	-4000	4000	-1492
chr11	94373316	94381316	94380759	8000	94377316	-4000	4000	3443
chr11	3660416	3668416	3666475	8000	3664416	-4000	4000	2059
chr11	5054650	5062650	5059317	8000	5058650	-4000	4000	667
chr11	55770382	55778382	55774287	8000	55774382	-4000	4000	-95
chr11	126419358	126427358	126424924	8000	126423358	-4000	4000	1566
chr11	4639060	4647060	4640417	8000	4643060	-4000	4000	-2643
chr11	55551419	55559419	55554409	8000	55555419	-4000	4000	-1010
chr11	55792500	55800500	55795579	8000	55796500	-4000	4000	-921
chr11	64933517	64941517	64935355	8000	64937517	-4000	4000	-2162
chr11	66559334	66567334	66564108	8000	66563334	-4000	4000	774
chr11	55931456	55939456	55935645	8000	55935456	-4000	4000	189
chr11	125745867	125753867	125747747	8000	125749867	-4000	4000	-2120
chr11	6165355	6173355	6169513	8000	6169355	-4000	4000	158
chr11	54599069	54607069	54603203	8000	54603069	-4000	4000	134
chr11	55835738	55843738	55839612	8000	55839738	-4000	4000	-126
chr11	63406294	63414294	63408736	8000	63410294	-4000	4000	-1558
chr11	3660416	3668416	3666525	8000	3664416	-4000	4000	2109
chr11	20152155	20160155	20159243	8000	20156155	-4000	4000	3088
chr11	58502807	58510807	58507410	8000	58506807	-4000	4000	603
chr11	123749580	123757580	123754145	8000	123753580	-4000	4000	565
chr11	62292281	62300281	62297597	8000	62296281	-4000	4000	1316
chr11	56173556	56181556	56177282	8000	56177556	-4000	4000	-274
chr11	55887810	55895810	55891153	8000	55891810	-4000	4000	-657
chr11	113396416	113404416	113399329	8000	113400416	-4000	4000	-1087
chr11	7087148	7095148	7090727	8000	7091148	-4000	4000	-421
chr11	66422707	66430707	66424673	8000	66426707	-4000	4000	-2034
chr11	56737223	56745223	56743460	8000	56741223	-4000	4000	2237
chr11	4764979	4772979	4769175	8000	4768979	-4000	4000	196
chr11	48242015	48250015	48245211	8000	48246015	-4000	4000	-804
chr11	71562735	71570735	71565859	8000	71566735	-4000	4000	-876
chr11	59708916	59716916	59713561	8000	59712916	-4000	4000	645
chr11	125772113	125780113	125777311	8000	125776113	-4000	4000	1198
chr11	5195735	5203735	5199859	8000	5199735	-4000	4000	124
chr11	56103658	56111658	56105365	8000	56107658	-4000	4000	-2293
chr11	77212558	77220558	77214738	8000	77216558	-4000	4000	-1820
chr11	71577855	71585855	71582130	8000	71581855	-4000	4000	275
chr11	125836072	125844072	125838404	8000	125840072	-4000	4000	-1668
chr11	14962668	14970668	14968871	8000	14966668	-4000	4000	2203
chr11	48242015	48250015	48245608	8000	48246015	-4000	4000	-407
chr11	55909650	55917650	55913689	8000	55913650	-4000	4000	39
chr11	5963177	5971177	5967923	8000	5967177	-4000	4000	746
chr11	48485722	48493722	48489644	8000	48489722	-4000	4000	-78
chr11	55364918	55372918	55368080	8000	55368918	-4000	4000	-838
chr11	55909650	55917650	55913842	8000	55913650	-4000	4000	192
chr11	55648854	55656854	55651777	8000	55652854	-4000	4000	-1077
chr11	5751958	5759958	5754852	8000	5755958	-4000	4000	-1106
chr11	56605236	56613236	56612971	8000	56609236	-4000	4000	3735
chr11	55961755	55969755	55968088	8000	55965755	-4000	4000	2333
chr11	5817483	5825483	5820602	8000	5821483	-4000	4000	-881
chr11	64568875	64576875	64569718	8000	64572875	-4000	4000	-3157
chr11	4938831	4946831	4946587	8000	4942831	-4000	4000	3756
chr11	68976021	68984021	68980467	8000	68980021	-4000	4000	446
chr11	22375503	22383503	22376029	8000	22379503	-4000	4000	-3474
chr11	48213739	48221739	48217427	8000	48217739	-4000	4000	-312
chr11	56284462	56292462	56290688	8000	56288462	-4000	4000	2226
chr11	65588836	65596836	65593122	8000	65592836	-4000	4000	286
chr11	49977473	49985473	49981726	8000	49981473	-4000	4000	253
chr11	58354124	58362124	58358713	8000	58358124	-4000	4000	589
chr11	64933517	64941517	64935162	8000	64937517	-4000	4000	-2355
chr11	4938831	4946831	4946301	8000	4942831	-4000	4000	3470
chr11	4639060	4647060	4640555	8000	4643060	-4000	4000	-2505
chr11	5751958	5759958	5755672	8000	5755958	-4000	4000	-286
chr11	30005730	30013730	30012400	8000	30009730	-4000	4000	2670
chr11	124019948	124027948	124023171	8000	124023948	-4000	4000	-777
chr11	58434994	58442994	58440103	8000	58438994	-4000	4000	1109
chr11	7920592	7928592	7928164	8000	7924592	-4000	4000	3572
chr11	56249222	56257222	56252395	8000	56253222	-4000	4000	-827
chr11	123905229	123913229	123906762	8000	123909229	-4000	4000	-2467
chr11	4363263	4371263	4367483	8000	4367263	-4000	4000	220
chr11	4542144	4550144	4545577	8000	4546144	-4000	4000	-567
chr11	5043461	5051461	5046641	8000	5047461	-4000	4000	-820
chr11	63406294	63414294	63408127	8000	63410294	-4000	4000	-2167
chr11	119186223	119194223	119189577	8000	119190223	-4000	4000	-646
chr11	60392596	60400596	60397975	8000	60396596	-4000	4000	1379
chr11	124616356	124624356	124619794	8000	124620356	-4000	4000	-562
chr11	281388	289388	284398	8000	285388	-4000	4000	-990
chr11	45902513	45910513	45903052	8000	45906513	-4000	4000	-3461
chr11	55648854	55656854	55651163	8000	55652854	-4000	4000	-1691
chr11	56605236	56613236	56613069	8000	56609236	-4000	4000	3833
chr11	58199202	58207202	58203867	8000	58203202	-4000	4000	665
chr11	4908588	4916588	4915527	8000	4912588	-4000	4000	2939
chr11	114703069	114711069	114706907	8000	114707069	-4000	4000	-162
chr11	116829072	116837072	116837003	8000	116833072	-4000	4000	3931
chr11	122973570	122981570	122979432	8000	122977570	-4000	4000	1862
chr11	55648854	55656854	55651378	8000	55652854	-4000	4000	-1476
chr11	4950772	4958772	4955696	8000	4954772	-4000	4000	924
chr11	58398464	58406464	58402882	8000	58402464	-4000	4000	418
chr11	60797305	60805305	60798456	8000	60801305	-4000	4000	-2849
chr11	123972661	123980661	123977575	8000	123976661	-4000	4000	914
chr11	5963177	5971177	5968074	8000	5967177	-4000	4000	897
chr11	6787558	6795558	6794888	8000	6791558	-4000	4000	3330
chr11	64115173	64123173	64117491	8000	64119173	-4000	4000	-1682
chr11	56342998	56350998	56346915	8000	56346998	-4000	4000	-83
chr11	18170280	18178280	18173312	8000	18174280	-4000	4000	-968
chr11	4988431	4996431	4992267	8000	4992431	-4000	4000	-164
chr11	55816571	55824571	55820018	8000	55820571	-4000	4000	-553
chr11	56272819	56280819	56276461	8000	56276819	-4000	4000	-358
chr11	4988431	4996431	4991482	8000	4992431	-4000	4000	-949
chr11	56249222	56257222	56252484	8000	56253222	-4000	4000	-738
chr11	294200	302200	299396	8000	298200	-4000	4000	1196
chr11	6268127	6276127	6270935	8000	6272127	-4000	4000	-1192
chr11	104035196	104043196	104038059	8000	104039196	-4000	4000	-1137
chr11	123972661	123980661	123977488	8000	123976661	-4000	4000	827
chr11	58398464	58406464	58402792	8000	58402464	-4000	4000	328
chr11	56130721	56138721	56137596	8000	56134721	-4000	4000	2875
chr11	56130721	56138721	56137390	8000	56134721	-4000	4000	2669
chr11	133836631	133844631	133842517	8000	133840631	-4000	4000	1886
chr11	94304146	94312146	94305646	8000	94308146	-4000	4000	-2500
chr11	124019948	124027948	124023433	8000	124023948	-4000	4000	-515
chr11	6240479	6248479	6241691	8000	6244479	-4000	4000	-2788
chr11	6240479	6248479	6241692	8000	6244479	-4000	4000	-2787
chr11	66559334	66567334	66562124	8000	66563334	-4000	4000	-1210
chr11	90038025	90046025	90041170	8000	90042025	-4000	4000	-855
chr11	59500511	59508511	59504481	8000	59504511	-4000	4000	-30
chr11	56985843	56993843	56989680	8000	56989843	-4000	4000	-163
chr11	72135892	72143892	72139030	8000	72139892	-4000	4000	-862
chr11	1626707	1634707	1630577	8000	1630707	-4000	4000	-130
chr11	55569060	55577060	55572496	8000	55573060	-4000	4000	-564
chr11	58354124	58362124	58358741	8000	58358124	-4000	4000	617
chr11	55808476	55816476	55811652	8000	55812476	-4000	4000	-824
chr11	18929499	18937499	18933850	8000	18933499	-4000	4000	351
chr11	6787558	6795558	6794816	8000	6791558	-4000	4000	3258
chr11	55931456	55939456	55936336	8000	55935456	-4000	4000	880
chr11	58223882	58231882	58228538	8000	58227882	-4000	4000	656
chr11	4446361	4454361	4450036	8000	4450361	-4000	4000	-325
chr11	95023596	95031596	95026666	8000	95027596	-4000	4000	-930
chr11	4489497	4497497	4489597	8000	4493497	-4000	4000	-3900
chr11	20152155	20160155	20156493	8000	20156155	-4000	4000	338
chr11	85679848	85687848	85685546	8000	85683848	-4000	4000	1698
chr11	85679848	85687848	85685998	8000	85683848	-4000	4000	2150
chr11	4542144	4550144	4545727	8000	4546144	-4000	4000	-417
chr11	58177616	58185616	58180086	8000	58181616	-4000	4000	-1530
chr11	19050455	19058455	19055295	8000	19054455	-4000	4000	840
chr11	55961755	55969755	55967586	8000	55965755	-4000	4000	1831
chr11	56090240	56098240	56093820	8000	56094240	-4000	4000	-420
chr11	49977473	49985473	49981905	8000	49981473	-4000	4000	432
chr11	7920592	7928592	7928004	8000	7924592	-4000	4000	3412
chr11	56699884	56707884	56700855	8000	56703884	-4000	4000	-3029
chr11	48242015	48250015	48245246	8000	48246015	-4000	4000	-769
chr11	58502807	58510807	58507380	8000	58506807	-4000	4000	573
chr11	65955963	65963963	65959196	8000	65959963	-4000	4000	-767
chr11	2400515	2408515	2406052	8000	2404515	-4000	4000	1537
chr11	4799433	4807433	4804190	8000	4803433	-4000	4000	757
chr11	58223882	58231882	58228496	8000	58227882	-4000	4000	614
chr11	4676171	4684171	4682515	8000	4680171	-4000	4000	2344
chr11	89713872	89721872	89714333	8000	89717872	-4000	4000	-3539
chr11	65588836	65596836	65595620	8000	65592836	-4000	4000	2784
chr11	62419195	62427195	62423107	8000	62423195	-4000	4000	-88
chr11	58199202	58207202	58203379	8000	58203202	-4000	4000	177
chr11	20152155	20160155	20156641	8000	20156155	-4000	4000	486
chr11	58398464	58406464	58402840	8000	58402464	-4000	4000	376
chr11	8220309	8228309	8224590	8000	8224309	-4000	4000	281
chr11	123972661	123980661	123977157	8000	123976661	-4000	4000	496
chr11	55931456	55939456	55935610	8000	55935456	-4000	4000	154
chr11	124419942	124427942	124424702	8000	124423942	-4000	4000	760
chr11	4919374	4927374	4923606	8000	4923374	-4000	4000	232
chr11	6761626	6769626	6768541	8000	6765626	-4000	4000	2915
chr11	46379789	46387789	46386131	8000	46383789	-4000	4000	2342
chr11	54703902	54711902	54707739	8000	54707902	-4000	4000	-163
chr11	5772165	5780165	5778032	8000	5776165	-4000	4000	1867
chr11	124014732	124022732	124016491	8000	124018732	-4000	4000	-2241
chr11	123749580	123757580	123753846	8000	123753580	-4000	4000	266
chr11	119186223	119194223	119187675	8000	119190223	-4000	4000	-2548
chr11	64296031	64304031	64297129	8000	64300031	-4000	4000	-2902
chr11	5348446	5356446	5351818	8000	5352446	-4000	4000	-628
chr11	64296031	64304031	64297441	8000	64300031	-4000	4000	-2590
chr11	57739514	57747514	57740483	8000	57743514	-4000	4000	-3031
chr11	3634512	3642512	3638601	8000	3638512	-4000	4000	89
chr11	56372553	56380553	56376154	8000	56376553	-4000	4000	-399
chr11	104035196	104043196	104036828	8000	104039196	-4000	4000	-2368
chr11	30005730	30013730	30012183	8000	30009730	-4000	4000	2453
chr11	55636309	55644309	55638452	8000	55640309	-4000	4000	-1857
chr11	5852749	5860749	5857002	8000	5856749	-4000	4000	253
chr11	56357511	56365511	56360417	8000	56361511	-4000	4000	-1094
chr11	56413258	56421258	56417883	8000	56417258	-4000	4000	625
chr11	68976021	68984021	68980804	8000	68980021	-4000	4000	783
chr11	36571574	36579574	36577007	8000	36575574	-4000	4000	1433
chr11	57546272	57554272	57546641	8000	57550272	-4000	4000	-3631
chr11	57739514	57747514	57742971	8000	57743514	-4000	4000	-543
chr11	88500576	88508576	88507729	8000	88504576	-4000	4000	3153
chr11	124315262	124323262	124319886	8000	124319262	-4000	4000	624
chr11	5817483	5825483	5821264	8000	5821483	-4000	4000	-219
chr11	55808476	55816476	55812208	8000	55812476	-4000	4000	-268
chr11	56737223	56745223	56742947	8000	56741223	-4000	4000	1724
chr11	30005730	30013730	30011871	8000	30009730	-4000	4000	2141
chr11	196261	204261	198069	8000	200261	-4000	4000	-2192
chr11	56249222	56257222	56252963	8000	56253222	-4000	4000	-259
chr11	90038025	90046025	90041398	8000	90042025	-4000	4000	-627
chr11	36571574	36579574	36575035	8000	36575574	-4000	4000	-539
chr11	95023596	95031596	95027057	8000	95027596	-4000	4000	-539
chr11	55931456	55939456	55936037	8000	55935456	-4000	4000	581
chr11	124262224	124270224	124265120	8000	124266224	-4000	4000	-1104
chr11	56572774	56580774	56577440	8000	56576774	-4000	4000	666
chr11	4950772	4958772	4954849	8000	4954772	-4000	4000	77
chr11	18134488	18142488	18137283	8000	18138488	-4000	4000	-1205
chr11	55551419	55559419	55555048	8000	55555419	-4000	4000	-371
chr11	55909650	55917650	55914571	8000	55913650	-4000	4000	921
chr11	6207135	6215135	6211698	8000	6211135	-4000	4000	563
chr11	5043461	5051461	5046982	8000	5047461	-4000	4000	-479
chr11	4908588	4916588	4915441	8000	4912588	-4000	4000	2853
chr11	55887810	55895810	55891271	8000	55891810	-4000	4000	-539
chr11	56737223	56745223	56742871	8000	56741223	-4000	4000	1648
chr11	113396416	113404416	113399497	8000	113400416	-4000	4000	-919
chr11	55835738	55843738	55839529	8000	55839738	-4000	4000	-209
chr11	64296031	64304031	64297333	8000	64300031	-4000	4000	-2698
chr11	56316639	56324639	56319181	8000	56320639	-4000	4000	-1458
chr11	55551419	55559419	55555190	8000	55555419	-4000	4000	-229
chr11	119186223	119194223	119188676	8000	119190223	-4000	4000	-1547
chr11	55770382	55778382	55774129	8000	55774382	-4000	4000	-253
chr11	60871693	60879693	60873222	8000	60875693	-4000	4000	-2471
chr11	5452518	5460518	5454415	8000	5456518	-4000	4000	-2103
chr11	5485749	5493749	5488923	8000	5489749	-4000	4000	-826
chr11	6787558	6795558	6795516	8000	6791558	-4000	4000	3958
chr11	8916076	8924076	8921461	8000	8920076	-4000	4000	1385
chr11	14962668	14970668	14968952	8000	14966668	-4000	4000	2284
chr11	48213739	48221739	48216823	8000	48217739	-4000	4000	-916
chr11	54703902	54711902	54707001	8000	54707902	-4000	4000	-901
chr11	60067115	60075115	60070383	8000	60071115	-4000	4000	-732
chr11	61254286	61262286	61258850	8000	61258286	-4000	4000	564
chr11	116785367	116793367	116790796	8000	116789367	-4000	4000	1429
chr11	5836928	5844928	5841018	8000	5840928	-4000	4000	90
chr11	56660618	56668618	56664020	8000	56664618	-4000	4000	-598
chr11	56699884	56707884	56701100	8000	56703884	-4000	4000	-2784
chr11	636706	644706	640571	8000	640706	-4000	4000	-135
chr11	6887574	6895574	6892432	8000	6891574	-4000	4000	858
chr11	5995445	6003445	6002942	8000	5999445	-4000	4000	3497
chr11	30005730	30013730	30011931	8000	30009730	-4000	4000	2201
chr11	36571574	36579574	36573686	8000	36575574	-4000	4000	-1888
chr11	55835738	55843738	55839035	8000	55839738	-4000	4000	-703
chr11	55835738	55843738	55839332	8000	55839738	-4000	4000	-406
chr11	56155394	56163394	56159806	8000	56159394	-4000	4000	412
chr11	57739514	57747514	57744442	8000	57743514	-4000	4000	928
chr11	58262792	58270792	58267472	8000	58266792	-4000	4000	680
chr11	66292664	66300664	66296306	8000	66296664	-4000	4000	-358
chr11	71524669	71532669	71527279	8000	71528669	-4000	4000	-1390
chr11	92981066	92989066	92982322	8000	92985066	-4000	4000	-2744
chr11	108304519	108312519	108312485	8000	108308519	-4000	4000	3966
chr11	123801408	123809408	123805691	8000	123805408	-4000	4000	283
chr11	124433445	124441445	124440886	8000	124437445	-4000	4000	3441
chr11	56227282	56235282	56232722	8000	56231282	-4000	4000	1440
chr11	56660618	56668618	56664204	8000	56664618	-4000	4000	-414
chr11	5043461	5051461	5046843	8000	5047461	-4000	4000	-618
chr11	5419206	5427206	5422281	8000	5423206	-4000	4000	-925
chr11	56538340	56546340	56542433	8000	56542340	-4000	4000	93
chr11	66036765	66044765	66043506	8000	66040765	-4000	4000	2741
chr11	77212558	77220558	77217252	8000	77216558	-4000	4000	694
chr11	55648854	55656854	55651696	8000	55652854	-4000	4000	-1158
chr11	55887810	55895810	55888111	8000	55891810	-4000	4000	-3699
chr11	4676171	4684171	4682191	8000	4680171	-4000	4000	2020
chr11	17489895	17497895	17496806	8000	17493895	-4000	4000	2911
chr11	6196186	6204186	6200128	8000	6200186	-4000	4000	-58
chr11	116831751	116839751	116837360	8000	116835751	-4000	4000	1609
chr11	123878920	123886920	123884530	8000	123882920	-4000	4000	1610
chr11	116829072	116837072	116835819	8000	116833072	-4000	4000	2747
chr11	3660416	3668416	3666300	8000	3664416	-4000	4000	1884
chr11	4542144	4550144	4545658	8000	4546144	-4000	4000	-486
chr11	5782471	5790471	5788544	8000	5786471	-4000	4000	2073
chr11	55792500	55800500	55796176	8000	55796500	-4000	4000	-324
chr11	55961755	55969755	55968245	8000	55965755	-4000	4000	2490
chr11	56357511	56365511	56360407	8000	56361511	-4000	4000	-1104
chr11	56985843	56993843	56989074	8000	56989843	-4000	4000	-769
chr11	89713872	89721872	89717842	8000	89717872	-4000	4000	-30
chr11	92981066	92989066	92982351	8000	92985066	-4000	4000	-2715
chr11	113986313	113994313	113986636	8000	113990313	-4000	4000	-3677
chr11	4446361	4454361	4450034	8000	4450361	-4000	4000	-327
chr11	55569060	55577060	55573033	8000	55573060	-4000	4000	-27
chr11	55931456	55939456	55936056	8000	55935456	-4000	4000	600
chr11	55989681	55997681	55994493	8000	55993681	-4000	4000	812
chr11	56227282	56235282	56232538	8000	56231282	-4000	4000	1256
chr11	66422707	66430707	66425032	8000	66426707	-4000	4000	-1675
chr11	2314204	2322204	2317875	8000	2318204	-4000	4000	-329
chr11	2400515	2408515	2402902	8000	2404515	-4000	4000	-1613
chr11	2400515	2408515	2403236	8000	2404515	-4000	4000	-1279
chr11	4589340	4597340	4594739	8000	4593340	-4000	4000	1399
chr11	7087148	7095148	7090223	8000	7091148	-4000	4000	-925
chr11	8916076	8924076	8919548	8000	8920076	-4000	4000	-528
chr11	36571574	36579574	36573754	8000	36575574	-4000	4000	-1820
chr11	48213739	48221739	48217233	8000	48217739	-4000	4000	-506
chr11	56103658	56111658	56105468	8000	56107658	-4000	4000	-2190
chr11	60044044	60052044	60046975	8000	60048044	-4000	4000	-1069
chr11	104990235	104998235	104997452	8000	104994235	-4000	4000	3217
chr11	124262224	124270224	124265517	8000	124266224	-4000	4000	-707
chr11	124315262	124323262	124320026	8000	124319262	-4000	4000	764
chr11	128930731	128938731	128937429	8000	128934731	-4000	4000	2698
chr11	124616356	124624356	124619816	8000	124620356	-4000	4000	-540
chr11	2291628	2299628	2299567	8000	2295628	-4000	4000	3939
chr11	3634512	3642512	3640063	8000	3638512	-4000	4000	1551
chr11	18448063	18456063	18451120	8000	18452063	-4000	4000	-943
chr11	56227282	56235282	56232753	8000	56231282	-4000	4000	1471
chr11	58434994	58442994	58440024	8000	58438994	-4000	4000	1030
chr11	95023596	95031596	95025918	8000	95027596	-4000	4000	-1678
chr11	116829072	116837072	116832805	8000	116833072	-4000	4000	-267
chr11	122973570	122981570	122977778	8000	122977570	-4000	4000	208
chr11	3221030	3229030	3228706	8000	3225030	-4000	4000	3676
chr11	18723928	18731928	18728914	8000	18727928	-4000	4000	986
chr11	30005730	30013730	30011526	8000	30009730	-4000	4000	1796
chr11	122973570	122981570	122981461	8000	122977570	-4000	4000	3891
chr11	4988431	4996431	4989785	8000	4992431	-4000	4000	-2646
chr11	55551419	55559419	55555398	8000	55555419	-4000	4000	-21
chr11	56272819	56280819	56276484	8000	56276819	-4000	4000	-335
chr11	56155394	56163394	56159472	8000	56159394	-4000	4000	78
chr11	6787558	6795558	6794975	8000	6791558	-4000	4000	3417
chr11	19050455	19058455	19055301	8000	19054455	-4000	4000	846
chr11	58212084	58220084	58215330	8000	58216084	-4000	4000	-754
chr11	123905229	123913229	123906892	8000	123909229	-4000	4000	-2337
chr11	54703902	54711902	54706972	8000	54707902	-4000	4000	-930
chr11	124184780	124192780	124185781	8000	124188780	-4000	4000	-2999
chr11	59708916	59716916	59712966	8000	59712916	-4000	4000	50
chr11	123972661	123980661	123977238	8000	123976661	-4000	4000	577
chr11	55887810	55895810	55891393	8000	55891810	-4000	4000	-417
chr11	72135892	72143892	72139879	8000	72139892	-4000	4000	-13
chr11	92981066	92989066	92982489	8000	92985066	-4000	4000	-2577
chr11	124535635	124543635	124543294	8000	124539635	-4000	4000	3659
chr11	1580342	1588342	1584748	8000	1584342	-4000	4000	406
chr11	14962668	14970668	14968723	8000	14966668	-4000	4000	2055
chr11	55551419	55559419	55554507	8000	55555419	-4000	4000	-912
chr11	44055977	44063977	44059884	8000	44059977	-4000	4000	-93
chr11	55961755	55969755	55968440	8000	55965755	-4000	4000	2685
chr11	124014732	124022732	124015835	8000	124018732	-4000	4000	-2897
chr11	124019948	124027948	124023273	8000	124023948	-4000	4000	-675
chr11	48971324	48979324	48979071	8000	48975324	-4000	4000	3747
chr11	5981892	5989892	5986152	8000	5985892	-4000	4000	260
chr11	6761626	6769626	6768928	8000	6765626	-4000	4000	3302
chr11	57739514	57747514	57741604	8000	57743514	-4000	4000	-1910
chr11	22375503	22383503	22375997	8000	22379503	-4000	4000	-3506
chr11	59708916	59716916	59713141	8000	59712916	-4000	4000	225
chr11	71562735	71570735	71565901	8000	71566735	-4000	4000	-834
chr11	4676171	4684171	4681906	8000	4680171	-4000	4000	1735
chr11	64568875	64576875	64571036	8000	64572875	-4000	4000	-1839
chr11	124014732	124022732	124016137	8000	124018732	-4000	4000	-2595
chr11	104035196	104043196	104037309	8000	104039196	-4000	4000	-1887
chr11	124433445	124441445	124440750	8000	124437445	-4000	4000	3305
chr11	111282401	111290401	111285742	8000	111286401	-4000	4000	-659
chr11	123905229	123913229	123906505	8000	123909229	-4000	4000	-2724
chr11	5195735	5203735	5200681	8000	5199735	-4000	4000	946
chr11	47585194	47593194	47589925	8000	47589194	-4000	4000	731
chr11	30005730	30013730	30010981	8000	30009730	-4000	4000	1251
chr11	56605236	56613236	56613053	8000	56609236	-4000	4000	3817
chr11	6165355	6173355	6169499	8000	6169355	-4000	4000	144
chr11	54599069	54607069	54603344	8000	54603069	-4000	4000	275
chr11	90083131	90091131	90086854	8000	90087131	-4000	4000	-277
chr11	123936573	123944573	123943261	8000	123940573	-4000	4000	2688
chr11	124019948	124027948	124023407	8000	124023948	-4000	4000	-541
chr11	6268127	6276127	6270841	8000	6272127	-4000	4000	-1286
chr11	4542144	4550144	4545376	8000	4546144	-4000	4000	-768
chr11	56637489	56645489	56642292	8000	56641489	-4000	4000	803
chr11	60067115	60075115	60070431	8000	60071115	-4000	4000	-684
chr11	48242015	48250015	48245626	8000	48246015	-4000	4000	-389
chr11	126419358	126427358	126424802	8000	126423358	-4000	4000	1444
chr11	5124776	5132776	5132037	8000	5128776	-4000	4000	3261
chr11	18929499	18937499	18934426	8000	18933499	-4000	4000	927
chr11	77212558	77220558	77213860	8000	77216558	-4000	4000	-2698
chr11	7791974	7799974	7796683	8000	7795974	-4000	4000	709
chr11	89713872	89721872	89717823	8000	89717872	-4000	4000	-49
chr11	13488054	13496054	13492241	8000	13492054	-4000	4000	187
chr11	55551419	55559419	55554669	8000	55555419	-4000	4000	-750
chr11	5947347	5955347	5947373	8000	5951347	-4000	4000	-3974
chr11	59453905	59461905	59456987	8000	59457905	-4000	4000	-918
chr11	6207135	6215135	6214443	8000	6211135	-4000	4000	3308
chr11	48260778	48268778	48264016	8000	48264778	-4000	4000	-762
chr11	56227282	56235282	56232409	8000	56231282	-4000	4000	1127
chr11	2314204	2322204	2316625	8000	2318204	-4000	4000	-1579
chr11	55824154	55832154	55827492	8000	55828154	-4000	4000	-662
chr11	1693755	1701755	1697290	8000	1697755	-4000	4000	-465
chr11	4938831	4946831	4946756	8000	4942831	-4000	4000	3925
chr11	48260778	48268778	48264046	8000	48264778	-4000	4000	-732
chr11	55961755	55969755	55968165	8000	55965755	-4000	4000	2410
chr11	77037973	77045973	77040615	8000	77041973	-4000	4000	-1358
chr11	59475361	59483361	59477793	8000	59479361	-4000	4000	-1568
chr11	7953537	7961537	7960657	8000	7957537	-4000	4000	3120
chr11	48303152	48311152	48306929	8000	48307152	-4000	4000	-223
chr11	134315564	134323564	134318683	8000	134319564	-4000	4000	-881
chr11	4764979	4772979	4769172	8000	4768979	-4000	4000	193
chr11	55824154	55832154	55828094	8000	55828154	-4000	4000	-60
chr11	56342998	56350998	56346121	8000	56346998	-4000	4000	-877
chr11	18929499	18937499	18934365	8000	18933499	-4000	4000	866
chr11	71545608	71553608	71548614	8000	71549608	-4000	4000	-994
chr11	124014732	124022732	124016094	8000	124018732	-4000	4000	-2638
chr11	124916677	124924677	124923780	8000	124920677	-4000	4000	3103
chr11	54599069	54607069	54603458	8000	54603069	-4000	4000	389
chr11	55909650	55917650	55913809	8000	55913650	-4000	4000	159
chr11	55824154	55832154	55827821	8000	55828154	-4000	4000	-333
chr11	4446361	4454361	4449637	8000	4450361	-4000	4000	-724
chr11	89713872	89721872	89717457	8000	89717872	-4000	4000	-415
chr11	5124776	5132776	5132478	8000	5128776	-4000	4000	3702
chr11	54599069	54607069	54603376	8000	54603069	-4000	4000	307
chr11	5852749	5860749	5856844	8000	5856749	-4000	4000	95
chr11	58398464	58406464	58403229	8000	58402464	-4000	4000	765
chr11	5772165	5780165	5778383	8000	5776165	-4000	4000	2218
chr11	56103658	56111658	56105590	8000	56107658	-4000	4000	-2068
chr11	281388	289388	285169	8000	285388	-4000	4000	-219
chr11	5485749	5493749	5489404	8000	5489749	-4000	4000	-345
chr11	56284462	56292462	56290558	8000	56288462	-4000	4000	2096
chr11	66422707	66430707	66424005	8000	66426707	-4000	4000	-2702
chr11	56413258	56421258	56417331	8000	56417258	-4000	4000	73
chr11	64930471	64938471	64931592	8000	64934471	-4000	4000	-2879
chr11	66422707	66430707	66424773	8000	66426707	-4000	4000	-1934
chr11	61247444	61255444	61249734	8000	61251444	-4000	4000	-1710
chr11	4363263	4371263	4368071	8000	4367263	-4000	4000	808
chr11	36571574	36579574	36577722	8000	36575574	-4000	4000	2148
chr11	61254286	61262286	61258788	8000	61258286	-4000	4000	502
chr11	56605236	56613236	56612675	8000	56609236	-4000	4000	3439
chr11	36571574	36579574	36574320	8000	36575574	-4000	4000	-1254
chr11	6207135	6215135	6211768	8000	6211135	-4000	4000	633
chr11	5124776	5132776	5132083	8000	5128776	-4000	4000	3307
chr11	7953537	7961537	7961091	8000	7957537	-4000	4000	3554
chr11	55569060	55577060	55572637	8000	55573060	-4000	4000	-423
chr11	612577	620577	619427	8000	616577	-4000	4000	2850
chr11	55364918	55372918	55368537	8000	55368918	-4000	4000	-381
chr11	56272819	56280819	56275640	8000	56276819	-4000	4000	-1179
chr11	6196186	6204186	6199839	8000	6200186	-4000	4000	-347
chr11	2155779	2163779	2159789	8000	2159779	-4000	4000	10
chr11	6240479	6248479	6240564	8000	6244479	-4000	4000	-3915
chr11	6240479	6248479	6241573	8000	6244479	-4000	4000	-2906
chr11	294200	302200	294744	8000	298200	-4000	4000	-3456
chr11	636706	644706	640489	8000	640706	-4000	4000	-217
chr11	783115	791115	788566	8000	787115	-4000	4000	1451
chr11	4639060	4647060	4640574	8000	4643060	-4000	4000	-2486
chr11	4799433	4807433	4804049	8000	4803433	-4000	4000	616
chr11	4799433	4807433	4804148	8000	4803433	-4000	4000	715
chr11	5043461	5051461	5047272	8000	5047461	-4000	4000	-189
chr11	5250392	5258392	5254483	8000	5254392	-4000	4000	91
chr11	5947347	5955347	5947499	8000	5951347	-4000	4000	-3848
chr11	5981892	5989892	5986580	8000	5985892	-4000	4000	688
chr11	6240479	6248479	6241542	8000	6244479	-4000	4000	-2937
chr11	6787558	6795558	6795265	8000	6791558	-4000	4000	3707
chr11	6870717	6878717	6877293	8000	6874717	-4000	4000	2576
chr11	7791974	7799974	7796235	8000	7795974	-4000	4000	261
chr11	7791974	7799974	7796795	8000	7795974	-4000	4000	821
chr11	18170280	18178280	18173765	8000	18174280	-4000	4000	-515
chr11	47585194	47593194	47586728	8000	47589194	-4000	4000	-2466
chr11	48260778	48268778	48263953	8000	48264778	-4000	4000	-825
chr11	48303152	48311152	48306440	8000	48307152	-4000	4000	-712
chr11	55824154	55832154	55827697	8000	55828154	-4000	4000	-457
chr11	55835738	55843738	55839525	8000	55839738	-4000	4000	-213
chr11	56130721	56138721	56137390	8000	56134721	-4000	4000	2669
chr11	56155394	56163394	56159930	8000	56159394	-4000	4000	536
chr11	56316639	56324639	56319189	8000	56320639	-4000	4000	-1450
chr11	56486435	56494435	56491349	8000	56490435	-4000	4000	914
chr11	56737223	56745223	56743543	8000	56741223	-4000	4000	2320
chr11	56985843	56993843	56989122	8000	56989843	-4000	4000	-721
chr11	57739514	57747514	57741680	8000	57743514	-4000	4000	-1834
chr11	57739514	57747514	57744227	8000	57743514	-4000	4000	713
chr11	58177616	58185616	58180094	8000	58181616	-4000	4000	-1522
chr11	59500511	59508511	59503660	8000	59504511	-4000	4000	-851
chr11	60797305	60805305	60798473	8000	60801305	-4000	4000	-2832
chr11	61254286	61262286	61259198	8000	61258286	-4000	4000	912
chr11	68976021	68984021	68980949	8000	68980021	-4000	4000	928
chr11	71524669	71532669	71527626	8000	71528669	-4000	4000	-1043
chr11	71562735	71570735	71566314	8000	71566735	-4000	4000	-421
chr11	71577855	71585855	71582668	8000	71581855	-4000	4000	813
chr11	72135892	72143892	72139480	8000	72139892	-4000	4000	-412
chr11	72235077	72243077	72238045	8000	72239077	-4000	4000	-1032
chr11	89713872	89721872	89717568	8000	89717872	-4000	4000	-304
chr11	89713872	89721872	89717842	8000	89717872	-4000	4000	-30
chr11	90083131	90091131	90087047	8000	90087131	-4000	4000	-84
chr11	113986313	113994313	113989762	8000	113990313	-4000	4000	-551
chr11	118158806	118166806	118166709	8000	118162806	-4000	4000	3903
chr11	119186223	119194223	119190724	8000	119190223	-4000	4000	501
chr11	128832315	128840315	128840132	8000	128836315	-4000	4000	3817
chr11	18170280	18178280	18173954	8000	18174280	-4000	4000	-326
chr11	55648854	55656854	55651611	8000	55652854	-4000	4000	-1243
chr11	123936573	123944573	123939863	8000	123940573	-4000	4000	-710
chr11	6787558	6795558	6795005	8000	6791558	-4000	4000	3447
chr11	55770382	55778382	55774246	8000	55774382	-4000	4000	-136
chr11	58434994	58442994	58439624	8000	58438994	-4000	4000	630
chr11	61254286	61262286	61258968	8000	61258286	-4000	4000	682
chr11	59475361	59483361	59477793	8000	59479361	-4000	4000	-1568
chr11	55636309	55644309	55639289	8000	55640309	-4000	4000	-1020
chr11	56985843	56993843	56988915	8000	56989843	-4000	4000	-928
chr11	55364918	55372918	55368746	8000	55368918	-4000	4000	-172
chr11	59475361	59483361	59477973	8000	59479361	-4000	4000	-1388
chr11	4489497	4497497	4489597	8000	4493497	-4000	4000	-3900
chr11	55792500	55800500	55796116	8000	55796500	-4000	4000	-384
chr11	56342998	56350998	56346809	8000	56346998	-4000	4000	-189
chr11	56227282	56235282	56232120	8000	56231282	-4000	4000	838
chr11	58212084	58220084	58215128	8000	58216084	-4000	4000	-956
chr11	63307783	63315783	63311301	8000	63311783	-4000	4000	-482
chr11	124535635	124543635	124542815	8000	124539635	-4000	4000	3180
chr11	128832315	128840315	128839453	8000	128836315	-4000	4000	3138
chr11	5995445	6003445	6003107	8000	5999445	-4000	4000	3662
chr11	6842636	6850636	6846586	8000	6846636	-4000	4000	-50
chr11	124419942	124427942	124424729	8000	124423942	-4000	4000	787
chr11	56103658	56111658	56105110	8000	56107658	-4000	4000	-2548
chr11	102707796	102715796	102715313	8000	102711796	-4000	4000	3517
chr11	3634512	3642512	3638804	8000	3638512	-4000	4000	292
chr11	4542144	4550144	4545987	8000	4546144	-4000	4000	-157
chr11	4589340	4597340	4594197	8000	4593340	-4000	4000	857
chr11	4988431	4996431	4989826	8000	4992431	-4000	4000	-2605
chr11	5124776	5132776	5132245	8000	5128776	-4000	4000	3469
chr11	5348446	5356446	5352108	8000	5352446	-4000	4000	-338
chr11	5389263	5397263	5390083	8000	5393263	-4000	4000	-3180
chr11	5419206	5427206	5423060	8000	5423206	-4000	4000	-146
chr11	5836928	5844928	5841579	8000	5840928	-4000	4000	651
chr11	5947347	5955347	5947870	8000	5951347	-4000	4000	-3477
chr11	6207135	6215135	6211027	8000	6211135	-4000	4000	-108
chr11	6917994	6925994	6921207	8000	6921994	-4000	4000	-787
chr11	7791974	7799974	7796185	8000	7795974	-4000	4000	211
chr11	7933171	7941171	7939513	8000	7937171	-4000	4000	2342
chr11	14962668	14970668	14968604	8000	14966668	-4000	4000	1936
chr11	17489895	17497895	17496804	8000	17493895	-4000	4000	2909
chr11	18134488	18142488	18137755	8000	18138488	-4000	4000	-733
chr11	19050455	19058455	19056323	8000	19054455	-4000	4000	1868
chr11	36571574	36579574	36575790	8000	36575574	-4000	4000	216
chr11	47327406	47335406	47332253	8000	47331406	-4000	4000	847
chr11	55267114	55275114	55270915	8000	55271114	-4000	4000	-199
chr11	55364918	55372918	55368231	8000	55368918	-4000	4000	-687
chr11	55551419	55559419	55554739	8000	55555419	-4000	4000	-680
chr11	55551419	55559419	55555221	8000	55555419	-4000	4000	-198
chr11	55648854	55656854	55650956	8000	55652854	-4000	4000	-1898
chr11	55792500	55800500	55796250	8000	55796500	-4000	4000	-250
chr11	55808476	55816476	55812344	8000	55812476	-4000	4000	-132
chr11	55961755	55969755	55968377	8000	55965755	-4000	4000	2622
chr11	55989681	55997681	55994356	8000	55993681	-4000	4000	675
chr11	56090240	56098240	56093406	8000	56094240	-4000	4000	-834
chr11	56103658	56111658	56105505	8000	56107658	-4000	4000	-2153
chr11	56119311	56127311	56123258	8000	56123311	-4000	4000	-53
chr11	56173556	56181556	56176899	8000	56177556	-4000	4000	-657
chr11	56249222	56257222	56252447	8000	56253222	-4000	4000	-775
chr11	56272819	56280819	56275766	8000	56276819	-4000	4000	-1053
chr11	56272819	56280819	56275844	8000	56276819	-4000	4000	-975
chr11	56284462	56292462	56290543	8000	56288462	-4000	4000	2081
chr11	56284462	56292462	56290697	8000	56288462	-4000	4000	2235
chr11	56316639	56324639	56318342	8000	56320639	-4000	4000	-2297
chr11	56316639	56324639	56318773	8000	56320639	-4000	4000	-1866
chr11	56342998	56350998	56346885	8000	56346998	-4000	4000	-113
chr11	56357511	56365511	56360758	8000	56361511	-4000	4000	-753
chr11	56605236	56613236	56612831	8000	56609236	-4000	4000	3595
chr11	56985843	56993843	56988949	8000	56989843	-4000	4000	-894
chr11	57739514	57747514	57741575	8000	57743514	-4000	4000	-1939
chr11	57739514	57747514	57741851	8000	57743514	-4000	4000	-1663
chr11	58177616	58185616	58180265	8000	58181616	-4000	4000	-1351
chr11	58212084	58220084	58215250	8000	58216084	-4000	4000	-834
chr11	59475361	59483361	59478089	8000	59479361	-4000	4000	-1272
chr11	65353613	65361613	65357182	8000	65357613	-4000	4000	-431
chr11	66012752	66020752	66017087	8000	66016752	-4000	4000	335
chr11	66559334	66567334	66560668	8000	66563334	-4000	4000	-2666
chr11	71524669	71532669	71527548	8000	71528669	-4000	4000	-1121
chr11	71577855	71585855	71582308	8000	71581855	-4000	4000	453
chr11	89713872	89721872	89717428	8000	89717872	-4000	4000	-444
chr11	94373316	94381316	94380071	8000	94377316	-4000	4000	2755
chr11	104035196	104043196	104037532	8000	104039196	-4000	4000	-1664
chr11	104035196	104043196	104037849	8000	104039196	-4000	4000	-1347
chr11	116785367	116793367	116790147	8000	116789367	-4000	4000	780
chr11	116816700	116824700	116821630	8000	116820700	-4000	4000	930
chr11	123801408	123809408	123805828	8000	123805408	-4000	4000	420
chr11	123972661	123980661	123977449	8000	123976661	-4000	4000	788
chr11	124262224	124270224	124265548	8000	124266224	-4000	4000	-676
chr11	125667522	125675522	125672621	8000	125671522	-4000	4000	1099
chr11	125745867	125753867	125748956	8000	125749867	-4000	4000	-911
chr11	5250392	5258392	5254340	8000	5254392	-4000	4000	-52
chr11	5995445	6003445	6003075	8000	5999445	-4000	4000	3630
chr11	30005730	30013730	30011206	8000	30009730	-4000	4000	1476
chr11	30005730	30013730	30011665	8000	30009730	-4000	4000	1935
chr11	6165355	6173355	6170018	8000	6169355	-4000	4000	663
chr11	116816700	116824700	116821373	8000	116820700	-4000	4000	673
chr11	122973570	122981570	122979302	8000	122977570	-4000	4000	1732
chr11	90038025	90046025	90041220	8000	90042025	-4000	4000	-805
chr11	123972661	123980661	123977617	8000	123976661	-4000	4000	956
chr11	124032013	124040013	124038903	8000	124036013	-4000	4000	2890
chr11	59500511	59508511	59503745	8000	59504511	-4000	4000	-766
chr11	124014732	124022732	124016063	8000	124018732	-4000	4000	-2669
chr11	134315564	134323564	134318877	8000	134319564	-4000	4000	-687
chr11	30231261	30239261	30233994	8000	30235261	-4000	4000	-1267
chr11	5419206	5427206	5423053	8000	5423206	-4000	4000	-153
chr11	102707796	102715796	102713358	8000	102711796	-4000	4000	1562
chr11	124535635	124543635	124543001	8000	124539635	-4000	4000	3366
chr11	55636309	55644309	55638752	8000	55640309	-4000	4000	-1557
chr11	55792500	55800500	55796039	8000	55796500	-4000	4000	-461
chr11	60392596	60400596	60392779	8000	60396596	-4000	4000	-3817
chr11	73966366	73974366	73969304	8000	73970366	-4000	4000	-1062
chr11	55824154	55832154	55827892	8000	55828154	-4000	4000	-262
chr11	49949419	49957419	49952723	8000	49953419	-4000	4000	-696
chr11	89713872	89721872	89717578	8000	89717872	-4000	4000	-294
chr11	56486435	56494435	56490649	8000	56490435	-4000	4000	214
chr11	55887810	55895810	55891700	8000	55891810	-4000	4000	-110
chr11	5419206	5427206	5423098	8000	5423206	-4000	4000	-108
chr11	56413258	56421258	56418200	8000	56417258	-4000	4000	942
chr11	54599069	54607069	54603419	8000	54603069	-4000	4000	350
chr11	118954559	118962559	118957644	8000	118958559	-4000	4000	-915
chr11	8933578	8941578	8937986	8000	8937578	-4000	4000	408
chr11	4919374	4927374	4923926	8000	4923374	-4000	4000	552
chr11	55824154	55832154	55827929	8000	55828154	-4000	4000	-225
chr11	55824154	55832154	55827930	8000	55828154	-4000	4000	-224
chr11	128832315	128840315	128839124	8000	128836315	-4000	4000	2809
chr11	36571574	36579574	36575903	8000	36575574	-4000	4000	329
chr11	20152155	20160155	20159248	8000	20156155	-4000	4000	3093
chr11	66973009	66981009	66975623	8000	66977009	-4000	4000	-1386
chr11	5836928	5844928	5841632	8000	5840928	-4000	4000	704
chr11	56538340	56546340	56543118	8000	56542340	-4000	4000	778
chr11	59708916	59716916	59713351	8000	59712916	-4000	4000	435
chr11	7953537	7961537	7961165	8000	7957537	-4000	4000	3628
chr11	85679848	85687848	85685067	8000	85683848	-4000	4000	1219
chr11	124419942	124427942	124424584	8000	124423942	-4000	4000	642
chr11	56103658	56111658	56105744	8000	56107658	-4000	4000	-1914
chr11	5419206	5427206	5422564	8000	5423206	-4000	4000	-642
chr11	5195735	5203735	5200317	8000	5199735	-4000	4000	582
chr11	5947347	5955347	5948115	8000	5951347	-4000	4000	-3232
chr11	49977473	49985473	49981656	8000	49981473	-4000	4000	183
chr11	65588836	65596836	65593496	8000	65592836	-4000	4000	660
chr11	113945079	113953079	113946331	8000	113949079	-4000	4000	-2748
chr11	123936573	123944573	123943383	8000	123940573	-4000	4000	2810
chr11	124026634	124034634	124029966	8000	124030634	-4000	4000	-668
chr11	124616356	124624356	124619420	8000	124620356	-4000	4000	-936
chr11	56413258	56421258	56417339	8000	56417258	-4000	4000	81
chr11	58212084	58220084	58215554	8000	58216084	-4000	4000	-530
chr11	59453905	59461905	59457676	8000	59457905	-4000	4000	-229
chr11	124014732	124022732	124016257	8000	124018732	-4000	4000	-2475
chr11	18170280	18178280	18173869	8000	18174280	-4000	4000	-411
chr11	56985843	56993843	56988973	8000	56989843	-4000	4000	-870
chr11	2155779	2163779	2159821	8000	2159779	-4000	4000	42
chr11	58177616	58185616	58179817	8000	58181616	-4000	4000	-1799
chr11	7953537	7961537	7960781	8000	7957537	-4000	4000	3244
chr11	56119311	56127311	56123001	8000	56123311	-4000	4000	-310
chr11	5836928	5844928	5841190	8000	5840928	-4000	4000	262
chr11	65353613	65361613	65355892	8000	65357613	-4000	4000	-1721
chr11	65353613	65361613	65357192	8000	65357613	-4000	4000	-421
chr11	55835738	55843738	55839633	8000	55839738	-4000	4000	-105
chr11	56605236	56613236	56612952	8000	56609236	-4000	4000	3716
chr11	56660618	56668618	56664611	8000	56664618	-4000	4000	-7
chr11	94373316	94381316	94380459	8000	94377316	-4000	4000	3143
chr11	124014732	124022732	124016013	8000	124018732	-4000	4000	-2719
chr11	5883079	5891079	5884376	8000	5887079	-4000	4000	-2703
chr11	6917994	6925994	6921717	8000	6921994	-4000	4000	-277
chr11	55569060	55577060	55572876	8000	55573060	-4000	4000	-184
chr11	56486435	56494435	56491163	8000	56490435	-4000	4000	728
chr11	64296031	64304031	64300374	8000	64300031	-4000	4000	343
chr11	66012752	66020752	66016848	8000	66016752	-4000	4000	96
chr11	122973570	122981570	122979385	8000	122977570	-4000	4000	1815
chr11	104035196	104043196	104037999	8000	104039196	-4000	4000	-1197
chr11	5043461	5051461	5047294	8000	5047461	-4000	4000	-167
chr11	47585194	47593194	47589935	8000	47589194	-4000	4000	741
chr11	66422707	66430707	66426181	8000	66426707	-4000	4000	-526
chr11	56372553	56380553	56376192	8000	56376553	-4000	4000	-361
chr11	294200	302200	299390	8000	298200	-4000	4000	1190
chr11	3213944	3221944	3218738	8000	3217944	-4000	4000	794
chr11	7087148	7095148	7089295	8000	7091148	-4000	4000	-1853
chr11	56342998	56350998	56346608	8000	56346998	-4000	4000	-390
chr11	124032013	124040013	124038748	8000	124036013	-4000	4000	2735
chr11	48213739	48221739	48217184	8000	48217739	-4000	4000	-555
chr11	47327406	47335406	47335107	8000	47331406	-4000	4000	3701
chr11	55816571	55824571	55819891	8000	55820571	-4000	4000	-680
chr11	46379789	46387789	46382098	8000	46383789	-4000	4000	-1691
chr11	55835738	55843738	55839691	8000	55839738	-4000	4000	-47
chr11	18929499	18937499	18934269	8000	18933499	-4000	4000	770
chr11	56227282	56235282	56232289	8000	56231282	-4000	4000	1007
chr11	66559334	66567334	66560694	8000	66563334	-4000	4000	-2640
chr11	68976021	68984021	68980619	8000	68980021	-4000	4000	598
chr11	18134488	18142488	18137925	8000	18138488	-4000	4000	-563
chr11	5195735	5203735	5199983	8000	5199735	-4000	4000	248
chr11	95023596	95031596	95025810	8000	95027596	-4000	4000	-1786
chr11	6207135	6215135	6211667	8000	6211135	-4000	4000	532
chr11	49977473	49985473	49981921	8000	49981473	-4000	4000	448
chr11	5577884	5585884	5581820	8000	5581884	-4000	4000	-64
chr11	18475601	18483601	18481644	8000	18479601	-4000	4000	2043
chr11	48303152	48311152	48307120	8000	48307152	-4000	4000	-32
chr11	3634512	3642512	3640101	8000	3638512	-4000	4000	1589
chr11	4919374	4927374	4923680	8000	4923374	-4000	4000	306
chr11	122111340	122119340	122116144	8000	122115340	-4000	4000	804
chr11	47585194	47593194	47586802	8000	47589194	-4000	4000	-2392
chr11	48213739	48221739	48217350	8000	48217739	-4000	4000	-389
chr11	48260778	48268778	48264548	8000	48264778	-4000	4000	-230
chr11	56637489	56645489	56641641	8000	56641489	-4000	4000	152
chr11	56372553	56380553	56376244	8000	56376553	-4000	4000	-309
chr11	64296031	64304031	64297154	8000	64300031	-4000	4000	-2877
chr11	49949419	49957419	49952785	8000	49953419	-4000	4000	-634
chr11	55770382	55778382	55773496	8000	55774382	-4000	4000	-886
chr11	66559334	66567334	66560665	8000	66563334	-4000	4000	-2669
chr11	128832315	128840315	128839091	8000	128836315	-4000	4000	2776
chr11	5228678	5236678	5234201	8000	5232678	-4000	4000	1523
chr11	5883079	5891079	5884928	8000	5887079	-4000	4000	-2151
chr11	58199202	58207202	58204107	8000	58203202	-4000	4000	905
chr11	783115	791115	787426	8000	787115	-4000	4000	311
chr11	3634512	3642512	3641902	8000	3638512	-4000	4000	3390
chr11	55648854	55656854	55651098	8000	55652854	-4000	4000	-1756
chr11	57546272	57554272	57552337	8000	57550272	-4000	4000	2065
chr11	54703902	54711902	54707243	8000	54707902	-4000	4000	-659
chr11	56538340	56546340	56542768	8000	56542340	-4000	4000	428
chr11	123936573	123944573	123943447	8000	123940573	-4000	4000	2874
chr11	4988431	4996431	4989833	8000	4992431	-4000	4000	-2598
chr11	66973009	66981009	66975379	8000	66977009	-4000	4000	-1630
chr11	54703902	54711902	54707609	8000	54707902	-4000	4000	-293
chr11	55824154	55832154	55827449	8000	55828154	-4000	4000	-705
chr11	18170280	18178280	18173675	8000	18174280	-4000	4000	-605
chr11	36571574	36579574	36573302	8000	36575574	-4000	4000	-2272
chr11	4446361	4454361	4450089	8000	4450361	-4000	4000	-272
chr11	48260778	48268778	48264541	8000	48264778	-4000	4000	-237
chr11	8220309	8228309	8224523	8000	8224309	-4000	4000	214
chr11	6870717	6878717	6876971	8000	6874717	-4000	4000	2254
chr11	20152155	20160155	20156448	8000	20156155	-4000	4000	293
chr11	4938831	4946831	4946193	8000	4942831	-4000	4000	3362
chr11	7933171	7941171	7939078	8000	7937171	-4000	4000	1907
chr11	123936573	123944573	123943704	8000	123940573	-4000	4000	3131
chr11	5817483	5825483	5820732	8000	5821483	-4000	4000	-751
chr11	7933171	7941171	7938717	8000	7937171	-4000	4000	1546
chr11	67514912	67522912	67519887	8000	67518912	-4000	4000	975
chr11	2314204	2322204	2316270	8000	2318204	-4000	4000	-1934
chr11	5043461	5051461	5047210	8000	5047461	-4000	4000	-251
chr11	5043461	5051461	5046927	8000	5047461	-4000	4000	-534
chr11	123801408	123809408	123806030	8000	123805408	-4000	4000	622
chr11	124014732	124022732	124016111	8000	124018732	-4000	4000	-2621
chr11	77037973	77045973	77040670	8000	77041973	-4000	4000	-1303
chr11	102707796	102715796	102714558	8000	102711796	-4000	4000	2762
chr11	123936573	123944573	123943189	8000	123940573	-4000	4000	2616
chr11	6165355	6173355	6169486	8000	6169355	-4000	4000	131
chr11	6917994	6925994	6921851	8000	6921994	-4000	4000	-143
chr11	55792500	55800500	55795626	8000	55796500	-4000	4000	-874
chr11	48321955	48329955	48325119	8000	48325955	-4000	4000	-836
chr11	55770382	55778382	55774120	8000	55774382	-4000	4000	-262
chr11	5250392	5258392	5254397	8000	5254392	-4000	4000	5
chr11	56699884	56707884	56701040	8000	56703884	-4000	4000	-2844
chr11	1626707	1634707	1630700	8000	1630707	-4000	4000	-7
chr11	123749580	123757580	123753610	8000	123753580	-4000	4000	30
chr11	61247444	61255444	61249926	8000	61251444	-4000	4000	-1518
chr11	57739514	57747514	57744179	8000	57743514	-4000	4000	665
chr11	57739514	57747514	57744509	8000	57743514	-4000	4000	995
chr11	56316639	56324639	56318651	8000	56320639	-4000	4000	-1988
chr11	783115	791115	788616	8000	787115	-4000	4000	1501
chr11	4446361	4454361	4449822	8000	4450361	-4000	4000	-539
chr11	7920592	7928592	7927822	8000	7924592	-4000	4000	3230
chr11	14962668	14970668	14967851	8000	14966668	-4000	4000	1183
chr11	89713872	89721872	89715966	8000	89717872	-4000	4000	-1906
chr11	111282401	111290401	111285832	8000	111286401	-4000	4000	-569
chr11	22375503	22383503	22376082	8000	22379503	-4000	4000	-3421
chr11	54703902	54711902	54707196	8000	54707902	-4000	4000	-706
chr11	123905229	123913229	123906486	8000	123909229	-4000	4000	-2743
chr11	56316639	56324639	56318338	8000	56320639	-4000	4000	-2301
chr11	4676171	4684171	4681776	8000	4680171	-4000	4000	1605
chr11	4908588	4916588	4915410	8000	4912588	-4000	4000	2822
chr11	4950772	4958772	4955421	8000	4954772	-4000	4000	649
chr11	55662195	55670195	55665847	8000	55666195	-4000	4000	-348
chr11	55792500	55800500	55795974	8000	55796500	-4000	4000	-526
chr11	55835738	55843738	55838927	8000	55839738	-4000	4000	-811
chr11	56605236	56613236	56612569	8000	56609236	-4000	4000	3333
chr11	58199202	58207202	58204017	8000	58203202	-4000	4000	815
chr11	61254286	61262286	61258918	8000	61258286	-4000	4000	632
chr11	124026634	124034634	124030336	8000	124030634	-4000	4000	-298
chr11	7791974	7799974	7796894	8000	7795974	-4000	4000	920
chr11	60392596	60400596	60400433	8000	60396596	-4000	4000	3837
chr11	56538340	56546340	56543239	8000	56542340	-4000	4000	899
chr11	56699884	56707884	56701301	8000	56703884	-4000	4000	-2583
chr11	104035196	104043196	104037193	8000	104039196	-4000	4000	-2003
chr11	2314204	2322204	2317875	8000	2318204	-4000	4000	-329
chr11	30231261	30239261	30233848	8000	30235261	-4000	4000	-1413
chr11	55808476	55816476	55811748	8000	55812476	-4000	4000	-728
chr11	93434487	93442487	93437552	8000	93438487	-4000	4000	-935
chr11	123749580	123757580	123754207	8000	123753580	-4000	4000	627
chr11	56737223	56745223	56743182	8000	56741223	-4000	4000	1959
chr11	18134488	18142488	18137303	8000	18138488	-4000	4000	-1185
chr11	55808476	55816476	55812023	8000	55812476	-4000	4000	-453
chr11	6870717	6878717	6876858	8000	6874717	-4000	4000	2141
chr12	129067725	129075725	129074679	8000	129071725	-4000	4000	2954
chr12	95512560	95520560	95513720	8000	95516560	-4000	4000	-2840
chr12	132192372	132200372	132197073	8000	132196372	-4000	4000	701
chr12	56233846	56241846	56237669	8000	56237846	-4000	4000	-177
chr12	7685784	7693784	7690655	8000	7689784	-4000	4000	871
chr12	52581589	52589589	52587718	8000	52585589	-4000	4000	2129
chr12	7645400	7653400	7652481	8000	7649400	-4000	4000	3081
chr12	7685784	7693784	7689818	8000	7689784	-4000	4000	34
chr12	48469622	48477622	48472889	8000	48473622	-4000	4000	-733
chr12	56233846	56241846	56235693	8000	56237846	-4000	4000	-2153
chr12	49328409	49336409	49330241	8000	49332409	-4000	4000	-2168
chr12	130368637	130376637	130371503	8000	130372637	-4000	4000	-1134
chr12	52640558	52648558	52648272	8000	52644558	-4000	4000	3714
chr12	55449347	55457347	55453152	8000	55453347	-4000	4000	-195
chr12	52389931	52397931	52396936	8000	52393931	-4000	4000	3005
chr12	56356568	56364568	56362022	8000	56360568	-4000	4000	1454
chr12	56356568	56364568	56362761	8000	56360568	-4000	4000	2193
chr12	7713559	7721559	7715401	8000	7717559	-4000	4000	-2158
chr12	52539909	52547909	52546481	8000	52543909	-4000	4000	2572
chr12	53427672	53435672	53431424	8000	53431672	-4000	4000	-248
chr12	55026017	55034017	55029705	8000	55030017	-4000	4000	-312
chr12	132618388	132626388	132621642	8000	132622388	-4000	4000	-746
chr12	100199669	100207669	100201060	8000	100203669	-4000	4000	-2609
chr12	52640558	52648558	52646766	8000	52644558	-4000	4000	2208
chr12	68150768	68158768	68157955	8000	68154768	-4000	4000	3187
chr12	20749386	20757386	20750686	8000	20753386	-4000	4000	-2700
chr12	27077057	27085057	27082315	8000	27081057	-4000	4000	1258
chr12	56994447	57002447	56996576	8000	56998447	-4000	4000	-1871
chr12	7685784	7693784	7690152	8000	7689784	-4000	4000	368
chr12	10014796	10022796	10017858	8000	10018796	-4000	4000	-938
chr12	55289988	55297988	55295074	8000	55293988	-4000	4000	1086
chr12	20749386	20757386	20750709	8000	20753386	-4000	4000	-2677
chr12	50883884	50891884	50887418	8000	50887884	-4000	4000	-466
chr12	4364227	4372227	4370412	8000	4368227	-4000	4000	2185
chr12	11261914	11269914	11267965	8000	11265914	-4000	4000	2051
chr12	10930845	10938845	10938728	8000	10934845	-4000	4000	3883
chr12	56356568	56364568	56361737	8000	56360568	-4000	4000	1169
chr12	55397467	55405467	55400743	8000	55401467	-4000	4000	-724
chr12	55318364	55326364	55320715	8000	55322364	-4000	4000	-1649
chr12	57024517	57032517	57030214	8000	57028517	-4000	4000	1697
chr12	5042788	5050788	5045015	8000	5046788	-4000	4000	-1773
chr12	10062031	10070031	10065688	8000	10066031	-4000	4000	-343
chr12	52539909	52547909	52544721	8000	52543909	-4000	4000	812
chr12	18735188	18743188	18737397	8000	18739188	-4000	4000	-1791
chr12	5042788	5050788	5044749	8000	5046788	-4000	4000	-2039
chr12	11261914	11269914	11267651	8000	11265914	-4000	4000	1737
chr12	55423192	55431192	55427034	8000	55427192	-4000	4000	-158
chr12	100418055	100426055	100420146	8000	100422055	-4000	4000	-1909
chr12	21537249	21545249	21540530	8000	21541249	-4000	4000	-719
chr12	48198339	48206339	48203122	8000	48202339	-4000	4000	783
chr12	55217975	55225975	55221363	8000	55221975	-4000	4000	-612
chr12	56994447	57002447	56995628	8000	56998447	-4000	4000	-2819
chr12	52833804	52841804	52839777	8000	52837804	-4000	4000	1973
chr12	132618388	132626388	132620469	8000	132622388	-4000	4000	-1919
chr12	57024517	57032517	57028753	8000	57028517	-4000	4000	236
chr12	52685626	52693626	52691193	8000	52689626	-4000	4000	1567
chr12	52640558	52648558	52647807	8000	52644558	-4000	4000	3249
chr12	129067725	129075725	129074796	8000	129071725	-4000	4000	3071
chr12	56233846	56241846	56236405	8000	56237846	-4000	4000	-1441
chr12	11387540	11395540	11393539	8000	11391540	-4000	4000	1999
chr12	100560414	100568414	100563491	8000	100564414	-4000	4000	-923
chr12	53322575	53330575	53328237	8000	53326575	-4000	4000	1662
chr12	11261914	11269914	11267240	8000	11265914	-4000	4000	1326
chr12	18679169	18687169	18684268	8000	18683169	-4000	4000	1099
chr12	57455280	57463280	57456634	8000	57459280	-4000	4000	-2646
chr12	52640558	52648558	52648309	8000	52644558	-4000	4000	3751
chr12	11181993	11189993	11186106	8000	11185993	-4000	4000	113
chr12	11387540	11395540	11393326	8000	11391540	-4000	4000	1786
chr12	129067725	129075725	129074175	8000	129071725	-4000	4000	2450
chr12	132618388	132626388	132625744	8000	132622388	-4000	4000	3356
chr12	55328687	55336687	55332208	8000	55332687	-4000	4000	-479
chr12	45010672	45018672	45016336	8000	45014672	-4000	4000	1664
chr12	55449347	55457347	55453134	8000	55453347	-4000	4000	-213
chr12	100560414	100568414	100563401	8000	100564414	-4000	4000	-1013
chr12	49954878	49962878	49962318	8000	49958878	-4000	4000	3440
chr12	49328409	49336409	49330869	8000	49332409	-4000	4000	-1540
chr12	52833804	52841804	52834244	8000	52837804	-4000	4000	-3560
chr12	55328687	55336687	55332567	8000	55332687	-4000	4000	-120
chr12	110529556	110537556	110530575	8000	110533556	-4000	4000	-2981
chr12	122199471	122207471	122204625	8000	122203471	-4000	4000	1154
chr12	132618388	132626388	132621606	8000	132622388	-4000	4000	-782
chr12	5042788	5050788	5045402	8000	5046788	-4000	4000	-1386
chr12	129067725	129075725	129073798	8000	129071725	-4000	4000	2073
chr12	129067725	129075725	129073799	8000	129071725	-4000	4000	2074
chr12	11387540	11395540	11393156	8000	11391540	-4000	4000	1616
chr12	128980968	128988968	128982994	8000	128984968	-4000	4000	-1974
chr12	129067725	129075725	129074768	8000	129071725	-4000	4000	3043
chr12	49973139	49981139	49973304	8000	49977139	-4000	4000	-3835
chr12	51887727	51895727	51888070	8000	51891727	-4000	4000	-3657
chr12	55128750	55136750	55130270	8000	55132750	-4000	4000	-2480
chr12	57448062	57456062	57450066	8000	57452062	-4000	4000	-1996
chr12	68197349	68205349	68201763	8000	68201349	-4000	4000	414
chr12	129067725	129075725	129074124	8000	129071725	-4000	4000	2399
chr12	109451523	109459523	109451810	8000	109455523	-4000	4000	-3713
chr12	55633833	55641833	55637537	8000	55637833	-4000	4000	-296
chr12	52685626	52693626	52692432	8000	52689626	-4000	4000	2806
chr12	55217975	55225975	55221316	8000	55221975	-4000	4000	-659
chr12	55423192	55431192	55426704	8000	55427192	-4000	4000	-488
chr12	100560414	100568414	100561893	8000	100564414	-4000	4000	-2521
chr12	132618388	132626388	132621555	8000	132622388	-4000	4000	-833
chr12	47705734	47713734	47711630	8000	47709734	-4000	4000	1896
chr12	122168029	122176029	122172270	8000	122172029	-4000	4000	241
chr12	49973139	49981139	49974449	8000	49977139	-4000	4000	-2690
chr12	11181993	11189993	11186337	8000	11185993	-4000	4000	344
chr12	49954878	49962878	49962109	8000	49958878	-4000	4000	3231
chr12	122199471	122207471	122200552	8000	122203471	-4000	4000	-2919
chr12	3589973	3597973	3593177	8000	3593973	-4000	4000	-796
chr12	52603570	52611570	52608351	8000	52607570	-4000	4000	781
chr12	57448062	57456062	57455703	8000	57452062	-4000	4000	3641
chr12	101124641	101132641	101127981	8000	101128641	-4000	4000	-660
chr12	69604564	69612564	69610548	8000	69608564	-4000	4000	1984
chr12	7685784	7693784	7689793	8000	7689784	-4000	4000	9
chr12	49082656	49090656	49089986	8000	49086656	-4000	4000	3330
chr12	55026017	55034017	55026913	8000	55030017	-4000	4000	-3104
chr12	109273978	109281978	109279857	8000	109277978	-4000	4000	1879
chr12	11303077	11311077	11308532	8000	11307077	-4000	4000	1455
chr12	49328409	49336409	49330981	8000	49332409	-4000	4000	-1428
chr12	52603570	52611570	52608411	8000	52607570	-4000	4000	841
chr12	11387540	11395540	11393764	8000	11391540	-4000	4000	2224
chr12	48978620	48986620	48980530	8000	48982620	-4000	4000	-2090
chr12	5042788	5050788	5045183	8000	5046788	-4000	4000	-1605
chr12	55026017	55034017	55028208	8000	55030017	-4000	4000	-1809
chr12	52373812	52381812	52378079	8000	52377812	-4000	4000	267
chr12	53322575	53330575	53328950	8000	53326575	-4000	4000	2375
chr12	56336410	56344410	56343418	8000	56340410	-4000	4000	3008
chr12	49973139	49981139	49975495	8000	49977139	-4000	4000	-1644
chr12	27077057	27085057	27082376	8000	27081057	-4000	4000	1319
chr12	56336410	56344410	56343835	8000	56340410	-4000	4000	3425
chr12	9981642	9989642	9982108	8000	9985642	-4000	4000	-3534
chr12	10802051	10810051	10806567	8000	10806051	-4000	4000	516
chr12	10930845	10938845	10938814	8000	10934845	-4000	4000	3969
chr12	52356006	52364006	52362379	8000	52360006	-4000	4000	2373
chr12	68150768	68158768	68158233	8000	68154768	-4000	4000	3465
chr12	80705474	80713474	80708901	8000	80709474	-4000	4000	-573
chr12	7645400	7653400	7649679	8000	7649400	-4000	4000	279
chr12	95512560	95520560	95517915	8000	95516560	-4000	4000	1355
chr12	10802051	10810051	10809883	8000	10806051	-4000	4000	3832
chr12	4364227	4372227	4370544	8000	4368227	-4000	4000	2317
chr12	7713559	7721559	7715247	8000	7717559	-4000	4000	-2312
chr12	95512560	95520560	95514264	8000	95516560	-4000	4000	-2296
chr12	132618388	132626388	132620309	8000	132622388	-4000	4000	-2079
chr12	122823528	122831528	122826569	8000	122827528	-4000	4000	-959
chr12	52833804	52841804	52833836	8000	52837804	-4000	4000	-3968
chr12	57024517	57032517	57028863	8000	57028517	-4000	4000	346
chr12	122199471	122207471	122200625	8000	122203471	-4000	4000	-2846
chr12	130392133	130400133	130399711	8000	130396133	-4000	4000	3578
chr12	120318115	120326115	120325944	8000	120322115	-4000	4000	3829
chr12	52685626	52693626	52692508	8000	52689626	-4000	4000	2882
chr12	9981642	9989642	9982055	8000	9985642	-4000	4000	-3587
chr12	10802051	10810051	10806130	8000	10806051	-4000	4000	79
chr12	45010672	45018672	45016389	8000	45014672	-4000	4000	1717
chr12	109273978	109281978	109281621	8000	109277978	-4000	4000	3643
chr12	7645400	7653400	7652668	8000	7649400	-4000	4000	3268
chr12	56994447	57002447	56995860	8000	56998447	-4000	4000	-2587
chr12	216621	224621	222589	8000	220621	-4000	4000	1968
chr12	45010672	45018672	45016537	8000	45014672	-4000	4000	1865
chr12	52833804	52841804	52839466	8000	52837804	-4000	4000	1662
chr12	55217975	55225975	55221280	8000	55221975	-4000	4000	-695
chr12	55423192	55431192	55426990	8000	55427192	-4000	4000	-202
chr12	56919133	56927133	56924043	8000	56923133	-4000	4000	910
chr12	110903535	110911535	110904682	8000	110907535	-4000	4000	-2853
chr12	110906819	110914819	110910925	8000	110910819	-4000	4000	106
chr12	4364227	4372227	4370573	8000	4368227	-4000	4000	2346
chr12	5042788	5050788	5045103	8000	5046788	-4000	4000	-1685
chr12	8518366	8526366	8521155	8000	8522366	-4000	4000	-1211
chr12	10802051	10810051	10806419	8000	10806051	-4000	4000	368
chr12	46760761	46768761	46765351	8000	46764761	-4000	4000	590
chr12	48761790	48769790	48768023	8000	48765790	-4000	4000	2233
chr12	56233846	56241846	56235240	8000	56237846	-4000	4000	-2606
chr12	7685784	7693784	7689986	8000	7689784	-4000	4000	202
chr12	5042788	5050788	5044785	8000	5046788	-4000	4000	-2003
chr12	13079532	13087532	13080835	8000	13083532	-4000	4000	-2697
chr12	51324442	51332442	51328516	8000	51328442	-4000	4000	74
chr12	68244242	68252242	68248819	8000	68248242	-4000	4000	577
chr12	85010311	85018311	85017474	8000	85014311	-4000	4000	3163
chr12	130392133	130400133	130399100	8000	130396133	-4000	4000	2967
chr12	51887727	51895727	51891321	8000	51891727	-4000	4000	-406
chr12	56336410	56344410	56343454	8000	56340410	-4000	4000	3044
chr12	120318115	120326115	120322296	8000	120322115	-4000	4000	181
chr12	27498185	27506185	27502048	8000	27502185	-4000	4000	-137
chr12	55217975	55225975	55221806	8000	55221975	-4000	4000	-169
chr12	55397467	55405467	55400783	8000	55401467	-4000	4000	-684
chr12	132618388	132626388	132620264	8000	132622388	-4000	4000	-2124
chr12	132618388	132626388	132624925	8000	132622388	-4000	4000	2537
chr12	55026017	55034017	55026929	8000	55030017	-4000	4000	-3088
chr12	52785685	52793685	52790849	8000	52789685	-4000	4000	1164
chr12	55217975	55225975	55221042	8000	55221975	-4000	4000	-933
chr12	7770121	7778121	7770455	8000	7774121	-4000	4000	-3666
chr12	52603570	52611570	52610805	8000	52607570	-4000	4000	3235
chr12	87976035	87984035	87983186	8000	87980035	-4000	4000	3151
chr12	53322575	53330575	53328771	8000	53326575	-4000	4000	2196
chr12	27077057	27085057	27081090	8000	27081057	-4000	4000	33
chr12	48961340	48969340	48968284	8000	48965340	-4000	4000	2944
chr12	11387540	11395540	11393699	8000	11391540	-4000	4000	2159
chr12	122199471	122207471	122207296	8000	122203471	-4000	4000	3825
chr12	55465200	55473200	55469523	8000	55469200	-4000	4000	323
chr12	109451523	109459523	109457645	8000	109455523	-4000	4000	2122
chr12	10802051	10810051	10809354	8000	10806051	-4000	4000	3303
chr12	9981642	9989642	9984882	8000	9985642	-4000	4000	-760
chr12	55423192	55431192	55426358	8000	55427192	-4000	4000	-834
chr12	11347823	11355823	11353291	8000	11351823	-4000	4000	1468
chr12	80376880	80384880	80377157	8000	80380880	-4000	4000	-3723
chr12	48326279	48334279	48329513	8000	48330279	-4000	4000	-766
chr12	7324719	7332719	7328336	8000	7328719	-4000	4000	-383
chr12	10062031	10070031	10065655	8000	10066031	-4000	4000	-376
chr12	80705474	80713474	80708593	8000	80709474	-4000	4000	-881
chr12	56336410	56344410	56339763	8000	56340410	-4000	4000	-647
chr12	130392133	130400133	130398648	8000	130396133	-4000	4000	2515
chr12	68150768	68158768	68155466	8000	68154768	-4000	4000	698
chr12	10408312	10416312	10409525	8000	10412312	-4000	4000	-2787
chr12	128980968	128988968	128983096	8000	128984968	-4000	4000	-1872
chr12	80705474	80713474	80707790	8000	80709474	-4000	4000	-1684
chr12	13079532	13087532	13080645	8000	13083532	-4000	4000	-2887
chr12	52561782	52569782	52568277	8000	52565782	-4000	4000	2495
chr12	132618388	132626388	132619713	8000	132622388	-4000	4000	-2675
chr12	18679169	18687169	18684204	8000	18683169	-4000	4000	1035
chr12	92768455	92776455	92772552	8000	92772455	-4000	4000	97
chr12	7713559	7721559	7715203	8000	7717559	-4000	4000	-2356
chr12	5042788	5050788	5044481	8000	5046788	-4000	4000	-2307
chr12	55423192	55431192	55426892	8000	55427192	-4000	4000	-300
chr12	80705474	80713474	80708105	8000	80709474	-4000	4000	-1369
chr12	99646114	99654114	99648374	8000	99650114	-4000	4000	-1740
chr12	129067725	129075725	129074922	8000	129071725	-4000	4000	3197
chr12	52640558	52648558	52647781	8000	52644558	-4000	4000	3223
chr12	7713559	7721559	7717040	8000	7717559	-4000	4000	-519
chr12	8474330	8482330	8476177	8000	8478330	-4000	4000	-2153
chr12	11347823	11355823	11354555	8000	11351823	-4000	4000	2732
chr12	21375980	21383980	21378426	8000	21379980	-4000	4000	-1554
chr12	49328409	49336409	49330302	8000	49332409	-4000	4000	-2107
chr12	49973139	49981139	49973522	8000	49977139	-4000	4000	-3617
chr12	52389931	52397931	52395760	8000	52393931	-4000	4000	1829
chr12	55633833	55641833	55637590	8000	55637833	-4000	4000	-243
chr12	56336410	56344410	56339190	8000	56340410	-4000	4000	-1220
chr12	80376880	80384880	80377847	8000	80380880	-4000	4000	-3033
chr12	92768455	92776455	92770333	8000	92772455	-4000	4000	-2122
chr12	95968662	95976662	95976492	8000	95972662	-4000	4000	3830
chr12	129067725	129075725	129073720	8000	129071725	-4000	4000	1995
chr12	11303077	11311077	11309372	8000	11307077	-4000	4000	2295
chr12	80705474	80713474	80707714	8000	80709474	-4000	4000	-1760
chr12	80705474	80713474	80708031	8000	80709474	-4000	4000	-1443
chr12	5042788	5050788	5045911	8000	5046788	-4000	4000	-877
chr12	48961340	48969340	48966039	8000	48965340	-4000	4000	699
chr12	52373812	52381812	52381447	8000	52377812	-4000	4000	3635
chr12	4364227	4372227	4370525	8000	4368227	-4000	4000	2298
chr12	52685626	52693626	52692479	8000	52689626	-4000	4000	2853
chr12	5042788	5050788	5044663	8000	5046788	-4000	4000	-2125
chr12	5042788	5050788	5045281	8000	5046788	-4000	4000	-1507
chr12	10062031	10070031	10065594	8000	10066031	-4000	4000	-437
chr12	11347823	11355823	11354555	8000	11351823	-4000	4000	2732
chr12	18735188	18743188	18738433	8000	18739188	-4000	4000	-755
chr12	27077057	27085057	27082447	8000	27081057	-4000	4000	1390
chr12	48198339	48206339	48202813	8000	48202339	-4000	4000	474
chr12	49973139	49981139	49975521	8000	49977139	-4000	4000	-1618
chr12	52356006	52364006	52360967	8000	52360006	-4000	4000	961
chr12	52389931	52397931	52395169	8000	52393931	-4000	4000	1238
chr12	52561782	52569782	52568256	8000	52565782	-4000	4000	2474
chr12	52603570	52611570	52609271	8000	52607570	-4000	4000	1701
chr12	55318364	55326364	55321006	8000	55322364	-4000	4000	-1358
chr12	55328687	55336687	55332392	8000	55332687	-4000	4000	-295
chr12	55397467	55405467	55401283	8000	55401467	-4000	4000	-184
chr12	55465200	55473200	55469646	8000	55469200	-4000	4000	446
chr12	55489316	55497316	55492735	8000	55493316	-4000	4000	-581
chr12	80705474	80713474	80708581	8000	80709474	-4000	4000	-893
chr12	80715671	80723671	80717437	8000	80719671	-4000	4000	-2234
chr12	101482997	101490997	101486430	8000	101486997	-4000	4000	-567
chr12	108897043	108905043	108900567	8000	108901043	-4000	4000	-476
chr12	122199471	122207471	122207120	8000	122203471	-4000	4000	3649
chr12	129067725	129075725	129073916	8000	129071725	-4000	4000	2191
chr12	48961340	48969340	48966090	8000	48965340	-4000	4000	750
chr12	55128750	55136750	55130439	8000	55132750	-4000	4000	-2311
chr12	56919133	56927133	56923875	8000	56923133	-4000	4000	742
chr12	56356568	56364568	56361413	8000	56360568	-4000	4000	845
chr12	80715671	80723671	80717347	8000	80719671	-4000	4000	-2324
chr12	130392133	130400133	130399774	8000	130396133	-4000	4000	3641
chr12	52785685	52793685	52790286	8000	52789685	-4000	4000	601
chr12	52764155	52772155	52771187	8000	52768155	-4000	4000	3032
chr12	95512560	95520560	95517795	8000	95516560	-4000	4000	1235
chr12	4364227	4372227	4370498	8000	4368227	-4000	4000	2271
chr12	52581589	52589589	52587801	8000	52585589	-4000	4000	2212
chr12	51887727	51895727	51891146	8000	51891727	-4000	4000	-581
chr12	132192372	132200372	132197214	8000	132196372	-4000	4000	842
chr12	52389931	52397931	52396231	8000	52393931	-4000	4000	2300
chr12	55328687	55336687	55332158	8000	55332687	-4000	4000	-529
chr12	55633833	55641833	55637267	8000	55637833	-4000	4000	-566
chr12	132618388	132626388	132621702	8000	132622388	-4000	4000	-686
chr12	56994447	57002447	57002361	8000	56998447	-4000	4000	3914
chr12	48198339	48206339	48202960	8000	48202339	-4000	4000	621
chr12	132618388	132626388	132621313	8000	132622388	-4000	4000	-1075
chr12	68244242	68252242	68248772	8000	68248242	-4000	4000	530
chr12	56356568	56364568	56361306	8000	56360568	-4000	4000	738
chr12	10062031	10070031	10065856	8000	10066031	-4000	4000	-175
chr12	27077057	27085057	27081228	8000	27081057	-4000	4000	171
chr12	55289988	55297988	55294770	8000	55293988	-4000	4000	782
chr12	5042788	5050788	5044793	8000	5046788	-4000	4000	-1995
chr12	48469622	48477622	48472708	8000	48473622	-4000	4000	-914
chr12	51887727	51895727	51889284	8000	51891727	-4000	4000	-2443
chr12	51887727	51895727	51891076	8000	51891727	-4000	4000	-651
chr12	129067725	129075725	129074536	8000	129071725	-4000	4000	2811
chr12	8598170	8606170	8604189	8000	8602170	-4000	4000	2019
chr12	11261914	11269914	11268134	8000	11265914	-4000	4000	2220
chr12	48469622	48477622	48472991	8000	48473622	-4000	4000	-631
chr12	55397467	55405467	55401110	8000	55401467	-4000	4000	-357
chr12	11303077	11311077	11308474	8000	11307077	-4000	4000	1397
chr12	13079532	13087532	13080679	8000	13083532	-4000	4000	-2853
chr12	56356568	56364568	56356569	8000	56360568	-4000	4000	-3999
chr12	55289988	55297988	55294899	8000	55293988	-4000	4000	911
chr12	95512560	95520560	95518024	8000	95516560	-4000	4000	1464
chr12	55318364	55326364	55320839	8000	55322364	-4000	4000	-1525
chr12	99646114	99654114	99649742	8000	99650114	-4000	4000	-372
chr12	27693596	27701596	27697199	8000	27697596	-4000	4000	-397
chr12	132618388	132626388	132621719	8000	132622388	-4000	4000	-669
chr12	56336410	56344410	56340175	8000	56340410	-4000	4000	-235
chr12	85297784	85305784	85301528	8000	85301784	-4000	4000	-256
chr12	11387540	11395540	11393873	8000	11391540	-4000	4000	2333
chr12	80715671	80723671	80717275	8000	80719671	-4000	4000	-2396
chr12	5042788	5050788	5045842	8000	5046788	-4000	4000	-946
chr12	122199471	122207471	122203396	8000	122203471	-4000	4000	-75
chr12	52373812	52381812	52380568	8000	52377812	-4000	4000	2756
chr12	55449347	55457347	55452766	8000	55453347	-4000	4000	-581
chr12	122199471	122207471	122206539	8000	122203471	-4000	4000	3068
chr12	100560414	100568414	100563571	8000	100564414	-4000	4000	-843
chr12	129067725	129075725	129073689	8000	129071725	-4000	4000	1964
chr12	129067725	129075725	129074283	8000	129071725	-4000	4000	2558
chr12	49954878	49962878	49955462	8000	49958878	-4000	4000	-3416
chr12	52356006	52364006	52360864	8000	52360006	-4000	4000	858
chr12	55289988	55297988	55295069	8000	55293988	-4000	4000	1081
chr12	4364227	4372227	4370563	8000	4368227	-4000	4000	2336
chr12	55318364	55326364	55320821	8000	55322364	-4000	4000	-1543
chr12	106758803	106766803	106761455	8000	106762803	-4000	4000	-1348
chr12	130392133	130400133	130399758	8000	130396133	-4000	4000	3625
chr12	27077057	27085057	27082133	8000	27081057	-4000	4000	1076
chr12	27758427	27766427	27763289	8000	27762427	-4000	4000	862
chr12	53322575	53330575	53329278	8000	53326575	-4000	4000	2703
chr13	113168386	113176386	113171716	8000	113172386	-4000	4000	-670
chr13	19169772	19177772	19177302	8000	19173772	-4000	4000	3530
chr13	19169772	19177772	19177510	8000	19173772	-4000	4000	3738
chr13	113644804	113652804	113649380	8000	113648804	-4000	4000	576
chr13	20134255	20142255	20141937	8000	20138255	-4000	4000	3682
chr13	102725367	102733367	102732605	8000	102729367	-4000	4000	3238
chr13	102725367	102733367	102732774	8000	102729367	-4000	4000	3407
chr13	112067706	112075706	112071036	8000	112071706	-4000	4000	-670
chr13	112430689	112438689	112434557	8000	112434689	-4000	4000	-132
chr13	38961925	38969925	38968474	8000	38965925	-4000	4000	2549
chr13	112067706	112075706	112069171	8000	112071706	-4000	4000	-2535
chr13	27956918	27964918	27963277	8000	27960918	-4000	4000	2359
chr13	27922313	27930313	27924481	8000	27926313	-4000	4000	-1832
chr13	36693839	36701839	36695167	8000	36697839	-4000	4000	-2672
chr13	78594362	78602362	78601589	8000	78598362	-4000	4000	3227
chr13	102725367	102733367	102730154	8000	102729367	-4000	4000	787
chr13	27790768	27798768	27793679	8000	27794768	-4000	4000	-1089
chr13	102725367	102733367	102730037	8000	102729367	-4000	4000	670
chr13	102725367	102733367	102732808	8000	102729367	-4000	4000	3441
chr13	51862232	51870232	51865457	8000	51866232	-4000	4000	-775
chr13	94705622	94713622	94712100	8000	94709622	-4000	4000	2478
chr13	51862232	51870232	51865374	8000	51866232	-4000	4000	-858
chr13	98171785	98179785	98176310	8000	98175785	-4000	4000	525
chr13	102725367	102733367	102732773	8000	102729367	-4000	4000	3406
chr13	52838889	52846889	52844790	8000	52842889	-4000	4000	1901
chr13	105487034	105495034	105490004	8000	105491034	-4000	4000	-1030
chr13	49218377	49226377	49222269	8000	49222377	-4000	4000	-108
chr13	102725367	102733367	102733099	8000	102729367	-4000	4000	3732
chr13	94705622	94713622	94711145	8000	94709622	-4000	4000	1523
chr13	46049186	46057186	46053790	8000	46053186	-4000	4000	604
chr13	19169772	19177772	19174098	8000	19173772	-4000	4000	326
chr13	46827546	46835546	46835500	8000	46831546	-4000	4000	3954
chr13	49218377	49226377	49222313	8000	49222377	-4000	4000	-64
chr13	24708472	24716472	24709759	8000	24712472	-4000	4000	-2713
chr13	45710559	45718559	45714162	8000	45714559	-4000	4000	-397
chr13	112430689	112438689	112434637	8000	112434689	-4000	4000	-52
chr13	46049186	46057186	46055796	8000	46053186	-4000	4000	2610
chr13	102725367	102733367	102729398	8000	102729367	-4000	4000	31
chr13	102725367	102733367	102730507	8000	102729367	-4000	4000	1140
chr13	112430689	112438689	112434512	8000	112434689	-4000	4000	-177
chr13	113644804	113652804	113649466	8000	113648804	-4000	4000	662
chr13	30971500	30979500	30974928	8000	30975500	-4000	4000	-572
chr13	46827546	46835546	46834644	8000	46831546	-4000	4000	3098
chr13	46827546	46835546	46834893	8000	46831546	-4000	4000	3347
chr13	49218377	49226377	49222125	8000	49222377	-4000	4000	-252
chr13	78594362	78602362	78599562	8000	78598362	-4000	4000	1200
chr13	19169772	19177772	19177148	8000	19173772	-4000	4000	3376
chr13	19418877	19426877	19423150	8000	19422877	-4000	4000	273
chr13	24875921	24883921	24883109	8000	24879921	-4000	4000	3188
chr13	38961925	38969925	38966746	8000	38965925	-4000	4000	821
chr13	46827546	46835546	46834770	8000	46831546	-4000	4000	3224
chr13	94432811	94440811	94439962	8000	94436811	-4000	4000	3151
chr13	102681747	102689747	102686303	8000	102685747	-4000	4000	556
chr13	102725367	102733367	102730982	8000	102729367	-4000	4000	1615
chr13	102725367	102733367	102733304	8000	102729367	-4000	4000	3937
chr13	29501947	29509947	29503003	8000	29505947	-4000	4000	-2944
chr13	99958964	99966964	99965387	8000	99962964	-4000	4000	2423
chr13	19169772	19177772	19174055	8000	19173772	-4000	4000	283
chr13	113733736	113741736	113735418	8000	113737736	-4000	4000	-2318
chr13	19418877	19426877	19425011	8000	19422877	-4000	4000	2134
chr13	27790768	27798768	27793836	8000	27794768	-4000	4000	-932
chr13	102725367	102733367	102733252	8000	102729367	-4000	4000	3885
chr13	98171785	98179785	98176701	8000	98175785	-4000	4000	916
chr13	113644804	113652804	113649492	8000	113648804	-4000	4000	688
chr13	98171785	98179785	98176420	8000	98175785	-4000	4000	635
chr13	98171785	98179785	98176341	8000	98175785	-4000	4000	556
chr13	46827546	46835546	46834762	8000	46831546	-4000	4000	3216
chr13	46827546	46835546	46834835	8000	46831546	-4000	4000	3289
chr13	19169772	19177772	19177500	8000	19173772	-4000	4000	3728
chr13	45188853	45196853	45194211	8000	45192853	-4000	4000	1358
chr13	30971500	30979500	30974911	8000	30975500	-4000	4000	-589
chr14	20056983	20064983	20060141	8000	20060983	-4000	4000	-842
chr14	20636696	20644696	20641364	8000	20640696	-4000	4000	668
chr14	60508850	60516850	60509696	8000	60512850	-4000	4000	-3154
chr14	20056983	20064983	20060488	8000	20060983	-4000	4000	-495
chr14	74848871	74856871	74855276	8000	74852871	-4000	4000	2405
chr14	81142306	81150306	81142986	8000	81146306	-4000	4000	-3320
chr14	19972565	19980565	19976493	8000	19976565	-4000	4000	-72
chr14	20010143	20018143	20015132	8000	20014143	-4000	4000	989
chr14	77470394	77478394	77475718	8000	77474394	-4000	4000	1324
chr14	100875753	100883753	100883069	8000	100879753	-4000	4000	3316
chr14	19826253	19834253	19828139	8000	19830253	-4000	4000	-2114
chr14	81142306	81150306	81143663	8000	81146306	-4000	4000	-2643
chr14	19917578	19925578	19921446	8000	19921578	-4000	4000	-132
chr14	24501353	24509353	24506193	8000	24505353	-4000	4000	840
chr14	44500149	44508149	44505860	8000	44504149	-4000	4000	1711
chr14	74258738	74266738	74259694	8000	74262738	-4000	4000	-3044
chr14	20220702	20228702	20223866	8000	20224702	-4000	4000	-836
chr14	56795905	56803905	56802064	8000	56799905	-4000	4000	2159
chr14	19917578	19925578	19921356	8000	19921578	-4000	4000	-222
chr14	35533054	35541054	35534439	8000	35537054	-4000	4000	-2615
chr14	94458717	94466717	94463103	8000	94462717	-4000	4000	386
chr14	21663886	21671886	21665438	8000	21667886	-4000	4000	-2448
chr14	24074100	24082100	24077781	8000	24078100	-4000	4000	-319
chr14	23269477	23277477	23276461	8000	23273477	-4000	4000	2984
chr14	20744380	20752380	20747895	8000	20748380	-4000	4000	-485
chr14	74356008	74364008	74358393	8000	74360008	-4000	4000	-1615
chr14	28766277	28774277	28767915	8000	28770277	-4000	4000	-2362
chr14	100326421	100334421	100327229	8000	100330421	-4000	4000	-3192
chr14	28766277	28774277	28768422	8000	28770277	-4000	4000	-1855
chr14	69771416	69779416	69778343	8000	69775416	-4000	4000	2927
chr14	20010143	20018143	20015144	8000	20014143	-4000	4000	1001
chr14	23040060	23048060	23042784	8000	23044060	-4000	4000	-1276
chr14	21663886	21671886	21665278	8000	21667886	-4000	4000	-2608
chr14	20141471	20149471	20144603	8000	20145471	-4000	4000	-868
chr14	23113306	23121306	23117587	8000	23117306	-4000	4000	281
chr14	23269477	23277477	23276450	8000	23273477	-4000	4000	2973
chr14	23377982	23385982	23384672	8000	23381982	-4000	4000	2690
chr14	24128849	24136849	24132232	8000	24132849	-4000	4000	-617
chr14	28766277	28774277	28767377	8000	28770277	-4000	4000	-2900
chr14	58404702	58412702	58409128	8000	58408702	-4000	4000	426
chr14	100326421	100334421	100328925	8000	100330421	-4000	4000	-1496
chr14	60508850	60516850	60509601	8000	60512850	-4000	4000	-3249
chr14	76866304	76874304	76870189	8000	76870304	-4000	4000	-115
chr14	19398486	19406486	19402594	8000	19402486	-4000	4000	108
chr14	23269477	23277477	23276526	8000	23273477	-4000	4000	3049
chr14	52272724	52280724	52274982	8000	52276724	-4000	4000	-1742
chr14	100875753	100883753	100882519	8000	100879753	-4000	4000	2766
chr14	69771416	69779416	69771428	8000	69775416	-4000	4000	-3988
chr14	20578892	20586892	20584127	8000	20582892	-4000	4000	1235
chr14	70456427	70464427	70457587	8000	70460427	-4000	4000	-2840
chr14	70456427	70464427	70458127	8000	70460427	-4000	4000	-2300
chr14	52272724	52280724	52274737	8000	52276724	-4000	4000	-1987
chr14	20240349	20248349	20242951	8000	20244349	-4000	4000	-1398
chr14	21629836	21637836	21634714	8000	21633836	-4000	4000	878
chr14	44500149	44508149	44504645	8000	44504149	-4000	4000	496
chr14	21347301	21355301	21348191	8000	21351301	-4000	4000	-3110
chr14	23040060	23048060	23043370	8000	23044060	-4000	4000	-690
chr14	23040060	23048060	23042576	8000	23044060	-4000	4000	-1484
chr14	36469207	36477207	36473790	8000	36473207	-4000	4000	583
chr14	100875753	100883753	100881630	8000	100879753	-4000	4000	1877
chr14	23564038	23572038	23571820	8000	23568038	-4000	4000	3782
chr14	100326421	100334421	100327301	8000	100330421	-4000	4000	-3120
chr14	100875753	100883753	100883183	8000	100879753	-4000	4000	3430
chr14	20552093	20560093	20556604	8000	20556093	-4000	4000	511
chr14	23095062	23103062	23095168	8000	23099062	-4000	4000	-3894
chr14	60508850	60516850	60509899	8000	60512850	-4000	4000	-2951
chr14	100875753	100883753	100882048	8000	100879753	-4000	4000	2295
chr14	20010143	20018143	20015042	8000	20014143	-4000	4000	899
chr14	23040060	23048060	23042911	8000	23044060	-4000	4000	-1149
chr14	100875753	100883753	100882585	8000	100879753	-4000	4000	2832
chr14	35533054	35541054	35534413	8000	35537054	-4000	4000	-2641
chr14	94483274	94491274	94487402	8000	94487274	-4000	4000	128
chr14	100875753	100883753	100883049	8000	100879753	-4000	4000	3296
chr14	23564038	23572038	23565898	8000	23568038	-4000	4000	-2140
chr14	74401894	74409894	74407667	8000	74405894	-4000	4000	1773
chr14	20744380	20752380	20747672	8000	20748380	-4000	4000	-708
chr14	19826253	19834253	19828008	8000	19830253	-4000	4000	-2245
chr14	56795905	56803905	56802340	8000	56799905	-4000	4000	2435
chr14	19826253	19834253	19828004	8000	19830253	-4000	4000	-2249
chr14	19917578	19925578	19920797	8000	19921578	-4000	4000	-781
chr14	35533054	35541054	35536334	8000	35537054	-4000	4000	-720
chr14	20636696	20644696	20641517	8000	20640696	-4000	4000	821
chr14	46835629	46843629	46840981	8000	46839629	-4000	4000	1352
chr14	23095062	23103062	23095311	8000	23099062	-4000	4000	-3751
chr14	20010143	20018143	20014826	8000	20014143	-4000	4000	683
chr14	36469207	36477207	36473561	8000	36473207	-4000	4000	354
chr14	20056983	20064983	20060306	8000	20060983	-4000	4000	-677
chr14	24204362	24212362	24209832	8000	24208362	-4000	4000	1470
chr14	69565799	69573799	69571105	8000	69569799	-4000	4000	1306
chr14	20888348	20896348	20891996	8000	20892348	-4000	4000	-352
chr14	21629836	21637836	21634760	8000	21633836	-4000	4000	924
chr14	20636696	20644696	20641191	8000	20640696	-4000	4000	495
chr14	20744380	20752380	20747926	8000	20748380	-4000	4000	-454
chr14	23564038	23572038	23566797	8000	23568038	-4000	4000	-1241
chr14	44500149	44508149	44505922	8000	44504149	-4000	4000	1773
chr14	44500149	44508149	44507044	8000	44504149	-4000	4000	2895
chr14	23564038	23572038	23566340	8000	23568038	-4000	4000	-1698
chr14	70456427	70464427	70457578	8000	70460427	-4000	4000	-2849
chr14	23040060	23048060	23042784	8000	23044060	-4000	4000	-1276
chr14	24074100	24082100	24077011	8000	24078100	-4000	4000	-1089
chr14	94483274	94491274	94487342	8000	94487274	-4000	4000	68
chr14	23095062	23103062	23097702	8000	23099062	-4000	4000	-1360
chr14	23269477	23277477	23275407	8000	23273477	-4000	4000	1930
chr14	20220702	20228702	20224337	8000	20224702	-4000	4000	-365
chr14	95688628	95696628	95690734	8000	95692628	-4000	4000	-1894
chr14	20636696	20644696	20641458	8000	20640696	-4000	4000	762
chr14	23095062	23103062	23097772	8000	23099062	-4000	4000	-1290
chr14	23269477	23277477	23276440	8000	23273477	-4000	4000	2963
chr14	21347301	21355301	21353817	8000	21351301	-4000	4000	2516
chr14	19932757	19940757	19935972	8000	19936757	-4000	4000	-785
chr14	20141471	20149471	20144476	8000	20145471	-4000	4000	-995
chr14	73615888	73623888	73616921	8000	73619888	-4000	4000	-2967
chr14	100875753	100883753	100882330	8000	100879753	-4000	4000	2577
chr14	19826253	19834253	19828243	8000	19830253	-4000	4000	-2010
chr14	46647010	46655010	46651777	8000	46651010	-4000	4000	767
chr14	70518358	70526358	70522783	8000	70522358	-4000	4000	425
chr14	70518358	70526358	70523227	8000	70522358	-4000	4000	869
chr14	100875753	100883753	100883463	8000	100879753	-4000	4000	3710
chr14	20636696	20644696	20641289	8000	20640696	-4000	4000	593
chr14	20010143	20018143	20014735	8000	20014143	-4000	4000	592
chr14	77261483	77269483	77269314	8000	77265483	-4000	4000	3831
chr14	69771416	69779416	69778479	8000	69775416	-4000	4000	3063
chr14	38209067	38217067	38210142	8000	38213067	-4000	4000	-2925
chr14	70456427	70464427	70457602	8000	70460427	-4000	4000	-2825
chr14	21032276	21040276	21034107	8000	21036276	-4000	4000	-2169
chr14	20141471	20149471	20144585	8000	20145471	-4000	4000	-886
chr14	77127270	77135270	77133864	8000	77131270	-4000	4000	2594
chr14	19826253	19834253	19828091	8000	19830253	-4000	4000	-2162
chr14	24204362	24212362	24206638	8000	24208362	-4000	4000	-1724
chr14	23375772	23383772	23378847	8000	23379772	-4000	4000	-925
chr14	20197075	20205075	20197770	8000	20201075	-4000	4000	-3305
chr14	100875753	100883753	100880793	8000	100879753	-4000	4000	1040
chr14	18598097	18606097	18601450	8000	18602097	-4000	4000	-647
chr14	20056983	20064983	20060944	8000	20060983	-4000	4000	-39
chr14	21663886	21671886	21665860	8000	21667886	-4000	4000	-2026
chr14	70456427	70464427	70458922	8000	70460427	-4000	4000	-1505
chr14	93925608	93933608	93929013	8000	93929608	-4000	4000	-595
chr14	20240349	20248349	20242810	8000	20244349	-4000	4000	-1539
chr14	28766277	28774277	28768935	8000	28770277	-4000	4000	-1342
chr14	70518358	70526358	70523252	8000	70522358	-4000	4000	894
chr14	20197075	20205075	20198111	8000	20201075	-4000	4000	-2964
chr14	20636696	20644696	20641664	8000	20640696	-4000	4000	968
chr14	21040234	21048234	21043363	8000	21044234	-4000	4000	-871
chr14	81142306	81150306	81143594	8000	81146306	-4000	4000	-2712
chr14	21040234	21048234	21043508	8000	21044234	-4000	4000	-726
chr14	36469207	36477207	36477061	8000	36473207	-4000	4000	3854
chr14	60508850	60516850	60511261	8000	60512850	-4000	4000	-1589
chr14	21564520	21572520	21570062	8000	21568520	-4000	4000	1542
chr14	21663886	21671886	21665730	8000	21667886	-4000	4000	-2156
chr14	18598097	18606097	18601251	8000	18602097	-4000	4000	-846
chr14	58404702	58412702	58408535	8000	58408702	-4000	4000	-167
chr14	24128849	24136849	24136292	8000	24132849	-4000	4000	3443
chr14	20220702	20228702	20223765	8000	20224702	-4000	4000	-937
chr14	94276460	94284460	94284050	8000	94280460	-4000	4000	3590
chr14	69771416	69779416	69778440	8000	69775416	-4000	4000	3024
chr14	21054455	21062455	21058352	8000	21058455	-4000	4000	-103
chr14	24501353	24509353	24508206	8000	24505353	-4000	4000	2853
chr14	23375772	23383772	23377321	8000	23379772	-4000	4000	-2451
chr14	74356008	74364008	74358101	8000	74360008	-4000	4000	-1907
chr14	21040234	21048234	21043172	8000	21044234	-4000	4000	-1062
chr14	70518358	70526358	70522889	8000	70522358	-4000	4000	531
chr14	20056983	20064983	20060336	8000	20060983	-4000	4000	-647
chr14	74356008	74364008	74357813	8000	74360008	-4000	4000	-2195
chr14	46647010	46655010	46651589	8000	46651010	-4000	4000	579
chr14	20197075	20205075	20197930	8000	20201075	-4000	4000	-3145
chr14	44500149	44508149	44506854	8000	44504149	-4000	4000	2705
chr14	20744380	20752380	20747946	8000	20748380	-4000	4000	-434
chr14	21629836	21637836	21634075	8000	21633836	-4000	4000	239
chr14	44500149	44508149	44505523	8000	44504149	-4000	4000	1374
chr14	20141471	20149471	20144092	8000	20145471	-4000	4000	-1379
chr14	41900549	41908549	41904208	8000	41904549	-4000	4000	-341
chr14	46647010	46655010	46651765	8000	46651010	-4000	4000	755
chr14	95688628	95696628	95691265	8000	95692628	-4000	4000	-1363
chr14	20010143	20018143	20014484	8000	20014143	-4000	4000	341
chr14	20578892	20586892	20583894	8000	20582892	-4000	4000	1002
chr14	23040060	23048060	23043410	8000	23044060	-4000	4000	-650
chr14	19972565	19980565	19975887	8000	19976565	-4000	4000	-678
chr14	20552093	20560093	20556612	8000	20556093	-4000	4000	519
chr14	23564038	23572038	23566137	8000	23568038	-4000	4000	-1901
chr14	94458717	94466717	94463055	8000	94462717	-4000	4000	338
chr14	20744380	20752380	20747955	8000	20748380	-4000	4000	-425
chr14	20010143	20018143	20014736	8000	20014143	-4000	4000	593
chr14	20636696	20644696	20641247	8000	20640696	-4000	4000	551
chr14	21629836	21637836	21634815	8000	21633836	-4000	4000	979
chr14	23372403	23380403	23373364	8000	23376403	-4000	4000	-3039
chr14	23564038	23572038	23569512	8000	23568038	-4000	4000	1474
chr14	28766277	28774277	28768605	8000	28770277	-4000	4000	-1672
chr14	70456427	70464427	70458327	8000	70460427	-4000	4000	-2100
chr14	74356008	74364008	74357817	8000	74360008	-4000	4000	-2191
chr14	94458717	94466717	94463129	8000	94462717	-4000	4000	412
chr14	19972565	19980565	19975687	8000	19976565	-4000	4000	-878
chr14	28766277	28774277	28767843	8000	28770277	-4000	4000	-2434
chr14	77470394	77478394	77475688	8000	77474394	-4000	4000	1294
chr14	19932757	19940757	19935815	8000	19936757	-4000	4000	-942
chr14	19972565	19980565	19975814	8000	19976565	-4000	4000	-751
chr14	20888348	20896348	20891984	8000	20892348	-4000	4000	-364
chr14	20997871	21005871	21000980	8000	21001871	-4000	4000	-891
chr14	21040234	21048234	21043265	8000	21044234	-4000	4000	-969
chr14	21564520	21572520	21569815	8000	21568520	-4000	4000	1295
chr14	21564520	21572520	21570433	8000	21568520	-4000	4000	1913
chr14	23372403	23380403	23373324	8000	23376403	-4000	4000	-3079
chr14	23375772	23383772	23377248	8000	23379772	-4000	4000	-2524
chr14	23375772	23383772	23378472	8000	23379772	-4000	4000	-1300
chr14	24074100	24082100	24075859	8000	24078100	-4000	4000	-2241
chr14	24204362	24212362	24211557	8000	24208362	-4000	4000	3195
chr14	36469207	36477207	36477011	8000	36473207	-4000	4000	3804
chr14	44500149	44508149	44507143	8000	44504149	-4000	4000	2994
chr14	52272724	52280724	52274878	8000	52276724	-4000	4000	-1846
chr14	56795905	56803905	56801895	8000	56799905	-4000	4000	1990
chr14	57465300	57473300	57471331	8000	57469300	-4000	4000	2031
chr14	60508850	60516850	60509694	8000	60512850	-4000	4000	-3156
chr14	76866304	76874304	76870163	8000	76870304	-4000	4000	-141
chr14	81142306	81150306	81144041	8000	81146306	-4000	4000	-2265
chr14	94483274	94491274	94489704	8000	94487274	-4000	4000	2430
chr14	21663886	21671886	21665177	8000	21667886	-4000	4000	-2709
chr14	56795905	56803905	56801912	8000	56799905	-4000	4000	2007
chr14	44500149	44508149	44504660	8000	44504149	-4000	4000	511
chr14	23269477	23277477	23276111	8000	23273477	-4000	4000	2634
chr14	20636696	20644696	20641584	8000	20640696	-4000	4000	888
chr14	21099724	21107724	21103417	8000	21103724	-4000	4000	-307
chr14	20197075	20205075	20197434	8000	20201075	-4000	4000	-3641
chr14	19917578	19925578	19921343	8000	19921578	-4000	4000	-235
chr14	24074100	24082100	24076679	8000	24078100	-4000	4000	-1421
chr14	18598097	18606097	18601450	8000	18602097	-4000	4000	-647
chr14	20952436	20960436	20955916	8000	20956436	-4000	4000	-520
chr14	100326421	100334421	100333930	8000	100330421	-4000	4000	3509
chr14	24128849	24136849	24136185	8000	24132849	-4000	4000	3336
chr14	23375772	23383772	23379338	8000	23379772	-4000	4000	-434
chr14	41900549	41908549	41904414	8000	41904549	-4000	4000	-135
chr14	70456427	70464427	70458581	8000	70460427	-4000	4000	-1846
chr14	76497837	76505837	76498451	8000	76501837	-4000	4000	-3386
chr14	81142306	81150306	81144018	8000	81146306	-4000	4000	-2288
chr14	44500149	44508149	44506129	8000	44504149	-4000	4000	1980
chr14	20744380	20752380	20748007	8000	20748380	-4000	4000	-373
chr14	21629836	21637836	21634150	8000	21633836	-4000	4000	314
chr14	23095062	23103062	23098575	8000	23099062	-4000	4000	-487
chr14	64080232	64088232	64080632	8000	64084232	-4000	4000	-3600
chr14	69565799	69573799	69571051	8000	69569799	-4000	4000	1252
chr14	19932757	19940757	19936140	8000	19936757	-4000	4000	-617
chr14	94276460	94284460	94278618	8000	94280460	-4000	4000	-1842
chr14	19932757	19940757	19935861	8000	19936757	-4000	4000	-896
chr14	23372403	23380403	23375734	8000	23376403	-4000	4000	-669
chr14	20888348	20896348	20891698	8000	20892348	-4000	4000	-650
chr14	21663886	21671886	21665436	8000	21667886	-4000	4000	-2450
chr14	20010143	20018143	20014882	8000	20014143	-4000	4000	739
chr14	100875753	100883753	100881825	8000	100879753	-4000	4000	2072
chr14	20552093	20560093	20556824	8000	20556093	-4000	4000	731
chr14	70518358	70526358	70524790	8000	70522358	-4000	4000	2432
chr14	18598097	18606097	18601924	8000	18602097	-4000	4000	-173
chr14	100326421	100334421	100327208	8000	100330421	-4000	4000	-3213
chr14	41900549	41908549	41904215	8000	41904549	-4000	4000	-334
chr14	94458717	94466717	94464729	8000	94462717	-4000	4000	2012
chr14	20507169	20515169	20510889	8000	20511169	-4000	4000	-280
chr14	81142306	81150306	81142991	8000	81146306	-4000	4000	-3315
chr14	23040060	23048060	23042534	8000	23044060	-4000	4000	-1526
chr14	52272724	52280724	52274826	8000	52276724	-4000	4000	-1898
chr14	23040060	23048060	23042846	8000	23044060	-4000	4000	-1214
chr14	19826253	19834253	19828149	8000	19830253	-4000	4000	-2104
chr14	23040060	23048060	23042907	8000	23044060	-4000	4000	-1153
chr14	23564038	23572038	23566388	8000	23568038	-4000	4000	-1650
chr14	70456427	70464427	70458493	8000	70460427	-4000	4000	-1934
chr14	74356008	74364008	74357315	8000	74360008	-4000	4000	-2693
chr14	23564038	23572038	23565851	8000	23568038	-4000	4000	-2187
chr14	23564038	23572038	23571444	8000	23568038	-4000	4000	3406
chr14	94458717	94466717	94462923	8000	94462717	-4000	4000	206
chr14	100875753	100883753	100880717	8000	100879753	-4000	4000	964
chr14	19972565	19980565	19975952	8000	19976565	-4000	4000	-613
chr14	20552093	20560093	20556342	8000	20556093	-4000	4000	249
chr15	23639549	23647549	23645285	8000	23643549	-4000	4000	1736
chr15	43272271	43280271	43279221	8000	43276271	-4000	4000	2950
chr15	98964229	98972229	98964323	8000	98968229	-4000	4000	-3906
chr15	34063458	34071458	34063489	8000	34067458	-4000	4000	-3969
chr15	75291807	75299807	75293731	8000	75295807	-4000	4000	-2076
chr15	43595563	43603563	43598910	8000	43599563	-4000	4000	-653
chr15	59204588	59212588	59208187	8000	59208588	-4000	4000	-401
chr15	43595563	43603563	43601008	8000	43599563	-4000	4000	1445
chr15	84941798	84949798	84943465	8000	84945798	-4000	4000	-2333
chr15	74333759	74341759	74335257	8000	74337759	-4000	4000	-2502
chr15	101802887	101810887	101806277	8000	101806887	-4000	4000	-610
chr15	30356566	30364566	30361400	8000	30360566	-4000	4000	834
chr15	34063458	34071458	34063553	8000	34067458	-4000	4000	-3905
chr15	43595563	43603563	43601507	8000	43599563	-4000	4000	1944
chr15	52751053	52759053	52757416	8000	52755053	-4000	4000	2363
chr15	84941798	84949798	84945476	8000	84945798	-4000	4000	-322
chr15	101918042	101926042	101922720	8000	101922042	-4000	4000	678
chr15	74715542	74723542	74720837	8000	74719542	-4000	4000	1295
chr15	43595563	43603563	43600082	8000	43599563	-4000	4000	519
chr15	72665599	72673599	72666062	8000	72669599	-4000	4000	-3537
chr15	59204588	59212588	59210533	8000	59208588	-4000	4000	1945
chr15	75723688	75731688	75727391	8000	75727688	-4000	4000	-297
chr15	45088650	45096650	45095969	8000	45092650	-4000	4000	3319
chr15	26945208	26953208	26948235	8000	26949208	-4000	4000	-973
chr15	41499637	41507637	41505257	8000	41503637	-4000	4000	1620
chr15	43595563	43603563	43598316	8000	43599563	-4000	4000	-1247
chr15	101802887	101810887	101806094	8000	101806887	-4000	4000	-793
chr15	74333759	74341759	74338689	8000	74337759	-4000	4000	930
chr15	41499637	41507637	41504195	8000	41503637	-4000	4000	558
chr15	73885214	73893214	73889081	8000	73889214	-4000	4000	-133
chr15	23435038	23443038	23441226	8000	23439038	-4000	4000	2188
chr15	40811451	40819451	40812832	8000	40815451	-4000	4000	-2619
chr15	34063458	34071458	34063663	8000	34067458	-4000	4000	-3795
chr15	54624707	54632707	54628385	8000	54628707	-4000	4000	-322
chr15	59204588	59212588	59208187	8000	59208588	-4000	4000	-401
chr15	78589052	78597052	78589855	8000	78593052	-4000	4000	-3197
chr15	34786230	34794230	34790323	8000	34790230	-4000	4000	93
chr15	24679393	24687393	24682025	8000	24683393	-4000	4000	-1368
chr15	24679393	24687393	24682026	8000	24683393	-4000	4000	-1367
chr15	74827802	74835802	74831108	8000	74831802	-4000	4000	-694
chr15	65049397	65057397	65055199	8000	65053397	-4000	4000	1802
chr15	74821757	74829757	74824362	8000	74825757	-4000	4000	-1395
chr15	72404367	72412367	72406749	8000	72408367	-4000	4000	-1618
chr15	23639549	23647549	23644682	8000	23643549	-4000	4000	1133
chr15	45114421	45122421	45122201	8000	45118421	-4000	4000	3780
chr15	23435038	23443038	23440724	8000	23439038	-4000	4000	1686
chr15	71814259	71822259	71817601	8000	71818259	-4000	4000	-658
chr15	34063458	34071458	34064367	8000	34067458	-4000	4000	-3091
chr15	74821757	74829757	74824403	8000	74825757	-4000	4000	-1354
chr15	71814259	71822259	71817585	8000	71818259	-4000	4000	-674
chr15	74333759	74341759	74338664	8000	74337759	-4000	4000	905
chr15	101802887	101810887	101805780	8000	101806887	-4000	4000	-1107
chr15	20527856	20535856	20534331	8000	20531856	-4000	4000	2475
chr15	23639549	23647549	23644347	8000	23643549	-4000	4000	798
chr15	43272271	43280271	43279278	8000	43276271	-4000	4000	3007
chr15	34747032	34755032	34752677	8000	34751032	-4000	4000	1645
chr15	100396395	100404395	100402626	8000	100400395	-4000	4000	2231
chr15	23639549	23647549	23645157	8000	23643549	-4000	4000	1608
chr15	65049397	65057397	65053658	8000	65053397	-4000	4000	261
chr15	75269455	75277455	75270086	8000	75273455	-4000	4000	-3369
chr15	34747032	34755032	34752694	8000	34751032	-4000	4000	1662
chr15	54624707	54632707	54627884	8000	54628707	-4000	4000	-823
chr15	101802887	101810887	101806414	8000	101806887	-4000	4000	-473
chr15	74065857	74073857	74071561	8000	74069857	-4000	4000	1704
chr15	34747032	34755032	34753302	8000	34751032	-4000	4000	2270
chr15	74333759	74341759	74335249	8000	74337759	-4000	4000	-2510
chr15	43272271	43280271	43279739	8000	43276271	-4000	4000	3468
chr15	74332472	74340472	74332773	8000	74336472	-4000	4000	-3699
chr15	65049397	65057397	65054861	8000	65053397	-4000	4000	1464
chr15	34353737	34361737	34355077	8000	34357737	-4000	4000	-2660
chr15	72665599	72673599	72666062	8000	72669599	-4000	4000	-3537
chr15	30997061	31005061	31001881	8000	31001061	-4000	4000	820
chr15	41499637	41507637	41505290	8000	41503637	-4000	4000	1653
chr15	73885214	73893214	73886092	8000	73889214	-4000	4000	-3122
chr15	41499637	41507637	41502968	8000	41503637	-4000	4000	-669
chr15	73315859	73323859	73323242	8000	73319859	-4000	4000	3383
chr15	28837832	28845832	28838709	8000	28841832	-4000	4000	-3123
chr15	45114421	45122421	45117745	8000	45118421	-4000	4000	-676
chr15	74821757	74829757	74825579	8000	74825757	-4000	4000	-178
chr15	89205869	89213869	89210149	8000	89209869	-4000	4000	280
chr15	28837832	28845832	28838787	8000	28841832	-4000	4000	-3045
chr15	41178725	41186725	41183900	8000	41182725	-4000	4000	1175
chr15	23435038	23443038	23440885	8000	23439038	-4000	4000	1847
chr15	45088650	45096650	45095571	8000	45092650	-4000	4000	2921
chr15	40811451	40819451	40813370	8000	40815451	-4000	4000	-2081
chr15	20527856	20535856	20535645	8000	20531856	-4000	4000	3789
chr15	41499637	41507637	41507119	8000	41503637	-4000	4000	3482
chr15	45114421	45122421	45117824	8000	45118421	-4000	4000	-597
chr15	101816197	101824197	101818384	8000	101820197	-4000	4000	-1813
chr15	73315859	73323859	73323330	8000	73319859	-4000	4000	3471
chr15	45114421	45122421	45117871	8000	45118421	-4000	4000	-550
chr15	78589052	78597052	78596401	8000	78593052	-4000	4000	3349
chr15	73315859	73323859	73323674	8000	73319859	-4000	4000	3815
chr15	74333759	74341759	74339682	8000	74337759	-4000	4000	1923
chr15	72404367	72412367	72407840	8000	72408367	-4000	4000	-527
chr15	67830582	67838582	67832281	8000	67834582	-4000	4000	-2301
chr15	41178725	41186725	41184134	8000	41182725	-4000	4000	1409
chr15	65049397	65057397	65054130	8000	65053397	-4000	4000	733
chr15	101816197	101824197	101818614	8000	101820197	-4000	4000	-1583
chr15	73315859	73323859	73321630	8000	73319859	-4000	4000	1771
chr15	45114421	45122421	45117499	8000	45118421	-4000	4000	-922
chr15	27750875	27758875	27755349	8000	27754875	-4000	4000	474
chr15	23435038	23443038	23441617	8000	23439038	-4000	4000	2579
chr15	23639549	23647549	23645282	8000	23643549	-4000	4000	1733
chr15	41499637	41507637	41504113	8000	41503637	-4000	4000	476
chr15	43595563	43603563	43600670	8000	43599563	-4000	4000	1107
chr15	54624707	54632707	54626873	8000	54628707	-4000	4000	-1834
chr15	72665599	72673599	72665784	8000	72669599	-4000	4000	-3815
chr15	74715542	74723542	74722602	8000	74719542	-4000	4000	3060
chr15	78589052	78597052	78589847	8000	78593052	-4000	4000	-3205
chr15	79294239	79302239	79294653	8000	79298239	-4000	4000	-3586
chr15	101816197	101824197	101818632	8000	101820197	-4000	4000	-1565
chr15	73315859	73323859	73323779	8000	73319859	-4000	4000	3920
chr15	54624707	54632707	54627034	8000	54628707	-4000	4000	-1673
chr15	79294239	79302239	79297065	8000	79298239	-4000	4000	-1174
chr15	20527856	20535856	20535186	8000	20531856	-4000	4000	3330
chr15	72671798	72679798	72676386	8000	72675798	-4000	4000	588
chr15	30997061	31005061	31002493	8000	31001061	-4000	4000	1432
chr15	30997061	31005061	31002987	8000	31001061	-4000	4000	1926
chr15	41499637	41507637	41507558	8000	41503637	-4000	4000	3921
chr15	43595563	43603563	43599162	8000	43599563	-4000	4000	-401
chr15	45114421	45122421	45117647	8000	45118421	-4000	4000	-774
chr15	65049397	65057397	65052994	8000	65053397	-4000	4000	-403
chr15	73885214	73893214	73888448	8000	73889214	-4000	4000	-766
chr15	73885214	73893214	73889190	8000	73889214	-4000	4000	-24
chr15	78589052	78597052	78596535	8000	78593052	-4000	4000	3483
chr15	34353737	34361737	34356438	8000	34357737	-4000	4000	-1299
chr15	43272271	43280271	43276951	8000	43276271	-4000	4000	680
chr15	74821757	74829757	74825653	8000	74825757	-4000	4000	-104
chr15	20527856	20535856	20535018	8000	20531856	-4000	4000	3162
chr15	101802887	101810887	101806121	8000	101806887	-4000	4000	-766
chr15	101816197	101824197	101818394	8000	101820197	-4000	4000	-1803
chr15	79294239	79302239	79294319	8000	79298239	-4000	4000	-3920
chr15	34353737	34361737	34353854	8000	34357737	-4000	4000	-3883
chr15	52105263	52113263	52109828	8000	52109263	-4000	4000	565
chr15	30997061	31005061	31002800	8000	31001061	-4000	4000	1739
chr15	65049397	65057397	65053024	8000	65053397	-4000	4000	-373
chr15	73315859	73323859	73323526	8000	73319859	-4000	4000	3667
chr15	23639549	23647549	23644487	8000	23643549	-4000	4000	938
chr15	101816197	101824197	101818800	8000	101820197	-4000	4000	-1397
chr15	45088650	45096650	45094940	8000	45092650	-4000	4000	2290
chr15	54624707	54632707	54627036	8000	54628707	-4000	4000	-1671
chr15	75291807	75299807	75293988	8000	75295807	-4000	4000	-1819
chr15	78589052	78597052	78590152	8000	78593052	-4000	4000	-2900
chr15	74715542	74723542	74723008	8000	74719542	-4000	4000	3466
chr15	65049397	65057397	65054168	8000	65053397	-4000	4000	771
chr15	23639549	23647549	23645018	8000	23643549	-4000	4000	1469
chr15	41499637	41507637	41505452	8000	41503637	-4000	4000	1815
chr15	24679393	24687393	24683345	8000	24683393	-4000	4000	-48
chr15	23639549	23647549	23644848	8000	23643549	-4000	4000	1299
chr15	34353737	34361737	34359129	8000	34357737	-4000	4000	1392
chr15	42063009	42071009	42068821	8000	42067009	-4000	4000	1812
chr15	20527856	20535856	20534995	8000	20531856	-4000	4000	3139
chr15	45114421	45122421	45114644	8000	45118421	-4000	4000	-3777
chr15	78620111	78628111	78624962	8000	78624111	-4000	4000	851
chr15	59204588	59212588	59206911	8000	59208588	-4000	4000	-1677
chr15	74752607	74760607	74754984	8000	74756607	-4000	4000	-1623
chr15	20527856	20535856	20534396	8000	20531856	-4000	4000	2540
chr15	73556013	73564013	73559907	8000	73560013	-4000	4000	-106
chr15	84941798	84949798	84945153	8000	84945798	-4000	4000	-645
chr15	34747032	34755032	34752760	8000	34751032	-4000	4000	1728
chr15	74715542	74723542	74722291	8000	74719542	-4000	4000	2749
chr15	74333759	74341759	74335853	8000	74337759	-4000	4000	-1906
chr15	74065857	74073857	74070838	8000	74069857	-4000	4000	981
chr15	23639549	23647549	23645490	8000	23643549	-4000	4000	1941
chr15	74715542	74723542	74721827	8000	74719542	-4000	4000	2285
chr15	45088650	45096650	45094184	8000	45092650	-4000	4000	1534
chr15	84941798	84949798	84945295	8000	84945798	-4000	4000	-503
chr16	162764	170764	166611	8000	166764	-4000	4000	-153
chr16	20024239	20032239	20032033	8000	20028239	-4000	4000	3794
chr16	56587088	56595088	56589959	8000	56591088	-4000	4000	-1129
chr16	21249850	21257850	21250880	8000	21253850	-4000	4000	-2970
chr16	26133685	26141685	26135946	8000	26137685	-4000	4000	-1739
chr16	3238027	3246027	3243879	8000	3242027	-4000	4000	1852
chr16	20024239	20032239	20032098	8000	20028239	-4000	4000	3859
chr16	57984116	57992116	57984701	8000	57988116	-4000	4000	-3415
chr16	66584275	66592275	66587089	8000	66588275	-4000	4000	-1186
chr16	67971663	67979663	67978300	8000	67975663	-4000	4000	2637
chr16	66904122	66912122	66908450	8000	66908122	-4000	4000	328
chr16	4773606	4781606	4779717	8000	4777606	-4000	4000	2111
chr16	28495362	28503362	28496532	8000	28499362	-4000	4000	-2830
chr16	28495362	28503362	28496983	8000	28499362	-4000	4000	-2379
chr16	28495362	28503362	28497242	8000	28499362	-4000	4000	-2120
chr16	28495362	28503362	28497990	8000	28499362	-4000	4000	-1372
chr16	72073246	72081246	72076600	8000	72077246	-4000	4000	-646
chr16	88859333	88867333	88862204	8000	88863333	-4000	4000	-1129
chr16	30373991	30381991	30381464	8000	30377991	-4000	4000	3473
chr16	28495362	28503362	28498525	8000	28499362	-4000	4000	-837
chr16	26133685	26141685	26136429	8000	26137685	-4000	4000	-1256
chr16	27065166	27073166	27067432	8000	27069166	-4000	4000	-1734
chr16	25224932	25232932	25228660	8000	25228932	-4000	4000	-272
chr16	20355175	20363175	20359371	8000	20359175	-4000	4000	196
chr16	20024239	20032239	20032115	8000	20028239	-4000	4000	3876
chr16	765428	773428	766661	8000	769428	-4000	4000	-2767
chr16	67285428	67293428	67286809	8000	67289428	-4000	4000	-2619
chr16	765428	773428	770069	8000	769428	-4000	4000	641
chr16	20024239	20032239	20031782	8000	20028239	-4000	4000	3543
chr16	46698282	46706282	46703892	8000	46702282	-4000	4000	1610
chr16	11269199	11277199	11275721	8000	11273199	-4000	4000	2522
chr16	24358412	24366412	24361815	8000	24362412	-4000	4000	-597
chr16	283215	291215	285568	8000	287215	-4000	4000	-1647
chr16	4596758	4604758	4600296	8000	4600758	-4000	4000	-462
chr16	28495362	28503362	28496384	8000	28499362	-4000	4000	-2978
chr16	71925538	71933538	71929644	8000	71929538	-4000	4000	106
chr16	67971663	67979663	67975913	8000	67975663	-4000	4000	250
chr16	2470145	2478145	2472740	8000	2474145	-4000	4000	-1405
chr16	21979865	21987865	21984465	8000	21983865	-4000	4000	600
chr16	84193168	84201168	84194503	8000	84197168	-4000	4000	-2665
chr16	88859333	88867333	88866377	8000	88863333	-4000	4000	3044
chr16	57685378	57693378	57685728	8000	57689378	-4000	4000	-3650
chr16	24358412	24366412	24361553	8000	24362412	-4000	4000	-859
chr16	66584275	66592275	66587981	8000	66588275	-4000	4000	-294
chr16	84193168	84201168	84194108	8000	84197168	-4000	4000	-3060
chr16	28495362	28503362	28495761	8000	28499362	-4000	4000	-3601
chr16	11269199	11277199	11274131	8000	11273199	-4000	4000	932
chr16	21249850	21257850	21250458	8000	21253850	-4000	4000	-3392
chr16	70183361	70191361	70185937	8000	70187361	-4000	4000	-1424
chr16	283215	291215	286659	8000	287215	-4000	4000	-556
chr16	30373991	30381991	30381118	8000	30377991	-4000	4000	3127
chr16	23754935	23762935	23756167	8000	23758935	-4000	4000	-2768
chr16	30373991	30381991	30381025	8000	30377991	-4000	4000	3034
chr16	1077454	1085454	1079135	8000	1081454	-4000	4000	-2319
chr16	24907628	24915628	24910367	8000	24911628	-4000	4000	-1261
chr16	28495362	28503362	28496534	8000	28499362	-4000	4000	-2828
chr16	3489484	3497484	3493937	8000	3493484	-4000	4000	453
chr16	20024239	20032239	20031926	8000	20028239	-4000	4000	3687
chr16	75222338	75230338	75224780	8000	75226338	-4000	4000	-1558
chr16	3238027	3246027	3243331	8000	3242027	-4000	4000	1304
chr16	11276841	11284841	11281027	8000	11280841	-4000	4000	186
chr16	72073246	72081246	72076439	8000	72077246	-4000	4000	-807
chr16	75222338	75230338	75229885	8000	75226338	-4000	4000	3547
chr16	765428	773428	772979	8000	769428	-4000	4000	3551
chr16	21979865	21987865	21983096	8000	21983865	-4000	4000	-769
chr16	11263748	11271748	11267890	8000	11267748	-4000	4000	142
chr16	28495362	28503362	28495444	8000	28499362	-4000	4000	-3918
chr16	67971663	67979663	67977773	8000	67975663	-4000	4000	2110
chr16	30373991	30381991	30381067	8000	30377991	-4000	4000	3076
chr16	67971663	67979663	67976111	8000	67975663	-4000	4000	448
chr16	90052566	90060566	90060528	8000	90056566	-4000	4000	3962
chr16	3238027	3246027	3243384	8000	3242027	-4000	4000	1357
chr16	23686310	23694310	23691368	8000	23690310	-4000	4000	1058
chr16	26133685	26141685	26135927	8000	26137685	-4000	4000	-1758
chr16	3084890	3092890	3090510	8000	3088890	-4000	4000	1620
chr16	561529	569529	563283	8000	565529	-4000	4000	-2246
chr16	71925538	71933538	71927810	8000	71929538	-4000	4000	-1728
chr16	56564957	56572957	56567751	8000	56568957	-4000	4000	-1206
chr16	21249850	21257850	21250337	8000	21253850	-4000	4000	-3513
chr16	55842154	55850154	55846635	8000	55846154	-4000	4000	481
chr16	283215	291215	285197	8000	287215	-4000	4000	-2018
chr16	11269199	11277199	11273288	8000	11273199	-4000	4000	89
chr16	21193450	21201450	21201442	8000	21197450	-4000	4000	3992
chr16	561529	569529	563320	8000	565529	-4000	4000	-2209
chr16	7709340	7717340	7711118	8000	7713340	-4000	4000	-2222
chr16	14668548	14676548	14672623	8000	14672548	-4000	4000	75
chr16	27065166	27073166	27067199	8000	27069166	-4000	4000	-1967
chr16	90052566	90060566	90058302	8000	90056566	-4000	4000	1736
chr16	29778973	29786973	29779634	8000	29782973	-4000	4000	-3339
chr16	27065166	27073166	27066982	8000	27069166	-4000	4000	-2184
chr16	46698282	46706282	46703892	8000	46702282	-4000	4000	1610
chr16	21757935	21765935	21760508	8000	21761935	-4000	4000	-1427
chr16	21757935	21765935	21760509	8000	21761935	-4000	4000	-1426
chr16	7709340	7717340	7710714	8000	7713340	-4000	4000	-2626
chr16	49395431	49403431	49396664	8000	49399431	-4000	4000	-2767
chr16	4596758	4604758	4600213	8000	4600758	-4000	4000	-545
chr16	57685378	57693378	57685893	8000	57689378	-4000	4000	-3485
chr16	28495362	28503362	28496815	8000	28499362	-4000	4000	-2547
chr16	71925538	71933538	71933458	8000	71929538	-4000	4000	3920
chr16	26133685	26141685	26136224	8000	26137685	-4000	4000	-1461
chr16	30023736	30031736	30023810	8000	30027736	-4000	4000	-3926
chr16	28495362	28503362	28497832	8000	28499362	-4000	4000	-1530
chr16	3353306	3361306	3356243	8000	3357306	-4000	4000	-1063
chr16	56649204	56657204	56653138	8000	56653204	-4000	4000	-66
chr16	67884855	67892855	67886101	8000	67888855	-4000	4000	-2754
chr16	71534748	71542748	71537711	8000	71538748	-4000	4000	-1037
chr16	49273917	49281917	49281235	8000	49277917	-4000	4000	3318
chr16	765428	773428	766765	8000	769428	-4000	4000	-2663
chr16	7709340	7717340	7710840	8000	7713340	-4000	4000	-2500
chr16	20355175	20363175	20360576	8000	20359175	-4000	4000	1401
chr16	28495362	28503362	28497520	8000	28499362	-4000	4000	-1842
chr16	28495362	28503362	28497841	8000	28499362	-4000	4000	-1521
chr16	28495362	28503362	28498334	8000	28499362	-4000	4000	-1028
chr16	4185374	4193374	4192566	8000	4189374	-4000	4000	3192
chr16	11263748	11271748	11267891	8000	11267748	-4000	4000	143
chr16	20355175	20363175	20362530	8000	20359175	-4000	4000	3355
chr16	20532226	20540226	20537264	8000	20536226	-4000	4000	1038
chr16	1481886	1489886	1485985	8000	1485886	-4000	4000	99
chr16	46698282	46706282	46703737	8000	46702282	-4000	4000	1455
chr16	26133685	26141685	26135949	8000	26137685	-4000	4000	-1736
chr16	57984116	57992116	57984764	8000	57988116	-4000	4000	-3352
chr16	88859333	88867333	88866533	8000	88863333	-4000	4000	3200
chr16	28495362	28503362	28495440	8000	28499362	-4000	4000	-3922
chr16	23754935	23762935	23757309	8000	23758935	-4000	4000	-1626
chr16	561529	569529	564348	8000	565529	-4000	4000	-1181
chr16	33840784	33848784	33845074	8000	33844784	-4000	4000	290
chr16	21979865	21987865	21984409	8000	21983865	-4000	4000	544
chr16	3084890	3092890	3090479	8000	3088890	-4000	4000	1589
chr16	10623501	10631501	10627604	8000	10627501	-4000	4000	103
chr16	88859333	88867333	88859751	8000	88863333	-4000	4000	-3582
chr16	46698282	46706282	46703892	8000	46702282	-4000	4000	1610
chr16	21193450	21201450	21199605	8000	21197450	-4000	4000	2155
chr16	28495362	28503362	28497145	8000	28499362	-4000	4000	-2217
chr16	67285428	67293428	67291683	8000	67289428	-4000	4000	2255
chr16	67381204	67389204	67385010	8000	67385204	-4000	4000	-194
chr16	75222338	75230338	75222846	8000	75226338	-4000	4000	-3492
chr16	84193168	84201168	84195054	8000	84197168	-4000	4000	-2114
chr16	30373991	30381991	30381791	8000	30377991	-4000	4000	3800
chr16	32251922	32259922	32254641	8000	32255922	-4000	4000	-1281
chr16	20024239	20032239	20032032	8000	20028239	-4000	4000	3793
chr16	20024239	20032239	20031792	8000	20028239	-4000	4000	3553
chr16	20532226	20540226	20537100	8000	20536226	-4000	4000	874
chr16	31524803	31532803	31528675	8000	31528803	-4000	4000	-128
chr16	1939974	1947974	1945839	8000	1943974	-4000	4000	1865
chr16	10623501	10631501	10627577	8000	10627501	-4000	4000	76
chr16	20024239	20032239	20032059	8000	20028239	-4000	4000	3820
chr16	20532226	20540226	20537168	8000	20536226	-4000	4000	942
chr16	23754935	23762935	23757248	8000	23758935	-4000	4000	-1687
chr16	33840784	33848784	33844827	8000	33844784	-4000	4000	43
chr16	56587088	56595088	56590727	8000	56591088	-4000	4000	-361
chr16	81287142	81295142	81287336	8000	81291142	-4000	4000	-3806
chr16	81287142	81295142	81290610	8000	81291142	-4000	4000	-532
chr16	3353306	3361306	3356666	8000	3357306	-4000	4000	-640
chr16	4773606	4781606	4779724	8000	4777606	-4000	4000	2118
chr16	11263748	11271748	11268961	8000	11267748	-4000	4000	1213
chr16	20532226	20540226	20537285	8000	20536226	-4000	4000	1059
chr16	24358412	24366412	24361887	8000	24362412	-4000	4000	-525
chr16	49395431	49403431	49396472	8000	49399431	-4000	4000	-2959
chr16	11263748	11271748	11267989	8000	11267748	-4000	4000	241
chr16	3084890	3092890	3092212	8000	3088890	-4000	4000	3322
chr16	56587088	56595088	56589556	8000	56591088	-4000	4000	-1532
chr16	67971663	67979663	67978561	8000	67975663	-4000	4000	2898
chr16	66850153	66858153	66850551	8000	66854153	-4000	4000	-3602
chr16	28495362	28503362	28495962	8000	28499362	-4000	4000	-3400
chr16	1077454	1085454	1079387	8000	1081454	-4000	4000	-2067
chr16	20929111	20937111	20933266	8000	20933111	-4000	4000	155
chr16	27065166	27073166	27067032	8000	27069166	-4000	4000	-2134
chr16	26133685	26141685	26136010	8000	26137685	-4000	4000	-1675
chr16	26133685	26141685	26136038	8000	26137685	-4000	4000	-1647
chr16	23686310	23694310	23690112	8000	23690310	-4000	4000	-198
chr16	23686310	23694310	23690905	8000	23690310	-4000	4000	595
chr16	28495362	28503362	28499731	8000	28499362	-4000	4000	369
chr16	56911850	56919850	56913357	8000	56915850	-4000	4000	-2493
chr16	3201188	3209188	3205059	8000	3205188	-4000	4000	-129
chr16	3238027	3246027	3243864	8000	3242027	-4000	4000	1837
chr16	46698282	46706282	46703892	8000	46702282	-4000	4000	1610
chr16	32251922	32259922	32253836	8000	32255922	-4000	4000	-2086
chr16	49395431	49403431	49399339	8000	49399431	-4000	4000	-92
chr16	21979865	21987865	21980658	8000	21983865	-4000	4000	-3207
chr16	7709340	7717340	7712449	8000	7713340	-4000	4000	-891
chr16	177179	185179	180684	8000	181179	-4000	4000	-495
chr16	30373991	30381991	30377862	8000	30377991	-4000	4000	-129
chr16	23686310	23694310	23689321	8000	23690310	-4000	4000	-989
chr16	1077454	1085454	1079206	8000	1081454	-4000	4000	-2248
chr16	20929111	20937111	20935458	8000	20933111	-4000	4000	2347
chr16	30023736	30031736	30025757	8000	30027736	-4000	4000	-1979
chr16	57685378	57693378	57685652	8000	57689378	-4000	4000	-3726
chr16	71925538	71933538	71927616	8000	71929538	-4000	4000	-1922
chr16	26133685	26141685	26135773	8000	26137685	-4000	4000	-1912
chr16	20532226	20540226	20537222	8000	20536226	-4000	4000	996
chr16	31524803	31532803	31528529	8000	31528803	-4000	4000	-274
chr16	7709340	7717340	7712047	8000	7713340	-4000	4000	-1293
chr16	11263748	11271748	11267988	8000	11267748	-4000	4000	240
chr16	20329051	20337051	20335501	8000	20333051	-4000	4000	2450
chr16	1077454	1085454	1079033	8000	1081454	-4000	4000	-2421
chr16	20329051	20337051	20335486	8000	20333051	-4000	4000	2435
chr16	24358412	24366412	24361411	8000	24362412	-4000	4000	-1001
chr16	88859333	88867333	88861591	8000	88863333	-4000	4000	-1742
chr16	67285428	67293428	67291444	8000	67289428	-4000	4000	2016
chr16	20929111	20937111	20933507	8000	20933111	-4000	4000	396
chr16	27065166	27073166	27067347	8000	27069166	-4000	4000	-1819
chr16	57984116	57992116	57987397	8000	57988116	-4000	4000	-719
chr16	30023736	30031736	30025635	8000	30027736	-4000	4000	-2101
chr17	8386702	8394702	8393278	8000	8390702	-4000	4000	2576
chr17	63868012	63876012	63872269	8000	63872012	-4000	4000	257
chr17	41135433	41143433	41140274	8000	41139433	-4000	4000	841
chr17	19413276	19421276	19413387	8000	19417276	-4000	4000	-3889
chr17	35188520	35196520	35193521	8000	35192520	-4000	4000	1001
chr17	36009056	36017056	36013761	8000	36013056	-4000	4000	705
chr17	74945992	74953992	74952334	8000	74949992	-4000	4000	2342
chr17	4797159	4805159	4798024	8000	4801159	-4000	4000	-3135
chr17	28534900	28542900	28535038	8000	28538900	-4000	4000	-3862
chr17	45843067	45851067	45846802	8000	45847067	-4000	4000	-265
chr17	60427426	60435426	60429481	8000	60431426	-4000	4000	-1945
chr17	82373458	82381458	82374779	8000	82377458	-4000	4000	-2679
chr17	35972493	35980493	35977683	8000	35976493	-4000	4000	1190
chr17	35850946	35858946	35855013	8000	35854946	-4000	4000	67
chr17	34356328	34364328	34357536	8000	34360328	-4000	4000	-2792
chr17	49219366	49227366	49222144	8000	49223366	-4000	4000	-1222
chr17	10439290	10447290	10443465	8000	10443290	-4000	4000	175
chr17	41102488	41110488	41105888	8000	41106488	-4000	4000	-600
chr17	63890909	63898909	63895505	8000	63894909	-4000	4000	596
chr17	74873302	74881302	74879444	8000	74877302	-4000	4000	2142
chr17	35188520	35196520	35194070	8000	35192520	-4000	4000	1550
chr17	41389721	41397721	41395534	8000	41393721	-4000	4000	1813
chr17	63868012	63876012	63872091	8000	63872012	-4000	4000	79
chr17	74945992	74953992	74952035	8000	74949992	-4000	4000	2043
chr17	41102488	41110488	41105680	8000	41106488	-4000	4000	-808
chr17	3214896	3222896	3215917	8000	3218896	-4000	4000	-2979
chr17	38320571	38328571	38326089	8000	38324571	-4000	4000	1518
chr17	41373669	41381669	41379373	8000	41377669	-4000	4000	1704
chr17	3214896	3222896	3216474	8000	3218896	-4000	4000	-2422
chr17	9767434	9775434	9771580	8000	9771434	-4000	4000	146
chr17	60427426	60435426	60435243	8000	60431426	-4000	4000	3817
chr17	4484208	4492208	4487974	8000	4488208	-4000	4000	-234
chr17	36940612	36948612	36940986	8000	36944612	-4000	4000	-3626
chr17	41135433	41143433	41140171	8000	41139433	-4000	4000	738
chr17	28534900	28542900	28537464	8000	28538900	-4000	4000	-1436
chr17	32993877	33001877	32996997	8000	32997877	-4000	4000	-880
chr17	40013813	40021813	40016933	8000	40017813	-4000	4000	-880
chr17	58155585	58163585	58157718	8000	58159585	-4000	4000	-1867
chr17	62697314	62705314	62701675	8000	62701314	-4000	4000	361
chr17	4786589	4794589	4789835	8000	4790589	-4000	4000	-754
chr17	63868012	63876012	63872555	8000	63872012	-4000	4000	543
chr17	50838353	50846353	50840634	8000	50842353	-4000	4000	-1719
chr17	35850946	35858946	35855277	8000	35854946	-4000	4000	331
chr17	53821193	53829193	53823764	8000	53825193	-4000	4000	-1429
chr17	63905597	63913597	63910609	8000	63909597	-4000	4000	1012
chr17	39973768	39981768	39974375	8000	39977768	-4000	4000	-3393
chr17	41173446	41181446	41178133	8000	41177446	-4000	4000	687
chr17	40693991	40701991	40699457	8000	40697991	-4000	4000	1466
chr17	40762238	40770238	40766460	8000	40766238	-4000	4000	222
chr17	41025351	41033351	41027089	8000	41029351	-4000	4000	-2262
chr17	3393104	3401104	3398157	8000	3397104	-4000	4000	1053
chr17	3428870	3436870	3432999	8000	3432870	-4000	4000	129
chr17	41389721	41397721	41397362	8000	41393721	-4000	4000	3641
chr17	63890909	63898909	63895520	8000	63894909	-4000	4000	611
chr17	41223652	41231652	41227061	8000	41227652	-4000	4000	-591
chr17	10488307	10496307	10494644	8000	10492307	-4000	4000	2337
chr17	41416547	41424547	41424190	8000	41420547	-4000	4000	3643
chr17	58201174	58209174	58207105	8000	58205174	-4000	4000	1931
chr17	63876215	63884215	63880273	8000	63880215	-4000	4000	58
chr17	81810008	81818008	81811070	8000	81814008	-4000	4000	-2938
chr17	82373458	82381458	82374569	8000	82377458	-4000	4000	-2889
chr17	53821193	53829193	53823306	8000	53825193	-4000	4000	-1887
chr17	3214896	3222896	3216427	8000	3218896	-4000	4000	-2469
chr17	58265855	58273855	58270720	8000	58269855	-4000	4000	865
chr17	4484208	4492208	4486555	8000	4488208	-4000	4000	-1653
chr17	38320571	38328571	38326704	8000	38324571	-4000	4000	2133
chr17	74929912	74937912	74930667	8000	74933912	-4000	4000	-3245
chr17	41482136	41490136	41489486	8000	41486136	-4000	4000	3350
chr17	3194448	3202448	3198376	8000	3198448	-4000	4000	-72
chr17	63868012	63876012	63872304	8000	63872012	-4000	4000	292
chr17	51626313	51634313	51631377	8000	51630313	-4000	4000	1064
chr17	58155585	58163585	58157368	8000	58159585	-4000	4000	-2217
chr17	9888099	9896099	9889422	8000	9892099	-4000	4000	-2677
chr17	19674288	19682288	19679971	8000	19678288	-4000	4000	1683
chr17	35188520	35196520	35194181	8000	35192520	-4000	4000	1661
chr17	53821193	53829193	53824786	8000	53825193	-4000	4000	-407
chr17	58167411	58175411	58170020	8000	58171411	-4000	4000	-1391
chr17	3436019	3444019	3443263	8000	3440019	-4000	4000	3244
chr17	63890909	63898909	63895580	8000	63894909	-4000	4000	671
chr17	45843067	45851067	45846008	8000	45847067	-4000	4000	-1059
chr17	58265855	58273855	58268013	8000	58269855	-4000	4000	-1842
chr17	45250393	45258393	45256393	8000	45254393	-4000	4000	2000
chr17	45843067	45851067	45845277	8000	45847067	-4000	4000	-1790
chr17	33009087	33017087	33013971	8000	33013087	-4000	4000	884
chr17	62697314	62705314	62701671	8000	62701314	-4000	4000	357
chr17	60427426	60435426	60435208	8000	60431426	-4000	4000	3782
chr17	81810008	81818008	81812838	8000	81814008	-4000	4000	-1170
chr17	39599536	39607536	39603941	8000	39603536	-4000	4000	405
chr17	63905597	63913597	63910847	8000	63909597	-4000	4000	1250
chr17	53821193	53829193	53823367	8000	53825193	-4000	4000	-1826
chr17	41432154	41440154	41438273	8000	41436154	-4000	4000	2119
chr17	42846707	42854707	42850266	8000	42850707	-4000	4000	-441
chr17	40788196	40796196	40793932	8000	40792196	-4000	4000	1736
chr17	40954417	40962417	40960316	8000	40958417	-4000	4000	1899
chr17	81810008	81818008	81812956	8000	81814008	-4000	4000	-1052
chr17	74929912	74937912	74930902	8000	74933912	-4000	4000	-3010
chr17	48717719	48725719	48724625	8000	48721719	-4000	4000	2906
chr17	6793101	6801101	6800864	8000	6797101	-4000	4000	3763
chr17	41113181	41121181	41118042	8000	41117181	-4000	4000	861
chr17	74368600	74376600	74372503	8000	74372600	-4000	4000	-97
chr17	58201174	58209174	58208142	8000	58205174	-4000	4000	2968
chr17	48720758	48728758	48726689	8000	48724758	-4000	4000	1931
chr17	35740511	35748511	35745156	8000	35744511	-4000	4000	645
chr17	40013813	40021813	40017351	8000	40017813	-4000	4000	-462
chr17	45843067	45851067	45845635	8000	45847067	-4000	4000	-1432
chr17	58201174	58209174	58204292	8000	58205174	-4000	4000	-882
chr17	3214896	3222896	3215975	8000	3218896	-4000	4000	-2921
chr17	38320571	38328571	38322553	8000	38324571	-4000	4000	-2018
chr17	41373669	41381669	41381146	8000	41377669	-4000	4000	3477
chr17	40995193	41003193	40999601	8000	40999193	-4000	4000	408
chr17	38320571	38328571	38322546	8000	38324571	-4000	4000	-2025
chr17	41472710	41480710	41477646	8000	41476710	-4000	4000	936
chr17	3420070	3428070	3421082	8000	3424070	-4000	4000	-2988
chr17	3428870	3436870	3433791	8000	3432870	-4000	4000	921
chr17	74929912	74937912	74933374	8000	74933912	-4000	4000	-538
chr17	53821193	53829193	53824740	8000	53825193	-4000	4000	-453
chr17	8116592	8124592	8116851	8000	8120592	-4000	4000	-3741
chr17	7479496	7487496	7481988	8000	7483496	-4000	4000	-1508
chr17	42846707	42854707	42854543	8000	42850707	-4000	4000	3836
chr17	48524526	48532526	48530467	8000	48528526	-4000	4000	1941
chr17	58201174	58209174	58206370	8000	58205174	-4000	4000	1196
chr17	62412480	62420480	62413813	8000	62416480	-4000	4000	-2667
chr17	35740511	35748511	35745519	8000	35744511	-4000	4000	1008
chr17	40013813	40021813	40015517	8000	40017813	-4000	4000	-2296
chr17	43936804	43944804	43941525	8000	43940804	-4000	4000	721
chr17	63890909	63898909	63894972	8000	63894909	-4000	4000	63
chr17	41036541	41044541	41041052	8000	41040541	-4000	4000	511
chr17	41373669	41381669	41379567	8000	41377669	-4000	4000	1898
chr17	41102488	41110488	41105534	8000	41106488	-4000	4000	-954
chr17	76466117	76474117	76469969	8000	76470117	-4000	4000	-148
chr17	8743524	8751524	8744614	8000	8747524	-4000	4000	-2910
chr17	74873302	74881302	74879541	8000	74877302	-4000	4000	2239
chr17	39973768	39981768	39974998	8000	39977768	-4000	4000	-2770
chr17	63905597	63913597	63909942	8000	63909597	-4000	4000	345
chr17	40013813	40021813	40019851	8000	40017813	-4000	4000	2038
chr17	3393104	3401104	3397685	8000	3397104	-4000	4000	581
chr17	35930518	35938518	35937767	8000	35934518	-4000	4000	3249
chr17	38320571	38328571	38322155	8000	38324571	-4000	4000	-2416
chr17	75643975	75651975	75650963	8000	75647975	-4000	4000	2988
chr17	35850946	35858946	35855703	8000	35854946	-4000	4000	757
chr17	41389721	41397721	41397474	8000	41393721	-4000	4000	3753
chr17	41482136	41490136	41489442	8000	41486136	-4000	4000	3306
chr17	49219366	49227366	49219933	8000	49223366	-4000	4000	-3433
chr17	63876215	63884215	63880755	8000	63880215	-4000	4000	540
chr17	53821193	53829193	53824526	8000	53825193	-4000	4000	-667
chr17	41155649	41163649	41160248	8000	41159649	-4000	4000	599
chr17	44244390	44252390	44251189	8000	44248390	-4000	4000	2799
chr17	3272942	3280942	3278744	8000	3276942	-4000	4000	1802
chr17	48720758	48728758	48728060	8000	48724758	-4000	4000	3302
chr17	44777846	44785846	44780949	8000	44781846	-4000	4000	-897
chr17	40693991	40701991	40700238	8000	40697991	-4000	4000	2247
chr17	79085345	79093345	79090706	8000	79089345	-4000	4000	1361
chr17	10296865	10304865	10303222	8000	10300865	-4000	4000	2357
chr17	58167411	58175411	58170484	8000	58171411	-4000	4000	-927
chr17	29250494	29258494	29254381	8000	29254494	-4000	4000	-113
chr17	10386322	10394322	10394290	8000	10390322	-4000	4000	3968
chr17	39873896	39881896	39875253	8000	39877896	-4000	4000	-2643
chr17	40744021	40752021	40749326	8000	40748021	-4000	4000	1305
chr17	38320571	38328571	38322753	8000	38324571	-4000	4000	-1818
chr17	40772808	40780808	40777116	8000	40776808	-4000	4000	308
chr17	76466117	76474117	76471537	8000	76470117	-4000	4000	1420
chr17	41561836	41569836	41568200	8000	41565836	-4000	4000	2364
chr17	41416547	41424547	41423395	8000	41420547	-4000	4000	2848
chr17	3194448	3202448	3197828	8000	3198448	-4000	4000	-620
chr17	41163231	41171231	41167576	8000	41167231	-4000	4000	345
chr17	7423568	7431568	7426506	8000	7427568	-4000	4000	-1062
chr17	41155649	41163649	41160261	8000	41159649	-4000	4000	612
chr17	41055240	41063240	41059712	8000	41059240	-4000	4000	472
chr17	44777846	44785846	44779236	8000	44781846	-4000	4000	-2610
chr17	41081141	41089141	41084984	8000	41085141	-4000	4000	-157
chr17	74368600	74376600	74372142	8000	74372600	-4000	4000	-458
chr17	40995193	41003193	40999619	8000	40999193	-4000	4000	426
chr17	40013813	40021813	40016511	8000	40017813	-4000	4000	-1302
chr17	41455513	41463513	41460169	8000	41459513	-4000	4000	656
chr17	29250494	29258494	29253670	8000	29254494	-4000	4000	-824
chr17	76466117	76474117	76473892	8000	76470117	-4000	4000	3775
chr17	35188520	35196520	35193459	8000	35192520	-4000	4000	939
chr17	42846707	42854707	42852921	8000	42850707	-4000	4000	2214
chr17	29250494	29258494	29252145	8000	29254494	-4000	4000	-2349
chr17	41050498	41058498	41055058	8000	41054498	-4000	4000	560
chr17	74368600	74376600	74370558	8000	74372600	-4000	4000	-2042
chr17	18775349	18783349	18778501	8000	18779349	-4000	4000	-848
chr17	35740511	35748511	35744841	8000	35744511	-4000	4000	330
chr17	41055240	41063240	41059484	8000	41059240	-4000	4000	244
chr17	74912083	74920083	74919984	8000	74916083	-4000	4000	3901
chr17	74929912	74937912	74930981	8000	74933912	-4000	4000	-2931
chr17	34356328	34364328	34361879	8000	34360328	-4000	4000	1551
chr17	34356328	34364328	34361880	8000	34360328	-4000	4000	1552
chr17	39599536	39607536	39606084	8000	39603536	-4000	4000	2548
chr17	74310884	74318884	74314159	8000	74314884	-4000	4000	-725
chr17	76466117	76474117	76471822	8000	76470117	-4000	4000	1705
chr17	74368600	74376600	74370558	8000	74372600	-4000	4000	-2042
chr17	45843067	45851067	45845521	8000	45847067	-4000	4000	-1546
chr17	7037621	7045621	7041736	8000	7041621	-4000	4000	115
chr17	30104452	30112452	30108246	8000	30108452	-4000	4000	-206
chr17	32993877	33001877	32995469	8000	32997877	-4000	4000	-2408
chr17	40772808	40780808	40780406	8000	40776808	-4000	4000	3598
chr17	41482136	41490136	41489629	8000	41486136	-4000	4000	3493
chr17	41844384	41852384	41845709	8000	41848384	-4000	4000	-2675
chr17	8116592	8124592	8120921	8000	8120592	-4000	4000	329
chr17	74352416	74360416	74352922	8000	74356416	-4000	4000	-3494
chr17	6785133	6793133	6786822	8000	6789133	-4000	4000	-2311
chr17	36009056	36017056	36013286	8000	36013056	-4000	4000	230
chr17	81810008	81818008	81811032	8000	81814008	-4000	4000	-2976
chr17	36424618	36432618	36430628	8000	36428618	-4000	4000	2010
chr17	44368180	44376180	44376093	8000	44372180	-4000	4000	3913
chr17	8068636	8076636	8072876	8000	8072636	-4000	4000	240
chr17	74945992	74953992	74947098	8000	74949992	-4000	4000	-2894
chr17	41155649	41163649	41160175	8000	41159649	-4000	4000	526
chr17	41223652	41231652	41226983	8000	41227652	-4000	4000	-669
chr17	58167411	58175411	58170337	8000	58171411	-4000	4000	-1074
chr17	75643975	75651975	75651200	8000	75647975	-4000	4000	3225
chr17	4484208	4492208	4486492	8000	4488208	-4000	4000	-1716
chr17	4797159	4805159	4797558	8000	4801159	-4000	4000	-3601
chr17	35740511	35748511	35746019	8000	35744511	-4000	4000	1508
chr17	40744021	40752021	40751288	8000	40748021	-4000	4000	3267
chr17	41036541	41044541	41041123	8000	41040541	-4000	4000	582
chr17	41342092	41350092	41346935	8000	41346092	-4000	4000	843
chr17	43948733	43956733	43953158	8000	43952733	-4000	4000	425
chr17	45250393	45258393	45255774	8000	45254393	-4000	4000	1381
chr17	49052145	49060145	49054882	8000	49056145	-4000	4000	-1263
chr17	48720758	48728758	48728029	8000	48724758	-4000	4000	3271
chr17	51626313	51634313	51633545	8000	51630313	-4000	4000	3232
chr17	19413276	19421276	19415035	8000	19417276	-4000	4000	-2241
chr17	53821193	53829193	53823174	8000	53825193	-4000	4000	-2019
chr17	45843067	45851067	45846867	8000	45847067	-4000	4000	-200
chr17	41102488	41110488	41105991	8000	41106488	-4000	4000	-497
chr17	41561836	41569836	41568160	8000	41565836	-4000	4000	2324
chr17	42846707	42854707	42852597	8000	42850707	-4000	4000	1890
chr17	38320571	38328571	38322300	8000	38324571	-4000	4000	-2271
chr17	58265855	58273855	58267797	8000	58269855	-4000	4000	-2058
chr17	58265855	58273855	58267798	8000	58269855	-4000	4000	-2057
chr17	42846707	42854707	42850205	8000	42850707	-4000	4000	-502
chr17	36424618	36432618	36431619	8000	36428618	-4000	4000	3001
chr17	38320571	38328571	38326500	8000	38324571	-4000	4000	1929
chr17	38320571	38328571	38326501	8000	38324571	-4000	4000	1930
chr17	81829492	81837492	81834620	8000	81833492	-4000	4000	1128
chr17	63876215	63884215	63881051	8000	63880215	-4000	4000	836
chr17	48720758	48728758	48728456	8000	48724758	-4000	4000	3698
chr17	62412480	62420480	62416071	8000	62416480	-4000	4000	-409
chr17	53821193	53829193	53825155	8000	53825193	-4000	4000	-38
chr17	79085345	79093345	79085683	8000	79089345	-4000	4000	-3662
chr17	9767434	9775434	9772920	8000	9771434	-4000	4000	1486
chr17	74352416	74360416	74356736	8000	74356416	-4000	4000	320
chr17	63876215	63884215	63880296	8000	63880215	-4000	4000	81
chr17	8116592	8124592	8122382	8000	8120592	-4000	4000	1790
chr17	36940612	36948612	36940717	8000	36944612	-4000	4000	-3895
chr17	40772808	40780808	40779724	8000	40776808	-4000	4000	2916
chr17	3214896	3222896	3215839	8000	3218896	-4000	4000	-3057
chr17	58201174	58209174	58208543	8000	58205174	-4000	4000	3369
chr17	81810008	81818008	81811941	8000	81814008	-4000	4000	-2067
chr17	35850946	35858946	35855718	8000	35854946	-4000	4000	772
chr17	40973715	40981715	40980884	8000	40977715	-4000	4000	3169
chr17	41455513	41463513	41460181	8000	41459513	-4000	4000	668
chr17	41472710	41480710	41479755	8000	41476710	-4000	4000	3045
chr17	63868012	63876012	63872548	8000	63872012	-4000	4000	536
chr17	63876215	63884215	63880350	8000	63880215	-4000	4000	135
chr17	63905597	63913597	63909740	8000	63909597	-4000	4000	143
chr17	36009056	36017056	36013296	8000	36013056	-4000	4000	240
chr17	40693991	40701991	40700292	8000	40697991	-4000	4000	2301
chr17	40772808	40780808	40776986	8000	40776808	-4000	4000	178
chr17	40788196	40796196	40793908	8000	40792196	-4000	4000	1712
chr17	35850946	35858946	35856299	8000	35854946	-4000	4000	1353
chr17	3058669	3066669	3062689	8000	3062669	-4000	4000	20
chr17	63905597	63913597	63910799	8000	63909597	-4000	4000	1202
chr17	34356328	34364328	34358034	8000	34360328	-4000	4000	-2294
chr17	41373669	41381669	41381157	8000	41377669	-4000	4000	3488
chr17	32993877	33001877	32995680	8000	32997877	-4000	4000	-2197
chr17	58201174	58209174	58208515	8000	58205174	-4000	4000	3341
chr17	3428870	3436870	3432998	8000	3432870	-4000	4000	128
chr17	41389721	41397721	41394025	8000	41393721	-4000	4000	304
chr17	3058669	3066669	3063359	8000	3062669	-4000	4000	690
chr17	3122610	3130610	3126752	8000	3126610	-4000	4000	142
chr17	3393104	3401104	3397626	8000	3397104	-4000	4000	522
chr17	4779213	4787213	4785953	8000	4783213	-4000	4000	2740
chr17	4786589	4794589	4789235	8000	4790589	-4000	4000	-1354
chr17	10488307	10496307	10496033	8000	10492307	-4000	4000	3726
chr17	14231673	14239673	14236587	8000	14235673	-4000	4000	914
chr17	18775349	18783349	18778749	8000	18779349	-4000	4000	-600
chr17	39599536	39607536	39605673	8000	39603536	-4000	4000	2137
chr17	41102488	41110488	41105925	8000	41106488	-4000	4000	-563
chr17	41482136	41490136	41486279	8000	41486136	-4000	4000	143
chr17	41561836	41569836	41568621	8000	41565836	-4000	4000	2785
chr17	48954554	48962554	48958676	8000	48958554	-4000	4000	122
chr17	53821193	53829193	53824494	8000	53825193	-4000	4000	-699
chr17	58167411	58175411	58169692	8000	58171411	-4000	4000	-1719
chr17	60427426	60435426	60429422	8000	60431426	-4000	4000	-2004
chr17	60427426	60435426	60433979	8000	60431426	-4000	4000	2553
chr17	75643975	75651975	75650567	8000	75647975	-4000	4000	2592
chr17	78236987	78244987	78239194	8000	78240987	-4000	4000	-1793
chr17	61481110	61489110	61482932	8000	61485110	-4000	4000	-2178
chr17	41389721	41397721	41394089	8000	41393721	-4000	4000	368
chr17	41025351	41033351	41026720	8000	41029351	-4000	4000	-2631
chr17	48524526	48532526	48529604	8000	48528526	-4000	4000	1078
chr17	42910438	42918438	42910946	8000	42914438	-4000	4000	-3492
chr17	42910438	42918438	42911363	8000	42914438	-4000	4000	-3075
chr17	53821193	53829193	53823843	8000	53825193	-4000	4000	-1350
chr17	43948733	43956733	43953852	8000	43952733	-4000	4000	1119
chr17	3194448	3202448	3198323	8000	3198448	-4000	4000	-125
chr17	41025351	41033351	41026822	8000	41029351	-4000	4000	-2529
chr17	63868012	63876012	63872139	8000	63872012	-4000	4000	127
chr17	41180100	41188100	41184421	8000	41184100	-4000	4000	321
chr17	35740511	35748511	35745724	8000	35744511	-4000	4000	1213
chr17	82359775	82367775	82363505	8000	82363775	-4000	4000	-270
chr17	41342092	41350092	41346929	8000	41346092	-4000	4000	837
chr17	53821193	53829193	53823628	8000	53825193	-4000	4000	-1565
chr17	8116592	8124592	8118766	8000	8120592	-4000	4000	-1826
chr17	9767434	9775434	9772921	8000	9771434	-4000	4000	1487
chr17	10386322	10394322	10390410	8000	10390322	-4000	4000	88
chr17	34268242	34276242	34271915	8000	34272242	-4000	4000	-327
chr17	34356328	34364328	34360505	8000	34360328	-4000	4000	177
chr17	39873896	39881896	39875264	8000	39877896	-4000	4000	-2632
chr17	40772808	40780808	40777663	8000	40776808	-4000	4000	855
chr17	41092981	41100981	41097300	8000	41096981	-4000	4000	319
chr17	42846707	42854707	42850278	8000	42850707	-4000	4000	-429
chr17	42846707	42854707	42852806	8000	42850707	-4000	4000	2099
chr17	43936804	43944804	43941520	8000	43940804	-4000	4000	716
chr17	44777846	44785846	44778003	8000	44781846	-4000	4000	-3843
chr17	45250393	45258393	45255708	8000	45254393	-4000	4000	1315
chr17	47219679	47227679	47223058	8000	47223679	-4000	4000	-621
chr17	49219366	49227366	49224770	8000	49223366	-4000	4000	1404
chr17	41235004	41243004	41238108	8000	41239004	-4000	4000	-896
chr17	40788196	40796196	40793988	8000	40792196	-4000	4000	1792
chr17	58155585	58163585	58157545	8000	58159585	-4000	4000	-2040
chr17	63876215	63884215	63881086	8000	63880215	-4000	4000	871
chr17	33009087	33017087	33014013	8000	33013087	-4000	4000	926
chr17	79085345	79093345	79090681	8000	79089345	-4000	4000	1336
chr17	41711969	41719969	41715532	8000	41715969	-4000	4000	-437
chr17	74368600	74376600	74372142	8000	74372600	-4000	4000	-458
chr17	36940612	36948612	36943158	8000	36944612	-4000	4000	-1454
chr17	10488307	10496307	10496080	8000	10492307	-4000	4000	3773
chr17	48717719	48725719	48722504	8000	48721719	-4000	4000	785
chr17	50838353	50846353	50839948	8000	50842353	-4000	4000	-2405
chr17	74368600	74376600	74372331	8000	74372600	-4000	4000	-269
chr17	48954554	48962554	48960985	8000	48958554	-4000	4000	2431
chr17	41135433	41143433	41140247	8000	41139433	-4000	4000	814
chr17	10488307	10496307	10494607	8000	10492307	-4000	4000	2300
chr17	8116592	8124592	8121298	8000	8120592	-4000	4000	706
chr17	19674288	19682288	19681567	8000	19678288	-4000	4000	3279
chr17	66208033	66216033	66214484	8000	66212033	-4000	4000	2451
chr17	63544977	63552977	63550655	8000	63548977	-4000	4000	1678
chr17	3214896	3222896	3216390	8000	3218896	-4000	4000	-2506
chr17	8116592	8124592	8116774	8000	8120592	-4000	4000	-3818
chr17	9639447	9647447	9643266	8000	9643447	-4000	4000	-181
chr17	8743524	8751524	8744528	8000	8747524	-4000	4000	-2996
chr17	7353219	7361219	7356423	8000	7357219	-4000	4000	-796
chr17	10818470	10826470	10825116	8000	10822470	-4000	4000	2646
chr17	35188520	35196520	35193740	8000	35192520	-4000	4000	1220
chr17	41180100	41188100	41184487	8000	41184100	-4000	4000	387
chr17	41482136	41490136	41487420	8000	41486136	-4000	4000	1284
chr17	45843067	45851067	45846405	8000	45847067	-4000	4000	-662
chr17	60427426	60435426	60431179	8000	60431426	-4000	4000	-247
chr17	74517174	74525174	74522716	8000	74521174	-4000	4000	1542
chr17	15299811	15307811	15303863	8000	15303811	-4000	4000	52
chr17	7423568	7431568	7427010	8000	7427568	-4000	4000	-558
chr17	41389721	41397721	41394991	8000	41393721	-4000	4000	1270
chr17	60427426	60435426	60435201	8000	60431426	-4000	4000	3775
chr17	78162297	78170297	78165899	8000	78166297	-4000	4000	-398
chr17	40744021	40752021	40751305	8000	40748021	-4000	4000	3284
chr17	40973715	40981715	40978209	8000	40977715	-4000	4000	494
chr17	62412480	62420480	62416136	8000	62416480	-4000	4000	-344
chr17	10488307	10496307	10495962	8000	10492307	-4000	4000	3655
chr17	40013813	40021813	40015765	8000	40017813	-4000	4000	-2048
chr17	48720758	48728758	48726980	8000	48724758	-4000	4000	2222
chr17	7097322	7105322	7101559	8000	7101322	-4000	4000	237
chr17	3194448	3202448	3197567	8000	3198448	-4000	4000	-881
chr17	63868012	63876012	63873608	8000	63872012	-4000	4000	1596
chr17	41135433	41143433	41140378	8000	41139433	-4000	4000	945
chr17	58265855	58273855	58272904	8000	58269855	-4000	4000	3049
chr17	41173446	41181446	41178022	8000	41177446	-4000	4000	576
chr17	58265855	58273855	58267443	8000	58269855	-4000	4000	-2412
chr17	35930518	35938518	35937771	8000	35934518	-4000	4000	3253
chr17	40772808	40780808	40780400	8000	40776808	-4000	4000	3592
chr17	41163231	41171231	41167572	8000	41167231	-4000	4000	341
chr17	41113181	41121181	41118203	8000	41117181	-4000	4000	1022
chr17	63890909	63898909	63895046	8000	63894909	-4000	4000	137
chr17	41246653	41254653	41250579	8000	41250653	-4000	4000	-74
chr17	63544977	63552977	63545082	8000	63548977	-4000	4000	-3895
chr17	63890909	63898909	63894992	8000	63894909	-4000	4000	83
chr17	76466117	76474117	76468858	8000	76470117	-4000	4000	-1259
chr17	36940612	36948612	36940727	8000	36944612	-4000	4000	-3885
chr17	41036541	41044541	41041054	8000	41040541	-4000	4000	513
chr17	42846707	42854707	42851845	8000	42850707	-4000	4000	1138
chr17	62697314	62705314	62701557	8000	62701314	-4000	4000	243
chr17	76466117	76474117	76474094	8000	76470117	-4000	4000	3977
chr17	53821193	53829193	53824834	8000	53825193	-4000	4000	-359
chr17	4779213	4787213	4783190	8000	4783213	-4000	4000	-23
chr17	6785133	6793133	6787333	8000	6789133	-4000	4000	-1800
chr17	8743524	8751524	8744588	8000	8747524	-4000	4000	-2936
chr17	41561836	41569836	41567623	8000	41565836	-4000	4000	1787
chr17	41561836	41569836	41568209	8000	41565836	-4000	4000	2373
chr17	41561836	41569836	41568269	8000	41565836	-4000	4000	2433
chr17	41561836	41569836	41568350	8000	41565836	-4000	4000	2514
chr17	41561836	41569836	41568571	8000	41565836	-4000	4000	2735
chr17	44368180	44376180	44376092	8000	44372180	-4000	4000	3912
chr17	63876215	63884215	63881042	8000	63880215	-4000	4000	827
chr17	74929912	74937912	74933462	8000	74933912	-4000	4000	-450
chr17	41036541	41044541	41041052	8000	41040541	-4000	4000	511
chr17	7423568	7431568	7426051	8000	7427568	-4000	4000	-1517
chr17	74352416	74360416	74354787	8000	74356416	-4000	4000	-1629
chr17	41844384	41852384	41848012	8000	41848384	-4000	4000	-372
chr17	34356328	34364328	34358029	8000	34360328	-4000	4000	-2299
chr17	38320571	38328571	38327070	8000	38324571	-4000	4000	2499
chr17	41135433	41143433	41139792	8000	41139433	-4000	4000	359
chr17	61481110	61489110	61483528	8000	61485110	-4000	4000	-1582
chr17	74945992	74953992	74949297	8000	74949992	-4000	4000	-695
chr17	3272942	3280942	3278290	8000	3276942	-4000	4000	1348
chr17	40772808	40780808	40779715	8000	40776808	-4000	4000	2907
chr17	41235004	41243004	41238276	8000	41239004	-4000	4000	-728
chr17	44244390	44252390	44250472	8000	44248390	-4000	4000	2082
chr17	74517174	74525174	74523179	8000	74521174	-4000	4000	2005
chr17	60427426	60435426	60431192	8000	60431426	-4000	4000	-234
chr17	78236987	78244987	78239818	8000	78240987	-4000	4000	-1169
chr17	3272942	3280942	3278305	8000	3276942	-4000	4000	1363
chr17	74310884	74318884	74312092	8000	74314884	-4000	4000	-2792
chr17	41482136	41490136	41489418	8000	41486136	-4000	4000	3282
chr17	42119352	42127352	42123294	8000	42123352	-4000	4000	-58
chr17	3058669	3066669	3063217	8000	3062669	-4000	4000	548
chr17	3214896	3222896	3216168	8000	3218896	-4000	4000	-2728
chr18	7228044	7236044	7232023	8000	7232044	-4000	4000	-21
chr18	63932111	63940111	63934884	8000	63936111	-4000	4000	-1227
chr18	26189355	26197355	26192465	8000	26193355	-4000	4000	-890
chr18	60367062	60375062	60371606	8000	60371062	-4000	4000	544
chr18	47028527	47036527	47033975	8000	47032527	-4000	4000	1448
chr18	47028527	47036527	47034333	8000	47032527	-4000	4000	1806
chr18	46472972	46480972	46477772	8000	46476972	-4000	4000	800
chr18	32216404	32224404	32217767	8000	32220404	-4000	4000	-2637
chr18	47028527	47036527	47034184	8000	47032527	-4000	4000	1657
chr18	31755584	31763584	31760859	8000	31759584	-4000	4000	1275
chr18	11606612	11614612	11609809	8000	11610612	-4000	4000	-803
chr18	63565329	63573329	63566618	8000	63569329	-4000	4000	-2711
chr18	9885275	9893275	9887866	8000	9889275	-4000	4000	-1409
chr18	74430775	74438775	74436684	8000	74434775	-4000	4000	1909
chr18	26189355	26197355	26192472	8000	26193355	-4000	4000	-883
chr18	24475961	24483961	24477378	8000	24479961	-4000	4000	-2583
chr18	31410912	31418912	31412915	8000	31414912	-4000	4000	-1997
chr18	5138911	5146911	5145613	8000	5142911	-4000	4000	2702
chr18	24475961	24483961	24477381	8000	24479961	-4000	4000	-2580
chr18	63722432	63730432	63723320	8000	63726432	-4000	4000	-3112
chr18	7228044	7236044	7231364	8000	7232044	-4000	4000	-680
chr18	13878044	13886044	13885540	8000	13882044	-4000	4000	3496
chr18	9885275	9893275	9887586	8000	9889275	-4000	4000	-1689
chr18	61551779	61559779	61554508	8000	61555779	-4000	4000	-1271
chr18	13878044	13886044	13885461	8000	13882044	-4000	4000	3417
chr18	13878044	13886044	13884765	8000	13882044	-4000	4000	2721
chr18	47028527	47036527	47035082	8000	47032527	-4000	4000	2555
chr18	12125764	12133764	12125780	8000	12129764	-4000	4000	-3984
chr18	61551779	61559779	61554399	8000	61555779	-4000	4000	-1380
chr18	46964695	46972695	46969280	8000	46968695	-4000	4000	585
chr18	47028527	47036527	47035354	8000	47032527	-4000	4000	2827
chr18	7228044	7236044	7231526	8000	7232044	-4000	4000	-518
chr18	60367062	60375062	60371986	8000	60371062	-4000	4000	924
chr18	32933402	32941402	32937696	8000	32937402	-4000	4000	294
chr18	47028527	47036527	47034568	8000	47032527	-4000	4000	2041
chr18	13878044	13886044	13884724	8000	13882044	-4000	4000	2680
chr18	74583212	74591212	74584645	8000	74587212	-4000	4000	-2567
chr18	13878044	13886044	13885178	8000	13882044	-4000	4000	3134
chr18	31410912	31418912	31411186	8000	31414912	-4000	4000	-3726
chr18	12125764	12133764	12126075	8000	12129764	-4000	4000	-3689
chr18	24475961	24483961	24476841	8000	24479961	-4000	4000	-3120
chr18	31594833	31602833	31598585	8000	31598833	-4000	4000	-248
chr18	42739227	42747227	42743557	8000	42743227	-4000	4000	330
chr18	63722432	63730432	63723648	8000	63726432	-4000	4000	-2784
chr18	31410912	31418912	31411157	8000	31414912	-4000	4000	-3755
chr18	47028527	47036527	47033725	8000	47032527	-4000	4000	1198
chr18	47028527	47036527	47034263	8000	47032527	-4000	4000	1736
chr18	60367062	60375062	60371709	8000	60371062	-4000	4000	647
chr18	63722432	63730432	63723432	8000	63726432	-4000	4000	-3000
chr18	63932111	63940111	63934997	8000	63936111	-4000	4000	-1114
chr18	47028527	47036527	47028907	8000	47032527	-4000	4000	-3620
chr18	9885275	9893275	9887954	8000	9889275	-4000	4000	-1321
chr18	33847100	33855100	33852932	8000	33851100	-4000	4000	1832
chr18	47028527	47036527	47034946	8000	47032527	-4000	4000	2419
chr18	47028527	47036527	47033146	8000	47032527	-4000	4000	619
chr18	75405476	75413476	75410282	8000	75409476	-4000	4000	806
chr18	74430775	74438775	74436509	8000	74434775	-4000	4000	1734
chr18	13878044	13886044	13884466	8000	13882044	-4000	4000	2422
chr18	46964695	46972695	46969126	8000	46968695	-4000	4000	431
chr18	47028527	47036527	47034826	8000	47032527	-4000	4000	2299
chr18	54595493	54603493	54597984	8000	54599493	-4000	4000	-1509
chr18	63565329	63573329	63566948	8000	63569329	-4000	4000	-2381
chr18	578114	586114	580508	8000	582114	-4000	4000	-1606
chr18	13878044	13886044	13884452	8000	13882044	-4000	4000	2408
chr18	31755584	31763584	31760124	8000	31759584	-4000	4000	540
chr18	45679688	45687688	45682508	8000	45683688	-4000	4000	-1180
chr18	45679688	45687688	45682671	8000	45683688	-4000	4000	-1017
chr18	57146410	57154410	57147583	8000	57150410	-4000	4000	-2827
chr18	578114	586114	580977	8000	582114	-4000	4000	-1137
chr18	13878044	13886044	13885000	8000	13882044	-4000	4000	2956
chr18	79896184	79904184	79899086	8000	79900184	-4000	4000	-1098
chr18	57146410	57154410	57147517	8000	57150410	-4000	4000	-2893
chr18	7228044	7236044	7231501	8000	7232044	-4000	4000	-543
chr18	24475961	24483961	24477522	8000	24479961	-4000	4000	-2439
chr18	54595493	54603493	54598129	8000	54599493	-4000	4000	-1364
chr18	13823323	13831323	13826449	8000	13827323	-4000	4000	-874
chr18	60367062	60375062	60371548	8000	60371062	-4000	4000	486
chr18	60367062	60375062	60372131	8000	60371062	-4000	4000	1069
chr18	31755584	31763584	31760117	8000	31759584	-4000	4000	533
chr18	75405476	75413476	75410580	8000	75409476	-4000	4000	1104
chr18	74430775	74438775	74436602	8000	74434775	-4000	4000	1827
chr18	31410912	31418912	31411152	8000	31414912	-4000	4000	-3760
chr18	9885275	9893275	9888093	8000	9889275	-4000	4000	-1182
chr18	59271156	59279156	59272499	8000	59275156	-4000	4000	-2657
chr18	47028527	47036527	47034232	8000	47032527	-4000	4000	1705
chr19	51326891	51334891	51334200	8000	51330891	-4000	4000	3309
chr19	54732632	54740632	54735283	8000	54736632	-4000	4000	-1349
chr19	53939950	53947950	53942305	8000	53943950	-4000	4000	-1645
chr19	357747	365747	362223	8000	361747	-4000	4000	476
chr19	39266188	39274188	39268842	8000	39270188	-4000	4000	-1346
chr19	5452856	5460856	5455899	8000	5456856	-4000	4000	-957
chr19	5452856	5460856	5456088	8000	5456856	-4000	4000	-768
chr19	35546031	35554031	35546707	8000	35550031	-4000	4000	-3324
chr19	44325695	44333695	44328548	8000	44329695	-4000	4000	-1147
chr19	44325695	44333695	44329433	8000	44329695	-4000	4000	-262
chr19	35220800	35228800	35228074	8000	35224800	-4000	4000	3274
chr19	39294673	39302673	39298241	8000	39298673	-4000	4000	-432
chr19	43716021	43724021	43719669	8000	43720021	-4000	4000	-352
chr19	46015153	46023153	46017249	8000	46019153	-4000	4000	-1904
chr19	55009705	55017705	55014627	8000	55013705	-4000	4000	922
chr19	10284522	10292522	10284564	8000	10288522	-4000	4000	-3958
chr19	5452856	5460856	5455656	8000	5456856	-4000	4000	-1200
chr19	4286722	4294722	4292538	8000	4290722	-4000	4000	1816
chr19	50821289	50829289	50826682	8000	50825289	-4000	4000	1393
chr19	39198825	39206825	39199257	8000	39202825	-4000	4000	-3568
chr19	54506687	54514687	54508165	8000	54510687	-4000	4000	-2522
chr19	35368962	35376962	35371562	8000	35372962	-4000	4000	-1400
chr19	4319843	4327843	4326993	8000	4323843	-4000	4000	3150
chr19	4319843	4327843	4324468	8000	4323843	-4000	4000	625
chr19	54506687	54514687	54508106	8000	54510687	-4000	4000	-2581
chr19	54749052	54757052	54752942	8000	54753052	-4000	4000	-110
chr19	41833074	41841074	41837328	8000	41837074	-4000	4000	254
chr19	42748686	42756686	42754393	8000	42752686	-4000	4000	1707
chr19	43414597	43422597	43416382	8000	43418597	-4000	4000	-2215
chr19	14938448	14946448	14942064	8000	14942448	-4000	4000	-384
chr19	49063397	49071397	49070638	8000	49067397	-4000	4000	3241
chr19	15725052	15733052	15729026	8000	15729052	-4000	4000	-26
chr19	45909214	45917214	45914561	8000	45913214	-4000	4000	1347
chr19	54506687	54514687	54508119	8000	54510687	-4000	4000	-2568
chr19	49424987	49432987	49431382	8000	49428987	-4000	4000	2395
chr19	9110828	9118828	9114888	8000	9114828	-4000	4000	60
chr19	51709112	51717112	51714069	8000	51713112	-4000	4000	957
chr19	8058660	8066660	8066098	8000	8062660	-4000	4000	3438
chr19	49051793	49059793	49054913	8000	49055793	-4000	4000	-880
chr19	54919509	54927509	54923786	8000	54923509	-4000	4000	277
chr19	8839340	8847340	8842684	8000	8843340	-4000	4000	-656
chr19	35863136	35871136	35866306	8000	35867136	-4000	4000	-830
chr19	10284522	10292522	10287604	8000	10288522	-4000	4000	-918
chr19	8839340	8847340	8843250	8000	8843340	-4000	4000	-90
chr19	4886437	4894437	4891106	8000	4890437	-4000	4000	669
chr19	37880823	37888823	37886222	8000	37884823	-4000	4000	1399
chr19	5452856	5460856	5456642	8000	5456856	-4000	4000	-214
chr19	9184818	9192818	9186211	8000	9188818	-4000	4000	-2607
chr19	35368962	35376962	35371358	8000	35372962	-4000	4000	-1604
chr19	9462355	9470355	9466699	8000	9466355	-4000	4000	344
chr19	54036825	54044825	54041948	8000	54040825	-4000	4000	1123
chr19	41903704	41911704	41906495	8000	41907704	-4000	4000	-1209
chr19	50655255	50663255	50662461	8000	50659255	-4000	4000	3206
chr19	6422037	6430037	6427152	8000	6426037	-4000	4000	1115
chr19	57150021	57158021	57154398	8000	57154021	-4000	4000	377
chr19	5452856	5460856	5455975	8000	5456856	-4000	4000	-881
chr19	6422037	6430037	6422371	8000	6426037	-4000	4000	-3666
chr19	12754458	12762458	12755438	8000	12758458	-4000	4000	-3020
chr19	12880422	12888422	12884802	8000	12884422	-4000	4000	380
chr19	15946350	15954350	15949639	8000	15950350	-4000	4000	-711
chr19	19250756	19258756	19258662	8000	19254756	-4000	4000	3906
chr19	35863136	35871136	35866418	8000	35867136	-4000	4000	-718
chr19	39504481	39512481	39505262	8000	39508481	-4000	4000	-3219
chr19	43716021	43724021	43719223	8000	43720021	-4000	4000	-798
chr19	44325695	44333695	44328128	8000	44329695	-4000	4000	-1567
chr19	51375909	51383909	51380220	8000	51379909	-4000	4000	311
chr19	55009705	55017705	55015063	8000	55013705	-4000	4000	1358
chr19	55374246	55382246	55378045	8000	55378246	-4000	4000	-201
chr19	55759421	55767421	55763108	8000	55763421	-4000	4000	-313
chr19	57675152	57683152	57676376	8000	57679152	-4000	4000	-2776
chr19	43188702	43196702	43194444	8000	43192702	-4000	4000	1742
chr19	9184818	9192818	9186706	8000	9188818	-4000	4000	-2112
chr19	14874203	14882203	14880514	8000	14878203	-4000	4000	2311
chr19	35713038	35721038	35719901	8000	35717038	-4000	4000	2863
chr19	35795988	35803988	35800156	8000	35799988	-4000	4000	168
chr19	50617307	50625307	50625234	8000	50621307	-4000	4000	3927
chr19	50791219	50799219	50794823	8000	50795219	-4000	4000	-396
chr19	53939950	53947950	53942235	8000	53943950	-4000	4000	-1715
chr19	19250756	19258756	19252153	8000	19254756	-4000	4000	-2603
chr19	41833074	41841074	41838094	8000	41837074	-4000	4000	1020
chr19	42898086	42906086	42903677	8000	42902086	-4000	4000	1591
chr19	5774734	5782734	5778701	8000	5778734	-4000	4000	-33
chr19	57127926	57135926	57135906	8000	57131926	-4000	4000	3980
chr19	8058660	8066660	8066113	8000	8062660	-4000	4000	3453
chr19	1776988	1784988	1783042	8000	1780988	-4000	4000	2054
chr19	4286722	4294722	4292692	8000	4290722	-4000	4000	1970
chr19	4319843	4327843	4325223	8000	4323843	-4000	4000	1380
chr19	53903652	53911652	53904655	8000	53907652	-4000	4000	-2997
chr19	54810517	54818517	54814033	8000	54814517	-4000	4000	-484
chr19	38380267	38388267	38385992	8000	38384267	-4000	4000	1725
chr19	49029238	49037238	49035698	8000	49033238	-4000	4000	2460
chr19	49063397	49071397	49070259	8000	49067397	-4000	4000	2862
chr19	12754458	12762458	12757944	8000	12758458	-4000	4000	-514
chr19	49424987	49432987	49429513	8000	49428987	-4000	4000	526
chr19	54780322	54788322	54786592	8000	54784322	-4000	4000	2270
chr19	55781397	55789397	55789327	8000	55785397	-4000	4000	3930
chr19	6579183	6587183	6586225	8000	6583183	-4000	4000	3042
chr19	29560551	29568551	29563897	8000	29564551	-4000	4000	-654
chr19	14468466	14476466	14472721	8000	14472466	-4000	4000	255
chr19	15019276	15027276	15023028	8000	15023276	-4000	4000	-248
chr19	4319843	4327843	4323755	8000	4323843	-4000	4000	-88
chr19	51384289	51392289	51387241	8000	51388289	-4000	4000	-1048
chr19	55360382	55368382	55362401	8000	55364382	-4000	4000	-1981
chr19	54810517	54818517	54818401	8000	54814517	-4000	4000	3884
chr19	50821289	50829289	50826977	8000	50825289	-4000	4000	1688
chr19	15946350	15954350	15949634	8000	15950350	-4000	4000	-716
chr19	39727255	39735255	39734399	8000	39731255	-4000	4000	3144
chr19	47797243	47805243	47801741	8000	47801243	-4000	4000	498
chr19	48876967	48884967	48881124	8000	48880967	-4000	4000	157
chr19	37880823	37888823	37887039	8000	37884823	-4000	4000	2216
chr19	41615015	41623015	41620233	8000	41619015	-4000	4000	1218
chr19	41903704	41911704	41905211	8000	41907704	-4000	4000	-2493
chr19	55704438	55712438	55711967	8000	55708438	-4000	4000	3529
chr19	54749052	54757052	54752615	8000	54753052	-4000	4000	-437
chr19	38904980	38912980	38907222	8000	38908980	-4000	4000	-1758
chr19	53262676	53270676	53266816	8000	53266676	-4000	4000	140
chr19	39705444	39713444	39706612	8000	39709444	-4000	4000	-2832
chr19	9184818	9192818	9185806	8000	9188818	-4000	4000	-3012
chr19	57127926	57135926	57128886	8000	57131926	-4000	4000	-3040
chr19	54732632	54740632	54738518	8000	54736632	-4000	4000	1886
chr19	58050631	58058631	58053710	8000	58054631	-4000	4000	-921
chr19	9184818	9192818	9185859	8000	9188818	-4000	4000	-2959
chr19	48372377	48380377	48376120	8000	48376377	-4000	4000	-257
chr19	43188702	43196702	43194996	8000	43192702	-4000	4000	2294
chr19	4319843	4327843	4323010	8000	4323843	-4000	4000	-833
chr19	2270631	2278631	2273084	8000	2274631	-4000	4000	-1547
chr19	43188702	43196702	43193298	8000	43192702	-4000	4000	596
chr19	51487227	51495227	51491675	8000	51491227	-4000	4000	448
chr19	3800024	3808024	3806018	8000	3804024	-4000	4000	1994
chr19	35795988	35803988	35802234	8000	35799988	-4000	4000	2246
chr19	38904980	38912980	38905097	8000	38908980	-4000	4000	-3883
chr19	49011980	49019980	49015857	8000	49015980	-4000	4000	-123
chr19	9110828	9118828	9115209	8000	9114828	-4000	4000	381
chr19	3938416	3946416	3941078	8000	3942416	-4000	4000	-1338
chr19	57127926	57135926	57130776	8000	57131926	-4000	4000	-1150
chr19	4319843	4327843	4324545	8000	4323843	-4000	4000	702
chr19	14468466	14476466	14472617	8000	14472466	-4000	4000	151
chr19	44325695	44333695	44327434	8000	44329695	-4000	4000	-2261
chr19	15874023	15882023	15878611	8000	15878023	-4000	4000	588
chr19	9462355	9470355	9468118	8000	9466355	-4000	4000	1763
chr19	8058660	8066660	8066180	8000	8062660	-4000	4000	3520
chr19	14938448	14946448	14942292	8000	14942448	-4000	4000	-156
chr19	19250756	19258756	19256791	8000	19254756	-4000	4000	2035
chr19	35150302	35158302	35155350	8000	35154302	-4000	4000	1048
chr19	47797243	47805243	47802760	8000	47801243	-4000	4000	1517
chr19	4886437	4894437	4891354	8000	4890437	-4000	4000	917
chr19	55877855	55885855	55881631	8000	55881855	-4000	4000	-224
chr19	3469986	3477986	3474887	8000	3473986	-4000	4000	901
chr19	35713038	35721038	35716756	8000	35717038	-4000	4000	-282
chr19	8728160	8736160	8731813	8000	8732160	-4000	4000	-347
chr19	39198825	39206825	39200350	8000	39202825	-4000	4000	-2475
chr19	49043638	49051638	49047644	8000	49047638	-4000	4000	6
chr19	50791219	50799219	50798077	8000	50795219	-4000	4000	2858
chr19	13876757	13884757	13877515	8000	13880757	-4000	4000	-3242
chr19	55374246	55382246	55376899	8000	55378246	-4000	4000	-1347
chr19	15738343	15746343	15742037	8000	15742343	-4000	4000	-306
chr19	51766531	51774531	51769075	8000	51770531	-4000	4000	-1456
chr19	56185570	56193570	56190906	8000	56189570	-4000	4000	1336
chr19	54036825	54044825	54040865	8000	54040825	-4000	4000	40
chr19	57127926	57135926	57131507	8000	57131926	-4000	4000	-419
chr19	51766531	51774531	51768819	8000	51770531	-4000	4000	-1712
chr19	50655255	50663255	50662359	8000	50659255	-4000	4000	3104
chr19	51487227	51495227	51491619	8000	51491227	-4000	4000	392
chr19	1776988	1784988	1784826	8000	1780988	-4000	4000	3838
chr19	54780322	54788322	54783508	8000	54784322	-4000	4000	-814
chr19	459346	467346	463919	8000	463346	-4000	4000	573
chr19	44325695	44333695	44327473	8000	44329695	-4000	4000	-2222
chr19	45791713	45799713	45796047	8000	45795713	-4000	4000	334
chr19	38797671	38805671	38803582	8000	38801671	-4000	4000	1911
chr19	1776988	1784988	1782209	8000	1780988	-4000	4000	1221
chr19	1776988	1784988	1783123	8000	1780988	-4000	4000	2135
chr19	3469986	3477986	3474789	8000	3473986	-4000	4000	803
chr19	4286722	4294722	4290547	8000	4290722	-4000	4000	-175
chr19	9122012	9130012	9126235	8000	9126012	-4000	4000	223
chr19	51709112	51717112	51714053	8000	51713112	-4000	4000	941
chr19	14468466	14476466	14470636	8000	14472466	-4000	4000	-1830
chr19	5774734	5782734	5776294	8000	5778734	-4000	4000	-2440
chr19	9110828	9118828	9115415	8000	9114828	-4000	4000	587
chr19	15725052	15733052	15728204	8000	15729052	-4000	4000	-848
chr19	7765605	7773605	7766305	8000	7769605	-4000	4000	-3300
chr19	15800549	15808549	15807354	8000	15804549	-4000	4000	2805
chr19	54863207	54871207	54866546	8000	54867207	-4000	4000	-661
chr19	48372377	48380377	48376184	8000	48376377	-4000	4000	-193
chr19	17812512	17820512	17816993	8000	17816512	-4000	4000	481
chr19	48025383	48033383	48030370	8000	48029383	-4000	4000	987
chr19	54780322	54788322	54784020	8000	54784322	-4000	4000	-302
chr19	55009705	55017705	55014349	8000	55013705	-4000	4000	644
chr19	50821289	50829289	50821892	8000	50825289	-4000	4000	-3397
chr19	38380267	38388267	38386164	8000	38384267	-4000	4000	1897
chr19	4169054	4177054	4171691	8000	4173054	-4000	4000	-1363
chr19	35713038	35721038	35719496	8000	35717038	-4000	4000	2458
chr19	17891174	17899174	17893944	8000	17895174	-4000	4000	-1230
chr19	35863136	35871136	35866441	8000	35867136	-4000	4000	-695
chr19	47839330	47847330	47839516	8000	47843330	-4000	4000	-3814
chr19	53257837	53265837	53259195	8000	53261837	-4000	4000	-2642
chr19	37880823	37888823	37886963	8000	37884823	-4000	4000	2140
chr19	14874203	14882203	14881221	8000	14878203	-4000	4000	3018
chr19	48283608	48291608	48286054	8000	48287608	-4000	4000	-1554
chr19	8728160	8736160	8731406	8000	8732160	-4000	4000	-754
chr19	38797671	38805671	38802067	8000	38801671	-4000	4000	396
chr19	43716021	43724021	43718845	8000	43720021	-4000	4000	-1176
chr19	51384289	51392289	51387242	8000	51388289	-4000	4000	-1047
chr19	40375271	40383271	40379508	8000	40379271	-4000	4000	237
chr19	51265330	51273330	51265587	8000	51269330	-4000	4000	-3743
chr19	5774734	5782734	5778536	8000	5778734	-4000	4000	-198
chr19	4169054	4177054	4171693	8000	4173054	-4000	4000	-1361
chr19	12880422	12888422	12881115	8000	12884422	-4000	4000	-3307
chr19	39294673	39302673	39298485	8000	39298673	-4000	4000	-188
chr19	15725052	15733052	15728737	8000	15729052	-4000	4000	-315
chr19	55360382	55368382	55362968	8000	55364382	-4000	4000	-1414
chr19	56185570	56193570	56191871	8000	56189570	-4000	4000	2301
chr19	3938416	3946416	3941102	8000	3942416	-4000	4000	-1314
chr19	47839330	47847330	47839743	8000	47843330	-4000	4000	-3587
chr19	44325695	44333695	44327856	8000	44329695	-4000	4000	-1839
chr19	14938448	14946448	14942424	8000	14942448	-4000	4000	-24
chr19	43414597	43422597	43416221	8000	43418597	-4000	4000	-2376
chr19	32826509	32834509	32830611	8000	32830509	-4000	4000	102
chr19	49018953	49026953	49024016	8000	49022953	-4000	4000	1063
chr19	9184818	9192818	9186662	8000	9188818	-4000	4000	-2156
chr19	9462355	9470355	9468067	8000	9466355	-4000	4000	1712
chr19	15874023	15882023	15879832	8000	15878023	-4000	4000	1809
chr19	15800549	15808549	15808032	8000	15804549	-4000	4000	3483
chr19	45869797	45877797	45873097	8000	45873797	-4000	4000	-700
chr19	49424987	49432987	49432614	8000	49428987	-4000	4000	3627
chr19	12754458	12762458	12756206	8000	12758458	-4000	4000	-2252
chr19	49029238	49037238	49032221	8000	49033238	-4000	4000	-1017
chr19	57127926	57135926	57135205	8000	57131926	-4000	4000	3279
chr19	1532046	1540046	1533985	8000	1536046	-4000	4000	-2061
chr19	12970760	12978760	12973405	8000	12974760	-4000	4000	-1355
chr19	54780322	54788322	54783685	8000	54784322	-4000	4000	-637
chr19	50821289	50829289	50826748	8000	50825289	-4000	4000	1459
chr19	6579183	6587183	6586114	8000	6583183	-4000	4000	2931
chr19	11322996	11330996	11324643	8000	11326996	-4000	4000	-2353
chr19	11322996	11330996	11325310	8000	11326996	-4000	4000	-1686
chr19	12013888	12021888	12015285	8000	12017888	-4000	4000	-2603
chr19	54887420	54895420	54889883	8000	54891420	-4000	4000	-1537
chr19	39107493	39115493	39110434	8000	39111493	-4000	4000	-1059
chr19	39603474	39611474	39604659	8000	39607474	-4000	4000	-2815
chr19	15800549	15808549	15807638	8000	15804549	-4000	4000	3089
chr19	19250756	19258756	19258545	8000	19254756	-4000	4000	3789
chr19	39294673	39302673	39298605	8000	39298673	-4000	4000	-68
chr19	9248625	9256625	9251366	8000	9252625	-4000	4000	-1259
chr19	38797671	38805671	38801900	8000	38801671	-4000	4000	229
chr19	42920132	42928132	42926551	8000	42924132	-4000	4000	2419
chr19	50821289	50829289	50825753	8000	50825289	-4000	4000	464
chr19	14027551	14035551	14032454	8000	14031551	-4000	4000	903
chr19	43188702	43196702	43195226	8000	43192702	-4000	4000	2524
chr19	57127926	57135926	57131399	8000	57131926	-4000	4000	-527
chr19	12013888	12021888	12015020	8000	12017888	-4000	4000	-2868
chr19	39705444	39713444	39705967	8000	39709444	-4000	4000	-3477
chr19	50512892	50520892	50518454	8000	50516892	-4000	4000	1562
chr19	53789741	53797741	53795895	8000	53793741	-4000	4000	2154
chr19	39705444	39713444	39709236	8000	39709444	-4000	4000	-208
chr19	55009705	55017705	55014890	8000	55013705	-4000	4000	1185
chr19	47797243	47805243	47802965	8000	47801243	-4000	4000	1722
chr19	51326891	51334891	51328692	8000	51330891	-4000	4000	-2199
chr19	56185570	56193570	56191899	8000	56189570	-4000	4000	2329
chr19	35863136	35871136	35866214	8000	35867136	-4000	4000	-922
chr19	39294673	39302673	39298232	8000	39298673	-4000	4000	-441
chr19	39294673	39302673	39298576	8000	39298673	-4000	4000	-97
chr19	14874203	14882203	14880559	8000	14878203	-4000	4000	2356
chr19	13876757	13884757	13880470	8000	13880757	-4000	4000	-287
chr19	8693400	8701400	8698235	8000	8697400	-4000	4000	835
chr19	35713038	35721038	35714733	8000	35717038	-4000	4000	-2305
chr19	7765605	7773605	7767720	8000	7769605	-4000	4000	-1885
chr19	48025383	48033383	48030430	8000	48029383	-4000	4000	1047
chr19	9091669	9099669	9093748	8000	9095669	-4000	4000	-1921
chr19	9091669	9099669	9093894	8000	9095669	-4000	4000	-1775
chr19	40212058	40220058	40217314	8000	40216058	-4000	4000	1256
chr19	48754333	48762333	48756146	8000	48758333	-4000	4000	-2187
chr19	49018953	49026953	49022962	8000	49022953	-4000	4000	9
chr19	34586644	34594644	34593498	8000	34590644	-4000	4000	2854
chr19	39603474	39611474	39604624	8000	39607474	-4000	4000	-2850
chr19	54780322	54788322	54788211	8000	54784322	-4000	4000	3889
chr19	56185570	56193570	56192984	8000	56189570	-4000	4000	3414
chr19	42748686	42756686	42754268	8000	42752686	-4000	4000	1582
chr19	42862464	42870464	42869025	8000	42866464	-4000	4000	2561
chr19	43716021	43724021	43719213	8000	43720021	-4000	4000	-808
chr19	54863207	54871207	54865909	8000	54867207	-4000	4000	-1298
chr19	57433970	57441970	57441920	8000	57437970	-4000	4000	3950
chr19	9248625	9256625	9251358	8000	9252625	-4000	4000	-1267
chr19	50512892	50520892	50513771	8000	50516892	-4000	4000	-3121
chr19	9462355	9470355	9466843	8000	9466355	-4000	4000	488
chr19	640373	648373	643333	8000	644373	-4000	4000	-1040
chr19	19250756	19258756	19258728	8000	19254756	-4000	4000	3972
chr19	35368962	35376962	35371403	8000	35372962	-4000	4000	-1559
chr19	40375271	40383271	40376743	8000	40379271	-4000	4000	-2528
chr19	49043638	49051638	49044046	8000	49047638	-4000	4000	-3592
chr19	9184818	9192818	9188548	8000	9188818	-4000	4000	-270
chr19	49418419	49426419	49423322	8000	49422419	-4000	4000	903
chr19	53012123	53020123	53014508	8000	53016123	-4000	4000	-1615
chr19	9096407	9104407	9102719	8000	9100407	-4000	4000	2312
chr19	7765605	7773605	7768858	8000	7769605	-4000	4000	-747
chr19	50512892	50520892	50518894	8000	50516892	-4000	4000	2002
chr19	50512892	50520892	50513012	8000	50516892	-4000	4000	-3880
chr19	4286722	4294722	4292735	8000	4290722	-4000	4000	2013
chr19	9184818	9192818	9186511	8000	9188818	-4000	4000	-2307
chr19	13876757	13884757	13880472	8000	13880757	-4000	4000	-285
chr19	13876757	13884757	13880595	8000	13880757	-4000	4000	-162
chr19	14468466	14476466	14472471	8000	14472466	-4000	4000	5
chr19	15946350	15954350	15949224	8000	15950350	-4000	4000	-1126
chr19	44325695	44333695	44328028	8000	44329695	-4000	4000	-1667
chr19	54732632	54740632	54735330	8000	54736632	-4000	4000	-1302
chr19	57127926	57135926	57129960	8000	57131926	-4000	4000	-1966
chr19	58050631	58058631	58052610	8000	58054631	-4000	4000	-2021
chr19	49043638	49051638	49048827	8000	49047638	-4000	4000	1189
chr19	38380267	38388267	38387249	8000	38384267	-4000	4000	2982
chr19	3765089	3773089	3771576	8000	3769089	-4000	4000	2487
chr19	50507600	50515600	50512233	8000	50511600	-4000	4000	633
chr19	54506687	54514687	54510627	8000	54510687	-4000	4000	-60
chr19	57127926	57135926	57129535	8000	57131926	-4000	4000	-2391
chr19	5452856	5460856	5455844	8000	5456856	-4000	4000	-1012
chr19	17812512	17820512	17816833	8000	17816512	-4000	4000	321
chr19	41833074	41841074	41837123	8000	41837074	-4000	4000	49
chr19	7765605	7773605	7767369	8000	7769605	-4000	4000	-2236
chr19	7765605	7773605	7768896	8000	7769605	-4000	4000	-709
chr19	35368962	35376962	35372022	8000	35372962	-4000	4000	-940
chr19	42898086	42906086	42902417	8000	42902086	-4000	4000	331
chr19	55009705	55017705	55014468	8000	55013705	-4000	4000	763
chr19	15725052	15733052	15728526	8000	15729052	-4000	4000	-526
chr19	6422037	6430037	6426434	8000	6426037	-4000	4000	397
chr19	7915097	7923097	7921702	8000	7919097	-4000	4000	2605
chr19	9110828	9118828	9115136	8000	9114828	-4000	4000	308
chr19	9110828	9118828	9115359	8000	9114828	-4000	4000	531
chr19	34586644	34594644	34594241	8000	34590644	-4000	4000	3597
chr19	37880823	37888823	37887592	8000	37884823	-4000	4000	2769
chr19	39504481	39512481	39505505	8000	39508481	-4000	4000	-2976
chr19	39727255	39735255	39731398	8000	39731255	-4000	4000	143
chr19	53012123	53020123	53015356	8000	53016123	-4000	4000	-767
chr19	53789741	53797741	53794004	8000	53793741	-4000	4000	263
chr19	53903652	53911652	53906365	8000	53907652	-4000	4000	-1287
chr19	58393079	58401079	58393442	8000	58397079	-4000	4000	-3637
chr19	9462355	9470355	9467256	8000	9466355	-4000	4000	901
chr19	15800549	15808549	15807964	8000	15804549	-4000	4000	3415
chr19	39294673	39302673	39296861	8000	39298673	-4000	4000	-1812
chr19	43060209	43068209	43066601	8000	43064209	-4000	4000	2392
chr19	48283608	48291608	48286849	8000	48287608	-4000	4000	-759
chr19	48736852	48744852	48743452	8000	48740852	-4000	4000	2600
chr19	49029238	49037238	49032216	8000	49033238	-4000	4000	-1022
chr19	29560551	29568551	29563851	8000	29564551	-4000	4000	-700
chr19	11462240	11470240	11466744	8000	11466240	-4000	4000	504
chr19	39603474	39611474	39605335	8000	39607474	-4000	4000	-2139
chr19	32826509	32834509	32830523	8000	32830509	-4000	4000	14
chr19	50512892	50520892	50517551	8000	50516892	-4000	4000	659
chr19	8058660	8066660	8062307	8000	8062660	-4000	4000	-353
chr19	53257837	53265837	53259135	8000	53261837	-4000	4000	-2702
chr19	55769420	55777420	55772836	8000	55773420	-4000	4000	-584
chr19	35713038	35721038	35719875	8000	35717038	-4000	4000	2837
chr19	15800549	15808549	15807046	8000	15804549	-4000	4000	2497
chr19	15874023	15882023	15878871	8000	15878023	-4000	4000	848
chr19	38380267	38388267	38383420	8000	38384267	-4000	4000	-847
chr19	43188702	43196702	43193262	8000	43192702	-4000	4000	560
chr19	48283608	48291608	48286928	8000	48287608	-4000	4000	-680
chr19	54887420	54895420	54888135	8000	54891420	-4000	4000	-3285
chr19	47839330	47847330	47839731	8000	47843330	-4000	4000	-3599
chr19	9122012	9130012	9126806	8000	9126012	-4000	4000	794
chr19	9248625	9256625	9251985	8000	9252625	-4000	4000	-640
chr19	58050631	58058631	58052507	8000	58054631	-4000	4000	-2124
chr19	10292778	10300778	10293695	8000	10296778	-4000	4000	-3083
chr19	35356489	35364489	35358908	8000	35360489	-4000	4000	-1581
chr19	53262676	53270676	53267366	8000	53266676	-4000	4000	690
chr19	8839340	8847340	8843144	8000	8843340	-4000	4000	-196
chr19	13876757	13884757	13882831	8000	13880757	-4000	4000	2074
chr19	15946350	15954350	15949595	8000	15950350	-4000	4000	-755
chr19	51766531	51774531	51769046	8000	51770531	-4000	4000	-1485
chr19	1776988	1784988	1784856	8000	1780988	-4000	4000	3868
chr19	15800549	15808549	15807421	8000	15804549	-4000	4000	2872
chr19	5452856	5460856	5456387	8000	5456856	-4000	4000	-469
chr19	49735753	49743753	49741934	8000	49739753	-4000	4000	2181
chr19	15725052	15733052	15728156	8000	15729052	-4000	4000	-896
chr19	15946350	15954350	15949392	8000	15950350	-4000	4000	-958
chr19	46227243	46235243	46230157	8000	46231243	-4000	4000	-1086
chr19	42862464	42870464	42867939	8000	42866464	-4000	4000	1475
chr19	55009705	55017705	55014424	8000	55013705	-4000	4000	719
chr19	50512892	50520892	50518396	8000	50516892	-4000	4000	1504
chr19	50791219	50799219	50798190	8000	50795219	-4000	4000	2971
chr19	43414597	43422597	43417927	8000	43418597	-4000	4000	-670
chr19	51384289	51392289	51387201	8000	51388289	-4000	4000	-1088
chr19	39782291	39790291	39784547	8000	39786291	-4000	4000	-1744
chr19	22970883	22978883	22977099	8000	22974883	-4000	4000	2216
chr19	54036825	54044825	54042190	8000	54040825	-4000	4000	1365
chr19	45869797	45877797	45872892	8000	45873797	-4000	4000	-905
chr19	8728160	8736160	8731730	8000	8732160	-4000	4000	-430
chr19	12013888	12021888	12016347	8000	12017888	-4000	4000	-1541
chr19	49018953	49026953	49023993	8000	49022953	-4000	4000	1040
chr19	6422037	6430037	6426292	8000	6426037	-4000	4000	255
chr19	34586644	34594644	34594543	8000	34590644	-4000	4000	3899
chr19	15946350	15954350	15949623	8000	15950350	-4000	4000	-727
chr19	42898086	42906086	42902187	8000	42902086	-4000	4000	101
chr19	50512892	50520892	50518289	8000	50516892	-4000	4000	1397
chr19	44325695	44333695	44327926	8000	44329695	-4000	4000	-1769
chr19	49413990	49421990	49417412	8000	49417990	-4000	4000	-578
chr19	9184818	9192818	9186627	8000	9188818	-4000	4000	-2191
chr19	4169054	4177054	4174721	8000	4173054	-4000	4000	1667
chr19	45145744	45153744	45153085	8000	45149744	-4000	4000	3341
chr19	35349862	35357862	35352158	8000	35353862	-4000	4000	-1704
chr19	39239455	39247455	39244916	8000	39243455	-4000	4000	1461
chr19	39239455	39247455	39243675	8000	39243455	-4000	4000	220
chr19	50512892	50520892	50518351	8000	50516892	-4000	4000	1459
chr19	9462355	9470355	9467089	8000	9466355	-4000	4000	734
chr19	50512892	50520892	50518831	8000	50516892	-4000	4000	1939
chr19	44325695	44333695	44327543	8000	44329695	-4000	4000	-2152
chr19	54810517	54818517	54813928	8000	54814517	-4000	4000	-589
chr19	54810517	54818517	54813929	8000	54814517	-4000	4000	-588
chr19	48025383	48033383	48030242	8000	48029383	-4000	4000	859
chr19	50512892	50520892	50519160	8000	50516892	-4000	4000	2268
chr19	4286722	4294722	4292797	8000	4290722	-4000	4000	2075
chr19	6579183	6587183	6586058	8000	6583183	-4000	4000	2875
chr19	10284522	10292522	10287127	8000	10288522	-4000	4000	-1395
chr19	10284522	10292522	10291220	8000	10288522	-4000	4000	2698
chr19	14836466	14844466	14841838	8000	14840466	-4000	4000	1372
chr19	14938448	14946448	14941640	8000	14942448	-4000	4000	-808
chr19	17812512	17820512	17816719	8000	17816512	-4000	4000	207
chr19	22970883	22978883	22976800	8000	22974883	-4000	4000	1917
chr19	35546031	35554031	35551011	8000	35550031	-4000	4000	980
chr19	35713038	35721038	35716697	8000	35717038	-4000	4000	-341
chr19	35713038	35721038	35720131	8000	35717038	-4000	4000	3093
chr19	36109711	36117711	36115916	8000	36113711	-4000	4000	2205
chr19	41807554	41815554	41810845	8000	41811554	-4000	4000	-709
chr19	42862464	42870464	42866996	8000	42866464	-4000	4000	532
chr19	42920132	42928132	42926715	8000	42924132	-4000	4000	2583
chr19	44325695	44333695	44328153	8000	44329695	-4000	4000	-1542
chr19	46035182	46043182	46040240	8000	46039182	-4000	4000	1058
chr19	48940969	48948969	48942445	8000	48944969	-4000	4000	-2524
chr19	49029238	49037238	49035647	8000	49033238	-4000	4000	2409
chr19	50767732	50775732	50771032	8000	50771732	-4000	4000	-700
chr19	51363098	51371098	51368536	8000	51367098	-4000	4000	1438
chr19	57127926	57135926	57134929	8000	57131926	-4000	4000	3003
chr19	57127926	57135926	57135611	8000	57131926	-4000	4000	3685
chr19	8693400	8701400	8698149	8000	8697400	-4000	4000	749
chr19	53939950	53947950	53941653	8000	53943950	-4000	4000	-2297
chr19	8058660	8066660	8066136	8000	8062660	-4000	4000	3476
chr19	50655255	50663255	50662227	8000	50659255	-4000	4000	2972
chr19	43716021	43724021	43719784	8000	43720021	-4000	4000	-237
chr19	49029238	49037238	49033033	8000	49033238	-4000	4000	-205
chr19	14874203	14882203	14880482	8000	14878203	-4000	4000	2279
chr19	42920132	42928132	42926715	8000	42924132	-4000	4000	2583
chr19	4286722	4294722	4292767	8000	4290722	-4000	4000	2045
chr19	5452856	5460856	5456582	8000	5456856	-4000	4000	-274
chr19	6579183	6587183	6585947	8000	6583183	-4000	4000	2764
chr19	36109711	36117711	36113785	8000	36113711	-4000	4000	74
chr19	57130096	57138096	57136956	8000	57134096	-4000	4000	2860
chr19	14468466	14476466	14469785	8000	14472466	-4000	4000	-2681
chr19	5452856	5460856	5456136	8000	5456856	-4000	4000	-720
chr19	7765605	7773605	7768927	8000	7769605	-4000	4000	-678
chr19	9096407	9104407	9103291	8000	9100407	-4000	4000	2884
chr19	9122012	9130012	9126660	8000	9126012	-4000	4000	648
chr19	9122012	9130012	9126828	8000	9126012	-4000	4000	816
chr19	9462355	9470355	9467306	8000	9466355	-4000	4000	951
chr19	9462355	9470355	9469147	8000	9466355	-4000	4000	2792
chr19	11322996	11330996	11325530	8000	11326996	-4000	4000	-1466
chr19	12013888	12021888	12015962	8000	12017888	-4000	4000	-1926
chr19	12970760	12978760	12973426	8000	12974760	-4000	4000	-1334
chr19	15800549	15808549	15807058	8000	15804549	-4000	4000	2509
chr19	15874023	15882023	15879399	8000	15878023	-4000	4000	1376
chr19	15946350	15954350	15949038	8000	15950350	-4000	4000	-1312
chr19	19260364	19268364	19266592	8000	19264364	-4000	4000	2228
chr19	37880823	37888823	37887559	8000	37884823	-4000	4000	2736
chr19	37880823	37888823	37888317	8000	37884823	-4000	4000	3494
chr19	38380267	38388267	38380973	8000	38384267	-4000	4000	-3294
chr19	39705444	39713444	39707215	8000	39709444	-4000	4000	-2229
chr19	39727255	39735255	39734408	8000	39731255	-4000	4000	3153
chr19	41807554	41815554	41811328	8000	41811554	-4000	4000	-226
chr19	42748686	42756686	42755051	8000	42752686	-4000	4000	2365
chr19	45869797	45877797	45872854	8000	45873797	-4000	4000	-943
chr19	47839330	47847330	47839665	8000	47843330	-4000	4000	-3665
chr19	52448315	52456315	52451633	8000	52452315	-4000	4000	-682
chr19	52448315	52456315	52451829	8000	52452315	-4000	4000	-486
chr19	53633009	53641009	53634590	8000	53637009	-4000	4000	-2419
chr19	54732632	54740632	54735323	8000	54736632	-4000	4000	-1309
chr19	54810517	54818517	54814218	8000	54814517	-4000	4000	-299
chr19	54810517	54818517	54818386	8000	54814517	-4000	4000	3869
chr19	56185570	56193570	56190120	8000	56189570	-4000	4000	550
chr19	57127926	57135926	57135821	8000	57131926	-4000	4000	3895
chr19	7504450	7512450	7505387	8000	7508450	-4000	4000	-3063
chr19	9248625	9256625	9251683	8000	9252625	-4000	4000	-942
chr19	35795988	35803988	35802234	8000	35799988	-4000	4000	2246
chr19	39727255	39735255	39731417	8000	39731255	-4000	4000	162
chr19	49063397	49071397	49070754	8000	49067397	-4000	4000	3357
chr19	53262676	53270676	53267112	8000	53266676	-4000	4000	436
chr19	57150021	57158021	57154332	8000	57154021	-4000	4000	311
chr19	57231548	57239548	57232109	8000	57235548	-4000	4000	-3439
chr19	4286722	4294722	4292528	8000	4290722	-4000	4000	1806
chr19	50767732	50775732	50770705	8000	50771732	-4000	4000	-1027
chr19	3765089	3773089	3765206	8000	3769089	-4000	4000	-3883
chr19	7765605	7773605	7766339	8000	7769605	-4000	4000	-3266
chr19	29560551	29568551	29563897	8000	29564551	-4000	4000	-654
chr19	39705444	39713444	39706003	8000	39709444	-4000	4000	-3441
chr19	47797243	47805243	47801741	8000	47801243	-4000	4000	498
chr19	50876567	50884567	50876725	8000	50880567	-4000	4000	-3842
chr19	9248625	9256625	9251175	8000	9252625	-4000	4000	-1450
chr19	49043638	49051638	49044185	8000	49047638	-4000	4000	-3453
chr19	55308801	55316801	55312980	8000	55312801	-4000	4000	179
chr19	55360382	55368382	55368282	8000	55364382	-4000	4000	3900
chr19	49051793	49059793	49055376	8000	49055793	-4000	4000	-417
chr19	45869797	45877797	45872917	8000	45873797	-4000	4000	-880
chr19	53262676	53270676	53267183	8000	53266676	-4000	4000	507
chr19	15725052	15733052	15728641	8000	15729052	-4000	4000	-411
chr19	54810517	54818517	54814275	8000	54814517	-4000	4000	-242
chr19	55009705	55017705	55015086	8000	55013705	-4000	4000	1381
chr19	41833074	41841074	41838141	8000	41837074	-4000	4000	1067
chr19	40212058	40220058	40215117	8000	40216058	-4000	4000	-941
chr19	44325695	44333695	44327873	8000	44329695	-4000	4000	-1822
chr19	9091669	9099669	9093695	8000	9095669	-4000	4000	-1974
chr19	58393079	58401079	58393159	8000	58397079	-4000	4000	-3920
chr19	45145744	45153744	45145774	8000	45149744	-4000	4000	-3970
chr19	8728160	8736160	8731177	8000	8732160	-4000	4000	-983
chr19	48603714	48611714	48607287	8000	48607714	-4000	4000	-427
chr19	55009705	55017705	55014760	8000	55013705	-4000	4000	1055
chr19	49018953	49026953	49022985	8000	49022953	-4000	4000	32
chr19	51513819	51521819	51520067	8000	51517819	-4000	4000	2248
chr19	4319843	4327843	4327144	8000	4323843	-4000	4000	3301
chr19	9184818	9192818	9186167	8000	9188818	-4000	4000	-2651
chr19	35356489	35364489	35358923	8000	35360489	-4000	4000	-1566
chr19	42862464	42870464	42866821	8000	42866464	-4000	4000	357
chr19	48754333	48762333	48756331	8000	48758333	-4000	4000	-2002
chr19	50876567	50884567	50876759	8000	50880567	-4000	4000	-3808
chr19	57127926	57135926	57130458	8000	57131926	-4000	4000	-1468
chr19	57130096	57138096	57136966	8000	57134096	-4000	4000	2870
chr19	39239455	39247455	39244885	8000	39243455	-4000	4000	1430
chr19	3924082	3932082	3924605	8000	3928082	-4000	4000	-3477
chr19	3924082	3932082	3924733	8000	3928082	-4000	4000	-3349
chr19	3938416	3946416	3941150	8000	3942416	-4000	4000	-1266
chr19	54732632	54740632	54736486	8000	54736632	-4000	4000	-146
chr19	15725052	15733052	15728089	8000	15729052	-4000	4000	-963
chr19	19260364	19268364	19266568	8000	19264364	-4000	4000	2204
chr19	14027551	14035551	14031931	8000	14031551	-4000	4000	380
chr19	54887420	54895420	54888182	8000	54891420	-4000	4000	-3238
chr19	3938416	3946416	3938655	8000	3942416	-4000	4000	-3761
chr19	41807554	41815554	41811346	8000	41811554	-4000	4000	-208
chr19	48372377	48380377	48375636	8000	48376377	-4000	4000	-741
chr19	14468466	14476466	14469391	8000	14472466	-4000	4000	-3075
chr19	43716021	43724021	43719696	8000	43720021	-4000	4000	-325
chr19	41124381	41132381	41124878	8000	41128381	-4000	4000	-3503
chr19	44325695	44333695	44329932	8000	44329695	-4000	4000	237
chr19	8728160	8736160	8731490	8000	8732160	-4000	4000	-670
chr19	58393079	58401079	58393416	8000	58397079	-4000	4000	-3663
chr19	15019276	15027276	15020569	8000	15023276	-4000	4000	-2707
chr19	46629953	46637953	46637555	8000	46633953	-4000	4000	3602
chr19	54826778	54834778	54829981	8000	54830778	-4000	4000	-797
chr19	852247	860247	853386	8000	856247	-4000	4000	-2861
chr19	7765605	7773605	7767571	8000	7769605	-4000	4000	-2034
chr19	14468466	14476466	14472638	8000	14472466	-4000	4000	172
chr19	46116067	46124067	46120096	8000	46120067	-4000	4000	29
chr19	56181775	56189775	56185299	8000	56185775	-4000	4000	-476
chr19	14836466	14844466	14841245	8000	14840466	-4000	4000	779
chr19	35713038	35721038	35716290	8000	35717038	-4000	4000	-748
chr19	5452856	5460856	5456792	8000	5456856	-4000	4000	-64
chr19	42862464	42870464	42868807	8000	42866464	-4000	4000	2343
chr19	42920132	42928132	42926586	8000	42924132	-4000	4000	2454
chr19	55374246	55382246	55377616	8000	55378246	-4000	4000	-630
chr19	35150302	35158302	35153967	8000	35154302	-4000	4000	-335
chr19	57675152	57683152	57679132	8000	57679152	-4000	4000	-20
chr19	45909214	45917214	45914358	8000	45913214	-4000	4000	1144
chr19	50791219	50799219	50793809	8000	50795219	-4000	4000	-1410
chr19	4319843	4327843	4325398	8000	4323843	-4000	4000	1555
chr19	19250756	19258756	19257744	8000	19254756	-4000	4000	2988
chr19	9206276	9214276	9214252	8000	9210276	-4000	4000	3976
chr19	57127926	57135926	57131064	8000	57131926	-4000	4000	-862
chr19	51709112	51717112	51713986	8000	51713112	-4000	4000	874
chr19	8693400	8701400	8697530	8000	8697400	-4000	4000	130
chr19	50512892	50520892	50518697	8000	50516892	-4000	4000	1805
chr19	38797671	38805671	38803431	8000	38801671	-4000	4000	1760
chr19	41903704	41911704	41906622	8000	41907704	-4000	4000	-1082
chr19	35368962	35376962	35371944	8000	35372962	-4000	4000	-1018
chr19	51709112	51717112	51714088	8000	51713112	-4000	4000	976
chr19	8693400	8701400	8697746	8000	8697400	-4000	4000	346
chr19	41615015	41623015	41620613	8000	41619015	-4000	4000	1598
chr19	49371116	49379116	49374809	8000	49375116	-4000	4000	-307
chr19	57127926	57135926	57129873	8000	57131926	-4000	4000	-2053
chr19	54887420	54895420	54889670	8000	54891420	-4000	4000	-1750
chr19	54887420	54895420	54888188	8000	54891420	-4000	4000	-3232
chr19	4319843	4327843	4325449	8000	4323843	-4000	4000	1606
chr19	35220800	35228800	35224889	8000	35224800	-4000	4000	89
chr19	35356489	35364489	35359043	8000	35360489	-4000	4000	-1446
chr19	14027551	14035551	14032392	8000	14031551	-4000	4000	841
chr19	57675152	57683152	57679047	8000	57679152	-4000	4000	-105
chr19	1776988	1784988	1783050	8000	1780988	-4000	4000	2062
chr19	34586644	34594644	34594238	8000	34590644	-4000	4000	3594
chr19	41615015	41623015	41619247	8000	41619015	-4000	4000	232
chr19	46015153	46023153	46018368	8000	46019153	-4000	4000	-785
chr19	19260364	19268364	19260922	8000	19264364	-4000	4000	-3442
chr19	57130096	57138096	57135969	8000	57134096	-4000	4000	1873
chr19	8058660	8066660	8062265	8000	8062660	-4000	4000	-395
chr19	41848333	41856333	41851665	8000	41852333	-4000	4000	-668
chr19	9091669	9099669	9093811	8000	9095669	-4000	4000	-1858
chr19	57231548	57239548	57232225	8000	57235548	-4000	4000	-3323
chr19	54810517	54818517	54813280	8000	54814517	-4000	4000	-1237
chr19	39782291	39790291	39785716	8000	39786291	-4000	4000	-575
chr19	50876567	50884567	50878492	8000	50880567	-4000	4000	-2075
chr19	14608035	14616035	14610075	8000	14612035	-4000	4000	-1960
chr19	53257837	53265837	53258617	8000	53261837	-4000	4000	-3220
chr19	57675152	57683152	57678826	8000	57679152	-4000	4000	-326
chr19	50821289	50829289	50825431	8000	50825289	-4000	4000	142
chr19	3765089	3773089	3771700	8000	3769089	-4000	4000	2611
chr19	4319843	4327843	4323052	8000	4323843	-4000	4000	-791
chr19	17891174	17899174	17893822	8000	17895174	-4000	4000	-1352
chr19	4319843	4327843	4327203	8000	4323843	-4000	4000	3360
chr19	13876757	13884757	13877421	8000	13880757	-4000	4000	-3336
chr19	35546031	35554031	35547162	8000	35550031	-4000	4000	-2869
chr19	42748686	42756686	42754398	8000	42752686	-4000	4000	1712
chr19	49029238	49037238	49032962	8000	49033238	-4000	4000	-276
chr19	55781397	55789397	55785763	8000	55785397	-4000	4000	366
chr19	50767732	50775732	50771389	8000	50771732	-4000	4000	-343
chr19	39239455	39247455	39243695	8000	39243455	-4000	4000	240
chr19	9248625	9256625	9251136	8000	9252625	-4000	4000	-1489
chr19	12970760	12978760	12973539	8000	12974760	-4000	4000	-1221
chr19	4286722	4294722	4294616	8000	4290722	-4000	4000	3894
chr20	45882491	45890491	45884746	8000	45886491	-4000	4000	-1745
chr20	1974757	1982757	1980564	8000	1978757	-4000	4000	1807
chr20	3041747	3049747	3047834	8000	3045747	-4000	4000	2087
chr20	45205768	45213768	45207553	8000	45209768	-4000	4000	-2215
chr20	57491966	57499966	57498671	8000	57495966	-4000	4000	2705
chr20	9533370	9541370	9539528	8000	9537370	-4000	4000	2158
chr20	33661619	33669619	33662224	8000	33665619	-4000	4000	-3395
chr20	63552695	63560695	63556112	8000	63556695	-4000	4000	-583
chr20	33040047	33048047	33043319	8000	33044047	-4000	4000	-728
chr20	56245815	56253815	56249510	8000	56249815	-4000	4000	-305
chr20	23492010	23500010	23495893	8000	23496010	-4000	4000	-117
chr20	23035237	23043237	23035861	8000	23039237	-4000	4000	-3376
chr20	38725372	38733372	38728381	8000	38729372	-4000	4000	-991
chr20	23035237	23043237	23035855	8000	23039237	-4000	4000	-3382
chr20	56245815	56253815	56248792	8000	56249815	-4000	4000	-1023
chr20	45087214	45095214	45094840	8000	45091214	-4000	4000	3626
chr20	45105452	45113452	45109754	8000	45109452	-4000	4000	302
chr20	45704817	45712817	45705019	8000	45708817	-4000	4000	-3798
chr20	1974757	1982757	1980906	8000	1978757	-4000	4000	2149
chr20	23035237	23043237	23036296	8000	23039237	-4000	4000	-2941
chr20	45603939	45611939	45608001	8000	45607939	-4000	4000	62
chr20	63552695	63560695	63556336	8000	63556695	-4000	4000	-359
chr20	56245815	56253815	56249513	8000	56249815	-4000	4000	-302
chr20	21714481	21722481	21714863	8000	21718481	-4000	4000	-3618
chr20	35281731	35289731	35288496	8000	35285731	-4000	4000	2765
chr20	45530196	45538196	45534322	8000	45534196	-4000	4000	126
chr20	45530196	45538196	45534432	8000	45534196	-4000	4000	236
chr20	1974757	1982757	1980878	8000	1978757	-4000	4000	2121
chr20	31400845	31408845	31406103	8000	31404845	-4000	4000	1258
chr20	32979773	32987773	32985813	8000	32983773	-4000	4000	2040
chr20	9533370	9541370	9539472	8000	9537370	-4000	4000	2102
chr20	23035237	23043237	23035882	8000	23039237	-4000	4000	-3355
chr20	23035237	23043237	23036559	8000	23039237	-4000	4000	-2678
chr20	35281731	35289731	35287815	8000	35285731	-4000	4000	2084
chr20	45220458	45228458	45222256	8000	45224458	-4000	4000	-2202
chr20	45882491	45890491	45883463	8000	45886491	-4000	4000	-3028
chr20	45882491	45890491	45890324	8000	45886491	-4000	4000	3833
chr20	44347238	44355238	44350981	8000	44351238	-4000	4000	-257
chr20	63552695	63560695	63556383	8000	63556695	-4000	4000	-312
chr20	45603939	45611939	45610202	8000	45607939	-4000	4000	2263
chr20	45644563	45652563	45650556	8000	45648563	-4000	4000	1993
chr20	46536946	46544946	46541251	8000	46540946	-4000	4000	305
chr20	5295218	5303218	5302681	8000	5299218	-4000	4000	3463
chr20	2428753	2436753	2432511	8000	2432753	-4000	4000	-242
chr20	31830689	31838689	31834263	8000	31834689	-4000	4000	-426
chr20	23492010	23500010	23493000	8000	23496010	-4000	4000	-3010
chr20	183853	191853	189585	8000	187853	-4000	4000	1732
chr20	23981050	23989050	23985775	8000	23985050	-4000	4000	725
chr20	45882491	45890491	45887139	8000	45886491	-4000	4000	648
chr20	155163	163163	158816	8000	159163	-4000	4000	-347
chr20	55993357	56001357	55998690	8000	55997357	-4000	4000	1333
chr20	22576998	22584998	22582278	8000	22580998	-4000	4000	1280
chr20	31299212	31307212	31303210	8000	31303212	-4000	4000	-2
chr20	93094	101094	96376	8000	97094	-4000	4000	-718
chr20	23035237	23043237	23036565	8000	23039237	-4000	4000	-2672
chr20	9533370	9541370	9538950	8000	9537370	-4000	4000	1580
chr20	45220458	45228458	45222429	8000	45224458	-4000	4000	-2029
chr20	257096	265096	259145	8000	261096	-4000	4000	-1951
chr20	45205768	45213768	45208250	8000	45209768	-4000	4000	-1518
chr20	45680651	45688651	45684889	8000	45684651	-4000	4000	238
chr20	93094	101094	96286	8000	97094	-4000	4000	-808
chr20	31299212	31307212	31303229	8000	31303212	-4000	4000	17
chr20	33661619	33669619	33668502	8000	33665619	-4000	4000	2883
chr20	225886	233886	229545	8000	229886	-4000	4000	-341
chr20	45220458	45228458	45222605	8000	45224458	-4000	4000	-1853
chr20	4216630	4224630	4221582	8000	4220630	-4000	4000	952
chr20	43722164	43730164	43726271	8000	43726164	-4000	4000	107
chr20	43722164	43730164	43726272	8000	43726164	-4000	4000	108
chr20	45882491	45890491	45882787	8000	45886491	-4000	4000	-3704
chr20	63552695	63560695	63555702	8000	63556695	-4000	4000	-993
chr20	6036546	6044546	6037204	8000	6040546	-4000	4000	-3342
chr20	45313824	45321824	45314033	8000	45317824	-4000	4000	-3791
chr20	45508461	45516461	45512752	8000	45512461	-4000	4000	291
chr20	17731871	17739871	17735837	8000	17735871	-4000	4000	-34
chr20	62210960	62218960	62216791	8000	62214960	-4000	4000	1831
chr20	45220458	45228458	45222255	8000	45224458	-4000	4000	-2203
chr20	22576998	22584998	22584221	8000	22580998	-4000	4000	3223
chr20	45508461	45516461	45512674	8000	45512461	-4000	4000	213
chr20	9533370	9541370	9539233	8000	9537370	-4000	4000	1863
chr20	1974757	1982757	1980572	8000	1978757	-4000	4000	1815
chr20	31369923	31377923	31372909	8000	31373923	-4000	4000	-1014
chr20	23035237	23043237	23036504	8000	23039237	-4000	4000	-2733
chr20	4216630	4224630	4221322	8000	4220630	-4000	4000	692
chr20	62210960	62218960	62215939	8000	62214960	-4000	4000	979
chr20	45105452	45113452	45110659	8000	45109452	-4000	4000	1207
chr20	45220458	45228458	45222507	8000	45224458	-4000	4000	-1951
chr20	31830689	31838689	31832071	8000	31834689	-4000	4000	-2618
chr20	45530196	45538196	45538084	8000	45534196	-4000	4000	3888
chr20	56245815	56253815	56249092	8000	56249815	-4000	4000	-723
chr20	183853	191853	188002	8000	187853	-4000	4000	149
chr20	4216630	4224630	4221895	8000	4220630	-4000	4000	1265
chr20	64099802	64107802	64106702	8000	64103802	-4000	4000	2900
chr20	62210960	62218960	62216210	8000	62214960	-4000	4000	1250
chr20	32979773	32987773	32985165	8000	32983773	-4000	4000	1392
chr20	33223806	33231806	33226430	8000	33227806	-4000	4000	-1376
chr20	33069628	33077628	33072782	8000	33073628	-4000	4000	-846
chr20	33177412	33185412	33178162	8000	33181412	-4000	4000	-3250
chr20	7878985	7886985	7883480	8000	7882985	-4000	4000	495
chr20	35281731	35289731	35287365	8000	35285731	-4000	4000	1634
chr20	35281731	35289731	35288800	8000	35285731	-4000	4000	3069
chr20	35281731	35289731	35287423	8000	35285731	-4000	4000	1692
chr20	31830689	31838689	31834458	8000	31834689	-4000	4000	-231
chr20	93094	101094	96033	8000	97094	-4000	4000	-1061
chr20	93094	101094	96151	8000	97094	-4000	4000	-943
chr20	7878985	7886985	7885727	8000	7882985	-4000	4000	2742
chr20	33107751	33115751	33111444	8000	33111751	-4000	4000	-307
chr20	31255632	31263632	31259577	8000	31259632	-4000	4000	-55
chr20	3041747	3049747	3046428	8000	3045747	-4000	4000	681
chr20	23035237	23043237	23036455	8000	23039237	-4000	4000	-2782
chr20	23440930	23448930	23444038	8000	23444930	-4000	4000	-892
chr20	63339223	63347223	63346719	8000	63343223	-4000	4000	3496
chr20	45205768	45213768	45207509	8000	45209768	-4000	4000	-2259
chr20	5295218	5303218	5302254	8000	5299218	-4000	4000	3036
chr20	35281731	35289731	35287069	8000	35285731	-4000	4000	1338
chr20	22576998	22584998	22582687	8000	22580998	-4000	4000	1689
chr20	45105452	45113452	45110694	8000	45109452	-4000	4000	1242
chr20	23440930	23448930	23444862	8000	23444930	-4000	4000	-68
chr20	45313824	45321824	45314449	8000	45317824	-4000	4000	-3375
chr20	44276947	44284947	44279036	8000	44280947	-4000	4000	-1911
chr20	2639580	2647580	2641498	8000	2643580	-4000	4000	-2082
chr20	23035237	23043237	23035606	8000	23039237	-4000	4000	-3631
chr20	45205768	45213768	45208485	8000	45209768	-4000	4000	-1283
chr20	45882491	45890491	45883686	8000	45886491	-4000	4000	-2805
chr20	32957845	32965845	32958461	8000	32961845	-4000	4000	-3384
chr20	1974757	1982757	1980666	8000	1978757	-4000	4000	1909
chr20	23035237	23043237	23036203	8000	23039237	-4000	4000	-3034
chr20	7878985	7886985	7883656	8000	7882985	-4000	4000	671
chr20	225886	233886	229846	8000	229886	-4000	4000	-40
chr20	2428753	2436753	2432652	8000	2432753	-4000	4000	-101
chr20	2639580	2647580	2641233	8000	2643580	-4000	4000	-2347
chr20	23981050	23989050	23986097	8000	23985050	-4000	4000	1047
chr20	32979773	32987773	32985870	8000	32983773	-4000	4000	2097
chr20	43722164	43730164	43726434	8000	43726164	-4000	4000	270
chr20	45119425	45127425	45124168	8000	45123425	-4000	4000	743
chr20	45819214	45827214	45824386	8000	45823214	-4000	4000	1172
chr20	56245815	56253815	56248970	8000	56249815	-4000	4000	-845
chr20	57491966	57499966	57498606	8000	57495966	-4000	4000	2640
chr20	62210960	62218960	62216651	8000	62214960	-4000	4000	1691
chr20	45547153	45555153	45552040	8000	45551153	-4000	4000	887
chr20	46536946	46544946	46541760	8000	46540946	-4000	4000	814
chr20	6036546	6044546	6037141	8000	6040546	-4000	4000	-3405
chr20	56245815	56253815	56249272	8000	56249815	-4000	4000	-543
chr20	225886	233886	229804	8000	229886	-4000	4000	-82
chr20	5295218	5303218	5302414	8000	5299218	-4000	4000	3196
chr20	7878985	7886985	7883656	8000	7882985	-4000	4000	671
chr20	23446403	23454403	23450561	8000	23450403	-4000	4000	158
chr20	31373164	31381164	31377181	8000	31377164	-4000	4000	17
chr20	31830689	31838689	31833769	8000	31834689	-4000	4000	-920
chr20	33040047	33048047	33042851	8000	33044047	-4000	4000	-1196
chr20	33223806	33231806	33223818	8000	33227806	-4000	4000	-3988
chr20	33223806	33231806	33227555	8000	33227806	-4000	4000	-251
chr20	38725372	38733372	38728081	8000	38729372	-4000	4000	-1291
chr20	45119425	45127425	45124432	8000	45123425	-4000	4000	1007
chr20	45220458	45228458	45222031	8000	45224458	-4000	4000	-2427
chr20	45220458	45228458	45222307	8000	45224458	-4000	4000	-2151
chr20	45313824	45321824	45316694	8000	45317824	-4000	4000	-1130
chr20	46536946	46544946	46541623	8000	46540946	-4000	4000	677
chr20	63552695	63560695	63560476	8000	63556695	-4000	4000	3781
chr20	56245815	56253815	56249160	8000	56249815	-4000	4000	-655
chr20	45087214	45095214	45095057	8000	45091214	-4000	4000	3843
chr20	57491966	57499966	57498431	8000	57495966	-4000	4000	2465
chr20	63236784	63244784	63239573	8000	63240784	-4000	4000	-1211
chr20	31373164	31381164	31373181	8000	31377164	-4000	4000	-3983
chr20	32979773	32987773	32985744	8000	32983773	-4000	4000	1971
chr20	23035237	23043237	23035829	8000	23039237	-4000	4000	-3408
chr20	23035237	23043237	23035830	8000	23039237	-4000	4000	-3407
chr20	31446257	31454257	31450078	8000	31450257	-4000	4000	-179
chr20	62210960	62218960	62216531	8000	62214960	-4000	4000	1571
chr20	18810378	18818378	18813920	8000	18814378	-4000	4000	-458
chr20	56245815	56253815	56249535	8000	56249815	-4000	4000	-280
chr20	38725372	38733372	38727676	8000	38729372	-4000	4000	-1696
chr20	23981050	23989050	23985743	8000	23985050	-4000	4000	693
chr20	63236784	63244784	63237962	8000	63240784	-4000	4000	-2822
chr20	56245815	56253815	56248731	8000	56249815	-4000	4000	-1084
chr20	45205768	45213768	45208366	8000	45209768	-4000	4000	-1402
chr20	18810378	18818378	18814237	8000	18814378	-4000	4000	-141
chr20	45220458	45228458	45222503	8000	45224458	-4000	4000	-1955
chr20	13845247	13853247	13849606	8000	13849247	-4000	4000	359
chr20	865900	873900	872997	8000	869900	-4000	4000	3097
chr20	35281731	35289731	35287340	8000	35285731	-4000	4000	1609
chr20	45819214	45827214	45824333	8000	45823214	-4000	4000	1119
chr20	45220458	45228458	45222257	8000	45224458	-4000	4000	-2201
chr20	22576998	22584998	22581719	8000	22580998	-4000	4000	721
chr20	6036546	6044546	6041018	8000	6040546	-4000	4000	472
chr20	45220458	45228458	45223250	8000	45224458	-4000	4000	-1208
chr20	64099802	64107802	64106554	8000	64103802	-4000	4000	2752
chr20	45105452	45113452	45110769	8000	45109452	-4000	4000	1317
chr20	22576998	22584998	22584375	8000	22580998	-4000	4000	3377
chr20	1974757	1982757	1980526	8000	1978757	-4000	4000	1769
chr20	31373164	31381164	31373290	8000	31377164	-4000	4000	-3874
chr20	9533370	9541370	9538482	8000	9537370	-4000	4000	1112
chr20	9533370	9541370	9539362	8000	9537370	-4000	4000	1992
chr21	18265116	18273116	18270006	8000	18269116	-4000	4000	890
chr21	33068413	33076413	33071821	8000	33072413	-4000	4000	-592
chr21	30427026	30435026	30430388	8000	30431026	-4000	4000	-638
chr21	44571371	44579371	44574142	8000	44575371	-4000	4000	-1229
chr21	34367381	34375381	34371084	8000	34371381	-4000	4000	-297
chr21	18265116	18273116	18266662	8000	18269116	-4000	4000	-2454
chr21	44608954	44616954	44612891	8000	44612954	-4000	4000	-63
chr21	42342357	42350357	42349915	8000	42346357	-4000	4000	3558
chr21	44294648	44302648	44297702	8000	44298648	-4000	4000	-946
chr21	44598174	44606174	44600975	8000	44602174	-4000	4000	-1199
chr21	30609431	30617431	30613824	8000	30613431	-4000	4000	393
chr21	44624378	44632378	44627430	8000	44628378	-4000	4000	-948
chr21	44624378	44632378	44628025	8000	44628378	-4000	4000	-353
chr21	30876644	30884644	30881105	8000	30880644	-4000	4000	461
chr21	30421265	30429265	30425490	8000	30425265	-4000	4000	225
chr21	44598174	44606174	44600992	8000	44602174	-4000	4000	-1182
chr21	30285145	30293145	30289344	8000	30289145	-4000	4000	199
chr21	10602140	10610140	10605436	8000	10606140	-4000	4000	-704
chr21	44654341	44662341	44658197	8000	44658341	-4000	4000	-144
chr21	44571371	44579371	44574615	8000	44575371	-4000	4000	-756
chr21	44634455	44642455	44638353	8000	44638455	-4000	4000	-102
chr21	44608954	44616954	44612340	8000	44612954	-4000	4000	-614
chr21	36456621	36464621	36461248	8000	36460621	-4000	4000	627
chr21	44624378	44632378	44627267	8000	44628378	-4000	4000	-1111
chr21	30639136	30647136	30642896	8000	30643136	-4000	4000	-240
chr21	30161565	30169565	30165980	8000	30165565	-4000	4000	415
chr21	33068413	33076413	33072127	8000	33072413	-4000	4000	-286
chr21	10602140	10610140	10605422	8000	10606140	-4000	4000	-718
chr21	31034159	31042159	31038185	8000	31038159	-4000	4000	26
chr21	30475706	30483706	30480208	8000	30479706	-4000	4000	502
chr21	44643650	44651650	44646677	8000	44647650	-4000	4000	-973
chr21	30367390	30375390	30371515	8000	30371390	-4000	4000	125
chr21	30589075	30597075	30592692	8000	30593075	-4000	4000	-383
chr21	46132160	46140160	46132526	8000	46136160	-4000	4000	-3634
chr21	30427026	30435026	30430418	8000	30431026	-4000	4000	-608
chr21	44608954	44616954	44612111	8000	44612954	-4000	4000	-843
chr21	42342357	42350357	42347619	8000	42346357	-4000	4000	1262
chr21	44608954	44616954	44612943	8000	44612954	-4000	4000	-11
chr21	30609431	30617431	30616609	8000	30613431	-4000	4000	3178
chr21	30483043	30491043	30487315	8000	30487043	-4000	4000	272
chr21	44598174	44606174	44600974	8000	44602174	-4000	4000	-1200
chr21	30492824	30500824	30497014	8000	30496824	-4000	4000	190
chr21	30639136	30647136	30642924	8000	30643136	-4000	4000	-212
chr21	44598174	44606174	44600960	8000	44602174	-4000	4000	-1214
chr21	44598174	44606174	44601370	8000	44602174	-4000	4000	-804
chr21	40006999	40014999	40012778	8000	40010999	-4000	4000	1779
chr21	44493893	44501893	44499788	8000	44497893	-4000	4000	1895
chr21	30421265	30429265	30425423	8000	30425265	-4000	4000	158
chr21	30631619	30639619	30635278	8000	30635619	-4000	4000	-341
chr21	30436869	30444869	30440581	8000	30440869	-4000	4000	-288
chr21	30161565	30169565	30166042	8000	30165565	-4000	4000	477
chr21	30333013	30341013	30337154	8000	30337013	-4000	4000	141
chr21	44571371	44579371	44573979	8000	44575371	-4000	4000	-1392
chr21	30161565	30169565	30166519	8000	30165565	-4000	4000	954
chr21	30537535	30545535	30541664	8000	30541535	-4000	4000	129
chr21	30161565	30169565	30166025	8000	30165565	-4000	4000	460
chr21	30367390	30375390	30371906	8000	30371390	-4000	4000	516
chr21	30616850	30624850	30620842	8000	30620850	-4000	4000	-8
chr21	44654341	44662341	44657973	8000	44658341	-4000	4000	-368
chr21	30751015	30759015	30755158	8000	30755015	-4000	4000	143
chr21	30808697	30816697	30813037	8000	30812697	-4000	4000	340
chr21	44624378	44632378	44627243	8000	44628378	-4000	4000	-1135
chr21	46132160	46140160	46132489	8000	46136160	-4000	4000	-3671
chr21	30333013	30341013	30337362	8000	30337013	-4000	4000	349
chr21	44571371	44579371	44573900	8000	44575371	-4000	4000	-1471
chr21	30285145	30293145	30289397	8000	30289145	-4000	4000	252
chr21	44643650	44651650	44646753	8000	44647650	-4000	4000	-897
chr21	30161565	30169565	30166436	8000	30165565	-4000	4000	871
chr21	44571371	44579371	44573890	8000	44575371	-4000	4000	-1481
chr21	44643650	44651650	44646828	8000	44647650	-4000	4000	-822
chr21	30492824	30500824	30496902	8000	30496824	-4000	4000	78
chr21	34367381	34375381	34370769	8000	34371381	-4000	4000	-612
chr21	30277309	30285309	30281996	8000	30281309	-4000	4000	687
chr21	30808697	30816697	30812925	8000	30812697	-4000	4000	228
chr21	44654341	44662341	44658308	8000	44658341	-4000	4000	-33
chr21	30436869	30444869	30440535	8000	30440869	-4000	4000	-334
chr21	44624378	44632378	44627539	8000	44628378	-4000	4000	-839
chr21	44654341	44662341	44658061	8000	44658341	-4000	4000	-280
chr21	34367381	34375381	34370618	8000	34371381	-4000	4000	-763
chr21	44643650	44651650	44647256	8000	44647650	-4000	4000	-394
chr21	44608954	44616954	44612076	8000	44612954	-4000	4000	-878
chr21	30277309	30285309	30282244	8000	30281309	-4000	4000	935
chr21	30277309	30285309	30282841	8000	30281309	-4000	4000	1532
chr21	32786673	32794673	32794338	8000	32790673	-4000	4000	3665
chr21	44634455	44642455	44637592	8000	44638455	-4000	4000	-863
chr21	30427026	30435026	30430620	8000	30431026	-4000	4000	-406
chr21	30751015	30759015	30755185	8000	30755015	-4000	4000	170
chr21	30609431	30617431	30613874	8000	30613431	-4000	4000	443
chr21	30344399	30352399	30348539	8000	30348399	-4000	4000	140
chr21	42912803	42920803	42919018	8000	42916803	-4000	4000	2215
chr21	30589075	30597075	30592559	8000	30593075	-4000	4000	-516
chr21	44694044	44702044	44697676	8000	44698044	-4000	4000	-368
chr21	44571371	44579371	44573858	8000	44575371	-4000	4000	-1513
chr21	44598174	44606174	44600675	8000	44602174	-4000	4000	-1499
chr21	30315124	30323124	30319964	8000	30319124	-4000	4000	840
chr21	44624378	44632378	44627668	8000	44628378	-4000	4000	-710
chr21	30537535	30545535	30541779	8000	30541535	-4000	4000	244
chr21	46132160	46140160	46132343	8000	46136160	-4000	4000	-3817
chr21	30537535	30545535	30541773	8000	30541535	-4000	4000	238
chr21	30631619	30639619	30635310	8000	30635619	-4000	4000	-309
chr21	39798081	39806081	39801333	8000	39802081	-4000	4000	-748
chr21	30589075	30597075	30592908	8000	30593075	-4000	4000	-167
chr21	44643650	44651650	44647252	8000	44647650	-4000	4000	-398
chr21	30421265	30429265	30425751	8000	30425265	-4000	4000	486
chr21	30609431	30617431	30613720	8000	30613431	-4000	4000	289
chr21	44643650	44651650	44646833	8000	44647650	-4000	4000	-817
chr21	30475706	30483706	30480066	8000	30479706	-4000	4000	360
chr21	30631619	30639619	30635326	8000	30635619	-4000	4000	-293
chr21	30277309	30285309	30282883	8000	30281309	-4000	4000	1574
chr21	30483043	30491043	30487349	8000	30487043	-4000	4000	306
chr21	46132160	46140160	46137061	8000	46136160	-4000	4000	901
chr21	30742794	30750794	30747039	8000	30746794	-4000	4000	245
chr22	38422327	38430327	38426830	8000	38426327	-4000	4000	503
chr22	22241515	22249515	22244957	8000	22245515	-4000	4000	-558
chr22	15717631	15725631	15721318	8000	15721631	-4000	4000	-313
chr22	16586751	16594751	16591644	8000	16590751	-4000	4000	893
chr22	46251663	46259663	46256975	8000	46255663	-4000	4000	1312
chr22	29438455	29446455	29438904	8000	29442455	-4000	4000	-3551
chr22	21024013	21032013	21030916	8000	21028013	-4000	4000	2903
chr22	37200237	37208237	37207591	8000	37204237	-4000	4000	3354
chr22	39739044	39747044	39744256	8000	39743044	-4000	4000	1212
chr22	37200237	37208237	37206789	8000	37204237	-4000	4000	2552
chr22	50157690	50165690	50158238	8000	50161690	-4000	4000	-3452
chr22	23761863	23769863	23766230	8000	23765863	-4000	4000	367
chr22	37200237	37208237	37207566	8000	37204237	-4000	4000	3329
chr22	15525139	15533139	15529076	8000	15529139	-4000	4000	-63
chr22	29054672	29062672	29059045	8000	29058672	-4000	4000	373
chr22	32145006	32153006	32149547	8000	32149006	-4000	4000	541
chr22	46251663	46259663	46258282	8000	46255663	-4000	4000	2619
chr22	16779412	16787412	16783806	8000	16783412	-4000	4000	394
chr22	16957936	16965936	16962709	8000	16961936	-4000	4000	773
chr22	32214464	32222464	32218529	8000	32218464	-4000	4000	65
chr22	50157690	50165690	50158248	8000	50161690	-4000	4000	-3442
chr22	46251663	46259663	46256488	8000	46255663	-4000	4000	825
chr22	35725483	35733483	35726845	8000	35729483	-4000	4000	-2638
chr22	15717631	15725631	15721600	8000	15721631	-4000	4000	-31
chr22	29308933	29316933	29310923	8000	29312933	-4000	4000	-2010
chr22	22241515	22249515	22245046	8000	22245515	-4000	4000	-469
chr22	22509736	22517736	22515607	8000	22513736	-4000	4000	1871
chr22	16779412	16787412	16784269	8000	16783412	-4000	4000	857
chr22	30173075	30181075	30176733	8000	30177075	-4000	4000	-342
chr22	32186435	32194435	32190649	8000	32190435	-4000	4000	214
chr22	20783720	20791720	20784206	8000	20787720	-4000	4000	-3514
chr22	15717631	15725631	15721600	8000	15721631	-4000	4000	-31
chr22	16957936	16965936	16965219	8000	16961936	-4000	4000	3283
chr22	29438455	29446455	29441635	8000	29442455	-4000	4000	-820
chr22	50741339	50749339	50744785	8000	50745339	-4000	4000	-554
chr22	35725483	35733483	35726754	8000	35729483	-4000	4000	-2729
chr22	15717631	15725631	15721486	8000	15721631	-4000	4000	-145
chr22	39739044	39747044	39743924	8000	39743044	-4000	4000	880
chr22	18601815	18609815	18608921	8000	18605815	-4000	4000	3106
chr22	36556857	36564857	36564640	8000	36560857	-4000	4000	3783
chr22	36987120	36995120	36991532	8000	36991120	-4000	4000	412
chr22	21024013	21032013	21031419	8000	21028013	-4000	4000	3406
chr22	35083387	35091387	35084382	8000	35087387	-4000	4000	-3005
chr22	16586751	16594751	16590990	8000	16590751	-4000	4000	239
chr22	15525139	15533139	15529031	8000	15529139	-4000	4000	-108
chr22	20783720	20791720	20786905	8000	20787720	-4000	4000	-815
chr22	32145006	32153006	32152597	8000	32149006	-4000	4000	3591
chr22	32214464	32222464	32221000	8000	32218464	-4000	4000	2536
chr22	16957936	16965936	16962574	8000	16961936	-4000	4000	638
chr22	46251663	46259663	46257442	8000	46255663	-4000	4000	1779
chr22	20783720	20791720	20786127	8000	20787720	-4000	4000	-1593
chr22	32409845	32417845	32414315	8000	32413845	-4000	4000	470
chr22	38514948	38522948	38519809	8000	38518948	-4000	4000	861
chr22	29438455	29446455	29439429	8000	29442455	-4000	4000	-3026
chr22	21024013	21032013	21026485	8000	21028013	-4000	4000	-1528
chr22	38422327	38430327	38427624	8000	38426327	-4000	4000	1297
chr22	18601815	18609815	18607415	8000	18605815	-4000	4000	1600
chr22	29438455	29446455	29441228	8000	29442455	-4000	4000	-1227
chr22	30484902	30492902	30489867	8000	30488902	-4000	4000	965
chr22	30550635	30558635	30555642	8000	30554635	-4000	4000	1007
chr22	15717631	15725631	15721436	8000	15721631	-4000	4000	-195
chr22	18601815	18609815	18608217	8000	18605815	-4000	4000	2402
chr22	38074134	38082134	38078556	8000	38078134	-4000	4000	422
chr22	29438455	29446455	29441851	8000	29442455	-4000	4000	-604
chr22	24715034	24723034	24719568	8000	24719034	-4000	4000	534
chr22	20144416	20152416	20145292	8000	20148416	-4000	4000	-3124
chr22	29054672	29062672	29061861	8000	29058672	-4000	4000	3189
chr22	32186435	32194435	32191211	8000	32190435	-4000	4000	776
chr22	32357161	32365161	32358250	8000	32361161	-4000	4000	-2911
chr22	22509736	22517736	22513792	8000	22513736	-4000	4000	56
chr22	21633329	21641329	21636597	8000	21637329	-4000	4000	-732
chr22	38422327	38430327	38427437	8000	38426327	-4000	4000	1110
chr22	16957936	16965936	16962616	8000	16961936	-4000	4000	680
chr22	21633329	21641329	21635084	8000	21637329	-4000	4000	-2245
chr22	22509736	22517736	22514839	8000	22513736	-4000	4000	1103
chr22	29438455	29446455	29438694	8000	29442455	-4000	4000	-3761
chr22	37200237	37208237	37207471	8000	37204237	-4000	4000	3234
chr22	39739044	39747044	39743763	8000	39743044	-4000	4000	719
chr22	46251663	46259663	46256470	8000	46255663	-4000	4000	807
chr22	46251663	46259663	46258469	8000	46255663	-4000	4000	2806
chr22	46251663	46259663	46259293	8000	46255663	-4000	4000	3630
chr22	50547112	50555112	50548338	8000	50551112	-4000	4000	-2774
chr22	15717631	15725631	15721449	8000	15721631	-4000	4000	-182
chr22	50547112	50555112	50549498	8000	50551112	-4000	4000	-1614
chr22	32186435	32194435	32193102	8000	32190435	-4000	4000	2667
chr22	16586751	16594751	16590928	8000	16590751	-4000	4000	177
chr22	21024013	21032013	21031059	8000	21028013	-4000	4000	3046
chr22	21024013	21032013	21031498	8000	21028013	-4000	4000	3485
chr22	22509736	22517736	22514368	8000	22513736	-4000	4000	632
chr22	22509736	22517736	22515172	8000	22513736	-4000	4000	1436
chr22	23569125	23577125	23573140	8000	23573125	-4000	4000	15
chr22	32409845	32417845	32417127	8000	32413845	-4000	4000	3282
chr22	39739044	39747044	39743628	8000	39743044	-4000	4000	584
chr22	39739044	39747044	39743868	8000	39743044	-4000	4000	824
chr22	46251663	46259663	46258165	8000	46255663	-4000	4000	2502
chr22	46251663	46259663	46259249	8000	46255663	-4000	4000	3586
chr22	46251663	46259663	46259347	8000	46255663	-4000	4000	3684
chr22	46251663	46259663	46259613	8000	46255663	-4000	4000	3950
chr22	26626669	26634669	26630359	8000	26630669	-4000	4000	-310
chr22	46251663	46259663	46256658	8000	46255663	-4000	4000	995
chr22	46251663	46259663	46256659	8000	46255663	-4000	4000	996
chr22	50157690	50165690	50161365	8000	50161690	-4000	4000	-325
chr22	18601815	18609815	18608013	8000	18605815	-4000	4000	2198
chr22	29438455	29446455	29441470	8000	29442455	-4000	4000	-985
chr22	32186435	32194435	32191170	8000	32190435	-4000	4000	735
chr22	46251663	46259663	46258823	8000	46255663	-4000	4000	3160
chr22	18601815	18609815	18608209	8000	18605815	-4000	4000	2394
chr22	15525139	15533139	15528924	8000	15529139	-4000	4000	-215
chr22	35083387	35091387	35085827	8000	35087387	-4000	4000	-1560
chr22	46251663	46259663	46257123	8000	46255663	-4000	4000	1460
chr22	46251663	46259663	46258304	8000	46255663	-4000	4000	2641
chr22	23748743	23756743	23754401	8000	23752743	-4000	4000	1658
chr22	32186435	32194435	32192962	8000	32190435	-4000	4000	2527
chr22	29308933	29316933	29310540	8000	29312933	-4000	4000	-2393
chr22	46251663	46259663	46259095	8000	46255663	-4000	4000	3432
chr22	46251663	46259663	46257544	8000	46255663	-4000	4000	1881
chr22	46251663	46259663	46259119	8000	46255663	-4000	4000	3456
chr22	19142993	19150993	19148992	8000	19146993	-4000	4000	1999
chr22	29438455	29446455	29438528	8000	29442455	-4000	4000	-3927
chr22	32357161	32365161	32358325	8000	32361161	-4000	4000	-2836
chr22	15525139	15533139	15528966	8000	15529139	-4000	4000	-173
chr22	30550635	30558635	30555023	8000	30554635	-4000	4000	388
chr22	32357161	32365161	32360359	8000	32361161	-4000	4000	-802
chr22	20144416	20152416	20146136	8000	20148416	-4000	4000	-2280
chr22	23748743	23756743	23754327	8000	23752743	-4000	4000	1584
chr22	32186435	32194435	32193041	8000	32190435	-4000	4000	2606
chr22	29438455	29446455	29439025	8000	29442455	-4000	4000	-3430
chr22	30550635	30558635	30555972	8000	30554635	-4000	4000	1337
chr22	16586751	16594751	16591070	8000	16590751	-4000	4000	319
chrX	71609583	71617583	71616393	8000	71613583	-4000	4000	2810
chrX	153578939	153586939	153580335	8000	153582939	-4000	4000	-2604
chrX	103495130	103503130	103499798	8000	103499130	-4000	4000	668
chrX	70236659	70244659	70239839	8000	70240659	-4000	4000	-820
chrX	103495130	103503130	103500438	8000	103499130	-4000	4000	1308
chrX	112453112	112461112	112455506	8000	112457112	-4000	4000	-1606
chrX	26136736	26144736	26139556	8000	26140736	-4000	4000	-1180
chrX	135755846	135763846	135760403	8000	135759846	-4000	4000	557
chrX	148022665	148030665	148024992	8000	148026665	-4000	4000	-1673
chrX	143504735	143512735	143509110	8000	143508735	-4000	4000	375
chrX	112453112	112461112	112455631	8000	112457112	-4000	4000	-1481
chrX	55074909	55082909	55076100	8000	55078909	-4000	4000	-2809
chrX	70036542	70044542	70041951	8000	70040542	-4000	4000	1409
chrX	110452334	110460334	110452842	8000	110456334	-4000	4000	-3492
chrX	34940915	34948915	34943145	8000	34944915	-4000	4000	-1770
chrX	126159499	126167499	126164666	8000	126163499	-4000	4000	1167
chrX	34125752	34133752	34130016	8000	34129752	-4000	4000	264
chrX	34940915	34948915	34944264	8000	34944915	-4000	4000	-651
chrX	70429390	70437390	70431117	8000	70433390	-4000	4000	-2273
chrX	83508127	83516127	83509454	8000	83512127	-4000	4000	-2673
chrX	87666050	87674050	87669298	8000	87670050	-4000	4000	-752
chrX	116170974	116178974	116172993	8000	116174974	-4000	4000	-1981
chrX	135909062	135917062	135909767	8000	135913062	-4000	4000	-3295
chrX	149881835	149889835	149884454	8000	149885835	-4000	4000	-1381
chrX	143504735	143512735	143508898	8000	143508735	-4000	4000	163
chrX	70429390	70437390	70431086	8000	70433390	-4000	4000	-2304
chrX	106926861	106934861	106928378	8000	106930861	-4000	4000	-2483
chrX	34125752	34133752	34131996	8000	34129752	-4000	4000	2244
chrX	23935509	23943509	23938618	8000	23939509	-4000	4000	-891
chrX	70036542	70044542	70042204	8000	70040542	-4000	4000	1662
chrX	139951728	139959728	139956669	8000	139955728	-4000	4000	941
chrX	27819014	27827014	27822012	8000	27823014	-4000	4000	-1002
chrX	149713268	149721268	149716113	8000	149717268	-4000	4000	-1155
chrX	126545383	126553383	126551549	8000	126549383	-4000	4000	2166
chrX	3108727	3116727	3112391	8000	3112727	-4000	4000	-336
chrX	71609583	71617583	71616996	8000	71613583	-4000	4000	3413
chrX	151741564	151749564	151744397	8000	151745564	-4000	4000	-1167
chrX	27456207	27464207	27462114	8000	27460207	-4000	4000	1907
chrX	26191646	26199646	26195026	8000	26195646	-4000	4000	-620
chrX	79171318	79179318	79171499	8000	79175318	-4000	4000	-3819
chrX	114999975	115007975	115004007	8000	115003975	-4000	4000	32
chrX	145825856	145833856	145828669	8000	145829856	-4000	4000	-1187
chrX	106028435	106036435	106034242	8000	106032435	-4000	4000	1807
chrX	120868607	120876607	120875352	8000	120872607	-4000	4000	2745
chrX	24363839	24371839	24365294	8000	24367839	-4000	4000	-2545
chrX	110519021	110527021	110521151	8000	110523021	-4000	4000	-1870
chrX	151741564	151749564	151744132	8000	151745564	-4000	4000	-1432
chrX	88750785	88758785	88754382	8000	88754785	-4000	4000	-403
chrX	6529618	6537618	6534150	8000	6533618	-4000	4000	532
chrX	132072990	132080990	132077650	8000	132076990	-4000	4000	660
chrX	149881835	149889835	149884673	8000	149885835	-4000	4000	-1162
chrX	83508127	83516127	83508868	8000	83512127	-4000	4000	-3259
chrX	104007147	104015147	104013429	8000	104011147	-4000	4000	2282
chrX	27456207	27464207	27462939	8000	27460207	-4000	4000	2732
chrX	55622192	55630192	55624159	8000	55626192	-4000	4000	-2033
chrX	93708274	93716274	93710695	8000	93712274	-4000	4000	-1579
chrX	151177465	151185465	151180164	8000	151181465	-4000	4000	-1301
chrX	27745942	27753942	27747898	8000	27749942	-4000	4000	-2044
chrX	13314647	13322647	13319576	8000	13318647	-4000	4000	929
chrX	126545383	126553383	126552237	8000	126549383	-4000	4000	2854
chrX	55220108	55228108	55224027	8000	55224108	-4000	4000	-81
chrX	132072990	132080990	132078561	8000	132076990	-4000	4000	1571
chrX	151741564	151749564	151743128	8000	151745564	-4000	4000	-2436
chrX	31067233	31075233	31071644	8000	31071233	-4000	4000	411
chrX	136489780	136497780	136492084	8000	136493780	-4000	4000	-1696
chrX	102934300	102942300	102937717	8000	102938300	-4000	4000	-583
chrX	126545383	126553383	126551487	8000	126549383	-4000	4000	2104
chrX	140498985	140506985	140504644	8000	140502985	-4000	4000	1659
chrX	27819014	27827014	27822421	8000	27823014	-4000	4000	-593
chrX	89918883	89926883	89922123	8000	89922883	-4000	4000	-760
chrX	104038454	104046454	104040127	8000	104042454	-4000	4000	-2327
chrX	30248040	30256040	30250977	8000	30252040	-4000	4000	-1063
chrX	29952718	29960718	29955622	8000	29956718	-4000	4000	-1096
chrX	104007147	104015147	104013618	8000	104011147	-4000	4000	2471
chrX	110452334	110460334	110453627	8000	110456334	-4000	4000	-2707
chrX	115188868	115196868	115190509	8000	115192868	-4000	4000	-2359
chrX	126817786	126825786	126821076	8000	126821786	-4000	4000	-710
chrX	136489780	136497780	136492286	8000	136493780	-4000	4000	-1494
chrX	139951728	139959728	139958078	8000	139955728	-4000	4000	2350
chrX	141893832	141901832	141897001	8000	141897832	-4000	4000	-831
chrX	118822968	118830968	118825479	8000	118826968	-4000	4000	-1489
chrX	136412890	136420890	136414241	8000	136416890	-4000	4000	-2649
chrX	55005055	55013055	55007016	8000	55009055	-4000	4000	-2039
chrX	115188868	115196868	115191465	8000	115192868	-4000	4000	-1403
chrX	120868607	120876607	120875304	8000	120872607	-4000	4000	2697
chrX	126159499	126167499	126164585	8000	126163499	-4000	4000	1086
chrX	34125752	34133752	34131267	8000	34129752	-4000	4000	1515
chrX	152129310	152137310	152135459	8000	152133310	-4000	4000	2149
chrX	34125752	34133752	34130819	8000	34129752	-4000	4000	1067
chrX	50912641	50920641	50916354	8000	50916641	-4000	4000	-287
chrX	64220194	64228194	64224202	8000	64224194	-4000	4000	8
chrX	70277840	70285840	70283574	8000	70281840	-4000	4000	1734
chrX	83508127	83516127	83508656	8000	83512127	-4000	4000	-3471
chrX	83508127	83516127	83509170	8000	83512127	-4000	4000	-2957
chrX	115188868	115196868	115190239	8000	115192868	-4000	4000	-2629
chrX	132072990	132080990	132080227	8000	132076990	-4000	4000	3237
chrX	152984824	152992824	152990659	8000	152988824	-4000	4000	1835
chrX	72868025	72876025	72872378	8000	72872025	-4000	4000	353
chrX	105214929	105222929	105219979	8000	105218929	-4000	4000	1050
chrX	47410498	47418498	47413605	8000	47414498	-4000	4000	-893
chrX	14727812	14735812	14730739	8000	14731812	-4000	4000	-1073
chrX	114906061	114914061	114906668	8000	114910061	-4000	4000	-3393
chrX	128046962	128054962	128051540	8000	128050962	-4000	4000	578
chrX	26191646	26199646	26194448	8000	26195646	-4000	4000	-1198
chrX	55254415	55262415	55260597	8000	55258415	-4000	4000	2182
chrX	115188868	115196868	115192064	8000	115192868	-4000	4000	-804
chrX	119074635	119082635	119081447	8000	119078635	-4000	4000	2812
chrX	131541000	131549000	131544411	8000	131545000	-4000	4000	-589
chrX	35799735	35807735	35803123	8000	35803735	-4000	4000	-612
chrX	151719194	151727194	151721914	8000	151723194	-4000	4000	-1280
chrX	70236659	70244659	70237073	8000	70240659	-4000	4000	-3586
chrX	139951728	139959728	139955816	8000	139955728	-4000	4000	88
chrX	154647972	154655972	154653324	8000	154651972	-4000	4000	1352
chrX	34940915	34948915	34944461	8000	34944915	-4000	4000	-454
chrX	132072990	132080990	132077650	8000	132076990	-4000	4000	660
chrX	79171318	79179318	79171375	8000	79175318	-4000	4000	-3943
chrX	50912641	50920641	50916301	8000	50916641	-4000	4000	-340
chrX	120868607	120876607	120873871	8000	120872607	-4000	4000	1264
chrX	27819014	27827014	27821419	8000	27823014	-4000	4000	-1595
chrX	30248040	30256040	30251198	8000	30252040	-4000	4000	-842
chrX	135909062	135917062	135912867	8000	135913062	-4000	4000	-195
chrX	26191646	26199646	26194798	8000	26195646	-4000	4000	-848
chrX	103495130	103503130	103500304	8000	103499130	-4000	4000	1174
chrX	29952718	29960718	29955828	8000	29956718	-4000	4000	-890
chrX	34125752	34133752	34131780	8000	34129752	-4000	4000	2028
chrX	115303563	115311563	115306304	8000	115307563	-4000	4000	-1259
chrX	152162234	152170234	152168492	8000	152166234	-4000	4000	2258
chrX	44840888	44848888	44844467	8000	44844888	-4000	4000	-421
chrX	79171318	79179318	79171501	8000	79175318	-4000	4000	-3817
chrX	34125752	34133752	34131740	8000	34129752	-4000	4000	1988
chrX	100986831	100994831	100987545	8000	100990831	-4000	4000	-3286
chrX	103495130	103503130	103500573	8000	103499130	-4000	4000	1443
chrX	103071810	103079810	103078598	8000	103075810	-4000	4000	2788
chrX	26136736	26144736	26139463	8000	26140736	-4000	4000	-1273
chrX	34940915	34948915	34943398	8000	34944915	-4000	4000	-1517
chrX	86828604	86836604	86832227	8000	86832604	-4000	4000	-377
chrX	71609583	71617583	71612882	8000	71613583	-4000	4000	-701
chrX	26191646	26199646	26193818	8000	26195646	-4000	4000	-1828
chrX	119074635	119082635	119081336	8000	119078635	-4000	4000	2701
chrX	141905374	141913374	141905714	8000	141909374	-4000	4000	-3660
chrX	27973992	27981992	27980399	8000	27977992	-4000	4000	2407
chrX	73451171	73459171	73454587	8000	73455171	-4000	4000	-584
chrX	102934300	102942300	102938058	8000	102938300	-4000	4000	-242
chrX	110519021	110527021	110521641	8000	110523021	-4000	4000	-1380
chrX	23935509	23943509	23938631	8000	23939509	-4000	4000	-878
chrX	115188868	115196868	115192034	8000	115192868	-4000	4000	-834
chrX	27973992	27981992	27980907	8000	27977992	-4000	4000	2915
chrX	119072373	119080373	119073993	8000	119076373	-4000	4000	-2380
chrX	145252208	145260208	145255715	8000	145256208	-4000	4000	-493
chrX	30233495	30241495	30236776	8000	30237495	-4000	4000	-719
chrX	27745942	27753942	27747055	8000	27749942	-4000	4000	-2887
chrX	78754714	78762714	78755923	8000	78758714	-4000	4000	-2791
chrX	110519021	110527021	110521570	8000	110523021	-4000	4000	-1451
chrX	126159499	126167499	126164788	8000	126163499	-4000	4000	1289
chrX	30248040	30256040	30250568	8000	30252040	-4000	4000	-1472
chrX	141693411	141701411	141697643	8000	141697411	-4000	4000	232
chrX	21650690	21658690	21657474	8000	21654690	-4000	4000	2784
chrX	55622192	55630192	55624502	8000	55626192	-4000	4000	-1690
chrX	70060179	70068179	70063244	8000	70064179	-4000	4000	-935
chrX	132072990	132080990	132077650	8000	132076990	-4000	4000	660
chrX	128046962	128054962	128051913	8000	128050962	-4000	4000	951
chrX	50186777	50194777	50192939	8000	50190777	-4000	4000	2162
chrX	52640061	52648061	52644530	8000	52644061	-4000	4000	469
chrX	104111842	104119842	104115328	8000	104115842	-4000	4000	-514
chrX	133212662	133220662	133217050	8000	133216662	-4000	4000	388
chrX	133212662	133220662	133217051	8000	133216662	-4000	4000	389
chrX	118822968	118830968	118825274	8000	118826968	-4000	4000	-1694
chrX	70277840	70285840	70284630	8000	70281840	-4000	4000	2790
chrX	139559459	139567459	139560814	8000	139563459	-4000	4000	-2645
chrX	105214929	105222929	105219449	8000	105218929	-4000	4000	520
chrX	34940915	34948915	34943685	8000	34944915	-4000	4000	-1230
chrX	50186777	50194777	50192795	8000	50190777	-4000	4000	2018
chrX	154155032	154163032	154156489	8000	154159032	-4000	4000	-2543
chrX	26136736	26144736	26139736	8000	26140736	-4000	4000	-1000
chrX	51404843	51412843	51406955	8000	51408843	-4000	4000	-1888
chrX	51404843	51412843	51408199	8000	51408843	-4000	4000	-644
chrX	151177465	151185465	151180580	8000	151181465	-4000	4000	-885
chrX	145825856	145833856	145829353	8000	145829856	-4000	4000	-503
chrX	149713268	149721268	149716421	8000	149717268	-4000	4000	-847
chrX	70254166	70262166	70259416	8000	70258166	-4000	4000	1250
chrX	31067233	31075233	31071781	8000	31071233	-4000	4000	548
chrX	50186777	50194777	50193343	8000	50190777	-4000	4000	2566
chrX	151177465	151185465	151180160	8000	151181465	-4000	4000	-1305
chrX	35799735	35807735	35802640	8000	35803735	-4000	4000	-1095
chrX	75778987	75786987	75784267	8000	75782987	-4000	4000	1280
chrX	11296761	11304761	11298785	8000	11300761	-4000	4000	-1976
chrX	51404843	51412843	51408340	8000	51408843	-4000	4000	-503
chrX	13314647	13322647	13319871	8000	13318647	-4000	4000	1224
chrX	109368906	109376906	109376126	8000	109372906	-4000	4000	3220
chrX	48182220	48190220	48186821	8000	48186220	-4000	4000	601
chrX	12720523	12728523	12721782	8000	12724523	-4000	4000	-2741
chrX	71609583	71617583	71616925	8000	71613583	-4000	4000	3342
chrX	64264081	64272081	64269038	8000	64268081	-4000	4000	957
chrX	70201704	70209704	70201972	8000	70205704	-4000	4000	-3732
chrX	34940915	34948915	34943558	8000	34944915	-4000	4000	-1357
chrX	26157824	26165824	26161275	8000	26161824	-4000	4000	-549
chrX	34940915	34948915	34943297	8000	34944915	-4000	4000	-1618
chrX	126545383	126553383	126550970	8000	126549383	-4000	4000	1587
chrX	130180870	130188870	130184435	8000	130184870	-4000	4000	-435
chrX	55622192	55630192	55624286	8000	55626192	-4000	4000	-1906
chrX	105763829	105771829	105767496	8000	105767829	-4000	4000	-333
chrX	104111842	104119842	104114830	8000	104115842	-4000	4000	-1012
chrX	126817786	126825786	126821286	8000	126821786	-4000	4000	-500
chrX	30248040	30256040	30251417	8000	30252040	-4000	4000	-623
chrX	50186777	50194777	50193714	8000	50190777	-4000	4000	2937
chrX	132072990	132080990	132077650	8000	132076990	-4000	4000	660
chrX	50361409	50369409	50368996	8000	50365409	-4000	4000	3587
chrX	27745942	27753942	27748239	8000	27749942	-4000	4000	-1703
chrX	102934300	102942300	102938080	8000	102938300	-4000	4000	-220
chrX	149881835	149889835	149884761	8000	149885835	-4000	4000	-1074
chrX	50186777	50194777	50193099	8000	50190777	-4000	4000	2322
chrX	128046962	128054962	128051887	8000	128050962	-4000	4000	925
chrX	141893832	141901832	141897252	8000	141897832	-4000	4000	-580
chrX	37007664	37015664	37008734	8000	37011664	-4000	4000	-2930
chrX	115188868	115196868	115190183	8000	115192868	-4000	4000	-2685
chrX	88750785	88758785	88753506	8000	88754785	-4000	4000	-1279
chrX	83508127	83516127	83509238	8000	83512127	-4000	4000	-2889
chrX	18635688	18643688	18641929	8000	18639688	-4000	4000	2241
chrX	141905374	141913374	141907694	8000	141909374	-4000	4000	-1680
chrX	151177465	151185465	151180720	8000	151181465	-4000	4000	-745
chrX	35799735	35807735	35802161	8000	35803735	-4000	4000	-1574
chrX	52792144	52800144	52796503	8000	52796144	-4000	4000	359
chrX	110452334	110460334	110452356	8000	110456334	-4000	4000	-3978
chrX	6529618	6537618	6533946	8000	6533618	-4000	4000	328
chrX	118822968	118830968	118826073	8000	118826968	-4000	4000	-895
chrX	26157824	26165824	26161516	8000	26161824	-4000	4000	-308
chrX	26191646	26199646	26194486	8000	26195646	-4000	4000	-1160
chrX	70921579	70929579	70927804	8000	70925579	-4000	4000	2225
chrX	102934300	102942300	102937507	8000	102938300	-4000	4000	-793
chrX	120868607	120876607	120875391	8000	120872607	-4000	4000	2784
chrX	131541000	131549000	131544371	8000	131545000	-4000	4000	-629
chrX	135909062	135917062	135911251	8000	135913062	-4000	4000	-1811
chrX	149713268	149721268	149716675	8000	149717268	-4000	4000	-593
chrX	149881835	149889835	149884681	8000	149885835	-4000	4000	-1154
chrX	37007664	37015664	37009869	8000	37011664	-4000	4000	-1795
chrX	26157824	26165824	26161732	8000	26161824	-4000	4000	-92
chrX	21650690	21658690	21657454	8000	21654690	-4000	4000	2764
chrX	126545383	126553383	126551990	8000	126549383	-4000	4000	2607
chrX	50186777	50194777	50192694	8000	50190777	-4000	4000	1917
chrX	78754714	78762714	78754852	8000	78758714	-4000	4000	-3862
chrX	115188868	115196868	115192103	8000	115192868	-4000	4000	-765
chrX	78754714	78762714	78756893	8000	78758714	-4000	4000	-1821
chrX	135909062	135917062	135911315	8000	135913062	-4000	4000	-1747
chrX	27973992	27981992	27981152	8000	27977992	-4000	4000	3160
chrX	152984824	152992824	152990814	8000	152988824	-4000	4000	1990
chrX	70254166	70262166	70258701	8000	70258166	-4000	4000	535
chrX	48182220	48190220	48190177	8000	48186220	-4000	4000	3957
chrX	141893832	141901832	141896649	8000	141897832	-4000	4000	-1183
chrX	119074635	119082635	119081379	8000	119078635	-4000	4000	2744
chrX	149772867	149780867	149774785	8000	149776867	-4000	4000	-2082
chrX	105214929	105222929	105220072	8000	105218929	-4000	4000	1143
chrX	30216089	30224089	30218974	8000	30220089	-4000	4000	-1115
chrX	55005055	55013055	55006740	8000	55009055	-4000	4000	-2315
chrX	115188868	115196868	115189513	8000	115192868	-4000	4000	-3355
chrX	74301034	74309034	74304261	8000	74305034	-4000	4000	-773
chrX	78754714	78762714	78755544	8000	78758714	-4000	4000	-3170
chrX	37007664	37015664	37009534	8000	37011664	-4000	4000	-2130
chrX	70201704	70209704	70204317	8000	70205704	-4000	4000	-1387
chrX	118822968	118830968	118826566	8000	118826968	-4000	4000	-402
chrX	49315841	49323841	49317184	8000	49319841	-4000	4000	-2657
chrX	34125752	34133752	34131378	8000	34129752	-4000	4000	1626
chrX	149772867	149780867	149775040	8000	149776867	-4000	4000	-1827
chrX	115188868	115196868	115190549	8000	115192868	-4000	4000	-2319
chrX	141893832	141901832	141897536	8000	141897832	-4000	4000	-296
chrX	8462510	8470510	8466351	8000	8466510	-4000	4000	-159
chrX	55088842	55096842	55091393	8000	55092842	-4000	4000	-1449
chrX	139951728	139959728	139955740	8000	139955728	-4000	4000	12
chrX	141905374	141913374	141907075	8000	141909374	-4000	4000	-2299
chrX	110452334	110460334	110452980	8000	110456334	-4000	4000	-3354
chrX	70921579	70929579	70926097	8000	70925579	-4000	4000	518
chrX	27973992	27981992	27979573	8000	27977992	-4000	4000	1581
chrX	149713268	149721268	149716520	8000	149717268	-4000	4000	-748
chrX	149713268	149721268	149716754	8000	149717268	-4000	4000	-514
chrX	141905374	141913374	141905516	8000	141909374	-4000	4000	-3858
chrX	114999975	115007975	115004010	8000	115003975	-4000	4000	35
chrX	126159499	126167499	126164887	8000	126163499	-4000	4000	1388
chrX	27973992	27981992	27979587	8000	27977992	-4000	4000	1595
chrX	15277697	15285697	15283618	8000	15281697	-4000	4000	1921
chrX	55220108	55228108	55221802	8000	55224108	-4000	4000	-2306
chrX	70236659	70244659	70238313	8000	70240659	-4000	4000	-2346
chrX	78652068	78660068	78658073	8000	78656068	-4000	4000	2005
chrX	114906061	114914061	114907165	8000	114910061	-4000	4000	-2896
chrX	106926861	106934861	106928661	8000	106930861	-4000	4000	-2200
chrX	50186777	50194777	50193594	8000	50190777	-4000	4000	2817
chrX	135909062	135917062	135910429	8000	135913062	-4000	4000	-2633
chrX	51404843	51412843	51408546	8000	51408843	-4000	4000	-297
chrX	37007664	37015664	37010197	8000	37011664	-4000	4000	-1467
chrX	50186777	50194777	50193428	8000	50190777	-4000	4000	2651
chrX	13314647	13322647	13319780	8000	13318647	-4000	4000	1133
chrX	73073276	73081276	73077850	8000	73077276	-4000	4000	574
chrX	112453112	112461112	112457124	8000	112457112	-4000	4000	12
chrX	70201704	70209704	70204469	8000	70205704	-4000	4000	-1235
chrX	78652068	78660068	78657141	8000	78656068	-4000	4000	1073
chrX	48342427	48350427	48348294	8000	48346427	-4000	4000	1867
chrX	152756222	152764222	152760041	8000	152760222	-4000	4000	-181
chrX	34125752	34133752	34130648	8000	34129752	-4000	4000	896
chrX	133019168	133027168	133026918	8000	133023168	-4000	4000	3750
chrX	114906061	114914061	114907103	8000	114910061	-4000	4000	-2958
chrX	126817786	126825786	126821328	8000	126821786	-4000	4000	-458
chrX	8462510	8470510	8465353	8000	8466510	-4000	4000	-1157
chrX	13314647	13322647	13318893	8000	13318647	-4000	4000	246
chrX	37007664	37015664	37009509	8000	37011664	-4000	4000	-2155
chrX	112453112	112461112	112455364	8000	112457112	-4000	4000	-1748
chrX	148022665	148030665	148024946	8000	148026665	-4000	4000	-1719
chrX	27745942	27753942	27747675	8000	27749942	-4000	4000	-2267
chrX	34125752	34133752	34132111	8000	34129752	-4000	4000	2359
chrX	47410498	47418498	47413458	8000	47414498	-4000	4000	-1040
chrX	77453278	77461278	77454212	8000	77457278	-4000	4000	-3066
chrX	24554087	24562087	24560794	8000	24558087	-4000	4000	2707
chrX	70201704	70209704	70205065	8000	70205704	-4000	4000	-639
chrX	13314647	13322647	13319991	8000	13318647	-4000	4000	1344
chrX	37007664	37015664	37009149	8000	37011664	-4000	4000	-2515
chrX	70036542	70044542	70043199	8000	70040542	-4000	4000	2657
chrX	78652068	78660068	78658386	8000	78656068	-4000	4000	2318
chrX	151719194	151727194	151721501	8000	151723194	-4000	4000	-1693
chrX	80441311	80449311	80442948	8000	80445311	-4000	4000	-2363
chrX	37007664	37015664	37010562	8000	37011664	-4000	4000	-1102
chrX	44840888	44848888	44844223	8000	44844888	-4000	4000	-665
chrX	50186777	50194777	50193686	8000	50190777	-4000	4000	2909
chrX	89918883	89926883	89922797	8000	89922883	-4000	4000	-86
chrX	101092367	101100367	101096305	8000	101096367	-4000	4000	-62
chrX	128046962	128054962	128051447	8000	128050962	-4000	4000	485
chrX	151719194	151727194	151722953	8000	151723194	-4000	4000	-241
chrX	50186777	50194777	50193260	8000	50190777	-4000	4000	2483
chrX	13031617	13039617	13036867	8000	13035617	-4000	4000	1250
chrX	140498985	140506985	140504607	8000	140502985	-4000	4000	1622
chrX	71609583	71617583	71612515	8000	71613583	-4000	4000	-1068
chrX	143707955	143715955	143712493	8000	143711955	-4000	4000	538
chrX	103495130	103503130	103500738	8000	103499130	-4000	4000	1608
chrX	136412890	136420890	136414164	8000	136416890	-4000	4000	-2726
chrX	145825856	145833856	145827906	8000	145829856	-4000	4000	-1950
chrX	27456207	27464207	27460819	8000	27460207	-4000	4000	612
chrX	70236659	70244659	70238273	8000	70240659	-4000	4000	-2386
chrX	110519021	110527021	110521974	8000	110523021	-4000	4000	-1047
chrX	114906061	114914061	114907031	8000	114910061	-4000	4000	-3030
chrX	133019168	133027168	133025113	8000	133023168	-4000	4000	1945
chrX	105763829	105771829	105767483	8000	105767829	-4000	4000	-346
chrX	132072990	132080990	132080262	8000	132076990	-4000	4000	3272
chrX	22999589	23007589	23000541	8000	23003589	-4000	4000	-3048
chrX	35799735	35807735	35802377	8000	35803735	-4000	4000	-1358
chrX	30233495	30241495	30235935	8000	30237495	-4000	4000	-1560
chrX	49315841	49323841	49323226	8000	49319841	-4000	4000	3385
chrX	55088842	55096842	55090512	8000	55092842	-4000	4000	-2330
chrX	64220194	64228194	64224252	8000	64224194	-4000	4000	58
chrX	106028435	106036435	106033455	8000	106032435	-4000	4000	1020
chrX	152756222	152764222	152759864	8000	152760222	-4000	4000	-358
chrX	22999589	23007589	23001656	8000	23003589	-4000	4000	-1933
chrX	21650690	21658690	21656297	8000	21654690	-4000	4000	1607
chrX	153903166	153911166	153905951	8000	153907166	-4000	4000	-1215
chrX	6529618	6537618	6534104	8000	6533618	-4000	4000	486
chrX	7840143	7848143	7843597	8000	7844143	-4000	4000	-546
chrX	8165944	8173944	8170250	8000	8169944	-4000	4000	306
chrX	21650690	21658690	21656238	8000	21654690	-4000	4000	1548
chrX	30233495	30241495	30236688	8000	30237495	-4000	4000	-807
chrX	47410498	47418498	47412698	8000	47414498	-4000	4000	-1800
chrX	49341922	49349922	49342913	8000	49345922	-4000	4000	-3009
chrX	51404843	51412843	51407094	8000	51408843	-4000	4000	-1749
chrX	70060179	70068179	70063145	8000	70064179	-4000	4000	-1034
chrX	72868025	72876025	72872458	8000	72872025	-4000	4000	433
chrX	104111842	104119842	104113923	8000	104115842	-4000	4000	-1919
chrX	126545383	126553383	126551974	8000	126549383	-4000	4000	2591
chrX	131541000	131549000	131544729	8000	131545000	-4000	4000	-271
chrX	37007664	37015664	37011456	8000	37011664	-4000	4000	-208
chrX	35799735	35807735	35803440	8000	35803735	-4000	4000	-295
chrX	70524940	70532940	70529848	8000	70528940	-4000	4000	908
chrX	29952718	29960718	29955817	8000	29956718	-4000	4000	-901
chrX	50186777	50194777	50192647	8000	50190777	-4000	4000	1870
chrX	106028435	106036435	106034262	8000	106032435	-4000	4000	1827
chrX	133019168	133027168	133025895	8000	133023168	-4000	4000	2727
chrX	27973992	27981992	27980964	8000	27977992	-4000	4000	2972
chrX	34125752	34133752	34131062	8000	34129752	-4000	4000	1310
chrX	115188868	115196868	115190495	8000	115192868	-4000	4000	-2373
chrX	41726130	41734130	41727606	8000	41730130	-4000	4000	-2524
chrX	149881835	149889835	149884994	8000	149885835	-4000	4000	-841
chrX	151719194	151727194	151721943	8000	151723194	-4000	4000	-1251
chrX	154155032	154163032	154156420	8000	154159032	-4000	4000	-2612
chrX	71609583	71617583	71617390	8000	71613583	-4000	4000	3807
chrX	133019168	133027168	133025419	8000	133023168	-4000	4000	2251
chrX	143707955	143715955	143712404	8000	143711955	-4000	4000	449
chrX	13031617	13039617	13037844	8000	13035617	-4000	4000	2227
chrX	30248040	30256040	30251328	8000	30252040	-4000	4000	-712
chrX	153578939	153586939	153580133	8000	153582939	-4000	4000	-2806
chrX	24363839	24371839	24364712	8000	24367839	-4000	4000	-3127
chrX	34125752	34133752	34131459	8000	34129752	-4000	4000	1707
chrX	34940915	34948915	34943803	8000	34944915	-4000	4000	-1112
chrX	48342427	48350427	48350010	8000	48346427	-4000	4000	3583
chrX	74301034	74309034	74304375	8000	74305034	-4000	4000	-659
chrX	74301034	74309034	74304630	8000	74305034	-4000	4000	-404
chrX	80441311	80449311	80443445	8000	80445311	-4000	4000	-1866
chrX	112453112	112461112	112455352	8000	112457112	-4000	4000	-1760
chrX	119756202	119764202	119759796	8000	119760202	-4000	4000	-406
chrX	129765536	129773536	129768654	8000	129769536	-4000	4000	-882
chrX	149577653	149585653	149582129	8000	149581653	-4000	4000	476
chrX	151741564	151749564	151742632	8000	151745564	-4000	4000	-2932
chrX	152129310	152137310	152135560	8000	152133310	-4000	4000	2250
chrX	152704261	152712261	152708568	8000	152708261	-4000	4000	307
chrX	9020232	9028232	9027952	8000	9024232	-4000	4000	3720
chrX	24363839	24371839	24363868	8000	24367839	-4000	4000	-3971
chrX	24554087	24562087	24561908	8000	24558087	-4000	4000	3821
chrX	26191646	26199646	26195160	8000	26195646	-4000	4000	-486
chrX	37007664	37015664	37008449	8000	37011664	-4000	4000	-3215
chrX	50186777	50194777	50192561	8000	50190777	-4000	4000	1784
chrX	102934300	102942300	102937997	8000	102938300	-4000	4000	-303
chrX	133019168	133027168	133025658	8000	133023168	-4000	4000	2490
chrX	24363839	24371839	24364689	8000	24367839	-4000	4000	-3150
chrX	132072990	132080990	132080052	8000	132076990	-4000	4000	3062
chrX	152984824	152992824	152991687	8000	152988824	-4000	4000	2863
chrX	104246038	104254038	104250183	8000	104250038	-4000	4000	145
chrX	79171318	79179318	79171893	8000	79175318	-4000	4000	-3425
chrX	80441311	80449311	80443558	8000	80445311	-4000	4000	-1753
chrX	80441311	80449311	80443559	8000	80445311	-4000	4000	-1752
chrX	149713268	149721268	149716656	8000	149717268	-4000	4000	-612
chrX	55622192	55630192	55623553	8000	55626192	-4000	4000	-2639
chrX	156006817	156014817	156009838	8000	156010817	-4000	4000	-979
chrX	18635688	18643688	18641874	8000	18639688	-4000	4000	2186
chrX	103269691	103277691	103274048	8000	103273691	-4000	4000	357
chrX	115188868	115196868	115191125	8000	115192868	-4000	4000	-1743
chrX	126545383	126553383	126551721	8000	126549383	-4000	4000	2338
chrX	104111842	104119842	104114991	8000	104115842	-4000	4000	-851
chrX	83508127	83516127	83508498	8000	83512127	-4000	4000	-3629
chrX	55220108	55228108	55221792	8000	55224108	-4000	4000	-2316
chrX	145825856	145833856	145829562	8000	145829856	-4000	4000	-294
chrX	55622192	55630192	55624652	8000	55626192	-4000	4000	-1540
chrX	70060179	70068179	70063165	8000	70064179	-4000	4000	-1014
chrX	34125752	34133752	34130758	8000	34129752	-4000	4000	1006
chrX	27745942	27753942	27748357	8000	27749942	-4000	4000	-1585
chrX	74301034	74309034	74304596	8000	74305034	-4000	4000	-438
chrX	106028435	106036435	106034303	8000	106032435	-4000	4000	1868
chrX	48790311	48798311	48791917	8000	48794311	-4000	4000	-2394
chrX	78652068	78660068	78657472	8000	78656068	-4000	4000	1404
chrX	27973992	27981992	27978762	8000	27977992	-4000	4000	770
chrX	71301371	71309371	71303473	8000	71305371	-4000	4000	-1898
chrX	100909445	100917445	100914973	8000	100913445	-4000	4000	1528
chrX	51404843	51412843	51408334	8000	51408843	-4000	4000	-509
chrX	107976864	107984864	107981500	8000	107980864	-4000	4000	636
chrX	149772867	149780867	149774603	8000	149776867	-4000	4000	-2264
chrX	79171318	79179318	79171715	8000	79175318	-4000	4000	-3603
chrX	51404843	51412843	51407242	8000	51408843	-4000	4000	-1601
chrX	126159499	126167499	126164673	8000	126163499	-4000	4000	1174
chrX	70429390	70437390	70433126	8000	70433390	-4000	4000	-264
chrX	118822968	118830968	118826331	8000	118826968	-4000	4000	-637
chrX	75778987	75786987	75784285	8000	75782987	-4000	4000	1298
chrX	133212662	133220662	133217229	8000	133216662	-4000	4000	567
chrX	13031617	13039617	13038390	8000	13035617	-4000	4000	2773
chrX	70277840	70285840	70281707	8000	70281840	-4000	4000	-133
chrX	71609583	71617583	71616598	8000	71613583	-4000	4000	3015
chrX	115188868	115196868	115191741	8000	115192868	-4000	4000	-1127
chrX	149881835	149889835	149885064	8000	149885835	-4000	4000	-771
chrX	24304210	24312210	24311343	8000	24308210	-4000	4000	3133
chrX	37007664	37015664	37011276	8000	37011664	-4000	4000	-388
chrX	143504735	143512735	143508939	8000	143508735	-4000	4000	204
chrX	88750785	88758785	88753721	8000	88754785	-4000	4000	-1064
chrX	107976864	107984864	107981008	8000	107980864	-4000	4000	144
chrX	80441311	80449311	80442728	8000	80445311	-4000	4000	-2583
chrX	34125752	34133752	34130724	8000	34129752	-4000	4000	972
chrX	30248040	30256040	30250763	8000	30252040	-4000	4000	-1277
chrX	47410498	47418498	47412649	8000	47414498	-4000	4000	-1849
chrX	115188868	115196868	115190971	8000	115192868	-4000	4000	-1897
chrX	149713268	149721268	149716803	8000	149717268	-4000	4000	-465
chrX	152162234	152170234	152168146	8000	152166234	-4000	4000	1912
chrX	26191646	26199646	26193816	8000	26195646	-4000	4000	-1830
chrX	78754714	78762714	78754930	8000	78758714	-4000	4000	-3784
chrX	30248040	30256040	30250522	8000	30252040	-4000	4000	-1518
chrX	77453278	77461278	77454186	8000	77457278	-4000	4000	-3092
chrX	103710032	103718032	103713636	8000	103714032	-4000	4000	-396
chrX	151741564	151749564	151744423	8000	151745564	-4000	4000	-1141
chrX	30233495	30241495	30237206	8000	30237495	-4000	4000	-289
chrX	78652068	78660068	78657677	8000	78656068	-4000	4000	1609
chrX	103495130	103503130	103500270	8000	103499130	-4000	4000	1140
chrX	35799735	35807735	35802257	8000	35803735	-4000	4000	-1478
chrX	103710032	103718032	103713705	8000	103714032	-4000	4000	-327
chrX	70429390	70437390	70431080	8000	70433390	-4000	4000	-2310
chrX	130180870	130188870	130184315	8000	130184870	-4000	4000	-555
chrX	103071810	103079810	103077743	8000	103075810	-4000	4000	1933
chrX	126159499	126167499	126164915	8000	126163499	-4000	4000	1416
chrX	70201704	70209704	70201972	8000	70205704	-4000	4000	-3732
chrX	15341596	15349596	15346236	8000	15345596	-4000	4000	640
chrX	135909062	135917062	135912389	8000	135913062	-4000	4000	-673
chrX	55088842	55096842	55091337	8000	55092842	-4000	4000	-1505
chrX	27973992	27981992	27980248	8000	27977992	-4000	4000	2256
chrX	128046962	128054962	128052111	8000	128050962	-4000	4000	1149
chrX	126159499	126167499	126165427	8000	126163499	-4000	4000	1928
chrX	128046962	128054962	128051348	8000	128050962	-4000	4000	386
chrX	129765536	129773536	129768494	8000	129769536	-4000	4000	-1042
chrX	104111842	104119842	104114692	8000	104115842	-4000	4000	-1150
chrX	22999589	23007589	23001249	8000	23003589	-4000	4000	-2340
chrX	34125752	34133752	34130979	8000	34129752	-4000	4000	1227
chrX	139559459	139567459	139560831	8000	139563459	-4000	4000	-2628
chrX	132072990	132080990	132073044	8000	132076990	-4000	4000	-3946
chrX	34940915	34948915	34943297	8000	34944915	-4000	4000	-1618
chrX	139951728	139959728	139956508	8000	139955728	-4000	4000	780
chrX	30216089	30224089	30218598	8000	30220089	-4000	4000	-1491
chrX	83508127	83516127	83508341	8000	83512127	-4000	4000	-3786
chrX	49683447	49691447	49689496	8000	49687447	-4000	4000	2049
chrX	64264081	64272081	64270967	8000	64268081	-4000	4000	2886
chrX	152984824	152992824	152990513	8000	152988824	-4000	4000	1689
chrX	21650690	21658690	21652465	8000	21654690	-4000	4000	-2225
chrX	23935509	23943509	23939297	8000	23939509	-4000	4000	-212
chrX	27819014	27827014	27822111	8000	27823014	-4000	4000	-903
chrX	29952718	29960718	29954635	8000	29956718	-4000	4000	-2083
chrX	37007664	37015664	37010794	8000	37011664	-4000	4000	-870
chrX	48263444	48271444	48266330	8000	48267444	-4000	4000	-1114
chrX	50912641	50920641	50916264	8000	50916641	-4000	4000	-377
chrX	52692896	52700896	52698055	8000	52696896	-4000	4000	1159
chrX	52792144	52800144	52797332	8000	52796144	-4000	4000	1188
chrX	52814301	52822301	52815145	8000	52818301	-4000	4000	-3156
chrX	55005055	55013055	55006756	8000	55009055	-4000	4000	-2299
chrX	70201704	70209704	70205022	8000	70205704	-4000	4000	-682
chrX	75778987	75786987	75783624	8000	75782987	-4000	4000	637
chrX	88750785	88758785	88753975	8000	88754785	-4000	4000	-810
chrX	101092367	101100367	101094783	8000	101096367	-4000	4000	-1584
chrX	120868607	120876607	120875034	8000	120872607	-4000	4000	2427
chrX	133212662	133220662	133217866	8000	133216662	-4000	4000	1204
chrX	141905374	141913374	141906855	8000	141909374	-4000	4000	-2519
chrX	141905374	141913374	141907064	8000	141909374	-4000	4000	-2310
chrX	153578939	153586939	153580450	8000	153582939	-4000	4000	-2489
chrX	153903166	153911166	153909773	8000	153907166	-4000	4000	2607
chrX	154326350	154334350	154327596	8000	154330350	-4000	4000	-2754
chrX	154881558	154889558	154885193	8000	154885558	-4000	4000	-365
chrX	156006817	156014817	156007531	8000	156010817	-4000	4000	-3286
chrX	34940915	34948915	34943844	8000	34944915	-4000	4000	-1071
chrX	114999975	115007975	115007962	8000	115003975	-4000	4000	3987
chrX	86828604	86836604	86832337	8000	86832604	-4000	4000	-267
chrX	87666050	87674050	87666850	8000	87670050	-4000	4000	-3200
chrX	152129310	152137310	152134594	8000	152133310	-4000	4000	1284
chrX	152984824	152992824	152991331	8000	152988824	-4000	4000	2507
chrX	30216089	30224089	30219739	8000	30220089	-4000	4000	-350
chrX	149713268	149721268	149715923	8000	149717268	-4000	4000	-1345
chrX	47410498	47418498	47413388	8000	47414498	-4000	4000	-1110
chrX	22999589	23007589	23000611	8000	23003589	-4000	4000	-2978
chrX	48182220	48190220	48187673	8000	48186220	-4000	4000	1453
chrX	152756222	152764222	152759591	8000	152760222	-4000	4000	-631
chrX	141893832	141901832	141895295	8000	141897832	-4000	4000	-2537
chrX	151741564	151749564	151743524	8000	151745564	-4000	4000	-2040
chrX	135909062	135917062	135910044	8000	135913062	-4000	4000	-3018
chrX	52814301	52822301	52818230	8000	52818301	-4000	4000	-71
chrX	107240247	107248247	107243262	8000	107244247	-4000	4000	-985
chrX	126545383	126553383	126551759	8000	126549383	-4000	4000	2376
chrX	48826138	48834138	48829986	8000	48830138	-4000	4000	-152
chrX	141905374	141913374	141907681	8000	141909374	-4000	4000	-1693
chrX	22999589	23007589	23000208	8000	23003589	-4000	4000	-3381
chrX	22999589	23007589	23001701	8000	23003589	-4000	4000	-1888
chrX	26136736	26144736	26138993	8000	26140736	-4000	4000	-1743
chrX	26191646	26199646	26194523	8000	26195646	-4000	4000	-1123
chrX	26191646	26199646	26194606	8000	26195646	-4000	4000	-1040
chrX	27819014	27827014	27821966	8000	27823014	-4000	4000	-1048
chrX	27973992	27981992	27981022	8000	27977992	-4000	4000	3030
chrX	30233495	30241495	30236616	8000	30237495	-4000	4000	-879
chrX	31067233	31075233	31071278	8000	31071233	-4000	4000	45
chrX	34940915	34948915	34943351	8000	34944915	-4000	4000	-1564
chrX	35799735	35807735	35802929	8000	35803735	-4000	4000	-806
chrX	36381317	36389317	36384954	8000	36385317	-4000	4000	-363
chrX	48342427	48350427	48348376	8000	48346427	-4000	4000	1949
chrX	50186777	50194777	50193559	8000	50190777	-4000	4000	2782
chrX	51404843	51412843	51408162	8000	51408843	-4000	4000	-681
chrX	64220194	64228194	64225406	8000	64224194	-4000	4000	1212
chrX	70036542	70044542	70043496	8000	70040542	-4000	4000	2954
chrX	70254166	70262166	70259201	8000	70258166	-4000	4000	1035
chrX	70277840	70285840	70282822	8000	70281840	-4000	4000	982
chrX	70921579	70929579	70926902	8000	70925579	-4000	4000	1323
chrX	72868025	72876025	72872399	8000	72872025	-4000	4000	374
chrX	80441311	80449311	80442663	8000	80445311	-4000	4000	-2648
chrX	83508127	83516127	83509278	8000	83512127	-4000	4000	-2849
chrX	93708274	93716274	93709430	8000	93712274	-4000	4000	-2844
chrX	103269691	103277691	103274580	8000	103273691	-4000	4000	889
chrX	103710032	103718032	103713798	8000	103714032	-4000	4000	-234
chrX	105214929	105222929	105219122	8000	105218929	-4000	4000	193
chrX	105763829	105771829	105767101	8000	105767829	-4000	4000	-728
chrX	116170974	116178974	116172372	8000	116174974	-4000	4000	-2602
chrX	135909062	135917062	135911589	8000	135913062	-4000	4000	-1473
chrX	135909062	135917062	135911938	8000	135913062	-4000	4000	-1124
chrX	154326350	154334350	154329824	8000	154330350	-4000	4000	-526
chrX	75778987	75786987	75783794	8000	75782987	-4000	4000	807
chrX	89918883	89926883	89922817	8000	89922883	-4000	4000	-66
chrX	114906061	114914061	114907414	8000	114910061	-4000	4000	-2647
chrX	133212662	133220662	133217593	8000	133216662	-4000	4000	931
chrX	135152540	135160540	135158251	8000	135156540	-4000	4000	1711
chrX	152162234	152170234	152168428	8000	152166234	-4000	4000	2194
chrX	103495130	103503130	103500621	8000	103499130	-4000	4000	1491
chrX	143504735	143512735	143508977	8000	143508735	-4000	4000	242
chrX	156006817	156014817	156010199	8000	156010817	-4000	4000	-618
chrX	37007664	37015664	37009335	8000	37011664	-4000	4000	-2329
chrX	52640061	52648061	52645460	8000	52644061	-4000	4000	1399
chrX	27973992	27981992	27980827	8000	27977992	-4000	4000	2835
chrX	55005055	55013055	55006689	8000	55009055	-4000	4000	-2366
chrX	141893832	141901832	141896503	8000	141897832	-4000	4000	-1329
chrX	120379249	120387249	120380964	8000	120383249	-4000	4000	-2285
chrX	30233495	30241495	30236655	8000	30237495	-4000	4000	-840
chrX	118822968	118830968	118825588	8000	118826968	-4000	4000	-1380
chrX	37007664	37015664	37009928	8000	37011664	-4000	4000	-1736
chrX	64264081	64272081	64268732	8000	64268081	-4000	4000	651
chrX	34940915	34948915	34942859	8000	34944915	-4000	4000	-2056
chrX	73451171	73459171	73453534	8000	73455171	-4000	4000	-1637
chrX	73451171	73459171	73453535	8000	73455171	-4000	4000	-1636
chrX	22999589	23007589	23001637	8000	23003589	-4000	4000	-1952
chrX	37007664	37015664	37010302	8000	37011664	-4000	4000	-1362
chrX	49683447	49691447	49689437	8000	49687447	-4000	4000	1990
chrX	78652068	78660068	78657771	8000	78656068	-4000	4000	1703
chrX	126545383	126553383	126551673	8000	126549383	-4000	4000	2290
chrX	114999975	115007975	115005217	8000	115003975	-4000	4000	1242
chrX	41471710	41479710	41474566	8000	41475710	-4000	4000	-1144
chrX	50186777	50194777	50194299	8000	50190777	-4000	4000	3522
chrX	153903166	153911166	153909519	8000	153907166	-4000	4000	2353
chrX	11296761	11304761	11298866	8000	11300761	-4000	4000	-1895
chrX	115188868	115196868	115191842	8000	115192868	-4000	4000	-1026
chrX	27973992	27981992	27980821	8000	27977992	-4000	4000	2829
chrX	47410498	47418498	47410717	8000	47414498	-4000	4000	-3781
chrX	136489780	136497780	136492276	8000	136493780	-4000	4000	-1504
chrX	48263444	48271444	48266326	8000	48267444	-4000	4000	-1118
chrX	72868025	72876025	72872429	8000	72872025	-4000	4000	404
chrX	14727812	14735812	14730296	8000	14731812	-4000	4000	-1516
chrX	154647972	154655972	154653318	8000	154651972	-4000	4000	1346
chrX	70236659	70244659	70239903	8000	70240659	-4000	4000	-756
chrX	149713268	149721268	149716814	8000	149717268	-4000	4000	-454
chrX	151672739	151680739	151676115	8000	151676739	-4000	4000	-624
chrX	52792144	52800144	52796356	8000	52796144	-4000	4000	212
chrX	120379249	120387249	120379632	8000	120383249	-4000	4000	-3617
chrX	153903166	153911166	153909520	8000	153907166	-4000	4000	2354
chrX	8462510	8470510	8466386	8000	8466510	-4000	4000	-124
chrX	26136736	26144736	26139498	8000	26140736	-4000	4000	-1238
chrX	44840888	44848888	44844364	8000	44844888	-4000	4000	-524
chrX	48790311	48798311	48794024	8000	48794311	-4000	4000	-287
chrX	71301371	71309371	71305277	8000	71305371	-4000	4000	-94
chrX	71609583	71617583	71616890	8000	71613583	-4000	4000	3307
chrX	75778987	75786987	75783315	8000	75782987	-4000	4000	328
chrX	80027774	80035774	80031018	8000	80031774	-4000	4000	-756
chrX	104038454	104046454	104040248	8000	104042454	-4000	4000	-2206
chrX	116170974	116178974	116172958	8000	116174974	-4000	4000	-2016
chrX	140498985	140506985	140504467	8000	140502985	-4000	4000	1482
chrX	143707955	143715955	143711990	8000	143711955	-4000	4000	35
chrX	152756222	152764222	152759507	8000	152760222	-4000	4000	-715
chrX	30233495	30241495	30235930	8000	30237495	-4000	4000	-1565
chrX	115188868	115196868	115192068	8000	115192868	-4000	4000	-800
chrX	37007664	37015664	37008565	8000	37011664	-4000	4000	-3099
chrX	24363839	24371839	24364432	8000	24367839	-4000	4000	-3407
chrX	34125752	34133752	34131780	8000	34129752	-4000	4000	2028
chrX	64220194	64228194	64225161	8000	64224194	-4000	4000	967
chrX	50186777	50194777	50190786	8000	50190777	-4000	4000	9
chrX	70429390	70437390	70431089	8000	70433390	-4000	4000	-2301
chrX	72868025	72876025	72872520	8000	72872025	-4000	4000	495
chrX	152129310	152137310	152134779	8000	152133310	-4000	4000	1469
chrX	48790311	48798311	48793842	8000	48794311	-4000	4000	-469
chrX	55074909	55082909	55077413	8000	55078909	-4000	4000	-1496
chrX	104038454	104046454	104040041	8000	104042454	-4000	4000	-2413
chrX	27456207	27464207	27461484	8000	27460207	-4000	4000	1277
chrX	27745942	27753942	27747687	8000	27749942	-4000	4000	-2255
chrX	55088842	55096842	55091412	8000	55092842	-4000	4000	-1430
chrX	116170974	116178974	116173216	8000	116174974	-4000	4000	-1758
chrX	71609583	71617583	71617152	8000	71613583	-4000	4000	3569
chrX	116170974	116178974	116173731	8000	116174974	-4000	4000	-1243
chrX	50186777	50194777	50194278	8000	50190777	-4000	4000	3501
chrX	149881835	149889835	149885173	8000	149885835	-4000	4000	-662
chrX	83508127	83516127	83508887	8000	83512127	-4000	4000	-3240
chrX	149577653	149585653	149581718	8000	149581653	-4000	4000	65
chrX	149881835	149889835	149885373	8000	149885835	-4000	4000	-462
chrX	128046962	128054962	128052095	8000	128050962	-4000	4000	1133
chrX	26191646	26199646	26195268	8000	26195646	-4000	4000	-378
chrX	92619230	92627230	92623091	8000	92623230	-4000	4000	-139
chrX	22999589	23007589	23000078	8000	23003589	-4000	4000	-3511
chrX	70236659	70244659	70239784	8000	70240659	-4000	4000	-875
chrX	70921579	70929579	70928499	8000	70925579	-4000	4000	2920
chrX	71609583	71617583	71612411	8000	71613583	-4000	4000	-1172
chrX	71609583	71617583	71617365	8000	71613583	-4000	4000	3782
chrX	141893832	141901832	141895518	8000	141897832	-4000	4000	-2314
chrX	34125752	34133752	34130578	8000	34129752	-4000	4000	826
chrX	34125752	34133752	34132083	8000	34129752	-4000	4000	2331
chrX	115188868	115196868	115191336	8000	115192868	-4000	4000	-1532
chrX	48769648	48777648	48773447	8000	48773648	-4000	4000	-201
chrX	145825856	145833856	145829548	8000	145829856	-4000	4000	-308
chrX	27745942	27753942	27746908	8000	27749942	-4000	4000	-3034
chrX	118822968	118830968	118826449	8000	118826968	-4000	4000	-519
chrX	37007664	37015664	37008571	8000	37011664	-4000	4000	-3093
chrX	71301371	71309371	71301782	8000	71305371	-4000	4000	-3589
chrX	71301371	71309371	71304587	8000	71305371	-4000	4000	-784
chrX	135909062	135917062	135912817	8000	135913062	-4000	4000	-245
chrX	14727812	14735812	14730232	8000	14731812	-4000	4000	-1580
chrX	14727812	14735812	14731407	8000	14731812	-4000	4000	-405
chrX	27973992	27981992	27979488	8000	27977992	-4000	4000	1496
chrX	26157824	26165824	26161271	8000	26161824	-4000	4000	-553
chrX	48182220	48190220	48186799	8000	48186220	-4000	4000	579
chrX	87666050	87674050	87669323	8000	87670050	-4000	4000	-727
chrX	86828604	86836604	86832313	8000	86832604	-4000	4000	-291
chrX	153903166	153911166	153906622	8000	153907166	-4000	4000	-544
chrX	64220194	64228194	64225052	8000	64224194	-4000	4000	858
chrX	110519021	110527021	110521682	8000	110523021	-4000	4000	-1339
chrX	141905374	141913374	141906479	8000	141909374	-4000	4000	-2895
chrX	34940915	34948915	34943722	8000	34944915	-4000	4000	-1193
chrX	34940915	34948915	34943560	8000	34944915	-4000	4000	-1355
chrX	51404843	51412843	51407555	8000	51408843	-4000	4000	-1288
chrX	78652068	78660068	78656818	8000	78656068	-4000	4000	750
chrX	27819014	27827014	27821313	8000	27823014	-4000	4000	-1701
chrX	64220194	64228194	64225462	8000	64224194	-4000	4000	1268
chrX	27456207	27464207	27461287	8000	27460207	-4000	4000	1080
chrX	52814301	52822301	52815149	8000	52818301	-4000	4000	-3152
chrX	126545383	126553383	126552131	8000	126549383	-4000	4000	2748
chrX	22999589	23007589	23000537	8000	23003589	-4000	4000	-3052
chrX	21650690	21658690	21652573	8000	21654690	-4000	4000	-2117
chrX	141893832	141901832	141896604	8000	141897832	-4000	4000	-1228
chrX	26136736	26144736	26139970	8000	26140736	-4000	4000	-766
chrX	151741564	151749564	151743197	8000	151745564	-4000	4000	-2367
chrX	110452334	110460334	110454189	8000	110456334	-4000	4000	-2145
chrX	103495130	103503130	103500819	8000	103499130	-4000	4000	1689
chrX	110452334	110460334	110453483	8000	110456334	-4000	4000	-2851
chrX	70060179	70068179	70063744	8000	70064179	-4000	4000	-435
chrX	149713268	149721268	149716295	8000	149717268	-4000	4000	-973
chrX	149588512	149596512	149594516	8000	149592512	-4000	4000	2004
chrX	70036542	70044542	70043563	8000	70040542	-4000	4000	3021
chrX	143030702	143038702	143034043	8000	143034702	-4000	4000	-659
chrX	30216089	30224089	30219055	8000	30220089	-4000	4000	-1034
chrX	70254166	70262166	70259201	8000	70258166	-4000	4000	1035
chrX	34940915	34948915	34942924	8000	34944915	-4000	4000	-1991
chrX	75778987	75786987	75783253	8000	75782987	-4000	4000	266
chrX	75778987	75786987	75784566	8000	75782987	-4000	4000	1579
chrX	141905374	141913374	141907607	8000	141909374	-4000	4000	-1767
chrX	24554087	24562087	24562040	8000	24558087	-4000	4000	3953
chrX	75778987	75786987	75784313	8000	75782987	-4000	4000	1326
chrX	74301034	74309034	74304252	8000	74305034	-4000	4000	-782
chrX	24304210	24312210	24311469	8000	24308210	-4000	4000	3259
chrX	35799735	35807735	35802386	8000	35803735	-4000	4000	-1349
chrX	104111842	104119842	104115556	8000	104115842	-4000	4000	-286
chrX	71301371	71309371	71304584	8000	71305371	-4000	4000	-787
chrX	88750785	88758785	88753776	8000	88754785	-4000	4000	-1009
chrX	70236659	70244659	70240408	8000	70240659	-4000	4000	-251
chrX	74301034	74309034	74304224	8000	74305034	-4000	4000	-810
chrX	120868607	120876607	120875399	8000	120872607	-4000	4000	2792
chrX	126817786	126825786	126821407	8000	126821786	-4000	4000	-379
chrX	133212662	133220662	133217070	8000	133216662	-4000	4000	408
chrX	110519021	110527021	110521105	8000	110523021	-4000	4000	-1916
chrX	34940915	34948915	34944527	8000	34944915	-4000	4000	-388
chrX	114999975	115007975	115007944	8000	115003975	-4000	4000	3969
chrX	26136736	26144736	26139426	8000	26140736	-4000	4000	-1310
chrX	41471710	41479710	41474505	8000	41475710	-4000	4000	-1205
chrX	151741564	151749564	151743399	8000	151745564	-4000	4000	-2165
chrX	64220194	64228194	64224901	8000	64224194	-4000	4000	707
chrX	70921579	70929579	70925809	8000	70925579	-4000	4000	230
chrX	149772867	149780867	149774783	8000	149776867	-4000	4000	-2084
chrX	141905374	141913374	141908074	8000	141909374	-4000	4000	-1300
chrX	24363839	24371839	24364719	8000	24367839	-4000	4000	-3120
chrX	34940915	34948915	34943138	8000	34944915	-4000	4000	-1777
chrX	153578939	153586939	153580328	8000	153582939	-4000	4000	-2611
chrX	71609583	71617583	71617575	8000	71613583	-4000	4000	3992
chrX	143707955	143715955	143712441	8000	143711955	-4000	4000	486
chrX	48263444	48271444	48266975	8000	48267444	-4000	4000	-469
chrX	104007147	104015147	104013198	8000	104011147	-4000	4000	2051
chrX	133019168	133027168	133026169	8000	133023168	-4000	4000	3001
chrX	132072990	132080990	132077614	8000	132076990	-4000	4000	624
chrX	18635688	18643688	18640690	8000	18639688	-4000	4000	1002
chrX	37007664	37015664	37010244	8000	37011664	-4000	4000	-1420
chrX	37007664	37015664	37010622	8000	37011664	-4000	4000	-1042
chrX	70201704	70209704	70202044	8000	70205704	-4000	4000	-3660
chrX	71609583	71617583	71617390	8000	71613583	-4000	4000	3807
chrX	93708274	93716274	93710538	8000	93712274	-4000	4000	-1736
chrX	110452334	110460334	110452507	8000	110456334	-4000	4000	-3827
chrX	149881835	149889835	149885228	8000	149885835	-4000	4000	-607
chrX	151672739	151680739	151674038	8000	151676739	-4000	4000	-2701
chrY	18023746	18031746	18026214	8000	18027746	-4000	4000	-1532
