Chr	Start	End	Name	Score	Strand	Length
chrX	99839933	99854882	TNMD	0	+	14949
chr7	120965421	120981158	WNT16	0	+	15737
chr6	110745890	110797844	SLC22A16	0	-	51954
chr7	20655290	20816658	ABCB5	0	+	161368
chrX	25021811	25034537	ARX	0	-	12726
chr17	42325758	42345509	SLC4A1	0	-	19751
chr7	93053798	93204042	CALCR	0	-	150244
chr17	56347216	56358296	MPO	0	-	11080
chr7	94926988	94953844	PON1	0	-	26856
chr16	1031770	1036979	SOX8	0	+	5209
chr7	95107756	95169545	ASB4	0	+	61789
chr11	17414045	17498441	ABCC8	0	-	84396
chr16	24267656	24373733	CACNG3	0	+	106077
chr17	48638076	48704835	CACNA1G	0	+	66759
chr7	75398851	75419214	CCL26	0	-	20363
chr19	40195121	40200084	LGALS14	0	+	4963
chr17	10204182	10276447	MYH13	0	-	72265
chr2	158733214	158992666	UPP2	0	+	259452
chr19	42055886	42093197	CEACAM21	0	+	37311
chr17	11501787	11873065	DNAH9	0	+	371278
chr17	62015914	62050278	SCN4A	0	-	34364
chr1	209757059	209787284	CAMK1G	0	+	30225
chr6	50681239	50740746	TFAP2D	0	+	59507
chr1	18957340	19075360	PAX7	0	+	118020
chr3	42734155	42744316	HHATL	0	-	10161
chr12	329787	372039	SLC6A13	0	-	42252
chr19	36195460	36207940	ZBTB32	0	+	12480
chr7	44552134	44580929	NPC1L1	0	-	28795
chr8	27092825	27115937	STMN4	0	-	23112
chr5	50679282	50690564	ISL1	0	+	11282
chr1	86934051	86965942	CLCA1	0	+	31891
chr7	99425636	99463716	CYP3A43	0	+	38080
chr19	33321415	33360673	SLC7A9	0	-	39258
chr1	57394880	57440056	C8B	0	-	45176
chr5	161274069	161326987	GABRA1	0	+	52918
chr9	113431059	113568838	MUSK	0	+	137779
chr1	70033605	70617628	LRRC7	0	+	584023
chr4	68424445	68473055	STAP1	0	+	48610
chr14	100150635	100193638	CYP46A1	0	+	43003
chr8	20002366	20040717	SLC18A1	0	-	38351
chr3	121902515	122010476	CASR	0	+	107961
chr5	41142218	41261540	C6	0	-	119322
chr5	157052687	157098488	SOX30	0	-	45801
chr19	12862516	12869272	BEST2	0	+	6756
chr5	24487209	24645087	CDH10	0	-	157878
chr13	109248500	109860353	MYO16	0	+	611853
chr7	49890017	50160925	ZPBP	0	-	270908
chr1	42619081	42621491	GUCA2B	0	+	2410
chr12	5641035	6055398	ANO2	0	-	414363
chrX	73952691	74145307	NEXMIF	0	-	192616
chr11	44281990	44331689	ALX4	0	-	49699
chr6	110565143	110679552	METTL24	0	-	114409
chr20	55904859	55919050	SPO11	0	+	14191
chr20	54572413	54580575	CBLN4	0	-	8162
chr2	56411125	56613307	CCDC85A	0	+	202182
chr3	52811611	52826084	ITIH1	0	+	14473
chr4	72897619	73014022	NPFFR2	0	+	116403
chr22	45277042	45405886	PHF21B	0	-	128844
chr1	76262567	76378927	MSH4	0	+	116360
chr13	113760102	113774999	F7	0	+	14897
chr19	4153628	4173051	CREB3L3	0	+	19423
chr12	130880678	131252773	RIMBP2	0	-	372095
chr5	137419679	137428054	WNT8A	0	+	8375
chrX	2959512	3030768	ARSF	0	+	71256
chr19	49792895	49828472	SLC6A16	0	-	35577
chr22	19134506	19137805	GSC2	0	-	3299
chr11	2323227	2339434	TSPAN32	0	+	16207
chr9	976655	991732	DMRT3	0	+	15077
chr3	87308554	87325734	POU1F1	0	-	17180
chr17	9725523	9795416	GLP2R	0	+	69893
chr3	123687368	123711025	ROPN1	0	-	23657
chr2	79412357	80875986	CTNNA2	0	+	1463629
chr3	137717577	137752497	CLDN18	0	+	34920
chr16	20547548	20587749	ACSM2B	0	-	40201
chrX	152783100	152848397	ATP2B3	0	+	65297
chrX	49452050	49460587	PAGE1	0	-	8537
chr5	135548433	135701233	TRPC7	0	-	152800
chr8	24298443	24384483	ADAM7	0	+	86040
chr11	637269	640706	DRD4	0	+	3437
chr11	626309	627181	SCT	0	-	872
chr5	44300349	44389808	FGF10	0	-	89459
chr19	639879	644373	FGF22	0	+	4494
chr10	50817141	50875988	CHAT	0	+	58847
chr5	149599054	149669656	CAMK2A	0	-	70602
chr1	22889982	22930088	EPHA8	0	+	40106
chr11	2425745	2465744	TRPM5	0	-	39999
chr11	60260251	60274903	MS4A12	0	+	14652
chr2	238475217	238475818	PRLH	0	+	601
chr2	234959323	234985778	SPP2	0	+	26455
chr2	220378892	220403494	ASIC4	0	+	24602
chrX	111011239	111326004	TRPC5	0	-	314765
chr22	50528308	50600119	MOV10L1	0	+	71811
chr2	169772008	169887834	ABCB11	0	-	115826
chr1	157800701	157868046	CD5L	0	-	67345
chr17	45810602	45823488	TBX21	0	+	12886
chr5	175969512	176022975	CDHR2	0	+	53463
chr5	176047083	176057557	SNCB	0	-	10474
chr6	155716502	155776973	NOX3	0	-	60471
chr15	48470635	48596275	SLC12A1	0	+	125640
chr20	62031561	62104030	KCNQ2	0	-	72469
chr10	102222766	102243501	WNT8B	0	+	20735
chr17	64831235	64890868	CACNG5	0	+	59633
chr10	102495153	102589701	PAX2	0	+	94548
chr19	3933067	3942414	NMRK2	0	+	9347
chr7	100240720	100254071	ACTL6B	0	-	13351
chrX	110187513	110470589	PAK3	0	+	283076
chrX	110537007	110655657	DCX	0	-	118650
chr10	22634374	22743153	SPAG6	0	+	108779
chr11	88911043	89028927	TYR	0	+	117884
chr1	236827441	236927931	ACTN2	0	+	100490
chr7	72742164	72772646	FKBP6	0	+	30482
chr16	5289803	7763342	RBFOX1	0	+	2473539
chr7	31091923	31151093	ADCYAP1R1	0	+	59170
chr8	16849690	16859854	FGF20	0	-	10164
chrX	78200829	78219224	P2RY10	0	+	18395
chr9	121915736	122131713	BRINP1	0	-	215977
chr20	31595510	31611509	BPIFB2	0	+	15999
chr18	596988	650334	CLUL1	0	+	53346
chr4	74347462	74369718	AFM	0	+	22256
chr6	25652429	25702011	SCGN	0	+	49582
chr6	72596253	73112852	RIMS1	0	+	516599
chr13	95089065	95131936	DCT	0	-	42871
chr3	96533425	97480376	EPHA6	0	+	946951
chr2	120197419	120282877	SCTR	0	-	85458
chr19	10123925	10132955	RDH8	0	+	9030
chrX	106449841	106487477	DNAAF6	0	+	37636
chr13	46627321	46679168	CPB2	0	-	51847
chr5	113391623	113832197	KCNN2	0	+	440574
chr11	133766333	133826863	IGSF9B	0	-	60530
chr1	196912868	196928752	CFHR2	0	+	15884
chr4	74296855	74321891	AFP	0	+	25036
chr18	63417488	63557573	CDH7	0	+	140085
chr3	100941390	101039419	IMPG2	0	-	98029
chr1	201008640	201081579	CACNA1S	0	-	72939
chr7	122753585	122840026	SLC13A1	0	-	86441
chr2	202509593	202563417	MPP4	0	-	53824
chr11	100900355	101000544	PGR	0	-	100189
chr6	70576448	70922171	COL19A1	0	+	345723
chr1	215179118	215410433	KCNK2	0	+	231315
chr8	54138284	54164197	OPRK1	0	-	25913
chr9	73143976	74061820	TRPM3	0	-	917844
chr2	21224301	21266945	APOB	0	-	42644
chr2	27719706	27746551	GCKR	0	+	26845
chr16	230458	231178	HBQ1	0	+	720
chrX	18694029	18846039	PPEF1	0	+	152010
chr19	50936149	50969578	MYBPC2	0	+	33429
chr16	56622986	56625000	MT3	0	+	2014
chr19	55525073	55549632	GP6	0	-	24559
chr20	138095	139804	DEFB127	0	+	1709
chr4	187187343	187210835	F11	0	+	23492
chr20	20033158	20341347	CFAP61	0	+	308189
chr12	120740119	120751052	SIRT4	0	+	10933
chr12	113008184	113336686	RPH3A	0	+	328502
chr12	117645947	117889975	NOS1	0	-	244028
chr3	164696686	164796284	SI	0	-	99598
chr3	186353758	186370930	FETUB	0	+	17172
chr7	107663993	107770806	LAMB4	0	-	106813
chr7	107301273	107358254	SLC26A4	0	+	56981
chr7	107405912	107443670	SLC26A3	0	-	37758
chr3	3108008	3168297	IL5RA	0	-	60289
chrX	21724096	21776234	SMPX	0	-	52138
chr17	64208151	64252643	APOH	0	-	44492
chr11	22359927	22401049	SLC17A6	0	+	41122
chr7	130020180	130027955	CPA1	0	+	7775
chr14	24974559	24977471	CMA1	0	-	2912
chr14	23881949	23904869	MYH7	0	-	22920
chr14	23586245	23589465	CEBPE	0	-	3220
chr14	21748242	21819460	RPGRIP1	0	+	71218
chr3	16628299	16711813	DAZL	0	-	83514
chrY	6778727	6970011	TBL1Y	0	+	191284
chr1	36549695	36553876	TEKT2	0	+	4181
chr19	15193022	15203781	OR1I1	0	+	10759
chr11	114389656	114430603	NXPE1	0	-	40947
chr10	95372294	95425767	PDE6C	0	+	53473
chr10	115939029	115992425	TDRD1	0	+	53396
chr6	39282474	39290744	KCNK16	0	-	8270
chr6	41303346	41318627	NCR2	0	+	15281
chr6	33762450	33771780	MLN	0	-	9330
chr16	31000577	31021959	STX1B	0	-	21382
chr19	1285872	1301430	EFNA2	0	+	15558
chrY	4868267	5610265	PCDH11Y	0	+	741998
chr19	589881	617159	HCN2	0	+	27278
chr19	489176	505343	MADCAM1	0	+	16167
chr22	30843946	30868004	SEC14L3	0	-	24058
chr22	24890075	24924358	UPB1	0	+	34283
chr22	25595825	25603326	CRYBB3	0	+	7501
chr22	31530793	31536494	PLA2G3	0	-	5701
chr22	22987085	22990368	GGTLC2	0	+	3283
chr22	26995242	27013991	CRYBB1	0	-	18749
chr22	38474141	38480191	SLC16A8	0	-	6050
chr22	32614451	32651334	SLC5A4	0	-	36883
chr22	38914953	38966209	DMC1	0	-	51256
chr22	23401593	23487208	RSPH14	0	-	85615
chr22	29454660	29457819	C22orf31	0	-	3159
chr22	50925213	50929077	MIOX	0	+	3864
chr22	51176624	51183767	ACR	0	+	7143
chr22	44275558	44287893	PNPLA5	0	-	12335
chr22	50497820	50523855	MLC1	0	-	26035
chr14	88646447	88793251	KCNK10	0	-	146804
chr14	77292715	77336647	LRRC74A	0	+	43932
chr14	70510932	70655787	SLC8A3	0	-	144855
chr14	24540046	24547309	CPNE6	0	+	7263
chr20	25051521	25062777	VSX1	0	-	11256
chr20	42965683	42979878	R3HDML	0	+	14195
chr20	57594484	57601709	TUBB1	0	+	7225
chr20	60790016	60795334	HRH3	0	-	5318
chr20	61867235	61871847	BIRC7	0	+	4612
chr20	61872136	61904046	NKAIN4	0	-	31910
chr20	3063202	3065370	AVP	0	-	2168
chr20	61924538	61966203	COL20A1	0	+	41665
chr20	61974575	62009753	CHRNA4	0	-	35178
chr20	3758151	3762095	SPEF1	0	-	3944
chr20	5279864	5297600	PROKR2	0	-	17736
chr20	30407111	30422492	MYLK2	0	+	15381
chr20	7863632	7921105	HAO1	0	-	57473
chr20	1959403	1974931	PDYN	0	-	15528
chr20	9518017	9819724	PAK5	0	-	301707
chr20	3052266	3053163	OXT	0	+	897
chr20	36932552	36965907	BPI	0	+	33355
chr20	23545369	23549121	CST9L	0	-	3752
chr20	37353129	37358015	SLC32A1	0	+	4886
chr20	32782375	32857150	ASIP	0	+	74775
chr20	44141101	44144262	SPINT3	0	-	3161
chr18	34823003	35145790	CELF4	0	-	322787
chr18	59000663	59223012	CDH20	0	+	222349
chr18	44247784	44339220	ST8SIA5	0	-	91436
chr18	31431064	31804916	NOL4	0	-	373852
chrX	103294523	103297021	H2BW2	0	+	2498
chrX	119243009	119249823	RHOXF1	0	-	6814
chrX	108616135	108725315	GUCY2F	0	-	109180
chrX	119495940	119517104	ATP1B4	0	+	21164
chrX	49593863	49598867	PAGE4	0	+	5004
chrX	14547420	14749934	GLRA2	0	+	202514
chrX	138663929	138790375	MCF2	0	-	126446
chrX	138612898	138645618	F9	0	+	32720
chrX	49061523	49089833	CACNA1F	0	-	28310
chrX	114524281	114542128	LUZP4	0	+	17847
chrX	63487961	63615332	MTMR8	0	-	127371
chrX	42636617	42637414	PPP1R2C	0	-	797
chrX	153409717	153424507	OPN1LW	0	+	14790
chrX	102192200	102193228	RAB40AL	0	+	1028
chrX	48644948	48652718	GATA1	0	+	7770
chrX	150345056	150349937	GPR50	0	+	4881
chrX	24576204	24690794	PCYT1B	0	-	114590
chrX	135570106	135575939	BRS3	0	+	5833
chrX	135730317	135742549	CD40LG	0	+	12232
chrX	86772412	86925050	KLHL4	0	+	152638
chrX	91034260	91878229	PCDH11X	0	+	843969
chrX	54775351	54824688	ITIH6	0	-	49337
chrX	74588262	74743337	ZDHHC15	0	-	155075
chrX	100474758	100519491	DRP2	0	+	44733
chrX	100523241	100548045	TAF7L	0	-	24804
chr13	47405681	47471211	HTR2A	0	-	65530
chr13	49794474	49796513	MLNR	0	+	2039
chr13	22245212	22278637	FGF9	0	+	33425
chr13	77522646	77532773	ACOD1	0	+	10127
chr16	49311828	49315749	CBLN1	0	-	3921
chr16	84001849	84036381	NECAB2	0	+	34532
chr16	21208771	21225831	ZP2	0	-	17060
chr16	2833954	2837949	PRSS33	0	-	3995
chr16	25227052	25240253	AQP8	0	+	13201
chr15	28000021	28344461	OCA2	0	-	344440
chr8	55421982	55784280	RP1	0	+	362298
chr8	143915663	143997922	GML	0	+	82259
chr8	124693034	124749642	ANXA13	0	-	56608
chr8	39601254	39695746	ADAM2	0	-	94492
chr8	17721889	17767874	FGL1	0	-	45985
chr19	49384224	49402001	TULP2	0	-	17777
chr19	49519237	49520348	LHB	0	-	1111
chr19	49570654	49575956	KCNA7	0	-	5302
chr19	45809671	45826133	CKM	0	-	16462
chr19	7733935	7735341	RETN	0	+	1406
chr19	7828096	7834491	CLEC4M	0	+	6395
chr19	46298971	46318566	RSPH6A	0	-	19595
chr19	55105047	55113846	LILRA1	0	+	8799
chr19	40093164	40098114	LGALS13	0	+	4950
chr19	40221895	40228669	CLC	0	-	6774
chr19	4279263	4290719	SHD	0	+	11456
chr19	36602045	36604613	OVOL3	0	+	2568
chr19	3804022	3869036	ZFR2	0	-	65014
chr19	42125388	42133442	CEACAM4	0	-	8054
chr19	51954101	51961710	SIGLEC8	0	-	7609
chr19	51883163	51891228	LIM2	0	-	8065
chr19	48323036	48346587	CRX	0	+	23551
chr19	5455428	5456867	ZNRF4	0	+	1439
chr19	48867624	48879634	SYNGR4	0	+	12010
chr19	48532640	48547336	CABP5	0	-	14696
chr19	361747	376026	THEG	0	-	14279
chr19	49258781	49261590	FGF21	0	+	2809
chr19	54412532	54447204	CACNG7	0	+	34672
chr19	12995236	12998015	KLF1	0	-	2779
chr19	18062102	18110894	KCNN1	0	+	48792
chr19	36040933	36054560	ATP4A	0	-	13627
chr19	35783028	35804710	MAG	0	+	21682
chr19	35771619	35776046	HAMP	0	+	4427
chr7	25264189	25268105	NPVF	0	-	3916
chr7	117854723	118136225	ANKRD7	0	+	281502
chr7	158820866	158937559	VIPR2	0	-	116693
chr7	30978284	31032869	GHRHR	0	+	54585
chr7	75440143	75452674	CCL24	0	-	12531
chr7	123469037	123517535	HYAL4	0	+	48498
chr7	123565291	123611468	SPAM1	0	+	46177
chr7	127250346	127258196	PAX4	0	-	7850
chr7	100181605	100198740	FBXO24	0	+	17135
chr7	31726829	31748069	PPP1R17	0	+	21240
chr7	100838288	100844319	MOGAT3	0	-	6031
chr7	144094333	144107320	NOBOX	0	-	12987
chr7	101256610	101272576	MYL10	0	-	15966
chr7	44178463	44180931	MYL7	0	-	2468
chr7	44182812	44237769	GCK	0	-	54957
chr7	151653464	151717014	GALNTL5	0	+	63550
chr9	126763949	126795580	LHX2	0	+	31631
chr9	116822407	116840608	AMBP	0	-	18201
chr9	117655623	117692875	TNFSF8	0	-	37252
chr9	5299864	5304716	RLN2	0	-	4852
chr9	5334930	5339876	RLN1	0	-	4946
chr9	138594031	138687354	KCNT1	0	+	93323
chr9	12685439	12710285	TYRP1	0	+	24846
chr9	139088096	139096974	LHX3	0	-	8878
chr10	98064166	98098321	DNTT	0	+	34155
chr10	116853124	117708510	ATRNL1	0	+	855386
chr10	102047906	102090021	PKD2L1	0	-	42115
chr10	16865965	17171810	CUBN	0	-	305845
chr10	103529866	103540128	FGF8	0	-	10262
chr10	103989943	104001269	PITX3	0	-	11326
chr10	108333421	108924464	SORCS1	0	-	591043
chr10	95517597	95566029	LGI1	0	+	48432
chr17	27573877	27581512	CRYBA1	0	+	7635
chr17	39576799	39580837	KRT37	0	-	4038
chr17	31340105	32501983	ASIC2	0	-	1161878
chr17	32597240	32599261	CCL7	0	+	2021
chr17	32687347	32690252	CCL1	0	-	2905
chr17	39615765	39623638	KRT32	0	-	7873
chr17	42018172	42019844	PPY	0	-	1672
chr17	65040670	65052913	CACNG1	0	+	12243
chr17	9799637	9808588	RCVRN	0	-	8951
chr17	10395624	10421859	MYH1	0	-	26235
chr4	41746099	41750742	PHOX2B	0	-	4643
chr4	46920917	46995598	GABRA4	0	-	74681
chr4	68602836	68620106	GNRHR	0	-	17270
chr4	69681712	69697741	UGT2B10	0	+	16029
chr4	71061442	71070293	ODAM	0	+	8851
chr4	71226477	71232875	SMR3A	0	+	6398
chr4	74719013	74720200	PF4V1	0	+	1187
chr4	141480585	141490115	UCP1	0	-	9530
chr4	123372625	123377880	IL2	0	-	5255
chr4	10488019	10686392	CLNK	0	-	198373
chr4	13542454	13546132	NKX3-2	0	-	3678
chr4	3443695	3451213	HGFAC	0	+	7518
chr11	125773243	125813597	DDX25	0	+	40354
chr11	20177701	20182021	DBX1	0	-	4320
chr11	120971952	121062199	TECTA	0	+	90247
chr11	122709208	122743351	CRTAM	0	+	34143
chr11	57105826	57139869	P2RX3	0	+	34043
chr11	6281036	6293357	CCKBR	0	+	12321
chr11	6452279	6463847	HPX	0	-	11568
chr11	71825915	71850936	FOLR3	0	+	25021
chr11	116660083	116663136	APOA5	0	-	3053
chr11	116691416	116694020	APOA4	0	-	2604
chr11	116700422	116703788	APOC3	0	+	3366
chr11	35272752	35441610	SLC1A2	0	-	168858
chr11	62037630	62040632	SCGB2A2	0	+	3002
chr11	107461817	107537505	ELMOD1	0	+	75688
chr11	18749475	18814268	PTPN5	0	-	64793
chr12	109252708	109294819	DAO	0	+	42111
chr12	33527173	33592754	SYT10	0	-	65581
chr12	81101413	81103253	MYF6	0	+	1840
chr12	81110691	81113450	MYF5	0	+	2759
chr12	3490515	3703139	PRMT8	0	+	212624
chr12	4537321	4554981	FGF6	0	-	17660
chr12	111348623	111359247	MYL2	0	-	10624
chr12	111471969	111788358	CUX2	0	+	316389
chr12	5019071	5027422	KCNA1	0	+	8351
chr12	13093509	13105104	GPRC5D	0	-	11595
chr12	48103517	48119350	ENDOU	0	-	15833
chr12	68595129	68619590	IL26	0	-	24461
chr12	68548548	68553520	IFNG	0	-	4972
chr12	7801996	7818504	APOBEC1	0	-	16508
chr12	7940390	7951742	NANOG	0	+	11352
chr12	8754751	8765838	AICDA	0	-	11087
chr12	106976782	107156581	RFX4	0	+	179799
chr6	116937642	116954148	RSPH4A	0	+	16506
chr6	89964183	90025018	GABRR2	0	-	60835
chr6	35465651	35480673	TULP1	0	-	15022
chr6	35911293	35992645	SLC26A8	0	-	81352
chr6	49572888	49604552	RHAG	0	-	31664
chr6	52051173	52055436	IL17A	0	+	4263
chr6	52101479	52110487	IL17F	0	-	9008
chr6	39016557	39059079	GLP1R	0	+	42522
chr6	41157487	41168887	TREML2	0	-	11400
chr6	97010424	97066502	FHL5	0	+	56078
chr6	62389866	62996130	KHDRBS2	0	-	606264
chr6	100054650	100063454	PRDM13	0	+	8804
chr6	100832885	100912797	SIM1	0	-	79912
chr6	22569795	22571895	HDGFL1	0	+	2100
chr6	108487226	108510009	NR2E1	0	+	22783
chr6	25912982	25930919	SLC17A2	0	-	17937
chr6	167684657	167729502	UNC93A	0	+	44845
chr6	160592093	160698670	SLC22A2	0	-	106577
chr6	165693153	165723094	C6orf118	0	-	29941
chr6	42151022	42162694	GUCA1B	0	-	11672
chr6	76630831	76782395	IMPG1	0	-	151564
chr6	46761126	46807515	MEP1A	0	+	46389
chr5	137450864	137475132	NME5	0	-	24268
chr5	139739779	139754726	SLC4A9	0	+	14947
chr5	26880706	27121257	CDH9	0	-	240551
chr5	153854532	153857787	HAND1	0	-	3255
chr5	178404588	178423207	GRM6	0	-	18619
chr5	158741788	158757871	IL12B	0	-	16083
chr5	180326077	180377906	BTNL8	0	+	51829
chr5	161427063	161589983	GABRG2	0	+	162920
chr5	34998206	35048240	AGXT2	0	-	50034
chr5	132009678	132018370	IL4	0	+	8692
chr5	39284242	39371426	C9	0	-	87184
chr5	149546341	149564121	CDX1	0	+	17780
chr5	176237520	176307899	UNC5A	0	+	70379
chr3	186435137	186462199	KNG1	0	+	27062
chr3	186378005	186396023	HRG	0	+	18018
chr3	120347019	120401116	HGD	0	-	54097
chr3	139171726	139199589	RBP2	0	-	27863
chr3	169556960	169587723	LRRC31	0	-	30763
chr3	50229043	50235129	GNAT1	0	+	6086
chr3	108015376	108097132	HHLA2	0	+	81756
chr3	108677095	108836981	MORC1	0	-	159886
chr3	125688003	125702297	ROPN1B	0	+	14294
chr3	179512746	179754841	PEX5L	0	-	242095
chr2	25383722	25391772	POMC	0	-	8050
chr2	162999392	163008914	GCG	0	-	9522
chr2	74740590	74744275	TLX2	0	+	3685
chr2	79347488	79350535	REG1A	0	+	3047
chr2	84743579	85046713	DNAH6	0	+	303134
chr2	233897382	233899767	NEU2	0	+	2385
chr2	219687031	219696809	PRKAG3	0	-	9778
chr2	88367344	88412903	SMYD1	0	+	45559
chr2	103035149	103069025	IL18RAP	0	+	33876
chr2	1377838	1547483	TPO	0	+	169645
chr2	172964166	172967628	DLX2	0	-	3462
chr2	136545420	136594754	LCT	0	-	49334
chr19	917287	921005	KISS1R	0	+	3718
chr1	175284330	175712752	TNR	0	-	428422
chr1	6161847	6240381	CHD5	0	-	78534
chr1	29138682	29197779	OPRD1	0	+	59097
chr1	186412698	186430246	PDC	0	-	17548
chr1	12851546	12856777	PRAMEF1	0	+	5231
chr1	12833881	12838049	PRAMEF12	0	+	4168
chr1	68894505	68915637	RPE65	0	-	21132
chr1	115215711	115238239	AMPD1	0	-	22528
chr1	119911402	119936753	HAO2	0	+	25351
chr1	40116901	40137779	NT5C1A	0	-	20878
chr1	40144320	40157157	HPCAL4	0	-	12837
chr1	238041164	238054222	ZP4	0	-	13058
chr1	43803489	43820137	MPL	0	+	16648
chr1	170904667	171033906	MROH9	0	+	129239
chr1	172628243	172636016	FASLG	0	+	7773
chr1	99355801	99693485	PLPPR5	0	-	337684
chr1	173872938	173886465	SERPINC1	0	-	13527
chr1	48688357	48714316	SLC5A9	0	+	25959
chr15	78916453	79020096	CHRNB4	0	-	103643
chr3	137842555	137851232	A4GNT	0	-	8677
chr11	102582527	102597781	MMP8	0	-	15254
chr11	116706467	116708338	APOA1	0	-	1871
chr2	208986331	208989248	CRYGD	0	-	2917
chr2	217724181	217724787	TNP1	0	-	606
chr1	150229646	150237478	CA14	0	+	7832
chr6	88757559	88776556	SPACA1	0	+	18997
chr6	146920103	147136598	ADGB	0	+	216495
chr6	135238531	135271253	ALDH8A1	0	-	32722
chr6	131791972	131905472	ARG1	0	+	113500
chr1	102268116	102462482	OLFM3	0	-	194366
chr2	196602427	196933561	DNAH7	0	-	331134
chr9	77337411	77503010	TRPM6	0	-	165599
chr1	231297804	231357311	TRIM67	0	+	59507
chr14	74706152	74729441	VSX2	0	+	23289
chr14	76777055	76968180	ESRRB	0	+	191125
chr10	114043158	114064796	TECTB	0	+	21638
chr10	103986056	103989346	ELOVL3	0	+	3290
chr10	101292699	101296281	NKX2-3	0	+	3582
chr10	120349509	120355160	PRLHR	0	-	5651
chr10	106113591	106214860	CFAP58	0	+	101269
chr10	101801950	101841626	CPN1	0	-	39676
chr10	99526508	99531756	SFRP5	0	-	5248
chr17	46605888	46608373	HOXB1	0	-	2485
chr9	27284652	27297148	EQTN	0	-	12496
chr9	5231419	5235304	INSL4	0	+	3885
chr9	21349834	21351377	KNOWN	0	-	1543
chr9	21409116	21410184	IFNA8	0	+	1068
chr4	158125334	158287227	GRIA2	0	+	161893
chr6	151815152	151942328	CCDC170	0	+	127176
chrX	30576926	30595883	TASL	0	-	18957
chr1	173008342	173020081	TNFSF18	0	-	11739
chr6	167568735	167571468	GPR31	0	-	2733
chr6	167738559	167772991	TTLL2	0	+	34432
chrX	69748790	70128561	TEX11	0	-	379771
chrX	69488155	69501690	ARR3	0	+	13535
chr10	29577990	29607257	LYZL1	0	+	29267
chr5	137203547	137223540	MYOT	0	+	19993
chr8	27317273	27337400	CHRNA2	0	-	20127
chr8	26605667	26724795	ADRA1A	0	-	119128
chr1	11917521	11919002	NPPB	0	-	1481
chr1	12916941	12921764	PRAMEF2	0	+	4823
chr17	56270087	56282535	EPX	0	+	12448
chr17	56634039	56769416	TEX14	0	-	135377
chr12	10958650	10959885	TAS2R8	0	-	1235
chr12	11544474	11653975	PRB2	0	-	109501
chr12	10954131	10955226	TAS2R7	0	-	1095
chr12	10961693	10962767	TAS2R9	0	-	1074
chr1	182378327	182529734	RGSL1	0	+	151407
chr3	109044991	109056393	DPPA4	0	-	11402
chr1	147374921	147381396	GJA8	0	+	6475
chr3	172161081	172166246	GHSR	0	-	5165
chr3	164904508	164914897	SLITRK3	0	-	10389
chr5	75379208	75649764	SV2C	0	+	270556
chr13	28577411	28674729	FLT3	0	-	97318
chr9	138437972	138441815	OBP2A	0	+	3843
chrX	79270252	79287273	TBX22	0	+	17021
chr1	203052257	203055140	MYOG	0	-	2883
chr6	161123270	161175129	PLG	0	+	51859
chr16	22825483	22927659	HS3ST2	0	+	102176
chr7	5919458	5925994	OCM	0	+	6536
chr7	8473239	8792591	NXPH1	0	+	319352
chr7	24323807	24331481	NPY	0	+	7674
chr9	34957605	34982541	PHF24	0	+	24936
chr9	34457412	34520986	DNAI1	0	+	63574
chr7	137687070	137803051	AKR1D1	0	+	115981
chrX	51075083	51080377	NUDT10	0	+	5294
chr10	81370695	81375211	SFTPA1	0	+	4516
chr10	71331454	71333178	NEUROG3	0	-	1724
chrX	127184941	127186382	ACTRT1	0	-	1441
chr13	52436105	52440368	CCDC70	0	+	4263
chr12	55413758	55423801	NEUROD4	0	+	10043
chr12	54348687	54352740	HOXC12	0	+	4053
chr9	136501485	136524451	DBH	0	+	22966
chrX	103028647	103047548	PLP1	0	+	18901
chrX	105276426	105282718	SERPINA7	0	-	6292
chrX	103265719	103268280	H2BW1	0	-	2561
chrX	103494719	103499614	ESX1	0	-	4895
chrX	13336766	13338172	ATXN3L	0	-	1406
chr1	207277578	207318317	C4BPA	0	+	40739
chr1	207262205	207273338	C4BPB	0	+	11133
chr11	94110482	94134585	GPR83	0	-	24103
chr2	228735770	228789060	DAW1	0	+	53290
chr2	223536377	223574649	MOGAT1	0	+	38272
chr2	225243415	225266824	FAM124B	0	-	23409
chr20	54823788	54824871	MC3R	0	+	1083
chr20	56071022	56100708	CTCFL	0	-	29686
chr20	43850014	43853099	SEMG2	0	+	3085
chr20	43922085	43937169	MATN4	0	-	15084
chr20	42875739	42909587	GDAP1L1	0	+	33848
chr20	42354804	42355642	GTSF1L	0	-	838
chr20	57875498	57901047	EDN3	0	+	25549
chr20	56791182	56803709	ANKRD60	0	-	12527
chr20	43835674	43838409	SEMG1	0	+	2735
chr20	56725958	56736206	C20orf85	0	+	10248
chr16	88704980	88706876	IL17C	0	+	1896
chr19	44220228	44224173	IRGC	0	+	3945
chr19	43256838	43359843	PSG8	0	-	103005
chr19	43084395	43099207	CEACAM8	0	-	14812
chrX	43808022	43832641	NDP	0	-	24619
chr6	49660071	49681303	CRISP2	0	-	21232
chr6	33986420	34123399	GRM4	0	-	136979
chr6	26500531	26510653	BTN1A1	0	+	10122
chr6	25833294	25882514	SLC17A3	0	-	49220
chr6	25783143	25832280	SLC17A1	0	-	49137
chr6	26017260	26018015	H1-1	0	-	755
chr6	27925019	27925960	OR2B6	0	+	941
chr6	35085848	35116387	TCP11	0	-	30539
chr6	38683087	38998568	DNAH8	0	+	315481
chr6	39266777	39282237	KCNK17	0	-	15460
chr6	49801970	49844809	CRISP1	0	-	42839
chr6	47749718	47800516	OPN5	0	+	50798
chr11	55650773	55659286	TRIM51	0	+	8513
chr11	62009711	62012284	SCGB1D2	0	+	2573
chr11	61976145	61981415	SCGB2A1	0	+	5270
chr3	8661072	8786726	SSUH2	0	-	125654
chr12	49372105	49376403	WNT1	0	+	4298
chr12	130822432	130857182	PIWIL1	0	+	34750
chr13	103696348	103718767	SLC10A2	0	-	22419
chr6	168396921	168445771	KIF25	0	+	48850
chrX	119392505	119445411	TMEM255A	0	-	52906
chr17	15207128	15244949	TEKT3	0	-	37821
chr17	10424465	10453017	MYH2	0	-	28552
chr9	135457993	135465639	BARHL1	0	+	7646
chr19	55281245	55295774	KIR2DL1	0	+	14529
chr20	61637279	61638387	BHLHE23	0	-	1108
chr2	113668742	113676459	IL37	0	+	7717
chrX	122318006	122624766	GRIA3	0	+	306760
chr20	3024268	3026393	GNRH2	0	+	2125
chr20	123231	126392	DEFB126	0	+	3161
chr20	21686297	21699119	PAX1	0	+	12822
chr20	23471738	23476647	CST8	0	+	4909
chr20	21376003	21378164	NKX2-4	0	-	2161
chr20	21491655	21494702	NKX2-2	0	-	3047
chr20	23406741	23425567	CSTL1	0	+	18826
chr20	23431040	23433513	CST11	0	-	2473
chr20	17206752	17465223	PCSK2	0	+	258471
chr20	3639895	3644046	GFRA4	0	-	4151
chr20	6021192	6034706	LRRN4	0	-	13514
chr20	16729003	16750707	OTOR	0	+	21704
chr20	17674317	17716516	BANF2	0	+	42199
chr20	207899	210527	DEFB129	0	+	2628
chr20	34021145	34042568	GDF5	0	-	21423
chr20	34111014	34117481	C20orf173	0	-	6467
chrX	16141688	16171641	GRPR	0	+	29953
chr13	113812962	113826700	PROZ	0	+	13738
chr19	35861970	35863864	GPR42	0	+	1894
chr19	35838805	35844766	FFAR1	0	+	5961
chr17	39642388	39648798	KRT36	0	-	6410
chr19	50243010	50266563	TSKS	0	-	23553
chr4	70796786	70812292	CSN1S1	0	+	15506
chr4	70861683	70868287	STATH	0	+	6604
chr4	70916155	70924565	HTN1	0	+	8410
chr19	54382444	54410906	PRKCG	0	+	28462
chr16	90122974	90158480	PRDM7	0	-	35506
chr1	192605268	192629441	RGS13	0	+	24173
chr12	68642022	68647384	IL22	0	-	5362
chr12	70037140	70093256	BEST3	0	-	56116
chr7	141490017	141491167	TAS2R5	0	+	1150
chr7	151125918	151137899	CRYGN	0	-	11981
chr7	142605267	142630843	TRPV5	0	-	25576
chr19	14951278	14959734	OR7A10	0	-	8456
chr19	15052301	15053260	OR7C2	0	+	959
chr19	14900072	14946188	OR7C1	0	-	46116
chr5	148750887	148783765	IL17B	0	-	32878
chr17	3336164	3337135	OR1E2	0	-	971
chr19	57173348	57183151	ZNF835	0	-	9803
chr4	57676026	57687908	SPINK2	0	-	11882
chr22	30950622	30970652	GAL3ST1	0	-	20030
chr22	29834572	29838444	RFPL1	0	+	3872
chr22	32586422	32601060	RFPL2	0	-	14638
chr22	32750872	32757148	RFPL3	0	+	6276
chr22	41075277	41078816	MCHR1	0	+	3539
chr22	38219389	38221492	GALR3	0	+	2103
chr22	36113919	36125530	APOL5	0	+	11611
chr22	23915312	23922489	IGLL1	0	-	7177
chr17	19314438	19320589	RNF112	0	+	6151
chr7	122634758	122635754	TAS2R16	0	-	996
chr7	105517242	105676878	CDHR3	0	+	159636
chr7	121941357	121950745	FEZF1	0	-	9388
chr2	178487972	178973066	PDE11A	0	-	485094
chr11	17741118	17743683	MYOD1	0	+	2565
chr11	18039102	18067816	TPH1	0	-	28714
chr11	19203577	19232118	CSRP3	0	-	28541
chr17	6297013	6338519	AIPL1	0	-	41506
chr17	74449433	74466199	AANAT	0	+	16766
chr11	3666358	3685646	ART1	0	+	19288
chrY	16168107	16168838	VCY1B	0	+	731
chrY	16097652	16098353	VCY	0	-	701
chrY	19990140	19992100	CDY2B	0	-	1960
chr16	89238156	89261900	CDH15	0	+	23744
chr19	812488	821955	PLPPR3	0	-	9467
chrX	150863079	150874396	PRRG3	0	+	11317
chr12	4829566	4961093	GALNT8	0	+	131527
chr12	5153045	5155954	KCNA5	0	+	2909
chr9	91148948	91199189	NXNL2	0	+	50241
chr19	11406815	11437672	TSPAN16	0	+	30857
chr16	3138891	3149296	ZSCAN10	0	-	10405
chr7	153584182	154685995	DPP6	0	+	1101813
chr19	19322767	19363042	NCAN	0	+	40275
chr6	160312020	160338479	MAS1	0	+	26459
chrX	50653735	50659641	BMP15	0	+	5906
chr7	100318091	100321323	EPO	0	+	3232
chr19	54494891	54515920	CACNG6	0	+	21029
chr22	16448824	16449805	KNOWN	0	-	981
chr2	234216462	234255701	SAG	0	+	39239
chr9	133539981	133558373	PRDM12	0	+	18392
chr12	123259073	123312075	CCDC62	0	+	53002
chr22	46651560	46659240	PKDREJ	0	-	7680
chr9	97080480	97090926	NUTM2F	0	-	10446
chr9	97321002	97356106	FBP2	0	-	35104
chr20	30458437	30532803	TTLL9	0	+	74366
chr20	31749574	31769218	BPIFA2	0	+	19644
chr20	31805116	31815612	BPIFA3	0	+	10496
chr20	29956404	29961726	DEFB118	0	+	5322
chr17	42980527	42994305	GFAP	0	-	13778
chr17	42030101	42081837	PYY	0	-	51736
chr19	43905648	43922749	TEX101	0	+	17101
chr19	8117202	8127544	CCL25	0	+	10342
chr5	176806236	176825849	SLC34A1	0	+	19613
chrX	72666889	72675007	CDX4	0	+	8118
chr19	14729929	14800839	ADGRE3	0	-	70910
chr3	14716648	14814543	C3orf20	0	+	97895
chr17	41052814	41066455	G6PC1	0	+	13641
chr1	9005926	9035151	CA6	0	+	29225
chrX	119292519	119299536	RHOXF2	0	+	7017
chr5	80529139	80562217	CKMT2	0	+	33078
chr11	30252561	30256808	FSHB	0	+	4247
chr19	57630506	57643294	USP29	0	+	12788
chr1	26737308	26756219	LIN28A	0	+	18911
chr14	60386431	60530277	LRRC9	0	+	143846
chr11	6255995	6265709	CNGA4	0	+	9714
chr7	50526134	50633102	DDC	0	-	106968
chrX	31089350	31090158	FTHL17	0	-	808
chr17	7905933	7923660	GUCY2D	0	+	17727
chr8	100973164	101143496	RGS22	0	-	170332
chr20	18794427	18795022	SCP2D1	0	+	595
chr20	23015949	23019874	SSTR4	0	+	3925
chr1	159682079	159684379	CRP	0	-	2300
chr1	156589123	156595517	HAPLN2	0	+	6394
chr1	159557616	159558655	APCS	0	+	1039
chr1	157715523	157746922	FCRL2	0	-	31399
chr11	67410026	67418201	ACY3	0	-	8175
chr18	40847857	40857500	SYT4	0	-	9643
chr18	42792960	43263653	SLC14A2	0	+	470693
chr5	151771107	151812929	NMUR2	0	-	41822
chr5	149237516	149324356	PDE6A	0	-	86840
chr13	19997016	20135765	TPTE2	0	-	138749
chr13	25338307	25454059	RNF17	0	+	115752
chr13	27329337	27334923	GPR12	0	-	5586
chr17	10293639	10325267	MYH8	0	-	31628
chr13	32313663	32377526	RXFP2	0	+	63863
chr13	38206200	38443939	TRPC4	0	-	237739
chr13	39540062	39564996	STOML3	0	-	24934
chrX	107963176	107979793	IRS4	0	-	16617
chr11	63273524	63284246	LGALS12	0	+	10722
chr12	85430092	85658235	LRRIQ1	0	+	228143
chr10	82104501	82127829	DYDC2	0	+	23328
chr8	30689060	30770524	TEX15	0	-	81464
chr8	33448848	33457541	DUSP26	0	-	8693
chr14	95234560	95236450	GSC	0	-	1890
chr14	93799565	94174222	UNC79	0	+	374657
chr14	74769772	74826711	VRTN	0	+	56939
chr14	70989075	71001732	ADAM20	0	-	12657
chr8	22570764	22857513	PEBP4	0	-	286749
chr18	48321490	48351772	MRO	0	-	30282
chr3	1134342	1445901	CNTN6	0	+	311559
chr15	31293264	31453476	TRPM1	0	-	160212
chr1	110145713	110162551	GNAT2	0	-	16838
chr1	115572447	115576923	TSHB	0	+	4476
chr1	114631913	114696502	SYT6	0	-	64589
chr1	111833473	111863188	CHIA	0	+	29715
chr1	120436156	120439138	ADAM30	0	-	2982
chr1	115828525	115881391	NGF	0	-	52866
chr1	196857144	196887925	CFHR4	0	+	30781
chr1	197237334	197447585	CRB1	0	+	210251
chr1	196944140	196978808	CFHR5	0	+	34668
chr18	56934267	56941318	RAX	0	-	7051
chr18	56887390	56898006	GRP	0	+	10616
chr18	22040601	22059925	HRH4	0	+	19324
chr12	23682438	24715478	SOX5	0	-	1033040
chr12	21284128	21392730	SLCO1B1	0	+	108602
chr11	47352957	47374253	MYBPC3	0	-	21296
chrX	132157196	132231137	USP26	0	-	73941
chrX	129305936	129318844	RAB33A	0	+	12908
chrX	139585150	139587234	SOX3	0	-	2084
chr11	92702817	92718232	MTNR1B	0	+	15415
chr11	59596746	59612972	CBLIF	0	-	16226
chr4	39408550	39453153	KLB	0	+	44603
chr12	117293949	117319246	HRK	0	-	25297
chr7	97613999	97620481	OCM2	0	-	6482
chr4	70820974	70831446	CSN2	0	-	10472
chr4	70146193	70160768	UGT2B28	0	+	14575
chr7	128349115	128371797	GARIN1B	0	+	22682
chr6	69345174	70100463	ADGRB3	0	+	755289
chr6	78170641	78173208	HTR1B	0	-	2567
chr6	90604188	90631479	GJA10	0	+	27291
chr12	53817639	53825456	AMHR2	0	+	7817
chr12	55024595	55028679	LACRT	0	-	4084
chr6	132909731	132910880	TAAR5	0	-	1149
chr6	142379467	142468259	NMBR	0	-	88792
chr2	73518057	73520829	EGR4	0	-	2772
chr16	81272294	81324747	BCO1	0	+	52453
chr1	182610951	182653722	RGS8	0	-	42771
chr2	231772033	231825781	GPR55	0	-	53748
chr2	233390703	233401377	CHRND	0	+	10674
chr2	223064606	223163717	PAX3	0	-	99111
chr2	105858200	105859924	GPR45	0	+	1724
chr12	103981051	104160497	STAB2	0	+	179446
chr13	53417024	53422776	PCDH8	0	-	5752
chr13	53277399	53313955	CNMD	0	-	36556
chr7	44037496	44049723	SPDYE1	0	+	12227
chr7	14184674	15014402	DGKB	0	-	829728
chr7	4945620	4998844	MMD2	0	-	53224
chr14	37049209	37051819	NKX2-8	0	-	2610
chr17	48585745	48608862	MYCBPAP	0	+	23117
chr17	61957575	61959304	GH2	0	-	1729
chr17	61972269	61974021	CSH1	0	-	1752
chr2	158175143	158184225	ERMN	0	-	9082
chr2	167260083	167467992	SCN7A	0	-	207909
chr8	11534468	11617511	GATA4	0	+	83043
chr2	113763036	113765621	IL36A	0	+	2585
chr2	113779666	113810444	IL36B	0	-	30778
chr2	113825547	113833420	IL1F10	0	+	7873
chr2	131349738	131357148	CFC1	0	-	7410
chr10	26505594	26593487	GAD2	0	+	87893
chr9	125239237	125240205	OR1J1	0	-	968
chr9	107379529	107380485	OR13C9	0	-	956
chr9	104182842	104211946	ALDOB	0	-	29104
chr9	100689073	100707138	HEMGN	0	-	18065
chr9	127243515	127269699	NR5A1	0	-	26184
chr9	125486269	125487204	OR1L4	0	+	935
chr9	129376207	129463311	LMX1B	0	+	87104
chr9	21165636	21166659	IFNA21	0	-	1023
chr9	841690	969090	DMRT1	0	+	127400
chr9	38406525	38424451	IGFBPL1	0	-	17926
chr6	43263432	43273276	SLC22A7	0	+	9844
chr6	44126548	44152138	CAPN11	0	+	25590
chr6	54172657	54254940	TINAG	0	+	82283
chr6	54971258	55147415	HCRTR2	0	+	176157
chr6	52991759	53013639	GCM1	0	-	21880
chr6	10671651	10695030	C6orf52	0	-	23379
chr4	147627769	147867034	TTC29	0	-	239265
chr8	63961112	63998612	TTPA	0	-	37500
chr11	114441313	114466508	NXPE4	0	-	25195
chr11	102447563	102496063	MMP20	0	-	48500
chr11	102562218	102576500	MMP27	0	-	14282
chr11	111338251	111385092	BTG4	0	-	46841
chr1	92414900	92479983	BRDT	0	+	65083
chr1	84864167	84880701	DNASE2B	0	+	16534
chr2	37394963	37423741	SULT6B1	0	-	28778
chr2	27505297	27530307	TRIM54	0	+	25010
chr10	96796529	96829254	CYP2C8	0	-	32725
chr10	102986751	102989220	LBX1	0	-	2469
chr10	74694520	74714564	PLA2G12B	0	-	20044
chr10	74653342	74692794	OIT3	0	+	39452
chr10	69847654	69971774	MYPN	0	+	124120
chr2	202655184	202760273	CDK15	0	+	105089
chr2	207602487	207630052	MDH1B	0	-	27565
chr2	175612320	175652663	CHRNA1	0	-	40343
chr3	108626639	108672726	GUCA1C	0	-	46087
chr3	107096286	107097482	CCDC54	0	+	1196
chr15	73612200	73661299	HCN4	0	-	49099
chr4	115748919	116035032	NDST4	0	-	286113
chr4	123531263	123542221	IL21	0	-	10958
chr4	122795636	122873215	TRPC3	0	-	77579
chr4	76501706	76555900	CDKL2	0	-	54194
chr4	110834039	110934922	EGF	0	+	100883
chr4	100432169	100463460	C4orf17	0	+	31291
chr4	100485238	100545154	MTTP	0	+	59916
chr22	50457004	50496727	TTLL8	0	-	39723
chr12	15125976	15134799	PDE6H	0	+	8823
chr12	18395895	18801350	PIK3C2G	0	+	405455
chr12	18836103	18891034	PLCZ1	0	-	54931
chr12	20848266	20906320	SLCO1C1	0	+	58054
chr12	9102640	9163356	KLRG1	0	+	60716
chr12	81651754	82153332	PPFIA2	0	-	501578
chr12	48866342	48867405	ANP32D	0	+	1063
chr12	57846106	57853063	INHBE	0	+	6957
chr12	91444268	91451801	KERA	0	-	7533
chr12	96337109	96362498	AMDHD1	0	+	25389
chr12	125670932	126146923	TMEM132B	0	+	475991
chr12	49480439	49488584	DHH	0	-	8145
chr12	51722226	51740463	CELA1	0	-	18237
chr12	52937693	52946929	KRT71	0	-	9236
chr13	44717286	44735393	SMIM2	0	-	18107
chr12	119419346	119600856	SRRM4	0	+	181510
chr13	103338097	103347394	METTL21C	0	-	9297
chr14	38677109	38682272	SSTR1	0	+	5163
chr14	23352431	23356887	REM2	0	+	4456
chr14	47308832	48144808	MDGA2	0	-	835976
chr14	70883824	70927144	ADAM21	0	+	43320
chr14	63166182	63568755	KCNH5	0	-	402573
chr14	96858465	96955764	AK7	0	+	97299
chr14	94385240	94395954	FAM181A	0	+	10714
chr14	92788925	92967825	SLC24A4	0	+	178900
chr14	94746797	94759605	SERPINA10	0	-	12808
chr14	100789676	100796758	SLC25A47	0	+	7082
chr15	75575176	75588148	GOLGA6D	0	+	12972
chr15	74495046	74628813	CCDC33	0	+	133767
chr15	75105057	75118098	LMAN1L	0	+	13041
chr15	89753100	89764845	RLBP1	0	-	11745
chr15	90234042	90286869	WDR93	0	+	52827
chr15	88402982	88800022	NTRK3	0	-	397040
chr15	92937111	93011958	ST8SIA2	0	+	74847
chr15	84115980	84287495	SH3GL3	0	+	171515
chr16	4827607	4838399	SEPTIN12	0	-	10792
chr16	46736194	46824319	MYLK3	0	-	88125
chr16	48114793	48189929	ABCC12	0	-	75136
chr16	77281710	77468931	ADAMTS18	0	-	187221
chr16	66613351	66622178	CMTM2	0	+	8827
chr16	1993975	2007607	RPL3L	0	-	13632
chr16	68009566	68014452	DPEP3	0	-	4886
chr17	33474836	33516364	UNC45B	0	+	41528
chr17	56225745	56236946	OR4D1	0	+	11201
chr17	51900288	51902554	KIF2B	0	+	2266
chr17	3343313	3417146	SPATA22	0	-	73833
chr17	31297394	31324895	SPACA3	0	+	27501
chr18	904872	912173	ADCYAP1	0	+	7301
chr18	29339547	29340843	SLC25A52	0	-	1296
chr18	71740588	71815078	FBXO15	0	-	74490
chr18	70203915	70305756	CBLN2	0	-	101841
chr17	37313147	37323737	ARL5C	0	-	10590
chr17	37366794	37382198	STAC2	0	-	15404
chr19	57645464	57656570	ZIM3	0	-	11106
chr19	16272179	16284336	CIB3	0	-	12157
chr19	42348806	42356401	DMRTC2	0	+	7595
chr21	45666222	45682099	DNMT3L	0	-	15877
chr1	206944109	207016326	IL19	0	+	72217
chr19	49164664	49176338	NTN5	0	-	11674
chr5	1392909	1445555	SLC6A3	0	-	52646
chr19	54296995	54327657	NLRP12	0	-	30662
chr19	54466191	54493469	CACNG8	0	+	27278
chr19	8130286	8214476	FBN3	0	-	84190
chr17	4675179	4686508	TM4SF5	0	+	11329
chr19	51273721	51274989	GPR32	0	+	1268
chr19	49925676	49926698	PTH2	0	-	1022
chr1	1853390	1935276	CFAP74	0	-	81886
chr1	34632484	34684732	C1orf94	0	+	52248
chr1	22328150	22339035	CELA3A	0	+	10885
chr1	45249257	45253842	BEST4	0	-	4585
chr1	53925072	53933161	DMRTB1	0	+	8089
chr1	110009168	110024756	SYPL2	0	+	15588
chr1	91177096	91182859	BARHL2	0	-	5763
chr1	111059839	111061797	KCNA10	0	-	1958
chr1	109255530	109285371	FNDC7	0	+	29841
chr1	110993771	110999980	PROK1	0	+	6209
chr1	167022073	167135716	GPA33	0	-	113643
chr1	165370159	165414592	RXRG	0	-	44433
chr1	168510006	168513235	XCL2	0	-	3229
chr1	167778623	167883453	ADCY10	0	-	104830
chr1	197007871	197036390	F13B	0	-	28519
chr1	179712426	179785333	FAM163A	0	+	72907
chr1	197881032	197904608	LHX9	0	+	23576
chr1	210850165	211307507	KCNH1	0	-	457342
chr1	152321211	152332482	FLG2	0	-	11271
chr1	153965161	154127592	NUP210L	0	-	162431
chr1	154293566	154297801	AQP10	0	+	4235
chr1	155259084	155271229	PKLR	0	-	12145
chr1	226124298	226129083	LEFTY2	0	-	4785
chr2	44059081	44110127	ABCG8	0	+	51046
chr2	79252812	79255631	REG3G	0	+	2819
chr2	96142756	96150502	TRIM43B	0	-	7746
chr2	96257749	96265526	TRIM43	0	+	7777
chr2	71205510	71212629	ANKRD53	0	+	7119
chr2	73867850	73869549	NAT8	0	-	1699
chr2	119913819	119916327	C1QL2	0	-	2508
chr2	98962651	99015064	CNGA3	0	+	52413
chr2	139426727	139537960	NXPH2	0	-	111233
chr2	137523115	138435288	THSD7B	0	+	912173
chr2	166841151	167005724	SCN1A	0	-	164573
chr2	162280843	162841792	SLC4A10	0	+	560949
chr2	180306709	180726339	ZNF385B	0	-	419630
chr2	192813769	193059659	TMEFF2	0	-	245890
chr2	172949468	172954405	DLX1	0	+	4937
chr2	210636556	210864024	UNC80	0	+	227468
chr2	207804242	207834198	CPO	0	+	29956
chr2	226264426	226594603	NYAP2	0	+	330177
chr2	234826018	234928166	TRPM8	0	+	102148
chr2	239008981	239041928	ESPNL	0	+	32947
chr3	9745510	9771592	CPNE9	0	+	26082
chr3	30767689	30936153	GADL1	0	-	168464
chr3	38323785	38360066	SLC22A14	0	+	36281
chr3	108099215	108248169	MYH15	0	-	148954
chr3	172607147	172859025	SPATA16	0	-	251878
chr8	12281920	12293915	FAM86B2	0	-	11995
chr3	186330849	186339107	AHSG	0	+	8258
chr3	183947373	183960117	VWA5B2	0	+	12744
chr4	66185281	66536213	EPHA5	0	-	350932
chr4	48485360	48491543	SLC10A4	0	+	6183
chr4	71200698	71202833	CABS1	0	+	2135
chr4	120238405	120243293	FABP2	0	-	4888
chr4	154631312	154681176	RNF175	0	-	49864
chr4	175558071	175750398	GLRA3	0	-	192327
chr5	10441636	10472141	ROPN1L	0	+	30505
chr5	19471405	20575982	CDH18	0	-	1104577
chr5	35951108	36001130	UGT3A1	0	-	50022
chr5	74364100	74532736	ANKRD31	0	-	168636
chr5	76248870	76276983	CRHBP	0	+	28113
chr5	96427571	96478457	LIX1	0	-	50886
chr5	94987885	95034415	SPATA9	0	-	46530
chr5	126626488	126801429	MEGF10	0	+	174941
chr5	128795974	129074376	ADAMTS19	0	+	278402
chr5	135257968	135290672	LECT2	0	-	32704
chr5	134812603	135225459	SLC25A48	0	+	412856
chr5	135227935	135231530	IL9	0	-	3595
chr5	156346303	156390237	TIMD4	0	-	43934
chr5	160715436	160976050	GABRB2	0	-	260614
chr5	147691982	147695485	SPINK7	0	+	3503
chr5	151202074	151304412	GLRA1	0	-	102338
chr6	25754927	25781427	SLC17A4	0	+	26500
chr6	25727005	25727573	H2BC1	0	+	568
chr5	179527795	179636211	RASGEF1C	0	-	108416
chr6	53794780	54131078	MLIP	0	+	336298
chr6	55299171	55443995	HMGCLL1	0	-	144824
chr6	63985856	64029888	LGSN	0	-	44032
chr6	43211219	43255996	TTBK1	0	+	44777
chr6	84222253	84235423	PRSS35	0	+	13170
chr6	89887223	89940997	GABRR1	0	-	53774
chr6	108023358	108145521	SCML4	0	-	122163
chr6	123317380	123394070	CLVS2	0	+	76690
chr6	110299459	110301923	GPR6	0	+	2464
chr6	132938161	132945414	TAAR2	0	-	7253
chr6	132891461	132892498	TAAR6	0	+	1037
chr6	132873811	132874895	TAAR8	0	+	1084
chr6	132964451	132980321	TAAR1	0	-	15870
chr6	160221281	160241736	PNLDC1	0	+	20455
chr6	153071932	153080900	VIP	0	+	8968
chr7	19184405	19185044	FERD3L	0	-	639
chr7	45927959	45933259	IGFBP1	0	+	5300
chr7	72726532	72742085	TRIM50	0	-	15553
chr7	123207064	123279535	ASB15	0	+	72471
chr7	100331218	100395419	ZAN	0	+	64201
chr7	134916731	134943415	STRA8	0	+	26684
chr7	150872785	150884919	ASB10	0	-	12134
chrX	49955420	49965658	AKAP4	0	-	10238
chrX	49967364	50094913	CCNB3	0	+	127549
chrX	47229977	47273897	ZNF157	0	+	43920
chrX	69501943	69504852	RAB41	0	+	2909
chrX	78400185	78430815	GPR174	0	+	30630
chrX	78003206	78014211	LPAR4	0	+	11005
chrX	69260392	69269788	AWAT2	0	-	9396
chrX	88002226	88009786	CPXCR1	0	+	7560
chrX	102330738	102348071	NXF3	0	-	17333
chrX	130192320	130223859	ARHGAP36	0	+	31539
chrX	129513423	129519648	GPR119	0	-	6225
chrX	150884507	150891666	FATE1	0	+	7159
chr8	42552509	42592550	CHRNB3	0	+	40041
chr8	42607763	42651535	CHRNA6	0	-	43772
chr8	25276774	25282170	GNRH1	0	-	5396
chr8	52232137	52722005	PXDNL	0	-	489868
chr8	53023398	53373519	ST18	0	-	350121
chr8	66933788	67013480	DNAJC5B	0	+	79692
chr8	67039131	67087720	TRIM55	0	+	48589
chr8	82352561	82359674	PMP2	0	-	7113
chr8	70963886	70983928	PRDM14	0	-	20042
chr8	92221722	92410383	SLC26A7	0	+	188661
chr8	86999552	87166454	ATP6V0D2	0	+	166902
chr8	105342552	105479283	DPYS	0	-	136731
chr8	108911544	109095870	RSPO2	0	-	184326
chr8	139142266	139509504	FAM135B	0	-	367238
chr9	14719722	14722731	CER1	0	-	3009
chr9	21304325	21305312	IFNA5	0	-	987
chr9	21216372	21217310	IFNA16	0	-	938
chr9	107288534	107289490	OR13C4	0	-	956
chr9	111616868	111618266	ACTL7B	0	-	1398
chr9	125551212	125552174	OR5C1	0	+	962
chr9	138555155	138558807	LCN9	0	+	3652
chr9	140772234	141019076	CACNA1B	0	+	246842
chr10	18240768	18332221	SLC39A12	0	+	91453
chr10	17794200	17842867	TMEM236	0	+	48667
chr10	17357420	17496594	ST8SIA6	0	-	139174
chr10	37414526	37521495	ANKRD30A	0	+	106969
chr10	52559169	52645435	A1CF	0	-	86266
chr10	85990422	86019716	RGR	0	+	29294
chr10	118888032	118897812	VAX1	0	-	9780
chr10	72007085	72043760	NPFFR1	0	-	36675
chr11	40135753	41481323	LRRC4C	0	-	1345570
chr11	58407899	58499447	GLYAT	0	-	91548
chr11	55761157	55762101	OR5F1	0	-	944
chr11	86085778	86134151	CCDC81	0	+	48373
chr11	113280327	113346413	DRD2	0	-	66086
chr11	113775518	113819801	HTR3B	0	+	44283
chr11	120382455	120859615	GRIK4	0	+	477160
chr20	23965687	23969416	GGTLC1	0	-	3729
chr11	62756626	62783313	SLC22A8	0	-	26687
chr20	2517219	2624226	TMC2	0	+	107007
chr11	60635015	60643166	ZP1	0	+	8151
chr11	59807882	59815517	OOSP2	0	+	7635
chr11	59824060	59838588	MS4A3	0	+	14528
chr11	126293253	126873355	KIRREL3	0	-	580102
chr11	118033521	118047354	SCN2B	0	-	13833
chr20	44515130	44516261	SPATA25	0	-	1131
chr20	45169585	45179293	OCSTAMP	0	-	9708
chr20	44350986	44354469	SPINT4	0	+	3483
chr20	44802378	44937137	CDH22	0	-	134759
chr11	63137257	63177766	SLC22A9	0	+	40509
chr16	30035748	30064299	TLCD3B	0	-	28551
chrX	21390919	21672813	CNKSR2	0	+	281894
chr11	98891679	100229616	CNTN5	0	+	1337937
chr12	9980077	9997606	KLRF1	0	+	17529
chr11	55029631	55038590	TRIM48	0	+	8959
chr11	56113515	56114474	OR8K1	0	+	959
chr10	55562531	57387702	PCDH15	0	-	1825171
chr13	70274726	70682625	KLHL1	0	-	407899
chr4	176554085	176923815	GPM6A	0	-	369730
chr4	176986992	177103969	WDR17	0	+	116977
chr4	177105730	177116736	SPATA4	0	-	11006
chr18	72201735	72254448	CNDP1	0	+	52713
chr15	39880558	40075042	FSIP1	0	-	194484
chr11	85566144	85631064	CCDC83	0	+	64920
chr1	192127592	192154945	RGS18	0	+	27353
chr2	11273254	11291443	C2orf50	0	+	18189
chr4	164392247	164394906	TKTL2	0	-	2659
chr10	25270908	25351208	ENKUR	0	-	80300
chr10	30900708	30918691	LYZL2	0	-	17983
chr14	33403602	34290069	NPAS3	0	+	886467
chr2	3705790	3750261	ALLC	0	+	44471
chr2	17997727	17999065	MSGN1	0	+	1338
chr1	198492352	198510075	ATP6V1G3	0	-	17723
chr4	128651555	128695447	SLC25A31	0	+	43892
chr12	101111304	101522419	ANO4	0	+	411115
chr3	113846427	113918254	DRD3	0	-	71827
chr4	147560045	147563626	POU4F2	0	+	3581
chr10	135051359	135055432	VENTX	0	+	4073
chr10	7745279	7791483	ITIH2	0	+	46204
chr11	128706210	128737268	KCNJ1	0	-	31058
chr14	58030638	58448912	SLC35F4	0	-	418274
chr4	46245565	46477247	GABRA2	0	-	231682
chr12	129337972	129469513	GLT1D1	0	+	131541
chr12	129556270	130388570	TMEM132D	0	-	832300
chr4	155702365	155749965	RBM46	0	+	47600
chr6	100366395	100442123	MCHR2	0	-	75728
chr2	130949318	130956012	TUBA3E	0	-	6694
chr1	176826438	177134109	ASTN1	0	-	307671
chr2	131278770	131286177	CFC1B	0	+	7407
chr13	49227847	49285362	CYSLTR2	0	+	57515
chr4	93225117	94731308	GRID2	0	+	1506191
chr18	40323192	40695656	RIT2	0	-	372464
chr11	13513601	13517728	PTH	0	-	4127
chr2	85645837	85664152	SH2D6	0	+	18315
chr5	79783788	79838382	FAM151B	0	+	54594
chr2	198591603	198651486	BOLL	0	-	59883
chr10	15074226	15115852	OLAH	0	+	41626
chr19	58545393	58565999	ZSCAN1	0	+	20606
chr11	105480721	105852819	GRIA4	0	+	372098
chr4	88529681	88538025	DSPP	0	+	8344
chr4	88571432	88585513	DMP1	0	+	14081
chr4	88742550	88767966	MEPE	0	+	25416
chr5	35904390	35938881	CAPSL	0	-	34491
chr2	71035775	71047731	CLEC4F	0	-	11956
chr1	67218142	67244730	DYNLT5	0	+	26588
chr10	91190056	91316398	SLC16A12	0	-	126342
chr6	146348782	146758737	GRM1	0	+	409955
chr5	57878048	58155221	RAB3C	0	+	277173
chr12	25562241	25801513	LMNTD1	0	-	239272
chr6	24126414	24155128	NRSN1	0	+	28714
chr3	147111209	147228080	ZIC1	0	+	116871
chr2	135596186	135659604	ACMSD	0	+	63418
chr1	247901917	247902861	OR14K1	0	+	944
chr2	159027585	159313265	CCDC148	0	-	285680
chr3	62355356	62359999	FEZF2	0	-	4643
chr6	168453775	168502191	FRMD1	0	-	48416
chr5	94727070	94786158	FAM81B	0	+	59088
chr13	111968531	111996596	TEX29	0	+	28065
chr13	113030669	113089003	SPACA7	0	+	58334
chr15	28623767	28637167	GOLGA8F	0	+	13400
chrX	89176907	89177882	TGIF2LX	0	+	975
chr16	85131964	85146078	CIBAR2	0	-	14114
chr2	228844671	229046403	SPHKAP	0	-	201732
chr17	68049570	68131749	KCNJ16	0	+	82179
chr1	76384558	76398089	ASB17	0	-	13531
chr11	124481324	124490252	PANX3	0	+	8928
chr2	242716237	242743702	GAL3ST2	0	+	27465
chr6	131949582	132068558	ENPP3	0	+	118976
chr1	228194699	228248972	WNT3A	0	+	54273
chr7	113516832	113715975	PPP1R3A	0	-	199143
chr10	125425871	125456915	GPR26	0	+	31044
chr2	170501935	170550915	CFAP210	0	-	48980
chr10	128113566	128487277	C10orf90	0	-	373711
chr6	89805678	89827790	SRSF12	0	-	22112
chr18	23713816	23773319	PSMA8	0	+	59503
chr21	19641433	19858197	TMPRSS15	0	-	216764
chr17	49707674	50237377	CA10	0	-	529703
chr7	55861233	55930448	SEPTIN14	0	-	69215
chr2	124782864	125678796	CNTNAP5	0	+	895932
chr8	103563817	103573246	ODF1	0	+	9429
chr14	20399076	20404916	OR4K1	0	+	5840
chr7	72430016	72439997	TRIM74	0	-	9981
chr5	152869175	153193429	GRIA1	0	+	324254
chr7	133812052	133949347	LRGUK	0	+	137295
chr16	21995186	22012437	PDZD9	0	-	17251
chr16	21675289	21773256	OTOA	0	+	97967
chr2	202352144	202483901	C2CD6	0	-	131757
chr1	240177648	240638487	FMN2	0	+	460839
chr9	105757593	105780770	CYLC2	0	+	23177
chr9	19507450	19789035	SLC24A2	0	-	281585
chr3	140396906	140419992	TRIM42	0	+	23086
chr8	131792547	132053155	ADCY8	0	-	260608
chr8	16884747	16980151	MICU3	0	+	95404
chr8	18248792	18258728	NAT2	0	+	9936
chr4	70345883	70391732	UGT2B4	0	-	45849
chr1	110082494	110091028	GPR61	0	+	8534
chr4	76781017	76823724	PPEF2	0	-	42707
chr15	81299374	81441520	CFAP161	0	+	142146
chr4	76932337	77035201	ART3	0	+	102864
chr15	85427885	85489029	SLC28A1	0	+	61144
chr21	31537883	31539123	CLDN17	0	-	1240
chr10	106401048	107025000	SORCS3	0	+	623952
chr5	170846651	170884630	FGF18	0	+	37979
chr10	72191692	72207707	NODAL	0	-	16015
chr11	57144242	57148623	PRG3	0	-	4381
chr8	35092993	35654068	UNC5D	0	+	561075
chr11	58601538	58671688	GLYATL2	0	-	70150
chr16	31439052	31439681	COX6A2	0	-	629
chr16	31404656	31437826	ITGAD	0	+	33170
chrX	135383122	135499049	ADGRG4	0	+	115927
chrX	136648286	136659850	ZIC3	0	+	11564
chr3	9540045	9595506	LHFPL4	0	-	55461
chr1	182869000	182922660	SHCBP1L	0	-	53660
chr3	10365707	10749692	ATP2B2	0	-	383985
chr3	42438575	42452102	LYZL4	0	-	13527
chr3	42727029	42734036	KLHL40	0	+	7007
chr1	57320441	57383896	C8A	0	+	63455
chr7	154862034	154879102	HTR5A	0	+	17068
chr1	12806148	12823847	CFAP107	0	+	17699
chr6	35704809	35716856	ARMC12	0	+	12047
chr16	70835987	71264625	HYDIN	0	-	428638
chr21	38979675	39493439	KCNJ6	0	-	513764
chr2	26624788	26679579	DRC1	0	+	54791
chr2	26804073	26864234	CIB4	0	-	60161
chr15	66187417	66546094	MEGF11	0	-	358677
chr1	26346375	26362955	EXTL1	0	+	16580
chr1	26377792	26394927	TRIM63	0	-	17135
chr11	7041710	7092757	NLRP14	0	+	51047
chr12	122277433	122301502	HPD	0	-	24069
chr12	122652285	122688018	LRRC43	0	+	35733
chr2	219221580	219232822	CATIP	0	+	11242
chr20	47909931	48100834	KCNB1	0	-	190903
chr1	158297741	158301321	CD1B	0	-	3580
chr1	158323486	158327343	CD1E	0	+	3857
chr5	143191726	143200281	HMHB1	0	+	8555
chr7	129906703	129929638	CPA2	0	+	22935
chr7	129984656	130008571	CPA5	0	+	23915
chr6	27253682	27280052	POM121L2	0	-	26370
chrX	54959394	55024967	PFKFB1	0	-	65573
chrX	55035488	55057410	ALAS2	0	-	21922
chr1	19991368	20007459	HTR6	0	+	16091
chr8	21899909	21906320	FGF17	0	+	6411
chr16	24857162	24922949	SLC5A11	0	+	65787
chr20	44179792	44207965	WFDC8	0	-	28173
chr17	44910567	44964096	WNT9B	0	+	53529
chr17	46799081	46799880	PRAC1	0	-	799
chr21	35736305	35743680	KCNE2	0	+	7375
chr17	47035916	47045958	GIP	0	-	10042
chr15	35043233	35047199	GJD2	0	-	3966
chr21	37832919	37948867	CLDN14	0	-	115948
chr15	74362198	74374891	GOLGA6A	0	-	12693
chr1	17634690	17690499	PADI4	0	+	55809
chr2	74785010	74875465	M1AP	0	-	90455
chr16	55358115	55364668	IRX6	0	+	6553
chr16	55880066	55989943	CES5A	0	-	109877
chr1	152658599	152659873	LCE2B	0	+	1274
chr15	43568469	43594453	TGM7	0	-	25984
chr16	57728705	57765717	DRC7	0	+	37012
chr3	126200009	126236616	UROC1	0	-	36607
chr16	67360701	67419107	LRRC36	0	+	58406
chr16	67516474	67517450	AGRP	0	-	976
chr19	44455375	44471861	ZNF221	0	+	16486
chr17	3323862	3324827	KNOWN	0	+	965
chr21	44589118	44592915	CRYAA	0	+	3797
chr21	47556074	47575493	FTCD	0	-	19419
chr19	51870352	51872257	CLDND2	0	-	1905
chr9	137772656	137779369	FCN2	0	+	6713
chr9	138413284	138418386	LCN1	0	+	5102
chr19	55888194	55889614	TMEM190	0	+	1420
chr1	154540254	154552489	CHRNB2	0	+	12235
chr3	46876601	46923662	MYL3	0	-	47061
chr1	156890424	156902886	LRRC71	0	+	12462
chr7	99354583	99381871	CYP3A4	0	-	27288
chr19	14583278	14586166	PTGER1	0	-	2888
chr19	15579456	15609767	PGLYRP2	0	-	30311
chr7	102453285	102715286	FBXL13	0	-	262001
chr19	3224659	3297074	CELF5	0	+	72415
chr22	21987005	21991618	CCDC116	0	+	4613
chr19	36316274	36360189	NPHS1	0	-	43915
chr17	72838162	72857627	GRIN2C	0	-	19465
chr17	39991937	40004636	KLHL10	0	+	12699
chr19	49891476	49921247	KASH5	0	+	29771
chr17	40336078	40337470	HCRT	0	-	1392
chr12	55038373	55042277	DCD	0	-	3904
chr19	50472857	50479076	SIGLEC16	0	+	6219
chr17	41924516	41941007	CD300LG	0	+	16491
chr19	50655805	50666538	IZUMO2	0	-	10733
chr19	51162512	51223059	SHANK1	0	-	60547
chr19	9225504	9226439	OR7G1	0	-	935
chr12	52787715	52800119	KRT82	0	-	12404
chr6	41117075	41122085	TREML1	0	-	5010
chr17	7004641	7019019	ASGR2	0	-	14378
chr17	8633253	8648537	CCDC42	0	-	15284
chr16	610394	615529	PRR35	0	+	5135
chr16	819428	833370	MSLNL	0	-	13942
chr16	1122747	1131454	SSTR5	0	+	8707
chr16	2521298	2524146	NTN3	0	+	2848
chr3	52828784	52843025	ITIH3	0	+	14241
chr1	47603107	47615399	CYP4A22	0	+	12292
chr1	50489701	50669444	ELAVL4	0	+	179743
chr1	55271736	55307925	LEXM	0	+	36189
chr1	55464606	55482845	BSND	0	+	18239
chr1	15764938	15775737	CTRC	0	+	10799
chr1	47011313	47017319	KNCN	0	-	6006
chr1	16068994	16074477	TMEM82	0	+	5483
chr1	31184124	31196432	MATN1	0	-	12308
chr1	1109260	1133316	TTLL10	0	+	24056
chr1	3663024	3688209	CCDC27	0	+	25185
chr1	60452941	60539442	C1orf87	0	-	86501
chr1	74491699	74663871	LRRIQ3	0	-	172172
chr1	75594119	75627218	LHX8	0	+	33099
chr1	85464830	85598821	DNAI3	0	+	133991
chr1	91726323	91870413	HFM1	0	-	144090
chr1	190066788	190447534	BRINP3	0	-	380746
chr1	196194909	196578355	KCNT2	0	-	383446
chr1	248020489	248043440	TRIM58	0	+	22951
chr1	159921282	159924027	SLAMF9	0	-	2745
chr1	248308450	248309388	OR2M5	0	+	938
chr1	160051328	160060353	KCNJ9	0	+	9025
chr1	173469599	173572211	SLC9C2	0	-	102612
chr1	165171104	165325952	LMX1A	0	-	154848
chr1	165513237	165533194	LRRC52	0	+	19957
chr1	212797816	212800117	GARIN4	0	+	2301
chr1	241815580	241966079	WDR64	0	+	150499
chr1	205305189	205326218	KLHDC8A	0	-	21029
chr1	207038968	207042568	IL20	0	+	3600
chr1	207131310	207143970	FCAMR	0	-	12660
chr2	155554367	155714866	KCNJ3	0	+	160499
chr2	187692202	187713935	ZSWIM2	0	-	21733
chr2	132905164	133015542	ANKRD30BL	0	-	110378
chr2	95537175	95542568	TEKT4	0	+	5393
chr2	120302008	120419827	CFAP221	0	+	117819
chr2	167744990	168116263	XIRP2	0	+	371273
chr4	95219686	95264027	HPGDS	0	-	44341
chr4	96761244	96762615	PDHA2	0	+	1371
chr4	98105244	99064627	STPG2	0	-	959383
chr1	152850798	152857523	SMCP	0	+	6725
chr2	69088041	69098529	BMP10	0	-	10488
chr1	154474695	154520623	TDRD10	0	+	45928
chr2	208992861	208994552	CRYGC	0	-	1691
chr1	154171561	154178809	CFAP141	0	-	7248
chr2	232786519	232791106	NPPC	0	-	4587
chr4	46037786	46126071	GABRG1	0	-	88285
chr4	46995740	47428464	GABRB1	0	+	432724
chr2	233320835	233325463	ALPI	0	+	4628
chr1	154966062	154966791	LENEP	0	+	729
chr1	155006300	155023406	DCST1	0	+	17106
chr3	68780917	69002448	TAFA4	0	-	221531
chr4	26483018	26492106	CCKAR	0	-	9088
chr1	201159952	201198080	IGFN1	0	+	38128
chr3	71820806	71834357	PROK2	0	-	13551
chr4	56422686	56458412	PDCL2	0	-	35726
chr2	216946589	216967506	TMEM169	0	+	20917
chr2	219027564	219031685	CXCR1	0	-	4121
chr2	219845809	219849906	FEV	0	-	4097
chr2	219854911	219858144	CRYBA2	0	-	3233
chr3	108462271	108476257	RETNLB	0	-	13986
chr1	157543537	157567875	FCRL4	0	-	24338
chr3	108541617	108573852	TRAT1	0	+	32235
chr3	109012635	109035364	DPPA2	0	-	22729
chr1	157764193	157789910	FCRL1	0	-	25717
chr1	158580494	158656505	SPTA1	0	-	76011
chr3	19920964	19988517	EFHB	0	-	67553
chr3	170714136	170744532	SLC2A2	0	-	30396
chr3	62384021	62861091	CADPS	0	-	477070
chr4	85413138	85420445	NKX6-1	0	-	7307
chr3	63213991	63602600	SYNPR	0	+	388609
chr3	150377672	150421758	ERICH6	0	-	44086
chr3	57231866	57261634	HESX1	0	-	29768
chr3	146109208	146213778	PLSCR2	0	-	104570
chr4	77234150	77343021	CCDC158	0	-	108871
chr2	27371872	27379842	TCF23	0	+	7970
chr3	44916100	44956482	TGM4	0	+	40382
chr3	45796941	45838066	SLC6A20	0	-	41125
chr3	46536101	46542440	RTP3	0	+	6339
chr3	46556875	46648438	LRRC2	0	-	91563
chr3	121312226	121349142	FBXO40	0	+	36916
chr1	37261128	37500116	GRIK3	0	-	238988
chr3	126113752	126155399	CFAP100	0	+	41647
chr3	129247482	129254187	RHO	0	+	6705
chr3	195924323	195938308	ZDHHC19	0	-	13985
chr4	4190453	4228656	OTOP1	0	-	38203
chr1	43198764	43205925	CLDN19	0	-	7161
chr3	48264837	48266981	CAMP	0	+	2144
chr3	48413709	48442666	FBXW12	0	+	28957
chr3	49895421	49907368	CAMKV	0	-	11947
chr3	51741084	51752629	GRM2	0	+	11545
chr4	109663204	109684210	ETNPPL	0	-	21006
chr4	118954773	119179789	NDST3	0	+	225016
chr4	122680036	122686582	SMIM43	0	-	6546
chr4	123300121	123350957	ADAD1	0	+	50836
chr4	159814286	159959912	C4orf45	0	-	145626
chr5	33944728	33984798	SLC45A2	0	-	40070
chr5	121465241	121518353	ZNF474	0	+	53112
chr5	36247015	36302216	RANBP3L	0	-	55201
chr5	23443695	23528202	PRDM9	0	+	84507
chr5	147830595	148056798	HTR4	0	-	226203
chr5	54408799	54469005	CDC20B	0	-	60206
chr5	79615444	79617661	SPZ1	0	+	2217
chr4	185009859	185142383	ENPP6	0	-	132524
chr5	72469020	72470970	TMEM174	0	+	1950
chr5	71015102	71016875	CARTPT	0	+	1773
chr4	187130133	187179625	KLKB1	0	+	49492
chr5	1225496	1246304	SLC6A18	0	+	20808
chr5	131396348	131398897	IL3	0	+	2549
chr5	131409482	131411863	CSF2	0	+	2381
chr6	101410577	102529497	GRIK2	0	+	1118920
chr5	170736252	170739143	TLX3	0	+	2891
chr6	139561198	139613135	TXLNB	0	-	51937
chr6	166571144	166582188	TBXT	0	-	11044
chr6	130465460	130686570	SAMD3	0	-	221110
chr6	137464957	137494785	IL22RA2	0	-	29828
chr6	168693510	168720457	DACT2	0	-	26947
chr6	25726291	25726790	H2AC1	0	-	499
chr5	55147185	55218682	IL31RA	0	+	71497
chr5	55395507	55529157	ANKRD55	0	-	133650
chr7	35242042	35293711	TBX20	0	-	51669
chr5	45255050	45696600	HCN1	0	-	441550
chr5	150040444	150058930	MYOZ3	0	+	18486
chr7	31377079	31380340	NEUROD6	0	-	3261
chr6	39297766	39693184	KIF6	0	-	395418
chr7	20821899	20826505	SP8	0	-	4606
chr7	123092247	123175131	IQUB	0	-	82884
chr17	33519539	33521412	SLC35G3	0	-	1873
chr7	48026745	48068716	SUN3	0	-	41971
chr7	48075108	48100901	C7orf57	0	+	25793
chr8	117962512	118188953	SLC30A8	0	+	226441
chr8	110975865	110988000	KCNV1	0	-	12135
chr8	113235157	114449168	CSMD3	0	-	1214011
chr8	6912826	6914261	DEFA5	0	-	1435
chr8	6793342	6795828	DEFA4	0	-	2486
chr8	6782219	6783598	DEFA6	0	-	1379
chr8	109619079	109799823	TMEM74	0	-	180744
chr7	1272508	1276962	UNCX	0	+	4454
chr8	7300206	7321196	SPAG11B	0	-	20990
chr8	86285665	86361269	CA3	0	+	75604
chr8	87226292	87333375	SLC7A13	0	-	107083
chr7	150845096	150871832	GBX1	0	-	26736
chr9	34379017	34397826	C9orf24	0	-	18809
chr9	71627420	71629029	PRKACG	0	-	1609
chr8	40388109	40755352	ZMAT4	0	-	367243
chr8	41502696	41508336	NKX6-3	0	-	5640
chr7	141536100	141541287	PRSS37	0	-	5187
chr8	68334273	68658613	CPA6	0	-	324340
chr8	69243190	69731258	C8orf34	0	+	488068
chr9	75136524	75453213	TMC1	0	+	316689
chr7	142636440	142637955	LLCFC1	0	+	1515
chrX	23926123	23957626	CXorf58	0	+	31503
chrX	15299819	15333762	ASB11	0	-	33943
chrX	15363718	15402535	VEGFD	0	-	38817
chr9	125377017	125377961	OR1Q1	0	+	944
chr10	23216953	23327452	ARMC3	0	+	110499
chr11	93063137	93171653	DEUP1	0	+	108516
chrX	70145429	70150975	SLC7A3	0	-	5546
chrX	136106088	136116154	GPR101	0	-	10066
chr10	54525140	54532544	MBL2	0	-	7404
chr11	124789101	124806308	HEPACAM	0	-	17207
chr14	47120213	47120984	RPL10L	0	-	771
chrX	140926102	140985618	MAGEC3	0	+	59516
chr14	77731826	77737549	NGB	0	-	5723
chr14	77860364	77889866	NOXRED1	0	-	29502
chr13	25735817	25746426	AMER2	0	-	10609
chrX	48045656	48056231	SSX5	0	-	10575
chrX	48205862	48216142	SSX3	0	-	10280
chr14	57266623	57283411	OTX2	0	-	16788
chr10	50572111	50604135	DRGX	0	-	32024
chr10	13263766	13276374	UCMA	0	-	12608
chrX	131211018	131262048	FRMD7	0	-	51030
chr14	20343301	20352091	OR4K2	0	+	8790
chr12	88373812	88427814	C12orf50	0	-	54002
chr10	118423207	118429775	C10orf82	0	-	6568
chr10	99332256	99343641	ANKRD2	0	+	11385
chr12	80493317	80774660	OTOGL	0	+	281343
chr11	47459315	47470695	RAPSN	0	-	11380
chr12	27599669	27655118	SMCO2	0	+	55449
chr14	94953611	94984181	SERPINA12	0	-	30570
chr11	20621140	20680831	SLC6A5	0	+	59691
chr12	96260826	96336413	CCDC38	0	-	75587
chr12	75433857	75603619	KCNC2	0	-	169762
chrX	150732147	150845211	PASD1	0	+	113064
chr15	38214140	38259925	TMCO5A	0	+	45785
chr14	23842018	23845612	IL25	0	+	3594
chr14	23845982	23848981	CMTM5	0	+	2999
chr11	134144139	134189458	GLB1L3	0	+	45319
chr12	109301517	109458873	SVOP	0	-	157356
chr11	133710526	133715433	SPATA19	0	-	4907
chr16	49407715	49433342	C16orf78	0	+	25627
chr12	100597447	100660857	DEPDC4	0	-	63410
chrX	153485225	153498755	OPN1MW2	0	+	13530
chr12	101869114	101880775	SPIC	0	+	11661
chr10	72530994	72545157	TBATA	0	-	14163
chr11	123499895	123525952	SCN3B	0	-	26057
chr12	70219007	70352877	MYRFL	0	+	133870
chr10	75404639	75423561	SYNPO2L	0	-	18922
chr11	108179246	108338258	C11orf65	0	-	159012
chr17	55821856	55822660	CCDC182	0	-	804
chr18	70409549	70535381	NETO1	0	-	125832
chr21	14982098	15018144	POTED	0	+	36046
chr19	33622996	33666705	WDR88	0	+	43709
chr11	6866914	6867867	OR10A5	0	+	953
chr11	6912805	6913731	OR2D2	0	-	926
chr11	8245856	8290263	LMO1	0	-	44407
chr12	8662071	8674962	CLEC4D	0	+	12891
chr16	84043272	84076400	SLC38A8	0	-	33128
chr18	56942388	56985881	CPLX4	0	-	43493
chr18	74961804	74989856	GALR1	0	+	28052
chr16	66942025	66952820	CDH16	0	-	10795
chr17	9479944	9546764	CFAP52	0	+	66820
chr18	58038295	58040008	MC4R	0	-	1713
chr18	61209602	61236562	SERPINB12	0	+	26960
chr11	113558269	113577095	TMPRSS5	0	-	18826
chr11	18433865	18473610	LDHC	0	+	39745
chr11	58672871	58811000	GLYATL1	0	+	138129
chr12	57388276	57392231	GPR182	0	+	3955
chr22	36956904	37099797	CACNG2	0	-	142893
chr12	57422301	57444982	MYO1A	0	-	22681
chr11	59224434	59225378	OR4D6	0	+	944
chr7	100081550	100092425	NYAP1	0	+	10875
chr11	60094728	60164069	MS4A6E	0	+	69341
chr11	60197045	60222687	MS4A5	0	+	25642
chr20	2361547	2413399	TGM6	0	+	51852
chr18	30517366	31021065	CCDC178	0	-	503699
chr7	100813777	100823574	NAT16	0	-	9797
chr15	45248885	45271427	TERB2	0	+	22542
chr17	47209822	47254202	B4GALNT2	0	+	44380
chr9	130478358	130493869	TTC16	0	+	15511
chr20	31571579	31592239	SUN5	0	-	20660
chr20	31619454	31631853	BPIFB6	0	+	12399
chr17	48838390	48844918	ANKRD40CL	0	-	6528
chr15	74165905	74181555	TBC1D21	0	+	15650
chr15	75550675	75565796	GOLGA6C	0	+	15121
chr18	44056935	44237183	LOXHD1	0	-	180248
chr11	3659742	3663546	ART5	0	-	3804
chr11	4701401	4719084	OR51E2	0	-	17683
chr11	4726014	5013661	MMP26	0	+	287647
chr19	47137210	47139798	GNG8	0	-	2588
chr17	56295909	56345879	LPO	0	+	49970
chr12	48961467	48963849	LALBA	0	-	2382
chr12	50344520	50352661	AQP2	0	+	8141
chr12	52281793	52285511	ANKRD33	0	+	3718
chr19	55009100	55021897	LAIR2	0	+	12797
chr19	55327923	55342233	KIR3DL1	0	+	14310
chr19	3879862	3928080	ATCAY	0	+	48218
chr19	4292224	4302428	TMIGD2	0	-	10204
chr19	6306153	6333623	ACER1	0	-	27470
chr12	53497270	53518319	SOAT2	0	+	21049
chr11	67286383	67291988	CABP2	0	-	5605
chr11	67398774	67407234	TBX10	0	-	8460
chr11	55902197	55907677	OR8J3	0	-	5480
chr11	55702932	55703876	OR5I1	0	-	944
chr17	6692452	6735080	TEKT1	0	-	42628
chr8	59402737	59412722	CYP7A1	0	-	9985
chr11	64323162	64340347	SLC22A11	0	+	17185
chr11	64704989	64739580	MAJIN	0	-	34591
chr8	28174503	28200872	PNOC	0	+	26369
chr16	3254247	3255188	OR1F1	0	+	941
chr6	27878963	27880174	OR2B2	0	-	1211
chr22	38822332	38851205	KCNJ4	0	-	28873
chr1	228612546	228613061	H3-4	0	-	515
chr16	3405889	3407306	OR2C1	0	+	1417
chr14	52734416	52743442	PTGDR	0	+	9026
chr10	23481241	23483174	PTF1A	0	+	1933
chr3	39508689	39570970	MOBP	0	+	62281
chr3	39304986	39323226	CX3CR1	0	-	18240
chr8	49966870	49988652	PPDPFL	0	+	21782
chr14	36003370	36006260	INSM2	0	+	2890
chr16	84252263	84273618	KCNG4	0	-	21355
chr2	239047309	239061588	KLHL30	0	+	14279
chr18	9885763	9889272	TXNDC2	0	+	3509
chr8	22004343	22014597	LGI3	0	-	10254
chr4	186366336	186392906	CCDC110	0	-	26570
chr2	237073879	237077029	GBX2	0	-	3150
chr1	145398250	145417545	HJV	0	+	19295
chr11	61957688	61961011	SCGB1D1	0	+	3323
chr2	211154874	211179898	MYL1	0	-	25024
chr11	62676151	62689279	CHRM1	0	-	13128
chr8	21547910	21669869	GFRA2	0	-	121959
chr2	209025464	209028313	CRYGA	0	-	2849
chr16	80574631	80584708	DYNLRB2	0	+	10077
chr4	175750819	175899331	ADAM29	0	+	148512
chr8	39442008	39587584	ADAM18	0	+	145576
chr5	37812779	37840143	GDNF	0	-	27364
chr2	98703579	98929762	VWA3B	0	+	226183
chr5	36035123	36071460	UGT3A2	0	-	36337
chr16	67323331	67360663	KCTD19	0	-	37332
chr20	43752066	43753106	WFDC12	0	-	1040
chrY	6114264	6117060	KNOWN	0	+	2796
chr3	159706622	159713806	IL12A	0	+	7184
chr9	35869460	35870398	OR13J1	0	-	938
chr6	87647246	87726397	HTR1E	0	+	79151
chr5	180415846	180433727	BTNL3	0	+	17881
chr16	75252886	75260236	CTRB1	0	+	7350
chr16	75238001	75241059	CTRB2	0	-	3058
chr11	89530823	89541743	TRIM49	0	-	10920
chr2	228226754	228246711	TM4SF20	0	-	19957
chr11	88237744	88799150	GRM5	0	-	561406
chr2	11798304	11810321	NTSR2	0	-	12017
chr3	166957631	167125662	ZBBX	0	-	168031
chr5	56775845	56778638	ACTBL2	0	-	2793
chr10	28064115	28288008	ODAD2	0	-	223893
chr16	27798849	28075035	GSG1L	0	-	276186
chr5	131991955	131996802	IL13	0	+	4847
chr14	22036651	22048210	OR10G3	0	-	11559
chr1	38076951	38100564	RSPO1	0	-	23613
chr1	247670360	247740992	GCSAML	0	+	70632
chr5	53751529	53752207	HSPB3	0	+	678
chrX	30322323	30327507	NR0B1	0	-	5184
chrX	28605563	29974835	IL1RAPL1	0	+	1369272
chr22	24105177	24108050	C22orf15	0	+	2873
chr14	21616529	21627219	OR5AU1	0	-	10690
chr16	20370497	20416059	PDILT	0	-	45562
chr16	20344373	20367623	UMOD	0	-	23250
chr16	20320896	20339130	GP2	0	-	18234
chr14	21423646	21424595	RNASE2	0	+	949
chr19	48497889	48528411	ELSPBP1	0	+	30522
chr14	21359544	21360507	RNASE3	0	+	963
chr8	140613081	140716352	KCNK9	0	-	103271
chr14	20482302	20487466	OR4K14	0	-	5164
chr14	20443750	20444724	OR4K15	0	+	974
chr8	38831747	38846182	HTRA4	0	+	14435
chr22	22868060	22874613	ZNF280A	0	-	6553
chrX	134290465	134305322	CT55	0	-	14857
chr22	22599192	22599927	VPREB1	0	+	735
chr16	56685798	56687116	MT1B	0	+	1318
chr3	128779622	128781249	GP9	0	+	1627
chr1	2938031	2939467	ACTRT2	0	+	1436
chr5	9627459	9712490	TAS2R1	0	-	85031
chrY	24636544	24660784	PRY	0	+	24240
chrY	24314689	24329129	RBMY1F	0	-	14440
chrY	24217903	24242154	PRY2	0	-	24251
chr4	104507188	104641142	TACR3	0	-	133954
chr13	28366620	28368905	GSX1	0	+	2285
chr15	53047250	53083275	ONECUT1	0	-	36025
chr16	31539221	31540124	AHSP	0	+	903
chr12	49359123	49365518	WNT10B	0	-	6395
chr1	1846547	1848735	CALML6	0	+	2188
chr3	149192484	149221181	TM4SF4	0	+	28697
chrX	11840542	12742642	FRMPD4	0	+	902100
chr4	153690506	153700882	TIGD4	0	-	10376
chr3	39850405	40301812	MYRIP	0	+	451407
chr3	101818088	102198685	ZPLD1	0	+	380597
chr14	94929054	94946026	SERPINA9	0	-	16972
chr5	177134982	177211436	FAM153A	0	-	76454
chr5	173472709	173670504	NSG2	0	+	197795
chr7	75121598	75133640	SPDYE5	0	+	12042
chr14	94770585	94789726	SERPINA6	0	-	19141
chr9	116231	118417	FOXD4	0	-	2186
chr1	200842109	200843306	GPR25	0	+	1197
chr6	117586721	117594728	VGLL2	0	+	8007
chr2	176964523	176967217	HOXD12	0	+	2694
chr4	145030456	145061904	GYPA	0	-	31448
chr5	159292087	159400019	ADRA1B	0	+	107932
chr11	18955046	18960961	MRGPRX1	0	-	5915
chr7	148287858	148312952	C7orf33	0	+	25094
chr8	87566205	87755903	CNGB3	0	-	189698
chr11	107578104	107590419	SLN	0	-	12315
chr10	49361131	49482739	FRMPD2	0	-	121608
chr20	23856571	23860385	CST5	0	-	3814
chr12	53720359	53739099	SP7	0	-	18740
chr2	185463256	185804219	ZNF804A	0	+	340963
chr7	54610018	54638773	VSTM2A	0	+	28755
chr12	52959566	52967627	KRT74	0	-	8061
chr4	88224941	88244038	HSD17B13	0	-	19097
chr5	3595946	3601517	IRX1	0	+	5571
chr12	55520190	55526534	OR9K2	0	+	6344
chr19	46367247	46377055	FOXA3	0	+	9808
chr7	102993177	103086654	SLC26A5	0	-	93477
chr9	103340361	103350671	CAVIN4	0	+	10310
chr11	7958718	7963255	OR10A3	0	-	4537
chr17	46839596	46894591	TTLL6	0	-	54995
chr11	7260009	7490274	SYT9	0	+	230265
chr11	7110229	7112379	RBMXL2	0	+	2150
chr9	6328375	6331891	TPD52L3	0	+	3516
chr11	6897856	6898850	OR10A4	0	+	994
chr11	6884288	6895948	OR10A2	0	+	11660
chr7	123295920	123304344	LMOD2	0	+	8424
chr3	133118900	133194066	BFSP2	0	+	75166
chr2	49189296	49381666	FSHR	0	-	192370
chr19	43406238	43423715	PSG6	0	-	17477
chr12	120759918	120765582	PLA2G1B	0	-	5664
chr19	9236688	9237626	OR7G3	0	-	938
chr19	9211083	9218151	OR7G2	0	-	7068
chrX	107224094	107225600	TEX13B	0	-	1506
chr19	9197737	9206345	OR1M1	0	+	8608
chr19	8943053	8954016	MBD3L1	0	+	10963
chr6	49753373	49754998	PGK2	0	-	1625
chr11	124409531	124415229	OR8B12	0	-	5698
chr19	42300519	42315592	CEACAM3	0	+	15073
chr11	30851916	31391357	DCDC1	0	-	539441
chr11	123810324	123811280	OR4D5	0	+	956
chr11	125616174	125619762	PATE1	0	+	3588
chr2	29415640	30144452	ALK	0	-	728812
chr9	136080664	136084637	OBP2B	0	-	3973
chrX	148855726	148858525	HSFX1	0	+	2799
chr19	5805078	5828335	NRTN	0	+	23257
chr2	42669157	42721122	KCNG3	0	-	51965
chr9	114089509	114092504	OR2K2	0	-	2995
chr19	14138960	14142363	RLN3	0	+	3403
chr1	248394719	248407981	OR2M4	0	+	13262
chr4	71296209	71348714	MUC7	0	+	52505
chr4	71263648	71275912	OPRPN	0	+	12264
chr4	71235810	71255961	SMR3B	0	+	20151
chr4	71104099	71117191	CSN3	0	+	13092
chr6	155585147	155597682	CLDN20	0	+	12535
chr17	39315901	39317000	KRTAP4-4	0	-	1099
chrX	52891554	52897114	XAGE3	0	-	5560
chrX	52840311	52847325	XAGE5	0	+	7014
chrX	48620151	48632064	GLOD5	0	+	11913
chr17	38933060	38938802	KRT27	0	-	5742
chr2	219824388	219826877	CDK5R2	0	+	2489
chr9	125504582	125513062	OR1L6	0	+	8480
chrX	47990008	47992002	SPACA5B	0	+	1994
chr9	125437409	125438383	OR1L3	0	+	974
chr19	56511092	56573176	NLRP5	0	+	62084
chrX	47863734	47869130	SPACA5	0	+	5396
chr5	40998119	41071444	MROH2B	0	-	73325
chr9	125329396	125345663	OR1L8	0	-	16267
chr9	125315391	125317452	OR1N2	0	+	2061
chr9	125288637	125289575	OR1N1	0	-	938
chr4	159236463	159574524	RXFP1	0	+	338061
chr17	37759789	37766030	NEUROD2	0	-	6241
chr5	76924537	76934538	OTP	0	-	10001
chr11	74792798	74807921	OR2AT4	0	-	15123
chr21	41382926	42219084	DSCAM	0	-	836158
chr17	72270373	72311023	DNAI2	0	+	40650
chr2	232387898	232395156	NMUR1	0	-	7258
chr6	42883727	42893576	PTCRA	0	+	9849
chr5	76145826	76217475	S100Z	0	+	71649
chr8	7752199	7754238	DEFB4A	0	+	2039
chr1	162342993	162346644	SPATA46	0	-	3651
chr10	135367405	135383339	SYCE1	0	-	15934
chr10	135043721	135045062	UTF1	0	+	1341
chr10	134973723	135039916	KNDC1	0	+	66193
chr19	38375463	38397317	WDR87	0	-	21854
chr10	134621896	134756327	CFAP46	0	-	134431
chr5	140430959	140438931	PCDHB1	0	+	7972
chr9	21077103	21077941	IFNB1	0	-	838
chr20	4702555	4709106	PRND	0	+	6551
chr1	44584493	44600812	KLF17	0	+	16319
chr20	4201277	4229934	ADRA1D	0	-	28657
chr18	24432007	24445735	AQP4	0	-	13728
chr17	18647339	18682662	FBXW10	0	+	35323
chr19	15848795	15853153	OR10H3	0	+	4358
chr19	15838834	15839862	OR10H2	0	+	1028
chr11	5150006	5159586	OR52A5	0	-	9580
chr15	60296433	60353929	FOXB1	0	+	57496
chr2	79384129	79386879	REG3A	0	-	2750
chr2	79312149	79315145	REG1B	0	-	2996
chr2	88824167	88829103	TEX37	0	+	4936
chr3	111859745	112013074	SLC9C1	0	-	153329
chr17	3110833	3122190	OR1A1	0	+	11357
chr17	3100813	3101742	OR1A2	0	+	929
chr11	55860784	55861716	OR8I2	0	+	932
chr1	152769197	152770657	LCE1D	0	+	1460
chr6	22287473	22303055	PRL	0	-	15582
chr11	55369836	55375121	OR4C11	0	-	5285
chr11	56143100	56144029	OR8U1	0	+	929
chr11	48266656	48267567	OR4X2	0	+	911
chr19	825097	832018	AZU1	0	+	6921
chr11	47611219	47615963	C1QTNF4	0	-	4744
chrY	27768264	27771049	CDY1	0	+	2785
chr2	168149511	168730555	B3GALT1	0	+	581044
chr11	59203942	59218853	OR5A1	0	+	14911
chr11	59184442	59193886	OR5A2	0	-	9444
chr11	119019762	119033362	ABCG4	0	+	13600
chrY	26191376	26194166	CDY1B	0	-	2790
chr11	58206467	58209709	OR5B12	0	-	3242
chr11	58188711	58195594	OR5B2	0	-	6883
chr4	120056987	120108944	MYOZ2	0	+	51957
chr1	67263423	67266959	INSL5	0	-	3536
chr17	60421302	60493841	EFCAB3	0	+	72539
chr11	56508699	56516173	OR9G4	0	-	7474
chr11	56431162	56432094	OR5AR1	0	+	932
chr11	56408965	56409915	OR5AP2	0	-	950
chr2	241808241	241819919	AGXT	0	+	11678
chr11	56127691	56128764	KNOWN	0	+	1073
chr11	56019676	56020698	KNOWN	0	+	1022
chr5	80625815	80689998	ACOT12	0	-	64183
chr19	15898471	15911167	OR10H5	0	+	12696
chr10	50339199	50342066	FAM170B	0	-	2867
chr2	946535	1371385	SNTG2	0	+	424850
chr12	48596122	48597075	OR10AD1	0	-	953
chr6	128029217	128239776	THEMIS	0	-	210559
chr8	57025501	57026541	MOS	0	-	1040
chr11	60552806	60568778	MS4A10	0	+	15972
chr8	30853318	30891231	PURG	0	-	37913
chr11	59278841	59288176	OR4D9	0	+	9335
chr11	58169937	58174347	OR5B3	0	-	4410
chr3	129120164	129147494	EFCAB12	0	-	27330
chr11	58034264	58035732	OR10W1	0	-	1468
chr12	53038342	53045995	KRT2	0	-	7653
chr11	68747490	68748455	MRGPRD	0	-	965
chr3	38307303	38320248	SLC22A13	0	+	12945
chr22	17264302	17306301	XKR3	0	-	41999
chr3	75713479	75716371	FRG2C	0	+	2892
chr3	35680437	35835988	ARPP21	0	+	155551
chr1	155911429	155912878	RXFP4	0	+	1449
chr12	111284573	111345339	CCDC63	0	+	60766
chr12	43747669	43946006	ADAMTS20	0	-	198337
chr12	39943835	40013605	ABCD2	0	-	69770
chr18	47221	49615	TUBB8B	0	-	2394
chr11	66742748	66744480	C11orf86	0	+	1732
chr5	145892707	145895753	GPR151	0	-	3046
chr9	114287439	114340124	ZNF483	0	+	52685
chr5	145463876	145485140	PLAC8L1	0	-	21264
chr1	158431364	158440647	OR10K1	0	+	9283
chr2	131486643	131487909	GPR148	0	+	1266
chr20	23583047	23586554	CST9	0	-	3507
chr3	51928892	51937369	IQCF1	0	-	8477
chr3	49235861	49295539	IHO1	0	+	59678
chr7	19758938	19813240	TMEM196	0	-	54302
chr2	26785453	26802400	FAM166C	0	+	16947
chr19	56403065	56443702	NLRP13	0	-	40637
chr4	70454135	70518967	UGT2A1	0	-	64832
chr6	117113248	117150246	GPRC6A	0	-	36998
chr6	116816152	116866847	TRAPPC3L	0	-	50695
chr1	6615367	6639815	TAS1R1	0	+	24448
chr1	6304239	6305638	HES3	0	+	1399
chr9	125423845	125424927	OR1L1	0	+	1082
chr2	231855039	231889770	SPATA3	0	+	34731
chr17	48912011	48919714	WFIKKN2	0	+	7703
chr1	244515937	244552965	C1orf100	0	+	37028
chr3	44283378	44373590	TOPAZ1	0	+	90212
chr17	60778675	60885705	MARCHF10	0	-	107030
chr17	47300728	47308149	PHOSPHO1	0	-	7421
chr17	38948448	38956211	KRT28	0	-	7763
chr19	3769087	3772226	RAX2	0	-	3139
chr13	46786063	46851250	LRRC63	0	+	65187
chrX	79591003	79700810	TENT5D	0	+	109807
chr9	35041092	35045983	C9orf131	0	+	4891
chr4	37246365	37451085	NWD2	0	+	204720
chr6	52761437	52774496	GSTA3	0	-	13059
chrX	100224697	100245820	ARL13A	0	+	21123
chr12	27849380	27850529	REP15	0	+	1149
chr3	113953478	113956425	ZNF80	0	-	2947
chr2	176942200	176948690	EVX2	0	-	6490
chr17	6944940	6947411	SLC16A11	0	-	2471
chr5	180166123	180167058	OR2Y1	0	-	935
chr4	40337350	40357234	CHRNA9	0	+	19884
chr5	1201710	1225226	SLC6A19	0	+	23516
chr8	110098814	110133794	TRHR	0	+	34980
chr8	107771711	107782472	ABRA	0	-	10761
chr18	51850728	51884334	STARD6	0	-	33606
chr15	23684185	23692390	GOLGA6L2	0	-	8205
chr2	215275778	215443700	VWC2L	0	+	167922
chrX	117957787	117960931	ZCCHC12	0	+	3144
chr4	172733405	173962710	GALNTL6	0	+	1229305
chr9	27937615	29213599	LINGO2	0	-	1275984
chr19	40721965	40724291	TTC9B	0	-	2326
chr12	109785705	109893328	MYO1H	0	+	107623
chr19	51328545	51340469	KLK15	0	-	11924
chr11	66188475	66194178	NPAS4	0	+	5703
chr3	134318765	134370478	KY	0	-	51713
chr19	9320952	9330265	OR7D4	0	-	9313
chrX	90689594	90693583	PABPC5	0	+	3989
chr3	167196472	167371771	WDR49	0	-	175299
chr3	57327727	57530071	DNAH12	0	-	202344
chr1	104230037	104239076	AMY1B	0	-	9039
chr11	278407	285388	NLRP6	0	+	6981
chr19	5720648	5778745	CATSPERD	0	+	58097
chr11	56466571	56471360	OR9G1	0	+	4789
chr3	154052732	154147979	GPR149	0	-	95247
chr11	55944094	55945032	OR5J2	0	+	938
chr11	55733231	55737421	OR10AG1	0	-	4190
chr11	55415803	55420330	OR4S2	0	+	4527
chr16	87915152	87970186	CA5A	0	-	55034
chr16	29789577	29794294	ZG16	0	+	4717
chr6	160542847	160579750	SLC22A1	0	+	36903
chr10	127265091	127371732	TEX36	0	-	106641
chr18	28956740	28994875	DSG4	0	+	38135
chr3	186915274	186919250	RTP1	0	+	3976
chr3	140770189	140867453	SPSB4	0	+	97264
chr1	248566349	248571321	OR2T1	0	+	4972
chr3	85008140	86123579	CADM2	0	+	1115439
chr12	57828567	57845845	INHBC	0	+	17278
chr11	65808236	65816632	GAL3ST3	0	-	8396
chr1	11006528	11042133	C1orf127	0	-	35605
chr16	22103859	22168285	VWA3A	0	+	64426
chr5	177419236	177423243	PROP1	0	-	4007
chr22	35462129	35483380	ISX	0	+	21251
chr12	56754352	56756641	APOF	0	-	2289
chr12	56030676	56031617	OR10P1	0	+	941
chr11	6220454	6221416	OR52W1	0	+	962
chr2	115199876	116603356	DPP10	0	+	1403480
chr11	65712951	65727437	TSGA10IP	0	+	14486
chr10	118305443	118327367	PNLIP	0	+	21924
chr11	48238362	48239291	OR4B1	0	+	929
chr13	31506793	31549637	TEX26	0	+	42844
chr14	94453571	94475209	CCDC197	0	+	21638
chr5	176057619	176073645	EIF4E1B	0	+	16026
chr13	103381717	103411422	CCDC168	0	-	29705
chr5	57787262	57792917	GAPT	0	+	5655
chr11	14926543	15103888	CALCB	0	+	177345
chr7	73275489	73280220	TMEM270	0	+	4731
chr21	45917776	46131487	TSPEAR	0	-	213711
chr8	124656682	124666041	KLHL38	0	-	9359
chr14	69951409	69998268	PLEKHD1	0	+	46859
chr11	8959125	8964563	ASCL3	0	-	5438
chr11	8941623	8954553	C11orf16	0	-	12930
chr3	111753583	111800116	TMPRSS7	0	+	46533
chr9	69650263	69660358	NOVEL	0	+	10095
chr18	13824148	13827322	MC5R	0	+	3174
chr17	56497528	56565769	HSF5	0	-	68241
chr14	29235993	29239483	FOXG1	0	+	3490
chr22	40139049	40289868	ENTHD1	0	-	150819
chr14	20707445	20712508	OR11H4	0	+	5063
chr11	59271049	59271984	OR4D11	0	+	935
chr2	76974811	77820445	LRRTM4	0	-	845634
chr14	20691869	20692861	OR11H6	0	+	992
chr14	20578898	20590358	OR4K17	0	+	11460
chr19	16055109	16061160	OR10H4	0	+	6051
chr10	15117474	15130775	ACBD7	0	-	13301
chr14	20528204	20529142	OR4L1	0	+	938
chr14	20497558	20504197	OR4K13	0	-	6639
chr8	116086	117024	OR4F21	0	-	938
chr14	20388766	20389737	OR4K5	0	+	971
chr14	20336356	20337302	OR4K3	0	-	946
chr14	20187174	20298412	OR4N2	0	+	111238
chr11	118842422	118851997	FOXR1	0	+	9575
chr17	47915662	47925431	TAC4	0	-	9769
chr6	166718788	166721936	PRR18	0	-	3148
chr7	99520889	99527243	GJC3	0	-	6354
chr11	59126368	59139187	OR5AN1	0	+	12819
chr7	143206349	143216562	OR10AC1	0	-	10213
chr11	48387037	48388017	OR4C5	0	-	980
chr11	48346472	48347507	OR4C3	0	+	1035
chr11	48327775	48328704	OR4S1	0	+	929
chr11	48285413	48286330	OR4X1	0	+	917
chr8	87878643	88627447	CNBD1	0	+	748804
chr2	135722055	135805038	MAP3K19	0	-	82983
chr22	30476453	30573064	HORMAD2	0	+	96611
chrY	3447108	3448082	TGIF2LY	0	+	974
chr19	107104	117102	OR4F17	0	+	9998
chr16	31443914	31454481	ZNF843	0	-	10567
chr11	5220965	5221912	OR51V1	0	-	947
chrX	26210557	26213763	MAGEB6	0	+	3206
chr10	132890654	133109984	TCERG1L	0	-	219330
chrX	26156460	26158853	MAGEB18	0	+	2393
chr8	7693958	7698764	DEFB104A	0	+	4806
chr11	5079880	5080857	OR52E2	0	-	977
chr8	7738914	7740185	DEFB103A	0	+	1271
chr11	5016081	5026766	OR51L1	0	+	10685
chr9	140033606	140063208	GRIN1	0	+	29602
chr9	139839637	139841427	C8G	0	+	1790
chr8	144239331	144242128	LY6H	0	-	2797
chr4	165937610	165962901	TRIM60	0	+	25291
chrX	147062857	147108185	FMR1NB	0	+	45328
chr8	7327830	7332604	DEFB104B	0	-	4774
chr19	58469805	58485902	C19orf18	0	-	16097
chr9	21140631	21141831	IFNW1	0	-	1200
chr11	117298488	117688240	DSCAML1	0	-	389752
chrX	8992273	9263722	FAM9B	0	-	271449
chr18	580380	582114	CETN1	0	+	1734
chr1	248799657	248808579	OR2T35	0	-	8922
chr1	248512077	248513015	OR14C36	0	+	938
chr1	248486932	248487870	OR2M7	0	-	938
chr1	248453441	248466726	OR2T12	0	-	13285
chr1	248433219	248441278	OR2T33	0	-	8059
chr16	31225412	31242858	TRIM72	0	+	17446
chr8	7286410	7287870	DEFB103B	0	-	1460
chr8	7272377	7274385	DEFB4B	0	-	2008
chr1	111196182	111217562	KCNA3	0	-	21380
chr1	248088191	248098641	OR2AJ1	0	+	10450
chr10	35894269	35897863	GJD4	0	+	3594
chr1	111062459	111174096	KCNA2	0	-	111637
chrX	18181051	18239006	BEND2	0	-	57955
chr10	50507215	50535537	C10orf71	0	+	28322
chr21	43483068	43563563	UMODL1	0	+	80495
chr1	64669306	64733051	UBE2U	0	+	63745
chr5	43192173	43280952	NIM1K	0	+	88779
chr1	248083554	248086454	OR2T8	0	+	2900
chr6	137813336	137815531	OLIG3	0	-	2195
chr1	247768888	247769817	OR2G3	0	+	929
chr1	247751662	247752615	OR2G2	0	+	953
chrX	8137985	8139308	VCX2	0	-	1323
chr18	55019788	55038962	ST8SIA3	0	+	19174
chr1	247612420	247621407	OR2B11	0	-	8987
chr19	35715703	35719642	FAM187B	0	-	3939
chr12	48876281	48890307	C12orf54	0	+	14026
chr2	232457575	232458987	TEX44	0	+	1412
chr6	49927962	49931877	DEFB114	0	-	3915
chrX	27826107	27841131	MAGEB10	0	+	15024
chr15	102462245	102463316	OR4F4	0	-	1071
chr8	11188521	11189869	SLC35G5	0	+	1348
chr4	44624105	44680573	YIPF7	0	-	56468
chr10	75391370	75401232	MYOZ1	0	-	9862
chr1	159968441	160039950	KCNJ10	0	-	71509
chr9	90744220	90753390	SPATA31C2	0	-	9170
chr12	18891053	18892122	CAPZA3	0	+	1069
chr9	90497792	90503818	SPATA31E1	0	+	6026
chr2	54557171	54610879	C2orf73	0	+	53708
chr5	94955791	94957846	GPR150	0	+	2055
chr3	183770835	183778461	HTR3C	0	+	7626
chr15	30844253	30857887	GOLGA8Q	0	+	13634
chr2	131513113	131525707	AMER3	0	+	12594
chr5	71735730	71803237	ZNF366	0	-	67507
chr5	178368192	178393434	ZNF454	0	+	25242
chr19	57966158	57968508	VN1R1	0	-	2350
chr10	82297658	82406316	SH2D4B	0	+	108658
chr4	1050038	1107352	RNF212	0	-	57314
chr13	84451340	84456609	SLITRK1	0	-	5269
chr8	7705398	7726389	SPAG11A	0	+	20991
chr18	77557938	77660184	KCNG2	0	+	102246
chr4	42399505	42404504	SHISA3	0	+	4999
chr11	6942233	6943225	OR2D3	0	+	992
chr5	63253701	63258334	HTR1A	0	-	4633
chr1	223566757	223568807	CCDC185	0	+	2050
chr4	113434672	113437336	NEUROG2	0	-	2664
chr10	5435064	5446791	TUBAL3	0	-	11727
chr10	5406929	5416655	UCN3	0	+	9726
chr4	71457973	71473005	AMBN	0	+	15032
chr2	240984494	240986444	OR6B3	0	-	1950
chr20	67891	77735	DEFB125	0	+	9844
chr2	241078443	241083979	OTOS	0	-	5536
chr10	50887697	50918307	C10orf53	0	+	30610
chr18	52254988	52266724	DYNAP	0	+	11736
chr3	194115550	194119995	GP5	0	-	4445
chr3	194060497	194072057	CPN2	0	-	11560
chr17	72517313	72527614	CD300LB	0	-	10301
chr11	76927603	77012732	GDPD4	0	-	85129
chr1	151682909	151702281	RIIAD1	0	+	19372
chr3	129262018	129270310	H1-8	0	+	8292
chr19	48304489	48322308	TPRX1	0	-	17819
chr1	75033801	75139476	ERICH3	0	-	105675
chr15	41474923	41522955	EXD1	0	-	48032
chr4	189012426	189030757	TRIML2	0	-	18331
chr9	107456799	107457743	OR13D1	0	+	944
chr11	85394891	85397238	CCDC89	0	-	2347
chr12	103631369	103889756	C12orf42	0	-	258387
chr3	87841856	88042989	HTR1F	0	+	201133
chr17	8023910	8027424	HES7	0	-	3514
chr10	23491625	23633774	C10orf67	0	-	142149
chr6	36358328	36410631	PXT1	0	-	52303
chr19	38874907	38878722	GGN	0	-	3815
chr19	51749603	51772584	SIGLECL1	0	+	22981
chr11	76092347	76125663	GVQW3	0	+	33316
chr20	59827317	60515673	CDH4	0	+	688356
chr2	29283842	29297389	PCARE	0	-	13547
chr19	13075973	13085574	DAND5	0	+	9601
chr11	66059365	66064135	TMEM151A	0	+	4770
chrX	77911565	77914825	RTL3	0	-	3260
chr11	107799174	107834208	RAB39A	0	+	35034
chrX	102965837	102968960	TMEM31	0	+	3123
chr1	244617679	244804479	CATSPERE	0	+	186800
chr13	92050875	93525935	GPC5	0	+	1475060
chr3	128181280	128185811	DNAJB8	0	-	4531
chr7	142723287	142724219	OR9A2	0	-	932
chr12	100750852	100815833	SLC17A8	0	+	64981
chr16	2016824	2018976	RNF151	0	+	2152
chr14	63779549	63785649	GPHB5	0	-	6100
chr7	126078652	126893147	GRM8	0	-	814495
chr12	55966252	55969396	OR2AP1	0	+	3144
chr12	55943386	55949616	OR6C4	0	+	6230
chr12	55837853	55847131	OR6C2	0	+	9278
chr19	56459198	56499995	NLRP8	0	+	40797
chr19	39693465	39694903	SYCN	0	-	1438
chr10	69990352	69991870	ATOH7	0	-	1518
chr3	26664263	26759028	LRRC3B	0	+	94765
chr13	43355686	43365685	FAM216B	0	+	9999
chr11	18194384	18195827	MRGPRX4	0	+	1443
chr11	18142502	18160035	MRGPRX3	0	+	17533
chr19	56296763	56348166	NLRP11	0	-	51403
chr2	50145641	51452713	NRXN1	0	-	1307072
chr12	55614809	55615759	OR10A7	0	+	950
chr1	182023705	182030847	ZNF648	0	-	7142
chr3	39371200	39375171	CCR8	0	+	3971
chr15	30375158	30388893	GOLGA8J	0	+	13735
chr17	3300398	3301704	OR1E1	0	-	1306
chr19	55866276	55874628	GARIN5B	0	-	8352
chr8	23559253	23564269	NKX2-6	0	-	5016
chr20	44277202	44298909	WFDC11	0	-	21707
chr20	44236578	44259923	WFDC9	0	-	23345
chr16	30382255	30389312	MYLPF	0	+	7057
chr11	46740746	46761056	F2	0	+	20310
chr9	127212730	127240868	ADGRD2	0	+	28138
chr16	20039561	20085212	GPR139	0	-	45651
chr1	242246288	242687999	PLD5	0	-	441711
chr6	36210980	36281732	PNPLA1	0	+	70752
chr12	85673998	85695562	ALX1	0	+	21564
chr7	31553704	31696118	ITPRID1	0	+	142414
chr20	30053274	30064560	DEFB124	0	-	11286
chr17	39431950	39432459	KRTAP9-7	0	+	509
chr20	30028435	30038060	DEFB123	0	+	9625
chr13	37248157	37271976	SERTM1	0	+	23819
chr11	57995354	57996390	OR10Q1	0	-	1036
chr12	75784869	75826468	GLIPR1L2	0	+	41599
chr20	29964967	29978393	DEFB119	0	-	13426
chr3	126245842	126277808	C3orf22	0	-	31966
chr1	158388000	158396027	OR10K2	0	-	8027
chr11	46405339	46413326	CHRM4	0	-	7987
chr10	129676105	129691205	CLRN3	0	-	15100
chrX	115301997	115306227	AGTR2	0	+	4230
chr18	14728271	14854666	ANKRD30B	0	+	126395
chr11	4664650	4676718	OR51E1	0	+	12068
chr6	50009812	50017642	DEFB112	0	-	7830
chr11	6226787	6232365	C11orf42	0	+	5578
chr11	6128914	6130065	OR56B4	0	+	1151
chr11	6040566	6055568	OR56A1	0	-	15002
chr11	5901859	5908309	OR52E4	0	+	6450
chr11	5830154	5842713	OR52N2	0	+	12559
chr1	172389825	172437971	C1orf105	0	+	48146
chr11	5807701	5812495	OR52N1	0	-	4794
chr11	5797395	5804585	OR52N5	0	-	7190
chr11	5782383	5790310	OR56B2P	0	+	7927
chr1	159770301	159786047	FCRL6	0	+	15746
chr11	5775473	5777188	OR52N4	0	+	1715
chr8	57349233	57359230	PENK	0	-	9997
chr11	124095437	124096371	OR8G2P	0	+	934
chr4	5899100	6202282	C4orf50	0	-	303182
chr12	128751715	129192456	TMEM132C	0	+	440741
chr19	6426048	6433790	SLC25A41	0	-	7742
chr11	56756389	56757318	OR5AK2	0	+	929
chr11	56738525	56739454	OR5AK3P	0	+	929
chr17	32906506	32966337	TMEM132E	0	+	59831
chr17	7323643	7324951	SPEM1	0	+	1308
chr11	56257911	56258846	OR5M8	0	-	935
chr2	219867568	219906249	CFAP65	0	-	38681
chr17	80329641	80335334	UTS2R	0	+	5693
chr12	49388932	49393158	DDN	0	-	4226
chr11	123813574	123814545	OR6T1	0	-	971
chr11	123772874	123779936	OR8D4	0	+	7062
chr14	21236563	21239107	EDDM3B	0	+	2544
chr14	21214046	21216539	EDDM3A	0	+	2493
chr18	12093842	12129763	ANKRD62	0	+	35921
chr1	101003695	101007577	GPR88	0	+	3882
chr11	56055938	56059730	OR8H1	0	-	3792
chr11	56041630	56044295	OR5T1	0	+	2665
chr11	55998758	56001731	OR5T2	0	-	2973
chr19	8831998	8842522	OR2Z1	0	+	10524
chr11	55926870	55927793	OR8K5	0	-	923
chr11	55889849	55890787	OR8H3	0	+	938
chr11	55871163	55875134	OR8H2	0	+	3971
chr9	71151496	71155799	TMEM252	0	-	4303
chr19	463346	474983	ODF3L2	0	-	11637
chr11	55795130	55805667	OR5AS1	0	+	10537
chr19	8807750	8809145	ACTL9	0	-	1395
chr14	21108855	21109850	OR6S1	0	-	995
chr5	121187577	121188528	FTMT	0	+	951
chr11	55429677	55433671	OR4C6	0	+	3994
chr11	55402589	55407785	OR4P4	0	+	5196
chr11	55321783	55322895	OR4C15	0	+	1112
chr11	55135450	55136394	OR4A15	0	+	944
chr11	55110677	55111663	OR4A16	0	+	986
chr11	4470525	4471591	OR52K2	0	+	1066
chr20	37209838	37217106	ADIG	0	+	7268
chr12	86349445	87232681	MGAT4C	0	-	883236
chr11	49049053	49060003	TRIM49B	0	+	10950
chr11	5168054	5175987	OR52A1	0	-	7933
chr10	27686050	27703297	PTCHD3	0	-	17247
chr2	240968841	240969906	KNOWN	0	-	1065
chr7	57509883	57533265	ZNF716	0	+	23382
chr5	169780491	170163636	KCNIP1	0	+	383145
chr17	77704705	77716018	ENPP7	0	+	11313
chr11	3239174	3240043	MRGPRG	0	-	869
chr2	237102102	237173052	ASB18	0	-	70950
chr1	53098840	53135355	SHISAL2A	0	+	36515
chr2	209007297	209010882	CRYGB	0	-	3585
chr4	48492269	48496406	ZAR1	0	+	4137
chr11	30031277	30038577	KCNA4	0	-	7300
chr15	27216328	27787130	GABRG3	0	+	570802
chr11	7979084	7986994	NLRP10	0	-	7910
chr19	49244109	49250166	IZUMO1	0	-	6057
chr17	28643351	28661077	TMIGD1	0	-	17726
chr4	41983773	41988482	DCAF4L1	0	+	4709
chr19	7056218	7069676	MBD3L3	0	-	13458
chr17	4692259	4693884	GLTPD2	0	+	1625
chr2	202937978	203069911	KIAA2012	0	+	131933
chr1	13386646	13390765	KNOWN	0	-	4119
chr10	90424198	90438571	LIPF	0	+	14373
chr11	7846365	7852387	OR5P3	0	-	6022
chr13	106118216	106143383	DAOA	0	+	25167
chr7	88389014	88967842	ZNF804B	0	+	578828
chr19	39787047	39789313	IFNL1	0	+	2266
chrY	20137667	20139626	CDY2A	0	+	1959
chr3	161214596	161221730	OTOL1	0	+	7134
chr11	64058774	64067503	KCNK4	0	+	8729
chr17	80317123	80321651	TEX19	0	+	4528
chr6	28021006	28021943	OR2B8P	0	-	937
chrX	111873876	111923282	LHFPL1	0	-	49406
chr14	55880928	55923444	TBPL2	0	-	42516
chr14	20973696	20982043	RNASE10	0	+	8347
chr21	32252963	32253899	KRTAP11-1	0	-	936
chr16	25703280	26149006	HS3ST4	0	+	445726
chr5	180574586	180586285	OR2V2	0	+	11699
chr5	33936491	33939023	RXFP3	0	+	2532
chr11	123906720	123912032	OR10G7	0	-	5312
chr10	118083960	118139541	CCDC172	0	+	55581
chr8	73449460	73850584	KCNB2	0	+	401124
chr17	79791368	79792926	PPP1R27	0	-	1558
chr17	74070862	74073618	GALR2	0	+	2756
chr2	220192129	220197899	RESP18	0	-	5770
chr6	137243439	137246798	SLC35D3	0	+	3359
chr8	144501352	144512902	MAFA	0	-	11550
chr1	248720213	248726073	OR2T29	0	-	5860
chr11	66357647	66360534	CCDC87	0	-	2887
chr6	52696453	52705641	GSTA5	0	-	9188
chrX	16185604	16189587	MAGEB17	0	+	3983
chr21	31743708	31744589	KRTAP13-2	0	-	881
chr15	102352405	102360400	OR4F15	0	+	7995
chr12	132680924	132905935	KNOWN	0	-	225011
chr17	7258442	7260538	TMEM95	0	+	2096
chr1	152056617	152061540	TCHHL1	0	-	4923
chr1	240930936	241520674	RGS7	0	-	589738
chr22	18043150	18073761	SLC25A18	0	+	30611
chr20	44313290	44333658	WFDC10B	0	-	20368
chr17	72931993	72946087	OTOP3	0	+	14094
chr15	76016382	76020029	ODF3L1	0	+	3647
chr13	112721463	112726020	SOX1	0	+	4557
chr17	3029904	3030845	OR1G1	0	-	941
chr17	72919045	72930007	OTOP2	0	+	10962
chrX	83116134	83141707	CYLC1	0	+	25573
chr21	41117110	41174008	IGSF5	0	+	56898
chr5	172659112	172662314	NKX2-5	0	-	3202
chr4	144498455	144621828	FREM3	0	-	123373
chr14	101003484	101053754	BEGAIN	0	-	50270
chr1	20879066	20881513	FAM43B	0	+	2447
chr7	71244476	71912136	CALN1	0	-	667660
chr3	97703946	97754159	GABRR3	0	-	50213
chr19	405445	409147	C2CD4C	0	-	3702
chr18	14507338	14543599	POTEC	0	-	36261
chr10	67672215	69523395	CTNNA3	0	-	1851180
chr11	5877979	5878920	OR52E8	0	-	941
chr11	7817521	7818489	OR5P2	0	-	968
chrX	8758836	8769424	FAM9A	0	-	10588
chr22	17597187	17602257	TMEM121B	0	-	5070
chr1	248737102	248738058	OR2T34	0	-	956
chr11	6007122	6008215	OR52L1	0	-	1093
chr17	8650842	8661877	SPDYE4	0	-	11035
chr15	73735505	73852354	REC114	0	+	116849
chr10	63422687	63526524	CABCOCO1	0	+	103837
chr11	7710668	7728024	OVCH2	0	-	17356
chr14	74872597	74892913	SYNDIG1L	0	-	20316
chr11	6020675	6028176	OR56A4	0	-	7501
chr3	48658192	48659202	TMEM89	0	-	1010
chr4	110769263	110793471	LRIT3	0	+	24208
chrX	132350690	132352382	TFDP3	0	-	1692
chr4	165875598	165898820	TRIM61	0	-	23222
chr16	9847261	10276785	GRIN2A	0	-	429524
chr13	28551854	28562830	URAD	0	-	10976
chr16	20420856	20452658	ACSM5	0	+	31802
chr10	124457225	124459362	C10orf120	0	-	2137
chr11	94037746	94041312	IZUMO1R	0	+	3566
chr15	99511458	99551021	PGPEP1L	0	-	39563
chr1	149784780	149785248	H3C13	0	-	468
chr2	69172364	69180025	GKN2	0	-	7661
chr3	46172382	46308197	CCR3	0	+	135815
chr15	28764757	28778160	GOLGA8G	0	-	13403
chrX	125953712	125955769	PRR32	0	+	2057
chr16	32684849	32687486	TP53TG3	0	-	2637
chr8	10463859	10569697	RP1L1	0	-	105838
chr21	32185015	32185592	KRTAP8-1	0	-	577
chr11	111385503	111407768	HOATZ	0	+	22265
chr5	16067248	16180871	MARCHF11	0	-	113623
chr3	68053390	68594772	TAFA1	0	+	541382
chr19	43715943	43773682	PSG9	0	-	57739
chrX	44007118	44202918	EFHC2	0	-	195800
chr11	19076002	19082264	MRGPRX2	0	-	6262
chr19	39759036	39760828	IFNL2	0	+	1792
chr11	132284871	133402396	OPCML	0	-	1117525
chr2	71004442	71017775	FIGLA	0	-	13333
chr16	20462783	20498991	ACSM2A	0	+	36208
chrY	25119966	25151612	BPY2	0	+	31646
chr5	143550437	143865249	KCTD16	0	+	314812
chr1	234040422	234460257	SLC35F3	0	+	419835
chr4	44175920	44450826	KCTD8	0	-	274906
chrY	26753707	26785354	BPY2B	0	+	31647
chr6	117073360	117086882	FAM162B	0	-	13522
chr1	173577475	173638990	ANKRD45	0	-	61515
chrX	152224766	152228827	PNMA3	0	+	4061
chr19	23258012	23330023	ZNF730	0	+	72011
chrX	150903218	150914036	CNGA2	0	+	10818
chr1	16330731	16335302	SRARP	0	+	4571
chr11	56949221	56959191	LRRC55	0	+	9970
chr16	22173813	22203529	SDR42E2	0	+	29716
chr16	2059927	2070756	NPW	0	+	10829
chr1	248753788	248761001	OR2T10	0	-	7213
chr21	32007525	32007938	KRTAP20-2	0	+	413
chr4	189060595	189068897	TRIML1	0	+	8302
chr15	102343712	102347090	OR4F6	0	+	3378
chr1	205012065	205047417	CNTN2	0	+	35352
chr1	152943124	152945050	SPRR4	0	+	1926
chr1	159504868	159505797	OR10J5	0	-	929
chr17	2991778	3007716	OR1D2	0	-	15938
chrX	69397333	69425554	DGAT2L6	0	+	28221
chr21	34442447	34444719	OLIG1	0	+	2272
chr12	7842380	7848371	GDF3	0	-	5991
chr3	51895631	51897440	IQCF2	0	+	1809
chr11	3246260	3253647	MRGPRE	0	-	7387
chr21	31852025	31852686	KRTAP19-1	0	-	661
chr17	43331760	43339461	SPATA32	0	-	7701
chr8	120007691	120120694	COLEC10	0	+	113003
chrX	72222778	72225945	PABPC1L2B	0	+	3167
chr1	33772367	33786699	A3GALT2	0	-	14332
chr14	20606979	20613630	OR4N5	0	+	6651
chr22	32809832	32860471	BPIFC	0	-	50639
chr16	1138226	1146244	C1QTNF8	0	-	8018
chr11	5959981	5972577	OR56A3	0	+	12596
chr2	114256242	114258727	FOXD4L1	0	+	2485
chr17	39868583	39872221	GAST	0	+	3638
chr15	34635516	34649938	NUTM1	0	+	14422
chr11	787115	790113	CEND1	0	-	2998
chr6	127840600	127912965	C6orf58	0	+	72365
chr17	9674751	9694909	DHRS7C	0	-	20158
chr17	7328935	7330887	SPEM2	0	+	1952
chr22	25115001	25170687	PIWIL3	0	-	55686
chr1	113261527	113269857	TAFA3	0	+	8330
chr2	163227917	163695277	KCNH7	0	-	467360
chr7	74320394	74331167	SPDYE12	0	-	10773
chr17	8243158	8249366	ODF4	0	+	6208
chr9	70426623	70429731	KNOWN	0	-	3108
chr8	85095022	85834079	RALYL	0	+	739057
chr21	31985750	31986249	KRTAP6-1	0	-	499
chrX	23018077	23021706	DDX53	0	+	3629
chr17	1182956	1204272	TRARG1	0	+	21316
chrY	2654896	2655723	SRY	0	-	827
chr1	16366747	16383806	CLCNKB	0	+	17059
chrX	71996714	72068637	DMRTC1B	0	+	71923
chr11	6812967	6820920	OR6A2	0	-	7953
chr11	32409321	32457110	WT1	0	-	47789
chr2	241631283	241637900	AQP12A	0	+	6617
chr12	55862984	55863922	OR6C70	0	-	938
chr15	34260698	34359659	CHRM5	0	+	98961
chr11	63035494	63079255	SLC22A10	0	+	43761
chr6	117198375	117253324	RFX6	0	+	54949
chr5	191610	196449	LRRC14B	0	+	4839
chr7	76160630	76172614	SPDYE16	0	-	11984
chr8	13942354	15095940	SGCZ	0	-	1153586
chr5	173400782	173433143	C5orf47	0	+	32361
chr6	27775257	27775707	H2BC13	0	-	450
chr4	156129788	156138230	NPY2R	0	+	8442
chr1	226411319	226414761	MIXL1	0	+	3442
chr2	241615835	241622323	AQP12B	0	-	6488
chr7	57187321	57207571	KNOWN	0	-	20250
chr19	685546	695498	PRSS57	0	-	9952
chr18	13882043	13915706	MC2R	0	-	33663
chr17	4835572	4838318	GP1BA	0	+	2746
chr5	93486556	93954309	KIAA0825	0	-	467753
chr22	37387161	37403892	TEX33	0	-	16731
chr14	20894011	20904325	KLHL33	0	-	10314
chr17	43922247	43924433	SPPL2C	0	+	2186
chr3	38738293	38857777	SCN10A	0	-	119484
chr5	180550122	180558169	OR2V1	0	-	8047
chr19	14989015	14996944	OR7A17	0	-	7929
chrX	34147869	34150431	FAM47A	0	-	2562
chr7	98771195	98847698	KPNA7	0	-	76503
chr15	91643180	91845795	SV2B	0	+	202615
chr1	213003483	213020991	SPATA45	0	-	17508
chr17	79617489	79630142	PDE6G	0	-	12653
chr12	45408455	45444882	DBX2	0	-	36427
chr16	333164	337215	PDIA2	0	+	4051
chr12	5541274	5630702	NTF3	0	+	89428
chr5	171209436	171223130	SMIM23	0	+	13694
chr22	32903807	33454367	SYN3	0	-	550560
chr9	124922187	124962367	MORN5	0	+	40180
chr10	1223253	1779719	ADARB2	0	-	556466
chr10	83634950	84746935	NRG3	0	+	1111985
chr16	4239375	4292081	SRL	0	-	52706
chr4	184242917	184243579	CLDN24	0	-	662
chr4	20730229	21950395	KCNIP4	0	-	1220166
chr9	43624507	43630730	KNOWN	0	-	6223
chr12	55820038	55820976	OR6C76	0	+	938
chr15	24920922	24928540	NPAP1	0	+	7618
chr4	69092371	69111412	TMPRSS11B	0	-	19041
chr1	228003376	228034171	PRSS38	0	+	30795
chrY	27177048	27208695	BPY2C	0	-	31647
chr19	35849362	35851391	FFAR3	0	+	2029
chr7	143140546	143141502	TAS2R60	0	+	956
chr11	51515282	51516211	OR4C46	0	+	929
chr10	105212997	105218657	CALHM1	0	-	5660
chr11	1651005	1652160	KRTAP5-5	0	+	1155
chr8	63161150	63926559	NKAIN3	0	+	765409
chrX	585079	620146	SHOX	0	+	35067
chrY	535079	570146	SHOX	0	+	35067
chr1	152595310	152595579	LCE3A	0	-	269
chr1	152538130	152539256	LCE3E	0	-	1126
chr9	36169385	36171331	CCIN	0	+	1946
chr13	114321470	114440708	KNOWN	0	+	119238
chr20	168494	170352	DEFB128	0	-	1858
chrX	144899347	144911374	SLITRK2	0	+	12027
chr19	1508022	1536045	PLK5	0	+	28023
chr13	114303119	114312513	ATP4B	0	-	9394
chr3	183814852	183824783	HTR3E	0	+	9931
chr13	51093500	51418075	DLEU7	0	-	324575
chr12	53001354	53012343	KRT73	0	-	10989
chr9	108424738	108425405	TAL2	0	+	667
chr17	38024455	38034149	ZPBP2	0	+	9694
chr1	108992904	109014542	NBPF6	0	+	21638
chr3	183749332	183757157	HTR3D	0	+	7825
chr1	65419	71585	OR4F5	0	+	6166
chr1	48998526	50489626	AGBL4	0	-	1491100
chr3	121286796	121309469	ARGFX	0	+	22673
chr11	55563032	55563976	OR5D14	0	+	944
chr11	55587106	55588047	OR5D18	0	+	941
chr12	11338599	11339543	TAS2R42	0	-	944
chr2	27359716	27362278	PRR30	0	-	2562
chr4	9446140	9452392	DEFB131A	0	+	6252
chr1	110655065	110656569	UBL4B	0	+	1504
chr1	47532903	47583990	CYP4Z1	0	+	51087
chr10	95326422	95364237	FFAR4	0	+	37815
chr20	31641709	31661653	BPIFB3	0	+	19944
chr20	31667449	31699557	BPIFB4	0	+	32108
chr1	152483279	152484653	LCE5A	0	+	1374
chr1	152758690	152760902	LCE1E	0	+	2212
chr6	97372496	97588630	KLHL32	0	+	216134
chr3	112182813	112218319	BTLA	0	-	35506
chrX	72297115	72299351	PABPC1L2A	0	-	2236
chr1	158368312	158369256	OR10T2	0	-	944
chr3	171561139	171656505	TMEM212	0	+	95366
chr5	150655919	150683327	SLC36A3	0	-	27408
chr5	150694533	150727151	SLC36A2	0	-	32618
chr5	129083787	129102425	MINAR2	0	+	18638
chr17	38922490	38928453	KRT26	0	-	5963
chr15	30692765	30706463	GOLGA8R	0	-	13698
chr19	55385691	55402786	FCAR	0	+	17095
chr6	123537484	123958238	TRDN	0	-	420754
chr1	158530396	158540370	OR6P1	0	-	9974
chr12	51236703	51281667	TMPRSS12	0	+	44964
chr2	24397922	24423718	FAM228A	0	+	25796
chr20	238365	241737	DEFB132	0	+	3372
chrX	119029800	119054679	AKAP14	0	+	24879
chr19	51532348	51538486	KLK12	0	-	6138
chr5	63801842	63908146	RGS7BP	0	+	106304
chr2	1792885	2335436	MYT1L	0	-	542551
chr11	57791353	57949088	OR9Q1	0	+	157735
chr1	16345370	16360545	CLCNKA	0	+	15175
chr11	57956542	57961525	OR9Q2	0	+	4983
chr8	7678526	7681402	DEFB105A	0	-	2876
chr8	7669242	7673238	DEFB107A	0	-	3996
chr8	7682661	7686575	DEFB106A	0	+	3914
chr8	7345201	7347115	DEFB105B	0	+	1914
chr7	76651623	76661678	SPDYE17	0	-	10055
chrX	75002822	75005089	MAGEE2	0	-	2267
chr19	15915359	15926474	OR10H1	0	-	11115
chr22	43807202	43903728	MPPED1	0	+	96526
chr17	79495403	79504156	FSCN2	0	+	8753
chr10	129535449	129539447	FOXI2	0	+	3998
chr4	264464	299263	ZNF732	0	-	34799
chr9	84558415	84565008	SPATA31D3	0	+	6593
chr1	47881957	47883724	FOXE3	0	+	1767
chr10	118957000	118969810	KCNK18	0	+	12810
chr9	21206180	21207142	IFNA10	0	-	962
chr19	40005779	40011315	SELENOV	0	+	5536
chr1	152799949	152800573	LCE1A	0	+	624
chr17	39471164	39471962	KRTAP17-1	0	-	798
chr4	122249797	122302214	QRFPR	0	-	52417
chr9	107266544	107267503	OR13F1	0	+	959
chr11	55491252	55497097	OR5D3P	0	+	5845
chr12	49726192	49730971	C1QL4	0	-	4779
chr14	94908801	94919137	SERPINA11	0	-	10336
chrX	69478016	69480054	P2RY4	0	-	2038
chr21	31973406	31973701	KRTAP22-1	0	+	295
chr21	31913854	31914183	KRTAP19-6	0	-	329
chr21	31970909	31971221	KRTAP6-2	0	-	312
chr9	107331449	107332411	OR13C8	0	+	962
chr5	109624934	110074657	TMEM232	0	-	449723
chr21	31859362	31859755	KRTAP19-2	0	-	393
chr21	31869142	31869483	KRTAP19-4	0	-	341
chr21	31812593	31813187	KRTAP15-1	0	+	594
chr21	31802538	31803344	KRTAP13-4	0	+	806
chr22	43924624	44208217	EFCAB6	0	-	283593
chr21	31873975	31874459	KRTAP19-5	0	-	484
chr21	31720717	31720924	KRTAP23-1	0	-	207
chr9	111624546	111626036	ACTL7A	0	+	1490
chr21	32127333	32127746	KRTAP21-1	0	-	413
chr10	118349897	118368687	PNLIPRP1	0	+	18790
chr21	32119112	32119577	KRTAP21-2	0	-	465
chr3	169629360	169656963	SAMD7	0	+	27603
chr22	37461476	37505753	TMPRSS6	0	-	44277
chr1	47394849	47407156	CYP4A11	0	-	12307
chr1	248128535	248129688	OR2AK2	0	+	1153
chr8	7340026	7343922	DEFB106B	0	-	3896
chr3	42299317	42307677	CCK	0	-	8360
chr10	98757795	98945716	SLIT1	0	-	187921
chr19	30016901	30055458	VSTM2B	0	+	38557
chr1	63788238	63790799	FOXD3	0	+	2561
chr12	48722763	48724062	H1-7	0	+	1299
chr1	152680636	152681910	LCE4A	0	+	1274
chr1	152670821	152671918	LCE2A	0	+	1097
chr1	152647755	152649045	LCE2C	0	+	1290
chr1	152635856	152637135	LCE2D	0	+	1279
chr1	152586287	152586574	LCE3B	0	+	287
chr17	39017555	39023475	KRT12	0	-	5920
chr7	34697830	34917944	NPSR1	0	+	220114
chrX	13053736	13062801	FAM9C	0	-	9065
chr17	39394251	39395256	KRTAP9-8	0	+	1005
chr3	9908395	9921939	CIDEC	0	-	13544
chr18	49866567	51062273	DCC	0	+	1195706
chr7	103969051	104549008	LHFPL3	0	+	579957
chr6	26107640	26108363	H1-6	0	-	723
chr3	49828165	49837306	CDHR4	0	-	9141
chr3	192992578	193096609	ATP13A5	0	-	104031
chr4	70999333	71042516	PRR27	0	+	43183
chr14	19988416	20020272	POTEG	0	-	31856
chr1	12952727	12958101	PRAMEF10	0	-	5374
chr19	56039978	56048500	SBK2	0	-	8522
chr10	94820555	94829297	CYP26C1	0	+	8742
chr19	13972877	13991571	NANOS3	0	+	18694
chr9	70917783	70920000	FOXD4L3	0	+	2217
chr12	7864029	7870155	DPPA3	0	+	6126
chr11	55681126	55682058	OR5W2	0	-	932
chr9	136379708	136393734	MYMK	0	-	14026
chr5	157098541	157107166	C5orf52	0	+	8625
chr19	19365565	19373613	HAPLN4	0	-	8048
chr3	55542339	56503123	ERC2	0	-	960784
chrX	48684923	48688548	ERAS	0	+	3625
chrX	51149800	51151695	EZHIP	0	+	1895
chr1	248813232	248814185	KNOWN	0	-	953
chr1	104287945	104301348	AMY1C	0	+	13403
chr9	88835180	88874572	C9orf153	0	-	39392
chrX	52673111	52683950	SSX7	0	-	10839
chr18	72102010	72125179	DIPK1C	0	-	23169
chr10	45406764	45432458	TMEM72	0	+	25694
chr9	34889063	34895761	FAM205C	0	-	6698
chr15	72690643	72700708	TMEM202	0	+	10065
chrX	118892551	118894165	SOWAHD	0	+	1614
chr4	185939644	185942107	HELT	0	+	2463
chrX	111326244	111700742	RTL4	0	+	374498
chr2	74011310	74044275	C2orf78	0	+	32965
chr12	133195362	133198974	P2RX2	0	+	3612
chr12	108168481	108170421	ASCL4	0	+	1940
chr12	55756759	55763063	OR6C75	0	+	6304
chr1	156549515	156557511	TTC24	0	+	7996
chr6	55192267	55267291	GFRAL	0	+	75024
chr1	57184462	57285369	FYB2	0	-	100907
chr19	55940107	55954667	SHISA7	0	-	14560
chr22	21400235	21418457	LRRC74B	0	+	18222
chr19	14693896	14722847	CLEC17A	0	+	28951
chr2	197669141	197674079	C2orf66	0	-	4938
chr12	29565407	29650619	OVCH1	0	-	85212
chrX	73524015	73524869	ZCCHC13	0	+	854
chr1	20487746	20513011	PLA2G2C	0	-	25265
chr6	28399707	28411279	ZSCAN23	0	-	11572
chr17	76142466	76162378	C17orf99	0	+	19912
chr19	9289655	9299494	OR7D2	0	+	9839
chr2	242811752	242815975	RTP5	0	+	4223
chr19	14192436	14196687	C19orf67	0	-	4251
chr7	143013204	143049176	CLCN1	0	+	35972
chr16	67918788	67922758	NRN1L	0	+	3970
chr19	16830658	16928774	NWD1	0	+	98116
chr6	41196077	41206620	TREML4	0	+	10543
chr11	6786857	6793207	OR2AG2	0	-	6350
chr9	32783538	32789199	TMEM215	0	+	5661
chr9	99690592	99702535	NUTM2G	0	+	11943
chr11	17568806	17668697	OTOG	0	+	99891
chr11	17373347	17398888	NCR3LG1	0	+	25541
chr22	50430240	50451194	IL17REL	0	-	20954
chr22	20692438	20716938	KNOWN	0	+	24500
chr3	169530658	169555561	LRRIQ4	0	+	24903
chr12	55687772	55690353	OR6C6	0	-	2581
chr19	48471303	48495427	BSPH1	0	-	24124
chr3	50242679	50258918	SLC38A3	0	+	16239
chr1	158744012	158750994	OR6N2	0	-	6982
chr9	21384254	21385397	IFNA2	0	-	1143
chr10	133849840	133998362	JAKMIP3	0	+	148522
chr12	10051272	10084969	CLEC2A	0	-	33697
chrX	26234286	26236387	MAGEB5	0	+	2101
chr19	46416472	46418036	NANOS2	0	-	1564
chr11	15133970	15268754	INSC	0	+	134784
chr4	109729881	110223908	COL25A1	0	-	494027
chr9	135285430	135448706	CFAP77	0	+	163276
chr1	248671374	248690638	OR2G6	0	+	19264
chr17	39196793	39197702	KRTAP1-1	0	-	909
chr3	142668006	142682516	PAQR9	0	-	14510
chr12	96883349	97269333	CFAP54	0	+	385984
chr10	124895486	124898939	HMX3	0	+	3453
chr19	46623324	46627945	IGFL3	0	-	4621
chr15	28943729	28983530	GOLGA8M	0	-	39801
chr10	97667360	97793502	CC2D2B	0	+	126142
chr14	21024252	21029090	RNASE9	0	-	4838
chr15	82555151	82577271	SAXO2	0	+	22120
chr2	209030067	209054754	C2orf80	0	-	24687
chr8	39792133	39873911	IDO2	0	+	81778
chr11	5988407	5989724	OR56A5	0	-	1317
chr21	31653627	31655268	KRTAP24-1	0	-	1641
chr9	133768094	133772199	QRFP	0	-	4105
chr10	76797230	76833400	DUSP29	0	-	36170
chr3	190917030	190983404	OSTN	0	+	66374
chr7	72848108	72850450	FZD9	0	+	2342
chr1	203463281	203478077	OPTC	0	+	14796
chr15	68112042	68126920	SKOR1	0	+	14878
chr1	26517052	26529459	CATSPER4	0	+	12407
chr1	20246502	20250110	PLA2G2E	0	-	3608
chr1	40711619	40717356	TMCO2	0	+	5737
chr17	11144530	11467380	SHISA6	0	+	322850
chr10	124907652	124910188	HMX2	0	+	2536
chr3	63638351	63664696	SNTN	0	+	26345
chr1	24197005	24239852	CNR2	0	-	42847
chr4	42112870	42154895	BEND4	0	-	42025
chr15	81623429	81666554	TMC3	0	-	43125
chr8	43147626	43218661	POTEA	0	+	71035
chr2	96788557	96804241	ASTL	0	-	15684
chr11	122848278	122852542	BSX	0	-	4264
chrX	41306596	41334963	NYX	0	+	28367
chr4	3246096	3273465	MSANTD1	0	+	27369
chr1	12776113	12788727	AADACL3	0	+	12614
chr12	16341419	16430619	SLC15A5	0	-	89200
chr21	15481134	15583276	LIPI	0	-	102142
chr4	52859818	52886529	LRRC66	0	-	26711
chr19	55315065	55325972	KIR2DL4	0	+	10907
chrX	35816459	35821889	MAGEB16	0	+	5430
chr1	156268415	156269098	VHLL	0	-	683
chrX	44703267	44704134	DUSP21	0	+	867
chr5	74907007	74977598	ANKDD1B	0	+	70591
chr17	8294020	8301145	RNF222	0	-	7125
chr19	54544079	54567207	VSTM1	0	-	23128
chr10	47177204	47181681	KNOWN	0	-	4477
chrX	103810880	105011822	IL1RAPL2	0	+	1200942
chr5	79852574	79866099	ANKRD34B	0	-	13525
chrX	34960913	34963032	FAM47B	0	+	2119
chr6	28227075	28228736	NKAPL	0	+	1661
chr14	44973352	44976486	FSCB	0	-	3134
chr17	19030848	19062500	GRAPL	0	+	31652
chrX	27608461	27768059	DCAF8L2	0	+	159598
chr8	27879481	27941453	NUGGC	0	-	61972
chrX	142596564	142605303	SPANXN3	0	-	8739
chr11	89603606	89611655	TRIM64B	0	-	8049
chr22	23950639	23974508	DRICH1	0	-	23869
chr2	279558	288851	ALKAL2	0	-	9293
chrX	55649833	55652625	FOXR2	0	+	2792
chr6	36283538	36304665	BNIP5	0	-	21127
chrX	142113714	142122488	SPANXN4	0	+	8774
chr19	53780715	53788200	FAM90A27P	0	+	7485
chr2	29179477	29275096	TOGARAM2	0	+	95619
chr9	84543343	84549913	SPATA31D4	0	+	6570
chr17	18537560	18547740	TBC1D28	0	-	10180
chrX	69282307	69284029	OTUD6A	0	+	1722
chrX	152676930	152691939	ZFP92	0	+	15009
chr19	55417506	55427508	NCR1	0	+	10002
chr1	248258486	248264465	OR2L13	0	+	5979
chr20	40701392	41818610	PTPRT	0	-	1117218
chr3	98072698	98073663	OR5K4	0	+	965
chr11	123676116	123677057	OR6M1	0	-	941
chr19	22361891	22398603	ZNF676	0	-	36712
chr11	124436556	124452838	OR8A1	0	+	16282
chr19	53761545	53765090	VN1R2	0	+	3545
chr17	39323483	39324473	KRTAP4-3	0	-	990
chr1	158669468	158670442	OR6K2	0	-	974
chr1	159407635	159412868	OR10J1	0	+	5233
chr11	1628795	1629693	KRTAP5-3	0	-	898
chr2	108856424	108881807	SULT1C3	0	+	25383
chr1	248608813	248619026	OR2T2	0	+	10213
chr11	123847368	123848488	OR10S1	0	-	1120
chr1	159283510	159284449	OR10J3	0	-	939
chr3	6811688	7783220	GRM7	0	+	971532
chr1	242121069	242122364	BECN2	0	+	1295
chr11	124172727	124184995	OR8D1	0	-	12268
chr19	22469243	22499978	ZNF729	0	+	30735
chr6	118228427	118638839	SLC35F1	0	+	410412
chr14	20468072	20472919	OR4Q2	0	+	4847
chrX	140785568	140786896	SPANXD	0	-	1328
chr19	840999	848175	PRTN3	0	+	7176
chr1	108765086	108786703	NBPF4	0	-	21617
chr22	27017927	27026633	CRYBA4	0	+	8706
chrX	1733952	1761974	ASMT	0	+	28022
chrY	1683952	1711974	ASMT	0	+	28022
chr2	102013821	102091574	RFX8	0	-	77753
chrX	76709648	76712769	KNOWN	0	+	3121
chr4	80327515	80329382	GK2	0	-	1867
chr1	248636652	248637608	OR2T3	0	+	956
chr14	66878422	66965395	CCDC196	0	+	86973
chr5	176827110	176827662	PFN3	0	-	552
chr3	97806017	97806946	OR5AC2	0	+	929
chr19	7018980	7021443	MBD3L2B	0	-	2463
chr11	62925909	63011071	SLC22A25	0	-	85162
chr1	219858769	220132360	SLC30A10	0	-	273591
chr11	47608230	47610746	FAM180B	0	+	2516
chr1	152784447	152785584	LCE1B	0	+	1137
chr6	35744371	35747329	CLPSL2	0	+	2958
chrX	82763298	82767135	POU3F4	0	+	3837
chr1	247977962	247987421	OR14A16	0	-	9459
chr11	4503876	4514727	OR52K1	0	+	10851
chr5	147548109	147555182	SPINK14	0	+	7073
chr2	233404402	233412825	CHRNG	0	+	8423
chr14	20659055	20669234	OR11G2	0	+	10179
chr11	125646008	125648723	PATE2	0	-	2715
chr17	39114669	39123200	KRT39	0	-	8531
chr5	125967397	125971976	TEX43	0	+	4579
chr1	248524883	248525929	KNOWN	0	+	1046
chrX	134229015	134232742	SMIM10L2B	0	-	3727
chr9	136442203	136474511	FAM163B	0	-	32308
chr16	28763108	28784128	NPIPB9	0	+	21020
chr4	36283238	36349133	DTHD1	0	+	65895
chr6	26104161	26104565	H4C3	0	+	404
chr17	39632962	39637403	KRT35	0	-	4441
chr1	152777308	152779127	LCE1C	0	-	1819
chr1	110693116	110744824	SLC6A17	0	+	51708
chr19	39734095	39735890	IFNL3	0	-	1795
chr7	63688852	63727309	ZNF679	0	+	38457
chr11	124307341	124315592	OR8B8	0	-	8251
chr8	38964509	39142436	ADAM32	0	+	177927
chr13	52607747	52703228	NEK5	0	-	95481
chr10	134901428	134945179	ADGRA1	0	+	43751
chr19	56701055	56709184	ZSCAN5B	0	-	8129
chr9	125273081	125274022	OR1J2	0	+	941
chr1	9063032	9086482	SLC2A7	0	-	23450
chr16	28510683	28523372	IL27	0	-	12689
chr11	124054052	124059487	OR10D3	0	+	5435
chr19	22573821	22715287	ZNF98	0	-	141466
chr1	158717604	158741985	OR6N1	0	-	24381
chr4	155152894	155412951	DCHS2	0	-	260057
chr8	82437216	82502374	FABP12	0	-	65158
chr11	4658707	4664290	OR51D1	0	+	5583
chr10	98102978	98119122	OPALIN	0	-	16144
chr1	247834114	247843041	OR13G1	0	-	8927
chr19	41620337	41634286	CYP2F1	0	+	13949
chr1	248176962	248187578	OR2L5	0	+	10616
chr4	144792017	144826716	GYPE	0	-	34699
chr19	56687377	56697144	GALP	0	+	9767
chr1	158514340	158524195	OR6Y1	0	-	9855
chr19	851014	856247	ELANE	0	+	5233
chr3	177990720	178562217	KCNMB2	0	+	571497
chr1	248004230	248005198	OR11L1	0	-	968
chr16	1484384	1494557	CCDC154	0	-	10173
chr14	23851191	23877482	MYH6	0	-	26291
chr1	247419274	247420512	VN1R5	0	+	1238
chr12	91299399	91348953	CCER1	0	-	49554
chr11	62847412	62911693	SLC22A24	0	-	64281
chr21	31691442	31692633	KRTAP26-1	0	-	1191
chr18	30252636	30352986	KLHL14	0	-	100350
chr12	55640982	55642086	KNOWN	0	+	1104
chr1	207818458	207911761	CR1L	0	+	93303
chr11	62063753	62066547	SCGB1D4	0	-	2794
chr10	105889646	105992122	CFAP43	0	-	102476
chr9	140145713	140147935	STPG3	0	+	2222
chr1	242158792	242162400	MAP1LC3C	0	-	3608
chr11	58125597	58126542	OR5B17	0	-	945
chr11	4566421	4567374	OR52M1	0	+	953
chr4	81256884	81884904	CFAP299	0	+	628020
chr19	41594356	41602100	CYP2A13	0	+	7744
chr11	124111835	124124260	OR8G1	0	+	12425
chr12	11418847	11422641	PRB3	0	-	3794
chr11	57970676	57971614	OR1S2	0	-	938
chr10	15001387	15030049	MEIG1	0	+	28662
chr11	64358113	64369825	SLC22A12	0	+	11712
chr10	115348473	115423829	NRAP	0	-	75356
chr11	62703857	62752439	SLC22A6	0	-	48582
chr1	152184552	152196669	HRNR	0	-	12117
chr9	21440438	21441315	IFNA1	0	+	877
chr1	2460184	2461702	HES5	0	-	1518
chr3	98001349	98002914	OR5H2	0	+	1565
chr3	151451704	151479127	AADACL2	0	+	27423
chr3	156543270	156763918	LEKR1	0	+	220648
chr13	61983991	62001982	ENSG00000197991	0	-	17991
chr12	10183277	10218630	CLEC9A	0	+	35353
chr8	687628	1656642	DLGAP2	0	+	969014
chrX	140671796	140672860	SPANXA1	0	-	1064
chr19	9577031	9609292	ZNF560	0	-	32261
chr1	206223632	206234395	AVPR1B	0	+	10763
chr22	16256441	16287937	KNOWN	0	-	31496
chr2	108994367	109005445	SULT1C4	0	+	11078
chr17	39411636	39412616	KRTAP9-9	0	+	980
chr17	39295685	39296796	KRTAP4-6	0	-	1111
chr4	68918916	68995587	TMPRSS11F	0	-	76671
chr4	100044808	100078949	ADH4	0	-	34141
chr1	248539047	248555112	OR2T6	0	+	16065
chr1	248210138	248226709	OR2L3	0	+	16571
chr8	7353433	7366833	DEFB107B	0	+	13400
chrX	37026439	37029737	FAM47C	0	+	3298
chr12	7881979	7904201	CLEC4C	0	-	22222
chr1	181286826	181782397	CACNA1E	0	+	495571
chr17	39305176	39306077	KRTAP4-5	0	-	901
chr11	58274280	58275578	OR5B21	0	-	1298
chr20	2796948	2800930	TMEM239	0	+	3982
chr17	45277812	45301045	MYL4	0	+	23233
chrX	125297482	125300272	DCAF12L2	0	-	2790
chr21	31768349	31769140	KRTAP13-1	0	+	791
chr3	190146444	190167690	TMEM207	0	-	21246
chr1	156785432	156851642	NTRK1	0	+	66210
chr17	39340352	39341163	KRTAP4-1	0	-	811
chr22	17071641	17073700	CCT8L2	0	-	2059
chr1	247780445	247785674	OR14L1P	0	+	5229
chr3	187416047	187420345	RTP2	0	-	4298
chr11	76745442	76753020	B3GNT6	0	+	7578
chr9	140125209	140131007	SLC34A3	0	+	5798
chr1	211649864	211665504	RD3	0	-	15640
chrX	140335596	140336650	SPANXC	0	-	1054
chr1	162365058	162381928	SH2D1B	0	-	16870
chr19	30719197	31204445	ZNF536	0	+	485248
chr1	248338123	248344369	OR2M2	0	+	6246
chr19	52932401	52955568	ZNF534	0	+	23167
chr16	71599563	71610995	TAT	0	-	11432
chr6	160952514	161085307	LPA	0	-	132793
chr12	62102054	62672931	TAFA2	0	-	570877
chr11	123864870	123865868	OR10G6	0	-	998
chr12	48953665	48956739	OR5BS1P	0	+	3074
chr6	28471073	28495992	GPX6	0	-	24919
chr1	115397484	115537991	SYCP1	0	+	140507
chr9	104331634	104500929	GRIN3A	0	-	169295
chr1	177140094	177251558	BRINP2	0	+	111464
chrX	30248774	30255612	MAGEB3	0	+	6838
chr12	70002344	70004687	LRRC10	0	-	2343
chr1	152691998	152692946	C1orf68	0	+	948
chr9	136243237	136271220	STKLD1	0	+	27983
chrX	63444074	63450487	ASB12	0	-	6413
chrX	125683366	125686797	DCAF12L1	0	-	3431
chr2	105469745	105475032	POU3F3	0	+	5287
chr5	178322899	178360213	ZFP2	0	+	37314
chr9	77112251	77308093	RORB	0	+	195842
chr1	158442010	158450726	OR10R2	0	+	8716
chr1	248651890	248654414	OR2T5	0	+	2524
chr1	248193372	248205607	OR2L2	0	+	12235
chr1	182367252	182369802	TEDDM1	0	-	2550
chr6	139117048	139225207	ECT2L	0	+	108159
chr1	170115100	170138007	NTMT2	0	+	22907
chr6	130152389	130182692	TMEM244	0	-	30303
chr1	158686117	158690510	OR6K3	0	-	4393
chr1	153232163	153234600	LORICRIN	0	+	2437
chr1	153175906	153177596	LELP1	0	+	1690
chr1	152730501	152734532	KPRP	0	+	4031
chr10	124670126	124672627	FAM24A	0	+	2501
chr10	118187359	118237469	PNLIPRP3	0	+	50110
chr1	119957554	119965658	HSD3B2	0	+	8104
chrX	154051623	154062937	SMIM9	0	-	11314
chr6	84563079	84567234	RIPPLY2	0	+	4155
chr6	74078278	74104856	OOEP	0	-	26578
chr6	74072381	74073894	KHDC3L	0	+	1513
chr6	74062786	74063999	DPPA5	0	-	1213
chr1	92683472	92711370	C1orf146	0	+	27898
chrX	144329023	144337728	SPANXN1	0	+	8705
chrX	140677835	140678889	SPANXA2	0	+	1054
chrX	139037887	139047680	CXorf66	0	-	9793
chrX	133371077	133380872	CCDC160	0	+	9795
chr1	67557848	67697536	C1orf141	0	-	139688
chr6	49976851	49989707	DEFB110	0	-	12856
chr6	49467636	49495791	GLYATL3	0	+	28155
chr1	54472971	54483859	LDLRAD1	0	-	10888
chrX	119206229	119211655	RHOXF2B	0	-	5426
chr9	139648838	139652995	LCN8	0	-	4157
chr9	139632619	139642905	ENSG00000204003	0	-	10286
chr1	51567893	51613758	C1orf185	0	+	45865
chr9	138515494	138531386	GLT6D1	0	-	15892
chrX	115592853	115594137	CT83	0	-	1284
chr10	90519739	90539383	LIPN	0	+	19644
chr10	90466006	90512533	LIPK	0	+	46527
chr10	90346510	90366733	LIPJ	0	+	20223
chr10	85980327	85985300	LRIT2	0	-	4973
chrX	102528619	102531678	TCEAL5	0	-	3059
chr2	242750160	242758739	NEU4	0	+	8579
chr6	35748796	35761452	CLPSL1	0	+	12656
chr10	47083457	47088320	NPY4R	0	+	4863
chr9	113065756	113100164	TXNDC8	0	-	34408
chrX	69454505	69460509	AWAT1	0	+	6004
chr9	107298030	107299137	OR13C3	0	-	1107
chr17	76227391	76237068	TMEM235	0	+	9677
chrX	55284848	55291349	PAGE3	0	-	6501
chr6	32361116	32374958	BTNL2	0	-	13842
chr6	32256303	32339684	TSBP1	0	-	83381
chr11	123753627	123756377	TMEM225	0	-	2750
chr2	171623388	171655487	ERICH2	0	+	32099
chr17	72575504	72588422	CD300LD	0	-	12918
chr17	72352555	72358007	BTBD17	0	-	5452
chr11	114549249	114577791	NXPE2	0	+	28542
chrX	52825184	52826467	SPANXN5	0	-	1283
chr11	104756445	104769397	CASP12	0	-	12952
chr17	61986957	61988701	CSHL1	0	-	1744
chr6	31686371	31694491	MPIG6B	0	+	8120
chr11	89764274	89775193	TRIM49C	0	+	10919
chr11	89699205	89707240	TRIM64	0	+	8035
chr6	31556672	31560783	NCR3	0	-	4111
chr1	13736907	13747803	PRAMEF20	0	+	10896
chr1	13716092	13719089	PRAMEF17	0	+	2997
chr1	13694889	13698405	PRAMEF19	0	-	3516
chr1	13668269	13673511	PRAMEF14	0	-	5242
chr1	13421176	13428191	KNOWN	0	+	7015
chr1	12976430	12980571	PRAMEF7	0	+	4141
chr1	12704104	12727087	AADACL4	0	+	22983
chr19	56713642	56720830	ZSCAN5C	0	+	7188
chr20	29992648	30000641	DEFB121	0	-	7993
chr11	71292901	71314399	KRTAP5-11	0	-	21498
chr11	71276609	71277781	KRTAP5-10	0	+	1172
chr12	133179736	133187168	LRCOL1	0	-	7432
chr19	54135253	54140268	DPRX	0	+	5015
chr6	30130983	30140470	TRIM15	0	+	9487
chr9	79634571	79635869	FOXB2	0	+	1298
chr6	30119720	30128988	TRIM10	0	-	9268
chr6	30103901	30116512	TRIM40	0	+	12611
chr1	11539212	11597608	DISP3	0	+	58396
chr2	101086944	101099742	NMS	0	+	12798
chr19	51014857	51017947	ASPDH	0	-	3090
chr6	29624779	29640149	MOG	0	+	15370
chr9	74666292	74687637	C9orf57	0	-	21345
chr6	29454474	29455733	MAS1L	0	-	1259
chr6	29424932	29432105	OR2H1	0	+	7173
chr6	29269478	29280794	OR14J1	0	+	11316
chr6	29138684	29143588	OR2J2	0	+	4904
chr6	29075835	29082547	OR2J3	0	+	6712
chr6	29067267	29070478	OR2J1	0	+	3211
chr6	29053985	29055090	OR2B3	0	-	1105
chr6	29011990	29012952	OR2W1	0	-	962
chr11	64937704	64940845	SPDYC	0	+	3141
chr9	72435733	72521143	CFAP95	0	+	85410
chr10	19337730	20079330	MALRD1	0	+	741600
chr9	70175707	70178815	FOXD4L5	0	-	3108
chr9	69204538	69269662	KNOWN	0	-	65124
chr9	39355666	39361959	SPATA31A1	0	+	6293
chr19	46542440	46580376	IGFL4	0	-	37936
chr2	73927703	73928467	NAT8B	0	-	764
chr17	39388701	39389706	KRTAP9-3	0	+	1005
chr17	39253233	39254394	KRTAP4-8	0	-	1161
chr8	142366570	142377386	GPR20	0	-	10816
chr17	39185603	39186447	KRTAP1-4	0	-	844
chr17	39133967	39143387	KRT40	0	-	9420
chr17	38904273	38911583	KRT25	0	-	7310
chr5	147700766	147719415	SPINK9	0	+	18649
chr17	38083985	38101252	LRRC3C	0	+	17267
chr11	61276221	61278490	LRRC10B	0	+	2269
chr17	37092685	37123656	FBXO47	0	-	30971
chr19	41949061	41950670	ERICH4	0	+	1609
chr11	60282865	60310194	MS4A13	0	+	27329
chr8	117950446	117956726	AARD	0	+	6280
chr16	88929741	88933068	PABPN1L	0	-	3327
chr11	55606228	55607214	OR5D16	0	+	986
chr11	55594695	55595630	OR5L2	0	+	935
chr8	110374690	110549436	PKHD1L1	0	+	174746
chr17	33791268	33864697	SLFN12L	0	-	73429
chr7	128311747	128327931	GARIN1A	0	+	16184
chr1	1470158	1476004	TMEM240	0	-	5846
chr4	190945522	190948412	FRG2	0	-	2890
chr9	34723050	34729485	FAM205A	0	-	6435
chr2	39395186	39471124	CDKL4	0	-	75938
chr1	1361251	1365635	TMEM88B	0	+	4384
chr11	44069531	44081527	ACCSL	0	+	11996
chr9	34621046	34629063	ARID3C	0	-	8017
chr8	86568695	86575726	KNOWN	0	-	7031
chr8	82370488	82373814	FABP9	0	-	3326
chr19	35081549	35168064	SCGB2B2	0	-	86515
chr2	36923833	37041937	VIT	0	+	118104
chr5	126984774	126994322	CTXN3	0	+	9548
chr4	141363416	141419531	MGAT4D	0	-	56115
chr12	55886162	55887100	OR6C68	0	+	938
chr12	55794313	55795251	OR6C65	0	+	938
chr12	55723827	55726471	OR6C3	0	+	2644
chr12	55708127	55716148	OR6C1	0	+	8021
chr5	101707478	101834720	SLCO6A1	0	-	127242
chr11	5862158	5863182	OR52E6	0	-	1024
chr9	24542950	24545944	IZUMO3	0	-	2994
chr16	32264607	32267249	TP53TG3D	0	+	2642
chr7	76679708	76691875	SPDYE18	0	-	12167
chr11	5067756	5068691	OR52J3	0	+	935
chr12	40787197	40964634	MUC19	0	+	177437
chr4	70894172	70902255	HTN3	0	+	8083
chrX	2924587	2952152	ARSH	0	+	27565
chr14	74077649	74086592	ACOT6	0	+	8943
chr4	65140975	65275186	TECRL	0	-	134211
chr14	73075742	73360809	DPF3	0	-	285067
chr22	42348178	42354937	SMIM45	0	+	6759
chr19	7037760	7040190	MBD3L4	0	-	2430
chrX	1314894	1331616	CRLF2	0	-	16722
chrY	1264894	1281616	CRLF2	0	-	16722
chr19	4890449	4902908	ARRDC5	0	-	12459
chr16	4606341	4650759	C16orf96	0	+	44418
chr3	190570526	190610218	GMNC	0	-	39692
chr12	8608558	8630926	CLEC6A	0	+	22368
chr22	32544993	32555309	C22orf42	0	-	10316
chr12	7917812	7926717	NANOGNB	0	+	8905
chr7	16566450	16621193	LRRC72	0	+	54743
chr13	24465238	24471641	C1QTNF9B	0	-	6403
chr11	1718425	1718985	KRTAP5-6	0	+	560
chr11	1618407	1619524	KRTAP5-2	0	-	1117
chr11	1605572	1606513	KRTAP5-1	0	-	941
chr8	11850683	11858261	DEFB134	0	-	7578
chr8	11839765	11842099	DEFB135	0	+	2334
chr8	11831446	11832108	DEFB136	0	-	662
chr17	1173738	1175109	BHLHA9	0	+	1371
chr19	1753505	1780987	ONECUT3	0	+	27482
chr21	34398243	34401504	OLIG2	0	+	3261
chr21	34162984	34186053	C21orf62	0	-	23069
chr11	298200	299526	IFITM5	0	-	1326
chr18	73121431	73139658	SMIM21	0	-	18227
chr18	71983074	72026424	C18orf63	0	+	43350
chr8	6835171	6837614	DEFA1	0	-	2443
chr22	25331065	25342662	LHFPL7	0	-	11597
chr21	32410478	32410795	KRTAP19-8	0	-	317
chr21	32015183	32015455	KRTAP20-3	0	+	272
chr21	31992946	31993169	KRTAP20-4	0	+	223
chr21	31962424	31962716	KRTAP22-2	0	-	292
chr21	31709331	31710012	KRTAP27-1	0	-	681
chr15	32734115	32747835	GOLGA8O	0	-	13720
chr16	203891	216763	HBM	0	+	12872
chr3	138666059	138672832	FOXL2NB	0	+	6773
chr3	130236021	130395888	COL6A6	0	+	159867
chr18	7231087	7232042	LRRC30	0	+	955
chr6	29407083	29408754	OR10C1	0	+	1671
chr3	112534556	112565711	CD200R1L	0	-	31155
chr3	98109510	98110475	OR5K3	0	+	965
chr3	32859489	32939316	TRIM71	0	+	79827
chr8	56014588	56454613	XKR4	0	+	440025
chr1	54356912	54376759	DIO1	0	+	19847
chr1	19592476	19600688	AKR7L	0	-	8212
chr17	39463952	39465561	KRTAP16-1	0	-	1609
chr17	39458078	39459103	KRTAP29-1	0	-	1025
chr17	39421630	39422112	KRTAP9-6	0	+	482
chr17	39273433	39274625	KRTAP4-11	0	-	1192
chr17	39261641	39262740	KRTAP4-9	0	+	1099
chr17	39215492	39216366	KRTAP2-3	0	-	874
chr17	39202793	39203568	KRTAP2-1	0	-	775
chr7	143925337	143936698	OR2A42	0	-	11361
chr17	39149682	39150416	KRTAP3-3	0	-	734
chr17	39155445	39156158	KRTAP3-2	0	-	713
chr21	31964759	31965394	KRTAP6-3	0	+	635
chr19	51124564	51143138	SYT3	0	-	18574
chr1	151772740	151777895	LINGO4	0	-	5155
chr7	143651937	143694405	OR2F1	0	+	42468
chr17	61949372	61951126	CSH2	0	-	1754
chr14	96152763	96158965	TCL1B	0	+	6202
chr17	39279343	39280434	KRTAP4-12	0	-	1091
chr17	39221368	39222131	KRTAP2-4	0	-	763
chr3	97783316	97784240	OR5AC1	0	+	924
chr15	75118968	75124143	CPLX3	0	+	5175
chr20	55108302	55111576	FAM209B	0	+	3274
chr4	70065669	70080466	UGT2B11	0	-	14797
chr19	51981793	51994555	CEACAM18	0	+	12762
chr19	45202421	45213990	CEACAM16	0	+	11569
chr19	40267235	40276931	LEUTX	0	+	9696
chr19	22934985	22966953	ZNF99	0	-	31968
chr19	19375173	19384200	TM6SF2	0	-	9027
chr9	21201468	21202204	IFNA7	0	-	736
chr3	196233750	196242217	SMCO1	0	-	8467
chr7	141408153	141431071	WEE2	0	+	22918
chrX	30261832	30270157	MAGEB1	0	+	8325
chr10	129347573	129351804	NPS	0	+	4231
chr3	126911974	126917028	C3orf56	0	+	5054
chr2	88746306	88752211	FOXI3	0	-	5905
chr5	171621176	171630458	EFCAB9	0	+	9282
chr11	93551398	93583784	VSTM5	0	-	32386
chr11	89443467	89451040	TRIM77	0	+	7573
chr22	30918786	30942728	SEC14L6	0	-	23942
chr5	147647743	147665818	SPINK13	0	+	18075
chr2	73429702	73439641	NOTO	0	+	9939
chr17	39210750	39211482	KRTAP2-2	0	-	732
chr15	83211951	83317612	CPEB1	0	-	105661
chr6	49936390	49937338	DEFB113	0	-	948
chr7	63505812	63545717	ZNF727	0	+	39905
chr3	51907737	51909617	IQCF5	0	-	1880
chr3	51812577	51813257	IQCF6	0	-	680
chr12	27233990	27235511	C12orf71	0	-	1521
chr11	60496777	60511685	MS4A18	0	+	14908
chr8	124864227	125132302	FER1L6	0	+	268075
chr17	20483037	20484224	CDRT15L2	0	+	1187
chr2	17691846	17699707	RAD51AP2	0	-	7861
chr2	3751165	3895598	DCDC2C	0	+	144433
chr11	57305068	57317745	SMTNL1	0	+	12677
chr11	49075266	49080664	TRIM64C	0	-	5398
chrX	152661097	152666850	PNMA6E	0	-	5753
chr9	84603687	84610168	SPATA31D1	0	+	6481
chr14	31952081	31957245	GPR33	0	-	5164
chr17	9703925	9725396	GSG1L2	0	-	21471
chr12	7456668	7481315	ACSM4	0	+	24647
chr16	3543484	3545489	C16orf90	0	-	2005
chr16	2848471	2855305	PRSS41	0	+	6834
chrX	57703500	57706693	NLRP2B	0	-	3193
chr15	72947038	72961940	GOLGA6B	0	+	14902
chr4	42894730	43032675	GRXCR1	0	+	137945
chr5	7830491	7851264	C5orf49	0	-	20773
chr8	36641842	36793643	KCNU1	0	+	151801
chr14	23654525	23742686	RNF212B	0	+	88161
chr8	11946847	11973025	ZNF705D	0	+	26178
chr8	7876951	7882174	FAM90A24P	0	-	5223
chr8	7783859	7809935	ZNF705B	0	+	26076
chr8	7213039	7243080	ZNF705G	0	-	30041
chr8	7144914	7147924	FAM90A5P	0	+	3010
chr18	44732540	44778031	SKOR2	0	-	45491
chr13	46351377	46425888	SIAH3	0	-	74511
chr20	31446729	31549651	EFCAB8	0	+	102922
chr20	29891015	29896388	DEFB116	0	-	5373
chr20	29845467	29847435	DEFB115	0	+	1968
chr22	17442826	17489112	GAB4	0	-	46286
chr20	1184098	1189720	C20orf202	0	+	5622
chr4	8847802	8873565	HMX1	0	-	25763
chr17	79762008	79771884	GCGR	0	+	9876
chr1	23279536	23299359	LACTBL1	0	-	19823
chr1	2568425	2718258	TTC34	0	-	149833
chr19	45116873	45140081	IGSF23	0	+	23208
chr2	242836139	242844702	FAM240C	0	-	8563
chr2	175199682	175203228	SP9	0	+	3546
chr22	50989541	51001348	SYCE3	0	-	11807
chr7	48964143	48967050	CDC14C	0	+	2907
chr2	21346840	21367240	TDRD15	0	+	20400
chr1	22303515	22325135	CELA3B	0	+	21620
chr11	64067830	64072242	CATSPERZ	0	+	4412
chr11	48997050	49005437	TRIM51G	0	-	8387
chr7	143697413	143705886	OR6B1	0	+	8473
chr8	25699241	25902929	EBF2	0	-	203688
chr19	43225790	43244633	PSG3	0	-	18843
chr7	143746041	143755938	OR2A5	0	+	9897
chr11	51411378	51412448	OR4A5	0	-	1070
chr17	39182278	39183460	KRTAP1-5	0	-	1182
chr7	143174966	143175889	TAS2R41	0	+	923
chr7	143783371	143796046	OR2A12	0	+	12675
chr19	43428284	43441359	PSG7	0	-	13075
chr17	39190136	39191126	KRTAP1-3	0	-	990
chr17	3180236	3289611	OR3A2	0	-	109375
chr1	247918148	247923858	OR1C1	0	-	5710
chr7	53103326	53104618	POM121L12	0	+	1292
chr7	143632326	143633279	OR2F2	0	+	953
chr11	123624288	123625226	OR6X1	0	-	938
chr7	143766904	143772963	OR2A25	0	+	6059
chr7	142919130	142920172	TAS2R40	0	+	1042
chr7	143820269	143828281	OR2A14	0	+	8012
chr19	35634154	35645205	FXYD7	0	+	11051
chr11	50003009	50004071	OR4C12	0	-	1062
chr19	55344131	55360024	KIR2DS4	0	+	15893
chr7	144009512	144019830	OR2A1	0	+	10318
chr14	22122051	22135856	OR4E2	0	+	13805
chr1	109834987	109849633	MYBPHL	0	-	14646
chr7	143806676	143807632	OR2A2	0	+	956
chr11	4388493	4389616	OR52B4	0	-	1123
chr14	23511421	23513269	PSMB11	0	+	1848
chr14	19553365	19589682	POTEM	0	+	36317
chr11	89644279	89654935	KNOWN	0	-	10656
chr8	11993944	11996358	USP17L2	0	-	2414
chr17	14138990	14140179	CDRT15	0	-	1189
chr4	9236111	9237772	USP17L15	0	+	1661
chrX	51453608	51455227	CENPVL1	0	+	1619
chr10	22497404	22506944	EBLN1	0	-	9540
chr11	5253908	5264887	HBD	0	-	10979
chrX	24326327	24332186	SUPT20HL2	0	-	5859
chr7	63667581	63680668	ZNF735	0	+	13087
chr19	56270463	56274787	RFPL4A	0	+	4324
chrX	24378756	24385956	SUPT20HL1	0	+	7200
chr8	7137292	7140302	FAM90A13P	0	+	3010
chrX	120072555	120075877	CT47A10	0	-	3322
chrX	134252881	134254454	ETDB	0	-	1573
chrX	51359872	51361764	CENPVL3	0	-	1892
chrX	145895624	145896262	CXorf51A	0	-	638
chrX	27478324	27481458	PPP4R3C	0	-	3134
chr12	120031579	120080880	TMEM233	0	+	49301
chrX	152583138	152587225	PNMA6F	0	-	4087
chr17	79139307	79156966	PVALEF	0	+	17659
chr8	7833915	7835507	USP17L3	0	-	1592
chrX	109764124	109766249	TDGF1P3	0	+	2125
chr1	151810294	151813033	C2CD4D	0	-	2739
chr7	142749438	142750379	OR6V1	0	+	941
chr10	135437399	135440299	FRG2B	0	-	2900
chr11	51435459	51436403	OR4A8	0	-	944
chrX	120092019	120095341	CT47A6	0	-	3322
chr2	200625267	200715915	FTCDNL1	0	-	90648
chr11	4602973	4614570	OR52I2	0	+	11597
chr6	28129547	28137372	ZKSCAN8P1	0	+	7825
chr2	241845747	241932728	CROCC2	0	+	86981
chrX	27996109	27999566	DCAF8L1	0	-	3457
chr8	11989926	11991608	USP17L7	0	-	1682
chr8	142524738	142528837	ENSG00000226490	0	+	4099
chrX	120077415	120080737	CT47A9	0	-	3322
chrX	120064104	120066155	CT47A12	0	-	2051
chr7	12509247	12581848	ENSG00000226690	0	+	72601
chr13	51656255	51774388	C13orf42	0	-	118133
chr8	142443929	142517330	MROH5	0	-	73401
chrX	120067694	120071012	CT47A11	0	-	3318
chrY	24549557	24564028	RBMY1J	0	+	14471
chr6	31539831	31542101	LTA	0	+	2270
chr12	133794898	133812463	ANHX	0	-	17565
chr4	9341129	9342721	USP17L5	0	+	1592
chr13	57734766	57737787	PRR20D	0	+	3021
chr1	248599660	248607617	OR2T7	0	+	7957
chr4	9221878	9223470	USP17L12	0	+	1592
chr15	28798714	28808925	GOLGA6L25P	0	+	10211
chr1	23337327	23345593	TEX46	0	-	8266
chr10	61496450	61515799	MRLN	0	-	19349
chr18	54814318	54817641	BOD1L2	0	+	3323
chr9	21239001	21240004	IFNA14	0	-	1003
chr1	248360567	248376227	OR2M3	0	+	15660
chr9	117092149	117095531	ORM2	0	+	3382
chr1	247933471	247942826	OR9H1P	0	+	9355
chrX	120087136	120090454	CT47A7	0	-	3318
chr19	53769929	53770976	VN1R4	0	-	1047
chr11	113650518	113651207	CLDN25	0	+	689
chr6	31021227	31027667	HCG22	0	+	6440
chrX	134928331	134953994	KNOWN	0	-	25663
chr4	9364855	9366447	USP17L30	0	+	1592
chrY	9236030	9238832	TSPY3	0	+	2802
chr11	60989819	60999166	PGA4	0	+	9347
chr19	56280484	56284786	RFPL4AL1	0	+	4302
chr3	48348332	48375151	SPINK8	0	-	26819
chr10	126133812	126138604	NKX1-2	0	-	4792
chrY	9195406	9198208	TSPY8	0	+	2802
chr1	13216356	13219581	PUTATIVE	0	-	3225
chr4	9336384	9337976	USP17L26	0	+	1592
chr17	46800547	46802120	PRAC2	0	+	1573
chr13	57715052	57731216	PRR20C	0	+	16164
chr11	60970779	60980570	PGA3	0	+	9791
chr4	166198959	166200856	GK3P	0	-	1897
chr4	9172135	9178456	FAM90A26	0	+	6321
chr7	18066393	18067469	PRPS1L1	0	-	1076
chr15	21040701	21071643	POTEB2	0	-	30942
chr8	7114426	7117436	FAM90A15P	0	+	3010
chr9	117418584	117424654	TEX53	0	-	6070
chr6	46714670	46727243	ANKRD66	0	+	12573
chr5	180794269	180795263	OR4F3	0	+	994
chr7	124116425	124117009	SSU72P8	0	+	584
chr3	97982096	97984200	OR5H6	0	+	2104
chrX	120082276	120085598	CT47A8	0	-	3322
chr4	9331637	9333229	USP17L25	0	+	1592
chr19	7049332	7051746	MBD3L2	0	+	2414
chr8	7189909	7191501	USP17L1	0	+	1592
chr5	127039083	127277199	CCDC192	0	+	238116
chrX	120101740	120105062	CT47A4	0	-	3322
chr9	117428714	117444472	TEX48	0	-	15758
chr12	11460011	11463370	PRB4	0	-	3359
chrX	139173837	139175070	ENSG00000230707	0	+	1233
chr6	17102281	17131609	STMND1	0	+	29328
chr4	9350619	9352211	USP17L28	0	+	1592
chr21	32090843	32091095	KRTAP21-3	0	-	252
chr3	97849565	97857392	OR5H1	0	+	7827
chr3	146294342	146323133	PLSCR5	0	-	28791
chr17	41857803	41864988	CFAP97D1	0	+	7185
chr19	56052023	56056909	SBK3	0	-	4886
chr4	9212383	9213975	USP17L10	0	+	1592
chr4	9355364	9356956	USP17L29	0	+	1592
chr12	85408090	85430055	TSPAN19	0	-	21965
chr18	5142910	5197502	AKAIN1	0	-	54592
chr19	43370616	43383974	PSG1	0	-	13358
chrX	26178718	26180527	MAGEB6B	0	+	1809
chr2	207516345	207586294	DYTN	0	-	69949
chr1	201083071	201096312	ASCL5	0	-	13241
chr16	8587607	8622304	TMEM114	0	-	34697
chr21	31661463	31661832	KRTAP25-1	0	-	369
chr4	9326891	9328483	USP17L24	0	+	1592
chr11	4614980	4616243	OR52I1	0	+	1263
chr3	98182045	98191768	OR5K1	0	+	9723
chr4	9226622	9228214	USP17L13	0	+	1592
chr1	12998302	13007406	PRAMEF6	0	-	9104
chr3	98025596	98031687	OR5H8	0	+	6091
chr8	12168471	12175825	DEFB130A	0	-	7354
chr8	11921898	11929256	DEFB130B	0	-	7358
chr8	7869304	7874533	FAM90A11P	0	-	5229
chr8	7122048	7125058	FAM90A3P	0	+	3010
chr4	9217131	9218723	USP17L11	0	+	1592
chr9	140121954	140124092	RNF224	0	+	2138
chr8	7152536	7155546	FAM90A20P	0	+	3010
chr3	97885540	97888618	OR5H15	0	+	3078
chr17	10725787	10741404	PIRT	0	-	15617
chr2	95873269	95925522	ENSG00000233757	0	+	52253
chr11	89657232	89666231	TRIM49D2	0	+	8999
chrY	9175073	9177893	TSPY4	0	+	2820
chr9	21367371	21368056	IFNA13	0	-	685
chr5	86512423	86534822	KNOWN	0	-	22399
chr16	27078248	27080487	C16orf82	0	+	2239
chr7	123670975	123673121	TMEM229A	0	-	2146
chr13	57741331	57744352	PRR20E	0	+	3021
chr22	20135939	20138578	CCDC188	0	-	2639
chrY	23673258	23711212	RBMY1A1	0	+	37954
chr15	65369084	65372286	KBTBD13	0	+	3202
chrX	9935398	9936392	CLDN34	0	+	994
chr11	123897505	123901341	OR10G8	0	+	3836
chr11	45928064	45928823	C11orf94	0	-	759
chr4	150272861	150817385	IQCM	0	-	544524
chr9	21227242	21228221	IFNA17	0	-	979
chr22	42305547	42311078	SHISA8	0	-	5531
chr9	131901692	132022854	ENSG00000235007	0	+	121162
chr2	207507211	207514089	FAM237A	0	+	6878
chr11	94758422	94760760	KDM4E	0	+	2338
chr9	35909487	35937150	SPAAR	0	+	27663
chr4	1396720	1400230	NKX1-1	0	-	3510
chrX	145891289	145891929	CXorf51B	0	+	640
chr15	79575064	79590581	ANKRD34C	0	+	15517
chr4	9345874	9347466	USP17L27	0	+	1592
chr1	152815332	152816459	LCE6A	0	+	1127
chrX	152240837	152243402	PNMA6A	0	+	2565
chr11	125658022	125661495	PATE3	0	+	3473
chr3	97866323	97875458	OR5H14	0	+	9135
chr8	7194637	7196229	USP17L4	0	+	1592
chrX	120106600	120109922	CT47A3	0	-	3322
chr17	33871004	33887838	SLFN14	0	-	16834
chrX	120116330	120119614	CT47A1	0	-	3284
chr18	11609595	11610611	SLC35G4	0	+	1016
chr7	142880512	142881528	TAS2R39	0	+	1016
chrY	9365489	9368291	TSPY10	0	+	2802
chrX	120006461	120009720	CT47B1	0	-	3259
chr9	138496191	138511739	ENSG00000236543	0	+	15548
chr9	21186617	21187586	IFNA4	0	-	969
chrX	49294472	49294588	GAGE12B	0	+	116
chr3	49215067	49229291	C3orf84	0	-	14224
chr11	123893720	123894655	OR10G9	0	+	935
chr8	7829183	7830775	USP17L8	0	-	1592
chr6	132859416	132860475	TAAR9	0	+	1059
chr19	7030589	7033022	MBD3L5	0	+	2433
chr11	125703211	125709967	PATE4	0	+	6756
chr13	64320874	64325213	ENSG00000237378	0	+	4339
chr11	48510345	48511274	OR4A47	0	+	929
chr19	46236697	46267799	MEIOSIN	0	+	31102
chr19	9358020	9363301	OR7E24	0	+	5281
chr2	127656440	127659673	TEX51	0	+	3233
chr7	141586948	141587892	OR9A1P	0	+	944
chr5	150226083	150280298	IRGM	0	+	54215
chr1	104198382	104207176	AMY1A	0	+	8794
chr1	16999498	17000007	KNOWN	0	+	509
chr15	28592997	28603230	GOLGA6L24P	0	-	10233
chrX	120096880	120100202	CT47A5	0	-	3322
chrY	9324876	9327690	TSPY9	0	+	2814
chrX	40482680	40483388	MPC1L	0	+	708
chr1	248058889	248059833	OR2W3	0	+	944
chr1	247875115	247887066	ENSG00000239395	0	-	11951
chr9	125281420	125282361	OR1J4	0	+	941
chr3	127002626	127006889	PRR20G	0	-	4263
chr1	13052394	13052998	PUTATIVE	0	-	604
chr8	6873391	6875819	DEFA3	0	-	2428
chr17	39382900	39383904	KRTAP9-2	0	+	1004
chr11	5275622	5699664	ENSG00000239920	0	-	424042
chr19	54844456	54850433	LILRA4	0	-	5977
chr19	55084387	55101752	LILRA2	0	+	17365
chr1	178482244	178517737	TEX35	0	+	35493
chr3	155008016	155011472	STRIT1	0	-	3456
chr8	6854288	6856720	DEFA1B	0	-	2432
chr1	152747616	152749500	LCE1F	0	+	1884
chr19	55361898	55378662	KIR3DL2	0	+	16764
chr21	31797698	31798244	KRTAP13-3	0	-	546
chr17	16833130	16875432	TNFRSF13B	0	-	42302
chr17	39346139	39346891	KRTAP9-1	0	+	752
chr1	62660521	62678000	L1TD1	0	+	17479
chr17	39240402	39241396	KRTAP4-7	0	+	994
chr7	63459227	63478459	ZNF722	0	+	19232
chr3	108837099	108870248	C3orf85	0	+	33149
chr11	71249071	71250255	KRTAP5-8	0	+	1184
chr17	39257754	39258461	KRTAP4-16	0	-	707
chr11	56587049	56587992	OR5G3	0	-	943
chr17	39405939	39406905	KRTAP9-4	0	+	966
chr11	1642188	1643368	KRTAP5-4	0	-	1180
chr19	55235947	55248099	KIR3DL3	0	+	12152
chr3	70243630	70361789	MDFIC2	0	-	118159
chr16	330450	333010	ARHGDIG	0	+	2560
chr19	43568361	43587197	PSG2	0	-	18836
chrX	120111460	120114782	CT47A2	0	-	3322
chrY	24049765	24064189	RBMY1E	0	-	14424
chr15	43891761	43910998	STRC	0	-	19237
chr7	92097694	92107300	ERVW-1	0	-	9606
chr1	12939033	12946025	PRAMEF4	0	-	6992
chr19	43511808	43530626	PSG11	0	-	18818
chr1	104160049	104168402	AMY2A	0	+	8353
chr21	35791013	35796249	SMIM34	0	-	5236
chr9	36002906	36003864	OR13C7	0	-	958
chr6	29321526	29399744	OR5V1	0	-	78218
chr19	55249978	55264504	KIR2DL3	0	+	14526
chr1	237167403	237167741	MT1HL1	0	-	338
chr21	31863780	31864331	KRTAP19-3	0	-	551
chr1	152572710	152573562	LCE3C	0	+	852
chr5	177611506	177614372	GMCL2	0	-	2866
chr21	31933194	31933633	KRTAP19-7	0	-	439
chrY	24026223	24040673	RBMY1D	0	-	14450
chr11	71238313	71239715	KRTAP5-7	0	+	1402
chr17	39333698	39334473	KRTAP4-2	0	-	775
chr20	1206688	1277065	RAD21L1	0	+	70377
chr21	31988744	31989018	KRTAP20-1	0	+	274
chr6	47824409	48078933	PTCHD4	0	-	254524
chr22	25608531	25627837	CRYBB2	0	+	19306
chr19	17927321	17932383	INSL3	0	-	5062
chr5	147601213	147623143	MARCOL	0	+	21930
chr4	165798330	165820117	APELA	0	+	21787
chr19	54573149	54584634	TARM1	0	-	11485
chr4	100557686	100578985	C4orf54	0	-	21299
chr11	66313866	66330805	ACTN3	0	+	16939
chr7	330136	334388	FOXL3	0	+	4252
chr4	165675216	165724947	SMIM31	0	+	49731
chr4	9255104	9256696	USP17L19	0	+	1592
chr4	9269345	9270937	USP17L22	0	+	1592
chr4	9245605	9247197	USP17L17	0	+	1592
chr20	44162835	44176301	EPPIN-WFDC6	0	-	13466
chr5	17610605	17611692	TAF11L12	0	+	1087
chrX	36737902	36738646	H2AL1Q	0	+	744
chr4	17516788	17528727	CLRN2	0	+	11939
chr5	17444119	17486938	LINC02218	0	+	42819
chr4	57396772	57469673	THEGL	0	+	72901
chr2	97308474	97370624	FER1L5	0	+	62150
chr1	159401994	159402928	OR10J4	0	+	934
chr4	9264598	9266190	USP17L21	0	+	1592
chr19	40146553	40151287	LGALS16	0	+	4734
chr15	32681800	32695493	GOLGA8K	0	-	13693
chr4	22694537	22821198	GBA3	0	+	126661
chr16	66788543	66835523	TERB1	0	-	46980
chr4	107278549	107289935	GIMD1	0	-	11386
chr4	144917257	144940533	GYPB	0	-	23276
chr14	96332924	96392000	TUNAR	0	+	59076
chr4	165975018	165981706	TRIM75	0	+	6688
chrX	118212598	118284542	KIAA1210	0	-	71944
chr6	31674681	31685695	LY6G6F-LY6G6D	0	+	11014
chr4	147135667	147153419	REELD1	0	+	17752
chr4	9259850	9261442	USP17L20	0	+	1592
chr5	17634569	17635162	TAF11L14	0	+	593
chr19	36290890	36304201	PRODH2	0	-	13311
chr4	56685956	56703655	EXOC1L	0	+	17699
chr4	9250356	9251948	USP17L18	0	+	1592
chr4	9274090	9274640	USP17L23	0	+	550
chr6	112668532	112672496	RFPL4B	0	+	3964
chr3	129800674	129832070	ALG1L2	0	+	31396
chr12	11504757	11508525	PRB1	0	-	3768
chr16	1535887	1538982	PTX4	0	-	3095
chr1	192286122	192336415	RGS21	0	+	50293
chr3	191178952	191179245	PYDC2	0	+	293
chr8	82605866	82607293	SLC10A5	0	-	1427
chr8	10340388	10405095	PRSS51	0	-	64707
chr1	157061835	157082204	ETV3L	0	-	20369
chr8	7884599	7889340	FAM90A12P	0	-	4741
chr11	59240788	59246834	OR4D10	0	+	6046
chr15	23888696	23893014	MAGEL2	0	-	4318
chr10	124214169	124216868	ARMS2	0	+	2699
chr11	2181009	2182451	INS	0	-	1442
chr14	101346090	101370059	RTL1	0	-	23969
chr11	55976461	55982698	OR8J2	0	-	6237
chr11	123883704	123889439	OR10G4	0	+	5735
chr11	56344212	56345263	KNOWN	0	-	1051
chr11	89819118	89820299	UBTFL1	0	+	1181
chr11	56376712	56382350	OR5M1	0	-	5638
chr11	58853780	58862259	GLYATL1B	0	+	8479
chr15	35375611	35377496	NANOGP8	0	-	1885
chr11	56309816	56310733	OR5M11	0	-	917
chr8	7397149	7399972	PRR23D1	0	+	2823
chr11	117874349	117959014	SMIM35	0	-	84665
chr11	124126272	124136120	OR8G5	0	+	9848
chr11	6190585	6191556	OR52B2	0	-	971
chr11	22868468	22882020	CCDC179	0	-	13552
chr8	7636113	7638935	PRR23D2	0	-	2822
chr11	59745493	59798550	OOSP4B	0	+	53057
chr8	11618896	11620309	KNOWN	0	+	1413
chr3	73110810	73112488	EBLN2	0	+	1678
chr11	124082414	124086535	OR8G3P	0	+	4121
chr11	105008441	105402424	CARD18	0	-	393983
chr16	28648975	28670065	NPIPB8	0	+	21090
chr14	22101992	22103096	OR10G2	0	-	1104
chr12	10564911	10588600	ENSG00000255641	0	-	23689
chr17	56244343	56248772	OR4D2	0	+	4429
chr14	23099834	23113561	OR6J1	0	-	13727
chr5	134779916	134788041	TIFAB	0	-	8125
chr11	94782586	94784502	KDM4F	0	+	1916
chr1	159804264	159842843	ENSG00000256029	0	-	38579
chrX	55207824	55208944	KNOWN	0	-	1120
chr6	131148546	131158275	SMLR1	0	+	9729
chr1	148201752	148202536	KNOWN	0	-	784
chr1	54598359	54665746	ENSG00000256407	0	-	67387
chr18	76739818	76762677	SALL3	0	+	22859
chr12	10163226	10171395	CLEC12B	0	+	8169
chr11	61008647	61018916	PGA5	0	+	10269
chr12	10034088	10048432	KLRF2	0	+	14344
chr12	101549271	101604016	SLC5A8	0	-	54745
chr17	72363597	72368739	GPR142	0	+	5142
chr11	94245627	94265289	C11orf97	0	+	19662
chr14	19377594	19378574	OR11H12	0	+	980
chr14	36942412	36990354	SFTA3	0	-	47942
chr7	141811518	141922124	MGAM2	0	+	110606
chr12	49121218	49159573	TEX49	0	+	38355
chr7	141951963	141957878	PRSS58	0	-	5915
chr19	52956806	53020135	ZNF578	0	+	63329
chr8	133036485	133097902	ENSG00000258417	0	-	61417
chr14	20181063	20182491	OR11H2	0	-	1428
chr14	94830650	94833035	SERPINA2	0	-	2385
chr14	20697561	20698505	OR11H7	0	+	944
chr11	49973943	49974971	OR4C13	0	+	1028
chr19	57665389	57678853	DUXA	0	-	13464
chr14	104941015	105071984	TMEM179	0	-	130969
chrY	9304564	9307358	TSPY1	0	+	2794
chr19	48362492	48364978	TPRX2	0	+	2486
chr14	21051051	21077954	ENSG00000259060	0	-	26903
chr11	121986048	121986923	BLID	0	-	875
chr16	33647251	33647696	IGHV3OR16-17	0	-	445
chr16	89262169	89268059	SLC22A31	0	-	5890
chr19	7979715	7983982	TGFBR3L	0	+	4267
chr9	111892573	111929529	FRRS1L	0	-	36956
chr3	150600784	150659530	ENSG00000260234	0	-	58746
chr16	71463883	71475957	TLE7	0	-	12074
chrX	110754873	110765627	SERTM2	0	+	10754
chr20	1520790	1600655	ENSG00000260861	0	-	79865
chr20	30555954	30591190	XKR7	0	+	35236
chr16	19297053	19333467	CLEC19A	0	+	36414
chr15	30427254	30440951	GOLGA8T	0	+	13697
chr6	30978251	31003179	MUC22	0	+	24928
chr12	52211683	52242502	FIGNL2	0	-	30819
chr19	51279398	51296399	ENSG00000261341	0	-	17001
chr10	92828	120103	TUBB8	0	-	27275
chr16	33262082	33264719	TP53TG3B	0	+	2637
chr15	29086978	29093821	GOLGA6L7	0	-	6843
chr8	144162047	144164903	LY6L	0	+	2856
chr15	23599895	23613488	GOLGA8S	0	+	13593
chr8	67858736	67874826	TCF24	0	-	16090
chr9	140063306	140066436	ENSG00000261793	0	-	3130
chr15	30896231	30909955	GOLGA8H	0	+	13724
chr17	53525794	53588805	SMIM36	0	-	63011
chr19	49927006	49932244	GFY	0	+	5238
chr17	3057183	3058176	OR1P1	0	-	993
chr16	3038257	3052017	GREP1	0	+	13760
chr17	4704454	4710308	C17orf114	0	-	5854
chr6	44184663	44185971	MYMX	0	+	1308
chr7	74911442	74918576	SPDYE9	0	+	7134
chr6	138699042	138704623	SMIM28	0	+	5581
chr17	2965963	2966901	OR1D5	0	-	938
chr19	51891543	51893845	C19orf84	0	-	2302
chr10	48411774	48416908	GDF2	0	-	5134
chr10	5196115	5227150	AKR1C8	0	-	31035
chr17	10346607	10372876	MYH4	0	-	26269
chr10	47083457	47088320	NPY4R2	0	+	4863
chr10	48381481	48390999	RBP3	0	-	9518
chr10	118380465	118404654	PNLIPRP2	0	+	24189
chr17	26125832	26220391	ENSG00000266202	0	-	94559
chr7	130415525	130418967	KLF14	0	-	3442
chr10	48425785	48439165	GDF10	0	-	13380
chr19	44833848	44905774	ENSG00000267173	0	-	71926
chr19	11577055	11616513	ENSG00000267477	0	-	39458
chr14	70036516	70041588	CCDC177	0	-	5072
chrX	48242957	48252789	SSX4	0	+	9832
chr19	57999086	58028927	ENSG00000268107	0	+	29841
chr19	57154527	57168615	SMIM17	0	+	14088
chrX	153448085	153462352	OPN1MW	0	+	14267
chr5	115368021	115395815	ARL14EPL	0	+	27794
chrX	101470277	101484526	TCP11X1	0	+	14249
chr19	8740083	8791414	NFILZ	0	+	51331
chr19	49521225	49523806	ENSG00000268655	0	-	2581
chr19	23015093	23041469	ZNF723	0	+	26376
chrX	148674172	148676974	HSFX2	0	-	2802
chr5	17491076	17492185	H3Y2	0	-	1109
chrX	142795055	142803846	SPANXN2	0	-	8791
chr1	17060447	17060956	KNOWN	0	-	509
chr19	17547420	17571613	ENSG00000269035	0	-	24193
chr19	23157685	23185978	ZNF728	0	-	28293
chr22	21358030	21360736	NOVEL	0	-	2706
chr19	21587961	21674068	ENSG00000269237	0	+	86107
chrX	101502161	101581636	NXF2	0	+	79475
chr5	17654977	17655958	H3Y1	0	-	981
chrX	72091859	72163679	DMRTC1	0	-	71820
chr19	57285915	57352099	ZIM2	0	-	66184
chr19	17498005	17505005	CCDC194	0	-	7000
chrX	48261524	48271405	SSX4B	0	-	9881
chr19	58907023	58908446	RNF225	0	+	1423
chr6	78359991	78636762	MEI4	0	+	276771
chr17	60349848	60360276	NOVEL	0	-	10428
chr7	142374104	142375550	KNOWN	0	+	1446
chr17	34071530	34080258	GAS2L2	0	-	8728
chr1	148644036	148644795	PPIAL4E	0	+	759
chr5	135527156	135528850	SMIM32	0	-	1694
chr4	187347700	187476482	ENSG00000272297	0	-	128782
chr19	39736954	39739496	IFNL4	0	-	2542
chr11	56180172	56181156	OR5AL1	0	+	984
chr12	54379629	54428672	ENSG00000273049	0	+	49043
chr12	13590876	14134936	GRIN2B	0	-	544060
chr11	5090802	5091727	OR52E1	0	+	925
chr19	42341148	42348760	LYPD4	0	-	7612
chr1	149389123	149400553	H3-7	0	-	11430
chr4	567669	570084	TMEM271	0	-	2415
chr15	86623102	87592400	AGBL1	0	+	969298
chr6	27782800	27783267	H2BC14	0	+	467
chr15	23569676	23579343	ENSG00000273756	0	-	9667
chr19	45005729	45033811	CEACAM20	0	-	28082
chr10	47657581	47701443	ANTXRL	0	+	43862
chr22	20366211	20368028	GGTLC3	0	-	1817
chr8	74153566	74171765	C8orf89	0	-	18199
chr7	72518310	72569519	SPDYE10	0	-	51209
chrX	50108408	50213824	DGKK	0	-	105416
chr22	21738040	21743767	RIMBP3B	0	+	5727
chr6	27861203	27861669	H2BC17	0	+	466
chr17	34340096	34345009	CCL23	0	-	4913
chr21	32201357	32202078	KRTAP7-1	0	-	721
chr6	27114885	27115341	H2AC12	0	+	456
chr22	22838767	22863060	ZNF280B	0	-	24293
chr16	33205547	33208186	TP53TG3E	0	+	2639
chr6	27840926	27841312	H4C13	0	-	386
chr17	34303529	34308533	CCL16	0	-	5004
chr6	27805658	27806153	H2AC15	0	-	495
chr6	27839623	27840124	H3C11	0	-	501
chr17	36991339	36997691	C17orf98	0	-	6352
chr7	2514363	2516528	GRIFIN	0	-	2165
chr8	6666038	6693046	XKR5	0	-	27008
chr6	26246839	26247224	H4C7	0	-	385
chr6	26020679	26021186	H3C1	0	+	507
chr17	34261522	34270717	LYZL6	0	-	9195
chr22	20455682	20461786	RIMBP3	0	-	6104
chr9	107366952	107367908	OR13C2	0	-	956
chr14	22136100	22142033	OR4E1	0	-	5933
chr6	27782080	27782555	H2AC14	0	-	475
chrX	142967173	142968362	UBE2NL	0	+	1189
chr6	26043455	26043941	H2BC3	0	-	486
chr10	49203355	49207825	FAM25C	0	-	4470
chr1	17698691	17728195	PADI6	0	+	29504
chr6	27833095	27833576	H2AC16	0	+	481
chr6	26188938	26189340	H4C4	0	-	402
chr17	2624095	2652946	CCDC92B	0	-	28851
chr15	20737094	20747114	GOLGA6L6	0	-	10020
chr17	36480454	36499839	GPR179	0	-	19385
chr19	46927954	46932193	PNMA8C	0	-	4239
chrX	118206956	118210728	ENSG00000277535	0	+	3772
chr9	107360738	107361694	OR13C5	0	-	956
chrX	154689076	154689666	H2AB3	0	-	590
chr10	46952511	46971400	SYT15B	0	-	18889
chr6	26250370	26250863	H3C7	0	-	493
chrX	154610358	154610948	H2AB2	0	+	590
chr11	5914438	5923960	OR52E5	0	+	9522
chr22	37600277	37608517	SSTR3	0	-	8240
chr6	26033320	26033846	H2AC4	0	-	526
chr15	22048290	22083259	POTEB3	0	-	34969
chr15	72084977	72110600	NR2E3	0	+	25623
chr6	26273159	26273640	H2BC10	0	+	481
chr6	26021877	26022278	H4C1	0	+	401
chrX	120011350	120012778	ENSG00000278646	0	-	1428
chr7	150887960	150902582	IQCA1L	0	-	14622
chr16	32684849	32687486	TP53TG3F	0	-	2637
chr9	35957105	35958151	OR2S2	0	-	1046
chr11	7946139	7952815	OR10A6	0	-	6676
chr1	158548709	158549689	OR10X1	0	-	980
chr11	124189158	124190093	OR8D2	0	-	935
chr1	13447429	13452656	PRAMEF13	0	-	5227
chr1	248112160	248113098	OR2L8	0	+	938
chr1	248786858	248798392	OR2T11	0	-	11534
chr11	55578843	55579952	OR5L1	0	+	1109
chr11	6804251	6812789	OR2AG1	0	+	8538
chr11	55339604	55340536	OR4C16	0	+	932
chr11	55540914	55541858	OR5D13	0	+	944
chr11	56184734	56185708	OR8U3	0	-	974
chr5	140602944	140625429	ENSG00000279983	0	+	22485
chr11	124293838	124294767	OR8B4	0	-	929
chr9	125390858	125391852	OR1B1	0	-	994
chr11	57980192	57983556	OR1S1	0	+	3364
chr11	56082620	56088115	OR8K3	0	+	5495
chr15	22303184	22383815	LINC02203	0	+	80631
chrY	22917994	22942918	RPS4Y2	0	+	24924
chr13	52387483	52419313	TMEM272	0	-	31830
chr5	131142836	131347330	ENSG00000281938	0	-	204494
chr7	99282580	99332725	CYP3A7-CYP3A51P	0	-	50145
chrX	124453720	124459065	TEX13C	0	+	5345
chr1	26490592	26495454	C1orf232	0	-	4862
chr1	46997838	47009641	TMEM275	0	-	11803
chr1	44603493	44607303	KLF18	0	-	3810
chr14	103550547	103556364	LBHD2	0	+	5817
chrX	51424145	51425764	CENPVL2	0	-	1619
chr9	90571129	90571798	ENSG00000283205	0	+	669
chr1	152919682	152921731	SPRR5	0	+	2049
chr7	45899593	45912681	CCDC201	0	-	13088
chr7	89945817	89950618	FAM237B	0	-	4801
chr5	138850589	138853285	SMIM33	0	+	2696
chr1	150859612	150885768	CTXND2	0	+	26156
chr9	38694263	38720130	FAM240B	0	-	25867
chr13	114920166	114988560	CFAP97D2	0	+	68394
chr2	225568481	225581082	CCDC195	0	-	12601
chr3	88387566	88516744	CSNKA2IP	0	+	129178
chr3	46654015	46668033	FAM240A	0	+	14018
chr16	8976208	8979208	LITAFD	0	+	3000
chr9	134420910	134435202	PRRT1B	0	+	14292
chr12	53635684	53636506	ENSG00000283536	0	+	822
chr19	55974368	55976118	C19orf85	0	-	1750
chrX	70887392	70891374	ENSG00000283599	0	+	3982
chr14	23568271	23574198	LMLN2	0	-	5927
chr1	171569761	171607939	MYOCOS	0	+	38178
